Chromosomes,Gene,Start,End,Size,Type
chr01,Bn1,2959419,79697775,76738356,TNL
chr01,Bn2,22169548,51997967,29828419,NBS
chr01,Bn3,85726275,92143898,6417623,CNL
chr01,Bn4,83436134,92313241,8877107,TNL
chr01,Bn5,53472004,88236381,34764377,NBS
chr01,Bn6,55259840,72540703,17280863,CN
chr01,Bn7,69161505,87964137,18802632,NBS
chr01,Bn8,86749186,92056352,5307166,RLK
chr01,Bn9,75176352,89964977,14788625,CNL
chr01,Bn10,70305134,94866518,24561384,CN
chr01,Bn11,40095137,57321083,17225946,CNL
chr01,Bn12,46378414,81503688,35125274,TNL
chr01,Bn13,37889502,88231099,50341597,RLK
chr01,Bn14,31014304,86824237,55809933,TN
chr01,Bn15,39346596,61877917,22531321,CN
chr01,Bn16,83459729,96350678,12890949,TNL
chr01,Bn17,87838478,95647742,7809264,TN
chr01,Bn18,17796049,75639052,57843003,NBS
chr01,Bn19,53939905,54102900,162995,RLK
chr01,Bn20,59283866,80580459,21296593,TNL
chr01,Bn21,43882104,55217723,11335619,RLK
chr01,Bn22,65486946,65979485,492539,TNL
chr01,Bn23,3971816,78931141,74959325,RLP
chr01,Bn24,39778400,52089620,12311220,TNL
chr01,Bn25,13313432,65856936,52543504,TNL
chr01,Bn26,48951375,94127297,45175922,RLP
chr01,Bn27,5456005,5645144,189139,TN
chr01,Bn28,95283218,99874269,4591051,CNL
chr01,Bn29,48623091,65644523,17021432,TNL
chr01,Bn30,96954532,97494779,540247,NBS
chr01,Bn31,49913711,65932775,16019064,RLK
chr01,Bn32,87240089,87647156,407067,TNL
chr01,Bn33,71216346,94633925,23417579,RLK
chr01,Bn34,57166392,82174865,25008473,NBS
chr01,Bn35,53240358,58421225,5180867,TN
chr01,Bn36,18590604,54351615,35761011,RLK
chr01,Bn37,29012996,85519767,56506771,RLK
chr01,Bn38,89738642,98250341,8511699,CNL
chr01,Bn39,97002105,99869903,2867798,NBS
chr01,Bn40,90512569,98404045,7891476,CNL
chr01,Bn41,43120571,54329516,11208945,TN
chr01,Bn42,66226034,80661477,14435443,NBS
chr01,Bn43,89532139,98709460,9177321,NBS
chr01,Bn44,22986201,27821845,4835644,NBS
chr01,Bn45,88837552,92532048,3694496,TN
chr01,Bn46,61613526,65324284,3710758,CNL
chr01,Bn47,92602226,98293063,5690837,CN
chr01,Bn48,81973545,98503449,16529904,RLK
chr01,Bn49,19220684,90608315,71387631,CN
chr01,Bn50,97062242,97163729,101487,TNL
chr01,Bn51,70180934,88983735,18802801,CNL
chr01,Bn52,57215188,75863066,18647878,TNL
chr01,Bn53,83881917,96826619,12944702,NBS
chr01,Bn54,40777717,46824949,6047232,RLP
chr01,Bn55,24404537,71066598,46662061,CNL
chr01,Bn56,13885715,85550770,71665055,CN
chr01,Bn57,39639946,79396770,39756824,RLK
chr01,Bn58,13156931,18419087,5262156,TNL
chr01,Bn59,29067417,81640182,52572765,NBS
chr01,Bn60,40803848,69781015,28977167,CN
chr01,Bn61,44048786,70363443,26314657,RLK
chr01,Bn62,83551577,91962665,8411088,CNL
chr01,Bn63,58686005,72210010,13524005,RLK
chr01,Bn64,26793342,67872081,41078739,RLP
chr01,Bn65,92450441,95369730,2919289,CN
chr01,Bn66,59794237,85512523,25718286,CN
chr01,Bn67,21982137,41781982,19799845,NBS
chr01,Bn68,19442367,74788304,55345937,NBS
chr01,Bn69,93505507,94678141,1172634,RLP
chr01,Bn70,67069128,96880011,29810883,CN
chr01,Bn71,18825835,71914291,53088456,CNL
chr01,Bn72,80560340,96633975,16073635,RLK
chr01,Bn73,24138918,51814651,27675733,TNL
chr01,Bn74,9567194,47273124,37705930,TN
chr01,Bn75,91894929,92711159,816230,RLK
chr01,Bn76,26112743,29951168,3838425,CNL
chr01,Bn77,87041439,90819766,3778327,TNL
chr01,Bn78,7868409,31089958,23221549,NBS
chr01,Bn79,81347111,96300087,14952976,RLP
chr01,Bn80,57814587,65393864,7579277,NBS
chr01,Bn81,64740916,86282612,21541696,NBS
chr01,Bn82,32644338,61466855,28822517,CN
chr01,Bn83,94913984,99963349,5049365,CNL
chr01,Bn84,65635731,68712383,3076652,TNL
chr01,Bn85,81865058,93624703,11759645,TN
chr01,Bn86,10890489,27120633,16230144,TN
chr01,Bn87,68808138,84835680,16027542,CNL
chr01,Bn88,10978819,54752730,43773911,RLP
chr01,Bn89,32785177,48738191,15953014,CNL
chr01,Bn90,18292161,50034936,31742775,RLP
chr01,Bn91,7663192,36611427,28948235,CN
chr01,Bn92,38151216,98483725,60332509,RLP
chr01,Bn93,39667132,40391753,724621,RLK
chr01,Bn94,54828964,63675999,8847035,NBS
chr01,Bn95,90858655,97709614,6850959,TN
chr01,Bn96,17951398,28797403,10846005,CN
chr01,Bn97,4141441,78980280,74838839,CN
chr01,Bn98,14900426,32282208,17381782,NBS
chr01,Bn99,46386426,47599333,1212907,RLP
chr01,Bn100,45953850,66445773,20491923,TNL
chr01,Bn101,40719858,84163273,43443415,RLK
chr01,Bn102,34813721,95726530,60912809,RLK
chr01,Bn103,3078180,98334396,95256216,TNL
chr01,Bn104,34782617,35137246,354629,CNL
chr01,Bn105,88404540,91069410,2664870,NBS
chr01,Bn106,72473868,73073486,599618,RLP
chr01,Bn107,64811063,94845844,30034781,TNL
chr01,Bn108,41584389,82997687,41413298,CNL
chr01,Bn109,18481019,43422016,24940997,TN
chr01,Bn110,17855840,49862099,32006259,NBS
chr01,Bn111,48791649,69559561,20767912,NBS
chr01,Bn112,27849567,92933970,65084403,NBS
chr01,Bn113,46261560,48068224,1806664,CN
chr01,Bn114,21800243,79176606,57376363,TNL
chr01,Bn115,51206815,57842030,6635215,TNL
chr01,Bn116,72629532,84709796,12080264,TN
chr01,Bn117,15566287,49444432,33878145,CN
chr01,Bn118,31485572,90803122,59317550,TNL
chr01,Bn119,37041105,58966154,21925049,RLP
chr01,Bn120,47148887,92610747,45461860,TNL
chr01,Bn121,51175121,63833735,12658614,TNL
chr01,Bn122,72738999,97686076,24947077,TNL
chr01,Bn123,84184987,84507925,322938,CN
chr01,Bn124,24532279,30208072,5675793,RLK
chr01,Bn125,28355130,47518027,19162897,RLK
chr01,Bn126,11065361,43020384,31955023,NBS
chr01,Bn127,1397983,29897706,28499723,NBS
chr01,Bn128,20622827,80059478,59436651,TNL
chr01,Bn129,42099477,86010905,43911428,TN
chr01,Bn130,65126779,86671078,21544299,TN
chr01,Bn131,11377177,82742041,71364864,CN
chr01,Bn132,24624759,44943543,20318784,CN
chr01,Bn133,29741354,33419785,3678431,CN
chr01,Bn134,16789116,70635342,53846226,CN
chr01,Bn135,45913492,91866620,45953128,TNL
chr01,Bn136,27723862,90496189,62772327,RLK
chr01,Bn137,60618401,75696319,15077918,RLK
chr01,Bn138,36597173,88339319,51742146,NBS
chr01,Bn139,44625169,51924383,7299214,CNL
chr01,Bn140,75015507,89059614,14044107,RLK
chr01,Bn141,61349516,66708212,5358696,RLP
chr01,Bn142,85927071,96674875,10747804,RLP
chr01,Bn143,32060445,59890693,27830248,TNL
chr01,Bn144,65093613,67021768,1928155,CNL
chr01,Bn145,81376666,91945529,10568863,CN
chr01,Bn146,20163642,62289610,42125968,CN
chr01,Bn147,39034385,40703177,1668792,TNL
chr01,Bn148,53136555,97858658,44722103,RLK
chr01,Bn149,20251816,99245444,78993628,NBS
chr01,Bn150,93913145,97569283,3656138,NBS
chr01,Bn151,55326433,99722285,44395852,CN
chr01,Bn152,54448130,65912549,11464419,NBS
chr01,Bn153,38346443,99483124,61136681,CNL
chr01,Bn154,98318584,98815774,497190,CNL
chr01,Bn155,31898011,64908016,33010005,NBS
chr01,Bn156,26971781,77411400,50439619,CN
chr01,Bn157,81563565,88707135,7143570,TNL
chr01,Bn158,51066623,79302744,28236121,RLK
chr01,Bn159,16150856,46505585,30354729,NBS
chr01,Bn160,89184253,96189198,7004945,NBS
chr01,Bn161,86872178,99790872,12918694,CN
chr01,Bn162,66535242,88083049,21547807,NBS
chr01,Bn163,81360170,99282051,17921881,TNL
chr01,Bn164,82183688,90998010,8814322,RLK
chr01,Bn165,26960432,32905860,5945428,CN
chr01,Bn166,42556662,67802668,25246006,TN
chr01,Bn167,44916223,98252885,53336662,CN
chr01,Bn168,3358593,46576600,43218007,CNL
chr01,Bn169,51934362,52582104,647742,CNL
chr01,Bn170,63250708,96315765,33065057,RLK
chr01,Bn171,71907507,98534668,26627161,TN
chr01,Bn172,10963059,68070928,57107869,TN
chr01,Bn173,61220845,95410974,34190129,CNL
chr01,Bn174,44566673,74946334,30379661,CNL
chr01,Bn175,19815431,62598925,42783494,NBS
chr01,Bn176,73501498,91669040,18167542,CN
chr01,Bn177,80220415,94202980,13982565,CN
chr01,Bn178,29629961,72798460,43168499,NBS
chr01,Bn179,65434706,91296775,25862069,TNL
chr01,Bn180,36518132,78223602,41705470,RLK
chr01,Bn181,83134084,95127987,11993903,TNL
chr01,Bn182,49995772,50969633,973861,TNL
chr01,Bn183,22876023,37245392,14369369,CNL
chr01,Bn184,73219240,96198170,22978930,TNL
chr01,Bn185,72933954,73204660,270706,TNL
chr01,Bn186,50287271,78624439,28337168,TNL
chr01,Bn187,82376018,98344847,15968829,TNL
chr01,Bn188,66792249,78345084,11552835,TN
chr01,Bn189,80336229,98190272,17854043,TNL
chr01,Bn190,32886366,78454372,45568006,CN
chr01,Bn191,69343523,80503764,11160241,RLK
chr01,Bn192,6773918,79240751,72466833,CN
chr01,Bn193,89690524,98979925,9289401,CNL
chr01,Bn194,12416556,94896572,82480016,RLK
chr01,Bn195,81559732,89211537,7651805,CN
chr01,Bn196,29359819,86046174,56686355,CN
chr01,Bn197,47548102,91163879,43615777,RLP
chr01,Bn198,30103567,49536415,19432848,RLP
chr01,Bn199,80052688,96496002,16443314,TNL
chr01,Bn200,29438715,98440623,69001908,TNL
chr01,Bn201,32918669,90531879,57613210,RLK
chr01,Bn202,61575030,66802334,5227304,RLK
chr01,Bn203,45054719,52917652,7862933,TNL
chr01,Bn204,16585645,60327796,43742151,RLK
chr01,Bn205,21852915,71455837,49602922,CNL
chr01,Bn206,9437369,25035255,15597886,TN
chr01,Bn207,54740622,55989165,1248543,RLK
chr01,Bn208,51779169,73901912,22122743,TN
chr01,Bn209,47660352,56065746,8405394,TN
chr01,Bn210,9165408,21984417,12819009,TNL
chr01,Bn211,97924601,99484247,1559646,RLP
chr01,Bn212,17499874,75671180,58171306,CNL
chr01,Bn213,69067111,79329049,10261938,TN
chr01,Bn214,35952638,47541148,11588510,CNL
chr01,Bn215,31507495,93107538,61600043,NBS
chr01,Bn216,83695065,98322366,14627301,TNL
chr01,Bn217,20848629,74793230,53944601,RLP
chr01,Bn218,45268761,99982833,54714072,CNL
chr01,Bn219,85298007,92002801,6704794,NBS
chr01,Bn220,74815891,76319844,1503953,CNL
chr01,Bn221,52835491,54129297,1293806,NBS
chr01,Bn222,65429404,71368602,5939198,NBS
chr01,Bn223,96518609,96670382,151773,CN
chr01,Bn224,33967445,77051462,43084017,TN
chr01,Bn225,66353877,70263578,3909701,TNL
chr01,Bn226,4472059,58833630,54361571,NBS
chr01,Bn227,33246230,51937002,18690772,RLK
chr01,Bn228,13994393,84825064,70830671,CN
chr01,Bn229,65394436,69870611,4476175,CN
chr01,Bn230,4201477,79069085,74867608,RLP
chr01,Bn231,95457009,97042303,1585294,RLP
chr01,Bn232,22568940,71169566,48600626,RLP
chr01,Bn233,70317045,85938715,15621670,CN
chr01,Bn234,47162187,54691370,7529183,CNL
chr01,Bn235,98233422,98884201,650779,RLP
chr01,Bn236,36691780,72221770,35529990,TN
chr01,Bn237,83235217,93938594,10703377,CN
chr01,Bn238,42473764,94417443,51943679,TNL
chr01,Bn239,93122075,99803464,6681389,RLP
chr01,Bn240,73756086,79670538,5914452,TN
chr01,Bn241,34075377,74905060,40829683,NBS
chr01,Bn242,84700151,87990234,3290083,CN
chr01,Bn243,78656772,87021981,8365209,RLP
chr01,Bn244,71353928,86723853,15369925,RLK
chr01,Bn245,28827959,39755721,10927762,CN
chr01,Bn246,87152282,95363432,8211150,CNL
chr01,Bn247,14252589,63529749,49277160,TNL
chr01,Bn248,88803031,90150351,1347320,CN
chr01,Bn249,68333252,71892099,3558847,NBS
chr01,Bn250,17892824,41154285,23261461,CN
chr01,Bn251,92318884,93183279,864395,RLP
chr01,Bn252,87405698,89690751,2285053,TNL
chr01,Bn253,84499956,95897925,11397969,NBS
chr01,Bn254,95678015,99439530,3761515,CNL
chr01,Bn255,69867990,78596738,8728748,RLP
chr01,Bn256,82794704,85515917,2721213,RLP
chr01,Bn257,20416457,82043079,61626622,RLK
chr01,Bn258,72448412,80901172,8452760,TNL
chr01,Bn259,63221292,99992365,36771073,RLK
chr01,Bn260,2140772,54570083,52429311,CNL
chr01,Bn261,41654013,79623830,37969817,TNL
chr01,Bn262,74080132,99667182,25587050,TNL
chr01,Bn263,63940518,97968325,34027807,RLK
chr01,Bn264,12326978,20650456,8323478,RLP
chr01,Bn265,71695723,75156204,3460481,RLK
chr01,Bn266,30374035,56869164,26495129,TN
chr01,Bn267,42306685,95710051,53403366,TNL
chr01,Bn268,54511055,96316106,41805051,TNL
chr01,Bn269,11528324,99009880,87481556,CN
chr01,Bn270,44230876,74632295,30401419,CNL
chr01,Bn271,2708175,83919340,81211165,NBS
chr01,Bn272,46659082,70051621,23392539,TNL
chr01,Bn273,55599590,57270650,1671060,NBS
chr01,Bn274,44086999,52857687,8770688,TN
chr01,Bn275,31551847,93597980,62046133,TNL
chr01,Bn276,18965784,70365220,51399436,RLP
chr01,Bn277,31354404,76139528,44785124,CNL
chr01,Bn278,44644100,97936360,53292260,TNL
chr01,Bn279,32666798,61076568,28409770,TNL
chr01,Bn280,22046887,74202866,52155979,RLK
chr01,Bn281,13371285,31016515,17645230,CN
chr01,Bn282,86116320,95004846,8888526,TN
chr01,Bn283,5333999,25673829,20339830,TNL
chr01,Bn284,15688991,62276044,46587053,NBS
chr01,Bn285,90530132,99558134,9028002,RLP
chr01,Bn286,24572138,52715427,28143289,TNL
chr01,Bn287,24694231,66121186,41426955,TNL
chr01,Bn288,83645222,94918144,11272922,CNL
chr01,Bn289,1221298,78644754,77423456,RLK
chr01,Bn290,23542480,98652098,75109618,RLK
chr01,Bn291,56234497,92054982,35820485,TNL
chr01,Bn292,9086164,43669168,34583004,NBS
chr01,Bn293,3987578,45517565,41529987,TN
chr01,Bn294,77443134,94184795,16741661,RLP
chr01,Bn295,11671925,33902649,22230724,CNL
chr01,Bn296,43557201,56440965,12883764,TN
chr01,Bn297,96985246,99428768,2443522,CN
chr01,Bn298,27650254,72003017,44352763,CN
chr01,Bn299,36065541,99065286,62999745,RLP
chr01,Bn300,98327965,99492420,1164455,CNL
chr01,Bn301,63507179,69223550,5716371,RLP
chr01,Bn302,79632877,85803598,6170721,RLK
chr01,Bn303,67154759,95787701,28632942,CNL
chr01,Bn304,59924870,66054244,6129374,RLK
chr01,Bn305,41775431,73567489,31792058,NBS
chr01,Bn306,80405762,99353911,18948149,TN
chr01,Bn307,37897408,80674706,42777298,RLP
chr01,Bn308,45973483,80073858,34100375,RLK
chr01,Bn309,1191388,22725538,21534150,CNL
chr01,Bn310,59099450,79113241,20013791,NBS
chr01,Bn311,52734265,82663975,29929710,RLK
chr01,Bn312,38749079,88910436,50161357,CN
chr01,Bn313,7735005,24104434,16369429,CNL
chr01,Bn314,78153210,84059190,5905980,TNL
chr01,Bn315,48578816,51883638,3304822,CNL
chr01,Bn316,3943881,86829779,82885898,CNL
chr01,Bn317,7713568,81926506,74212938,CN
chr01,Bn318,34036330,46381768,12345438,RLK
chr01,Bn319,44569602,54001416,9431814,CN
chr01,Bn320,93312600,95591086,2278486,CNL
chr01,Bn321,57987564,64768665,6781101,CNL
chr01,Bn322,25444363,68964819,43520456,TNL
chr01,Bn323,33528456,54601578,21073122,RLP
chr01,Bn324,90590271,91801752,1211481,CN
chr01,Bn325,53207623,97895806,44688183,CNL
chr01,Bn326,65379238,82067800,16688562,NBS
chr01,Bn327,46028451,71162597,25134146,RLK
chr01,Bn328,14310957,97717757,83406800,NBS
chr01,Bn329,40914393,78095617,37181224,CN
chr01,Bn330,77418993,90934840,13515847,CNL
chr01,Bn331,69114756,69213631,98875,NBS
chr01,Bn332,87495015,96928278,9433263,NBS
chr01,Bn333,8441203,24479741,16038538,NBS
chr01,Bn334,80996537,99783002,18786465,RLP
chr01,Bn335,18679146,30763965,12084819,TNL
chr01,Bn336,78635119,88543998,9908879,CNL
chr01,Bn337,31756987,93010464,61253477,RLP
chr01,Bn338,5527115,23548019,18020904,CN
chr01,Bn339,35518345,39887977,4369632,TNL
chr01,Bn340,30850180,99975486,69125306,TNL
chr01,Bn341,62583899,71911744,9327845,RLP
chr01,Bn342,2345150,68635615,66290465,CNL
chr01,Bn343,76473866,79196978,2723112,RLK
chr01,Bn344,28800032,92099903,63299871,RLK
chr01,Bn345,2624874,19934117,17309243,RLK
chr01,Bn346,34467224,59115813,24648589,NBS
chr01,Bn347,84270314,89270205,4999891,TN
chr01,Bn348,30358482,78272315,47913833,NBS
chr01,Bn349,18901581,54284537,35382956,CN
chr01,Bn350,20373549,80146708,59773159,RLP
chr01,Bn351,77237870,85200769,7962899,CN
chr01,Bn352,63526882,77837943,14311061,CNL
chr01,Bn353,74981535,96227521,21245986,RLP
chr01,Bn354,65994999,82155921,16160922,NBS
chr01,Bn355,21535132,71116376,49581244,CN
chr01,Bn356,65149284,85068882,19919598,RLP
chr01,Bn357,66326022,77253935,10927913,TNL
chr01,Bn358,76164360,77303996,1139636,RLK
chr01,Bn359,55051596,79202955,24151359,NBS
chr01,Bn360,88464869,99074003,10609134,CN
chr01,Bn361,53874150,83532683,29658533,CN
chr01,Bn362,31300421,53210126,21909705,CN
chr01,Bn363,57612641,64653370,7040729,TN
chr01,Bn364,79382940,88707062,9324122,RLP
chr01,Bn365,41300941,97005775,55704834,CNL
chr01,Bn366,87225658,96770444,9544786,NBS
chr01,Bn367,57743875,92071549,34327674,CNL
chr01,Bn368,66250896,96249260,29998364,RLK
chr01,Bn369,71375335,79335530,7960195,CN
chr01,Bn370,28415855,66754837,38338982,TN
chr01,Bn371,45896614,64211899,18315285,TNL
chr01,Bn372,33869646,87403465,53533819,CNL
chr01,Bn373,16294671,77280706,60986035,TN
chr01,Bn374,17716199,59308464,41592265,NBS
chr01,Bn375,71721571,90822337,19100766,TN
chr01,Bn376,80455219,94488059,14032840,TN
chr01,Bn377,23922740,74965703,51042963,CNL
chr01,Bn378,63084219,83836180,20751961,RLK
chr01,Bn379,25951273,36616241,10664968,CNL
chr01,Bn380,18894780,97403093,78508313,TNL
chr01,Bn381,91306739,97962481,6655742,TN
chr01,Bn382,64119705,82289995,18170290,TN
chr01,Bn383,97936103,97940689,4586,TNL
chr01,Bn384,29521562,46774050,17252488,CN
chr01,Bn385,78740237,95080185,16339948,TNL
chr01,Bn386,25371788,69487983,44116195,TNL
chr01,Bn387,49112701,75780911,26668210,NBS
chr01,Bn388,7142559,73039834,65897275,RLK
chr01,Bn389,17857738,85769084,67911346,NBS
chr01,Bn390,69292760,79269625,9976865,RLP
chr01,Bn391,53632545,86701867,33069322,TN
chr01,Bn392,66415627,83828861,17413234,RLP
chr01,Bn393,71762850,80348819,8585969,NBS
chr01,Bn394,92073030,95707301,3634271,CNL
chr01,Bn395,71374599,99233761,27859162,TNL
chr01,Bn396,20087492,46264547,26177055,RLK
chr01,Bn397,97787373,98001990,214617,RLK
chr01,Bn398,27336471,37399963,10063492,NBS
chr01,Bn399,33661585,52802353,19140768,RLK
chr01,Bn400,42002117,91102568,49100451,CN
chr01,Bn401,44846678,51192264,6345586,CNL
chr01,Bn402,33486923,93131319,59644396,TNL
chr01,Bn403,92305860,96950011,4644151,CNL
chr01,Bn404,87041457,97375604,10334147,CN
chr01,Bn405,6000498,42577123,36576625,NBS
chr01,Bn406,93442535,98189555,4747020,NBS
chr01,Bn407,4429514,22589967,18160453,CN
chr01,Bn408,45366588,65382410,20015822,TNL
chr01,Bn409,76925791,78350625,1424834,RLP
chr01,Bn410,48216279,67414335,19198056,CN
chr01,Bn411,77179701,95362586,18182885,RLP
chr01,Bn412,59457810,98062853,38605043,CN
chr01,Bn413,87846006,93308413,5462407,TNL
chr01,Bn414,27929827,75285948,47356121,TN
chr01,Bn415,31384790,31649229,264439,CNL
chr01,Bn416,89288101,92496308,3208207,CN
chr01,Bn417,61706076,65894121,4188045,RLP
chr01,Bn418,76005382,79719937,3714555,RLK
chr01,Bn419,97937804,99253017,1315213,TN
chr01,Bn420,32949762,48331661,15381899,TNL
chr01,Bn421,95243862,97859649,2615787,TN
chr01,Bn422,6569308,79078164,72508856,CN
chr01,Bn423,85208304,92063957,6855653,CN
chr01,Bn424,90140040,92510893,2370853,RLP
chr01,Bn425,72183447,97931088,25747641,RLP
chr01,Bn426,48517019,69290516,20773497,TN
chr01,Bn427,32985645,61983304,28997659,TNL
chr01,Bn428,57760466,64148994,6388528,TN
chr01,Bn429,64200602,91673356,27472754,CNL
chr01,Bn430,24870738,64334655,39463917,RLK
chr01,Bn431,49250341,72451280,23200939,RLK
chr01,Bn432,33670690,81684200,48013510,TN
chr01,Bn433,98832552,99852616,1020064,RLP
chr01,Bn434,11330633,90327835,78997202,CNL
chr01,Bn435,19450255,94928998,75478743,TNL
chr01,Bn436,81413168,90739266,9326098,TNL
chr01,Bn437,21405083,35726441,14321358,CN
chr01,Bn438,60714323,74268498,13554175,CN
chr01,Bn439,14010406,22336176,8325770,RLK
chr01,Bn440,91032773,98985449,7952676,RLK
chr01,Bn441,39796577,78000710,38204133,CN
chr01,Bn442,21562904,57763308,36200404,TN
chr01,Bn443,63484779,97505366,34020587,CNL
chr01,Bn444,34385206,64955403,30570197,RLP
chr01,Bn445,52404770,59689019,7284249,TNL
chr01,Bn446,59097201,85091605,25994404,NBS
chr01,Bn447,73939806,74416008,476202,RLP
chr01,Bn448,36647607,93504030,56856423,CN
chr01,Bn449,14914058,65477393,50563335,NBS
chr01,Bn450,76240383,91444243,15203860,TNL
chr01,Bn451,4186643,34964556,30777913,CNL
chr01,Bn452,99647913,99664919,17006,CN
chr01,Bn453,24857079,30599299,5742220,TN
chr01,Bn454,89990408,97641574,7651166,CNL
chr01,Bn455,77818811,79967236,2148425,RLK
chr01,Bn456,77820100,94297380,16477280,RLK
chr01,Bn457,47557318,76472446,28915128,RLK
chr01,Bn458,50161929,88447128,38285199,NBS
chr01,Bn459,48525713,73612216,25086503,TN
chr01,Bn460,10632953,91672072,81039119,CNL
chr01,Bn461,82091451,86748268,4656817,CNL
chr01,Bn462,26166943,72836942,46669999,NBS
chr01,Bn463,17080282,68352900,51272618,TN
chr01,Bn464,99448132,99711354,263222,CN
chr01,Bn465,80934350,84775342,3840992,CN
chr01,Bn466,61341007,65039384,3698377,RLK
chr01,Bn467,43955924,92089904,48133980,CN
chr01,Bn468,26218103,49968752,23750649,NBS
chr01,Bn469,41720835,51350057,9629222,CN
chr01,Bn470,12306815,19875317,7568502,NBS
chr01,Bn471,27434821,56161782,28726961,CN
chr01,Bn472,79646463,85385847,5739384,RLK
chr01,Bn473,79736418,89685461,9949043,NBS
chr01,Bn474,32704318,86428315,53723997,NBS
chr01,Bn475,6369524,59298249,52928725,CNL
chr01,Bn476,55703329,77800093,22096764,TN
chr01,Bn477,2244967,3982937,1737970,RLP
chr01,Bn478,65132157,80864386,15732229,TN
chr01,Bn479,80381915,99267255,18885340,RLK
chr01,Bn480,44988632,81051311,36062679,RLK
chr01,Bn481,59077256,96668285,37591029,CNL
chr01,Bn482,19656272,20050442,394170,CN
chr01,Bn483,72545590,92669701,20124111,TN
chr01,Bn484,11308931,69272754,57963823,CNL
chr01,Bn485,34226310,50487724,16261414,TNL
chr01,Bn486,46848596,55966891,9118295,CNL
chr01,Bn487,9751960,94781156,85029196,RLK
chr01,Bn488,15072208,54899388,39827180,TNL
chr01,Bn489,60895563,77169344,16273781,RLP
chr01,Bn490,95152320,98480446,3328126,RLP
chr01,Bn491,3666905,51636937,47970032,TN
chr01,Bn492,36484004,40964429,4480425,CN
chr01,Bn493,1649405,82394306,80744901,CNL
chr01,Bn494,85158140,86129123,970983,NBS
chr01,Bn495,40662100,94695040,54032940,CNL
chr01,Bn496,30854111,95986473,65132362,CNL
chr01,Bn497,75940962,79719838,3778876,CNL
chr01,Bn498,27459997,39378080,11918083,RLK
chr01,Bn499,78962845,91058367,12095522,CN
chr01,Bn500,84564977,92424740,7859763,TN
chr01,Bn501,43726946,93215486,49488540,TNL
chr01,Bn502,46924272,49938894,3014622,TNL
chr01,Bn503,82135575,99900739,17765164,TN
chr01,Bn504,37065707,53188037,16122330,TNL
chr01,Bn505,10013281,54555195,44541914,CNL
chr01,Bn506,73355369,93976492,20621123,TN
chr01,Bn507,60224443,88137098,27912655,RLK
chr01,Bn508,7510722,90061315,82550593,NBS
chr01,Bn509,46518724,98281509,51762785,CNL
chr01,Bn510,13684638,92162482,78477844,RLK
chr01,Bn511,27297726,41896468,14598742,RLK
chr01,Bn512,83854209,94045405,10191196,RLK
chr01,Bn513,71191368,95008291,23816923,TNL
chr01,Bn514,46466737,73412295,26945558,RLK
chr01,Bn515,47301641,48028551,726910,RLK
chr01,Bn516,6443204,41299725,34856521,NBS
chr01,Bn517,76654698,91681919,15027221,TN
chr01,Bn518,32695122,84563312,51868190,RLK
chr01,Bn519,34014682,47661703,13647021,NBS
chr01,Bn520,42286460,87176112,44889652,NBS
chr01,Bn521,10937526,96769491,85831965,CN
chr01,Bn522,35745961,50578820,14832859,CN
chr01,Bn523,58735526,79827261,21091735,RLK
chr01,Bn524,29160390,57414881,28254491,RLK
chr01,Bn525,14488100,98403903,83915803,CN
chr01,Bn526,27535614,50105676,22570062,CNL
chr01,Bn527,10970673,68781670,57810997,CN
chr01,Bn528,21626016,52790659,31164643,NBS
chr01,Bn529,30962346,58795076,27832730,TNL
chr01,Bn530,1451766,72602446,71150680,RLK
chr01,Bn531,69099651,79725392,10625741,TNL
chr01,Bn532,95793300,96881431,1088131,TN
chr01,Bn533,77081186,92913398,15832212,RLK
chr01,Bn534,47224542,74490953,27266411,TN
chr01,Bn535,85143604,99720799,14577195,TNL
chr01,Bn536,34181924,37790778,3608854,TN
chr01,Bn537,69305466,88725715,19420249,RLK
chr01,Bn538,53969548,63847259,9877711,CN
chr01,Bn539,66254092,73681238,7427146,TNL
chr01,Bn540,74087066,74291100,204034,NBS
chr01,Bn541,96513105,98112568,1599463,CNL
chr01,Bn542,64521572,69027125,4505553,NBS
chr01,Bn543,71306117,96056549,24750432,NBS
chr01,Bn544,80775937,85491202,4715265,TNL
chr01,Bn545,39507303,90002958,50495655,CN
chr01,Bn546,60309372,92670356,32360984,RLP
chr01,Bn547,36703253,77263246,40559993,CN
chr01,Bn548,69973400,95293976,25320576,RLK
chr01,Bn549,16555433,51483106,34927673,TN
chr01,Bn550,78692887,96951369,18258482,CN
chr01,Bn551,65028948,80208787,15179839,TNL
chr01,Bn552,85935779,89837996,3902217,NBS
chr01,Bn553,74847548,98155933,23308385,NBS
chr01,Bn554,40478898,94939525,54460627,NBS
chr01,Bn555,50502814,91690886,41188072,RLK
chr01,Bn556,44424300,62327682,17903382,CNL
chr01,Bn557,89032293,92532447,3500154,RLP
chr01,Bn558,37156128,88775541,51619413,CNL
chr01,Bn559,41292767,63109323,21816556,NBS
chr01,Bn560,9775129,29401983,19626854,RLK
chr01,Bn561,74847937,94949824,20101887,NBS
chr01,Bn562,80782145,87498856,6716711,CN
chr01,Bn563,85879303,93274136,7394833,TNL
chr01,Bn564,58911228,80123882,21212654,RLP
chr01,Bn565,93177093,94823105,1646012,TN
chr01,Bn566,19168146,98939831,79771685,CNL
chr01,Bn567,98240799,98733035,492236,RLK
chr01,Bn568,59038730,74715061,15676331,TN
chr01,Bn569,64903701,97869777,32966076,CN
chr01,Bn570,12721424,58375019,45653595,TN
chr01,Bn571,23221315,35148591,11927276,RLK
chr01,Bn572,10333325,10423984,90659,CNL
chr01,Bn573,15141331,53659175,38517844,RLK
chr01,Bn574,3608611,41140147,37531536,CNL
chr01,Bn575,43956919,45308261,1351342,NBS
chr01,Bn576,42907801,45318672,2410871,NBS
chr01,Bn577,81262559,82605082,1342523,RLP
chr01,Bn578,99895756,99929849,34093,NBS
chr01,Bn579,57573873,76895734,19321861,NBS
chr01,Bn580,19421470,54879732,35458262,TN
chr01,Bn581,94121228,96659899,2538671,CNL
chr01,Bn582,63906110,93997256,30091146,TN
chr01,Bn583,11008445,51115676,40107231,NBS
chr01,Bn584,88718940,95942889,7223949,TN
chr01,Bn585,12071827,58444754,46372927,RLP
chr01,Bn586,30235134,41960614,11725480,NBS
chr01,Bn587,61997175,71181169,9183994,RLK
chr01,Bn588,42359474,83722512,41363038,TN
chr01,Bn589,43356358,98478122,55121764,CN
chr01,Bn590,65271856,66608930,1337074,NBS
chr01,Bn591,66082509,94833040,28750531,TN
chr01,Bn592,66335185,68770713,2435528,NBS
chr01,Bn593,18655775,56576288,37920513,CNL
chr01,Bn594,14847365,28679538,13832173,TN
chr01,Bn595,21921112,52094788,30173676,CN
chr01,Bn596,41760878,94795398,53034520,NBS
chr01,Bn597,48313376,99318918,51005542,NBS
chr01,Bn598,26392343,73017362,46625019,TN
chr01,Bn599,14065442,70650149,56584707,TN
chr01,Bn600,75180054,77798248,2618194,NBS
chr01,Bn601,38676090,53370367,14694277,TN
chr01,Bn602,77197185,79562294,2365109,CNL
chr01,Bn603,67955056,74769204,6814148,TNL
chr01,Bn604,69464092,91680155,22216063,CN
chr01,Bn605,58358898,82983393,24624495,RLK
chr01,Bn606,84027653,92216650,8188997,NBS
chr01,Bn607,28780135,57545076,28764941,TN
chr01,Bn608,67676901,70148643,2471742,CNL
chr01,Bn609,91993525,95873795,3880270,TNL
chr01,Bn610,12857008,40560703,27703695,NBS
chr01,Bn611,26277293,64826760,38549467,TN
chr01,Bn612,92072214,98192801,6120587,RLK
chr01,Bn613,99553258,99697828,144570,CN
chr01,Bn614,16494942,83059433,66564491,RLK
chr01,Bn615,96311132,99279461,2968329,RLK
chr01,Bn616,46080030,71295533,25215503,TNL
chr01,Bn617,90382305,92559693,2177388,NBS
chr01,Bn618,4876141,99176690,94300549,RLP
chr01,Bn619,25594466,30128031,4533565,TN
chr01,Bn620,36723987,40913551,4189564,TN
chr01,Bn621,34817691,79603049,44785358,CN
chr01,Bn622,42040120,68060127,26020007,TN
chr01,Bn623,87124167,97694011,10569844,TN
chr01,Bn624,92482250,97140688,4658438,NBS
chr01,Bn625,9431474,30426242,20994768,TN
chr01,Bn626,86836434,95704173,8867739,TNL
chr01,Bn627,83251248,89827647,6576399,CN
chr01,Bn628,68683851,71855765,3171914,CNL
chr01,Bn629,36558280,45597461,9039181,CNL
chr01,Bn630,83665319,95443253,11777934,CN
chr01,Bn631,5157191,51529109,46371918,RLK
chr01,Bn632,68894768,69298427,403659,CN
chr01,Bn633,58913691,97944277,39030586,CN
chr01,Bn634,5686454,8714481,3028027,RLK
chr01,Bn635,6892015,20335383,13443368,RLK
chr01,Bn636,50941235,75635212,24693977,CN
chr01,Bn637,24603703,63813403,39209700,TNL
chr01,Bn638,78908728,81613918,2705190,NBS
chr01,Bn639,75149282,78892064,3742782,TN
chr01,Bn640,38045556,68047080,30001524,NBS
chr01,Bn641,69679279,91157360,21478081,RLP
chr01,Bn642,17090336,31031054,13940718,CN
chr01,Bn643,5434519,19588843,14154324,NBS
chr01,Bn644,96764435,96853318,88883,NBS
chr01,Bn645,99020981,99849415,828434,RLK
chr01,Bn646,68140753,92058416,23917663,CN
chr01,Bn647,91192439,98920581,7728142,TNL
chr01,Bn648,10247800,23314823,13067023,TNL
chr01,Bn649,80200874,97364135,17163261,RLP
chr01,Bn650,60999849,62554546,1554697,CN
chr01,Bn651,73243406,88249075,15005669,TNL
chr01,Bn652,64808758,79219182,14410424,RLP
chr01,Bn653,70308123,95957665,25649542,TNL
chr01,Bn654,73627360,89289516,15662156,RLK
chr01,Bn655,80066316,88344568,8278252,TN
chr01,Bn656,19192649,49714247,30521598,TN
chr01,Bn657,8354582,28740372,20385790,TN
chr01,Bn658,47213444,66706467,19493023,CNL
chr01,Bn659,68914379,79750552,10836173,CNL
chr01,Bn660,6564401,63239184,56674783,RLK
chr01,Bn661,72544112,91001154,18457042,TNL
chr01,Bn662,24309716,61877160,37567444,RLK
chr01,Bn663,77578486,81596430,4017944,RLK
chr01,Bn664,50395089,80479896,30084807,TN
chr01,Bn665,86900912,96156895,9255983,CNL
chr01,Bn666,76184202,99757281,23573079,TNL
chr01,Bn667,41673727,71167927,29494200,RLK
chr01,Bn668,56631674,88718953,32087279,RLP
chr01,Bn669,2470397,76583418,74113021,RLP
chr01,Bn670,29420077,56761052,27340975,TN
chr01,Bn671,21585131,73504828,51919697,RLP
chr01,Bn672,36807197,50193650,13386453,CN
chr01,Bn673,1402145,87007185,85605040,NBS
chr01,Bn674,57376014,98651765,41275751,TN
chr01,Bn675,81265507,83840754,2575247,RLP
chr01,Bn676,56893942,58166495,1272553,TN
chr01,Bn677,21777542,96005410,74227868,TNL
chr01,Bn678,56928173,77343709,20415536,CNL
chr01,Bn679,24558315,68676478,44118163,CNL
chr01,Bn680,35521793,75693588,40171795,RLP
chr01,Bn681,68994355,86898629,17904274,NBS
chr01,Bn682,1737444,18717459,16980015,RLK
chr01,Bn683,16669859,58587760,41917901,RLP
chr01,Bn684,92092732,98824605,6731873,TN
chr01,Bn685,24004305,77469217,53464912,TN
chr01,Bn686,99624828,99790282,165454,TN
chr01,Bn687,17287707,99634975,82347268,CN
chr01,Bn688,16333061,27895972,11562911,TN
chr01,Bn689,73637779,76033841,2396062,CNL
chr01,Bn690,99751709,99991254,239545,CNL
chr01,Bn691,39742871,50596879,10854008,RLP
chr01,Bn692,73827187,83205373,9378186,NBS
chr01,Bn693,27463405,45468142,18004737,NBS
chr01,Bn694,87582401,99576429,11994028,TNL
chr01,Bn695,97885904,99032239,1146335,CN
chr01,Bn696,46291327,74283891,27992564,CNL
chr01,Bn697,56241243,78696737,22455494,TNL
chr01,Bn698,23376989,40946347,17569358,TNL
chr01,Bn699,4177605,70115083,65937478,RLP
chr01,Bn700,59575605,81337919,21762314,TNL
chr01,Bn701,63437069,71335144,7898075,TNL
chr01,Bn702,86511355,99791492,13280137,RLP
chr01,Bn703,22430095,60477562,38047467,CN
chr01,Bn704,82580109,98780016,16199907,RLP
chr01,Bn705,19874097,81352953,61478856,TNL
chr01,Bn706,35709748,48316392,12606644,CN
chr01,Bn707,40657711,60132318,19474607,RLK
chr01,Bn708,69131111,69489219,358108,RLK
chr01,Bn709,84387154,84793080,405926,NBS
chr01,Bn710,24751817,73722686,48970869,NBS
chr01,Bn711,41882077,81095591,39213514,TNL
chr01,Bn712,51684013,69387129,17703116,RLP
chr01,Bn713,72514161,74589345,2075184,TNL
chr01,Bn714,36459956,81187159,44727203,RLK
chr01,Bn715,22605515,79518387,56912872,TN
chr01,Bn716,33749176,55943635,22194459,TN
chr01,Bn717,47080733,56369235,9288502,NBS
chr01,Bn718,21512564,46966043,25453479,NBS
chr01,Bn719,17385168,37633165,20247997,CN
chr01,Bn720,10007760,66147420,56139660,NBS
chr01,Bn721,17587184,48161623,30574439,CNL
chr01,Bn722,31645535,90157558,58512023,TNL
chr01,Bn723,92433551,93591219,1157668,TN
chr01,Bn724,47427067,80335728,32908661,CNL
chr01,Bn725,50620233,52121330,1501097,TNL
chr01,Bn726,21355800,98694512,77338712,NBS
chr01,Bn727,98912149,99905040,992891,TN
chr01,Bn728,96478377,97130836,652459,TN
chr01,Bn729,14450978,53377317,38926339,TNL
chr01,Bn730,79871780,86451807,6580027,CN
chr01,Bn731,13961747,64045825,50084078,CN
chr01,Bn732,65721299,95614056,29892757,RLP
chr01,Bn733,64259448,92485012,28225564,CNL
chr01,Bn734,80184145,86322247,6138102,RLK
chr01,Bn735,90881242,99318485,8437243,RLK
chr01,Bn736,92451273,95480543,3029270,TN
chr01,Bn737,74049115,77553596,3504481,RLK
chr01,Bn738,38882123,45282085,6399962,RLP
chr01,Bn739,9125928,98584330,89458402,NBS
chr01,Bn740,67291715,98329482,31037767,TN
chr01,Bn741,54706134,92934720,38228586,NBS
chr01,Bn742,71300274,96346760,25046486,CNL
chr01,Bn743,28608528,94514994,65906466,TNL
chr01,Bn744,32842431,92116861,59274430,RLP
chr01,Bn745,74015455,88604218,14588763,RLP
chr01,Bn746,1677645,97987187,96309542,RLK
chr01,Bn747,17851043,54454385,36603342,CN
chr01,Bn748,93846768,99008361,5161593,CN
chr01,Bn749,72664161,81472408,8808247,TNL
chr01,Bn750,30041777,59351702,29309925,RLP
chr01,Bn751,9830242,88150343,78320101,RLK
chr01,Bn752,39655426,80328768,40673342,RLP
chr01,Bn753,60501958,91276789,30774831,CN
chr01,Bn754,80236932,93006732,12769800,CNL
chr01,Bn755,2032178,4274835,2242657,CNL
chr01,Bn756,71714677,82619533,10904856,RLK
chr01,Bn757,73085684,80849703,7764019,TN
chr01,Bn758,50798694,89933862,39135168,NBS
chr01,Bn759,26083785,64645644,38561859,CN
chr01,Bn760,63589439,75588242,11998803,NBS
chr01,Bn761,66246942,75348441,9101499,TN
chr01,Bn762,57248465,72493190,15244725,TN
chr01,Bn763,42534293,82073603,39539310,CN
chr01,Bn764,77286936,92031495,14744559,RLK
chr01,Bn765,52611014,70280787,17669773,TNL
chr01,Bn766,11685102,26432091,14746989,TN
chr01,Bn767,85729189,92708751,6979562,CN
chr01,Bn768,41635652,99180129,57544477,RLP
chr01,Bn769,42667786,69461991,26794205,CN
chr01,Bn770,66117582,66343702,226120,CN
chr01,Bn771,62341424,98945563,36604139,CNL
chr01,Bn772,96508771,97019025,510254,CNL
chr01,Bn773,8893624,35088389,26194765,NBS
chr01,Bn774,51854544,94830383,42975839,TNL
chr01,Bn775,72517641,98085665,25568024,TNL
chr01,Bn776,81631934,98733181,17101247,RLP
chr01,Bn777,82001293,85203257,3201964,CN
chr01,Bn778,68442530,73554326,5111796,RLK
chr01,Bn779,82558742,86244320,3685578,NBS
chr01,Bn780,64501264,92868053,28366789,CNL
chr01,Bn781,19255974,56675699,37419725,TN
chr01,Bn782,12232788,33633355,21400567,NBS
chr01,Bn783,69186135,85226159,16040024,TNL
chr01,Bn784,53775664,71256761,17481097,TNL
chr01,Bn785,31974691,91971880,59997189,RLP
chr01,Bn786,4450264,99957741,95507477,TN
chr01,Bn787,18686205,64567935,45881730,CNL
chr01,Bn788,12715980,61786698,49070718,TNL
chr01,Bn789,34601471,75322539,40721068,TN
chr01,Bn790,4135287,91356429,87221142,CN
chr01,Bn791,99757875,99798880,41005,RLK
chr01,Bn792,56394983,90069604,33674621,RLK
chr01,Bn793,51303152,55879860,4576708,RLP
chr01,Bn794,96038271,99912374,3874103,RLK
chr01,Bn795,59782357,98669506,38887149,CNL
chr01,Bn796,57340744,82178064,24837320,NBS
chr01,Bn797,94559224,94897332,338108,TN
chr01,Bn798,31344580,61928322,30583742,TN
chr01,Bn799,7622751,67696642,60073891,CN
chr01,Bn800,16629436,66934377,50304941,NBS
chr01,Bn801,90656248,93166393,2510145,CNL
chr01,Bn802,10536634,57680281,47143647,NBS
chr01,Bn803,99765974,99913787,147813,RLP
chr01,Bn804,35514572,47000100,11485528,RLK
chr01,Bn805,53061443,63159451,10098008,RLK
chr01,Bn806,7195951,25189926,17993975,RLK
chr01,Bn807,73129852,77653742,4523890,CN
chr01,Bn808,35008152,35674103,665951,RLP
chr01,Bn809,61333285,66780916,5447631,TN
chr01,Bn810,33798842,89626222,55827380,CNL
chr01,Bn811,36943015,77959700,41016685,CNL
chr01,Bn812,99981958,99982077,119,RLP
chr01,Bn813,31295898,32796964,1501066,RLP
chr01,Bn814,61506180,88728792,27222612,CNL
chr01,Bn815,44124797,88377655,44252858,RLK
chr01,Bn816,2967303,75778621,72811318,TNL
chr01,Bn817,88629333,92253544,3624211,TN
chr01,Bn818,30954652,69207175,38252523,TNL
chr01,Bn819,96863652,98192913,1329261,TNL
chr01,Bn820,9488921,74959837,65470916,CN
chr01,Bn821,63903590,87879305,23975715,NBS
chr01,Bn822,10964560,28433323,17468763,TN
chr01,Bn823,17880206,47951288,30071082,CN
chr01,Bn824,35208489,78900736,43692247,TN
chr01,Bn825,42642908,65859911,23217003,TN
chr01,Bn826,86192151,94376191,8184040,CN
chr01,Bn827,88239082,98734339,10495257,CN
chr01,Bn828,48794953,50845336,2050383,CNL
chr01,Bn829,9643972,83353303,73709331,TN
chr01,Bn830,87312304,99901085,12588781,TN
chr01,Bn831,81104809,98325209,17220400,NBS
chr01,Bn832,62827297,89764321,26937024,RLK
chr01,Bn833,53205008,53842014,637006,TN
chr01,Bn834,48265069,85513118,37248049,TN
chr01,Bn835,51997458,96899879,44902421,NBS
chr01,Bn836,87793292,98126390,10333098,RLK
chr01,Bn837,88381371,93770369,5388998,CN
chr01,Bn838,52594296,78883764,26289468,CNL
chr01,Bn839,68211367,68864854,653487,NBS
chr01,Bn840,96480703,99310748,2830045,CNL
chr01,Bn841,93503788,99299648,5795860,CNL
chr01,Bn842,93181717,99154773,5973056,TN
chr01,Bn843,32446930,76925024,44478094,CN
chr01,Bn844,48769320,77044960,28275640,RLP
chr01,Bn845,84821588,91435949,6614361,RLP
chr01,Bn846,86989056,91535992,4546936,CNL
chr01,Bn847,79447871,81302722,1854851,RLP
chr01,Bn848,33541114,72722675,39181561,RLK
chr01,Bn849,82636208,87452968,4816760,CN
chr01,Bn850,83483606,94007274,10523668,RLK
chr01,Bn851,61287353,73865669,12578316,RLK
chr01,Bn852,11764974,28492406,16727432,TNL
chr01,Bn853,93272517,93300928,28411,RLK
chr01,Bn854,65399539,81382763,15983224,CN
chr01,Bn855,22217966,80594507,58376541,CNL
chr01,Bn856,17879905,49184730,31304825,TNL
chr01,Bn857,54844557,72922679,18078122,RLP
chr01,Bn858,11567896,96028593,84460697,NBS
chr01,Bn859,11992576,75955687,63963111,TN
chr01,Bn860,25031771,86461711,61429940,TN
chr01,Bn861,71895603,73899012,2003409,CNL
chr01,Bn862,4663053,71899257,67236204,CNL
chr01,Bn863,27169623,60363329,33193706,RLP
chr01,Bn864,76058179,76307522,249343,RLK
chr01,Bn865,19379627,57689178,38309551,TNL
chr01,Bn866,18699768,99119122,80419354,RLP
chr01,Bn867,81639436,82081707,442271,RLK
chr01,Bn868,76089948,77042995,953047,TN
chr01,Bn869,99323353,99633227,309874,CNL
chr01,Bn870,92476084,96679955,4203871,TN
chr01,Bn871,51794067,80868375,29074308,CN
chr01,Bn872,28147975,50151527,22003552,TNL
chr01,Bn873,29907192,59836806,29929614,TN
chr01,Bn874,52068902,58731437,6662535,RLK
chr01,Bn875,43523787,56455250,12931463,CN
chr01,Bn876,23047261,93013031,69965770,RLK
chr01,Bn877,79678293,89055141,9376848,TN
chr01,Bn878,85702791,86871916,1169125,TN
chr01,Bn879,41020700,42346096,1325396,CNL
chr01,Bn880,18314114,40160091,21845977,CNL
chr01,Bn881,74164355,93003698,18839343,RLK
chr01,Bn882,78781536,99332869,20551333,CNL
chr01,Bn883,15080074,24814710,9734636,CNL
chr01,Bn884,24048020,29413369,5365349,TN
chr01,Bn885,41230181,75008191,33778010,TNL
chr01,Bn886,34765883,98627968,63862085,CN
chr01,Bn887,45753404,66462164,20708760,RLP
chr01,Bn888,62430189,88192150,25761961,NBS
chr01,Bn889,38575645,59476428,20900783,TNL
chr01,Bn890,73360276,76517972,3157696,CNL
chr01,Bn891,77416504,79517066,2100562,CNL
chr01,Bn892,22587944,33791333,11203389,RLK
chr01,Bn893,77156944,78904651,1747707,CN
chr01,Bn894,1958087,74865010,72906923,TN
chr01,Bn895,64125821,74089955,9964134,CN
chr01,Bn896,7024223,22578104,15553881,TN
chr01,Bn897,92206294,97458555,5252261,CNL
chr01,Bn898,83401282,99214580,15813298,TN
chr01,Bn899,49969285,78752728,28783443,RLK
chr01,Bn900,55975763,66086352,10110589,CNL
chr01,Bn901,87606284,95971483,8365199,CN
chr01,Bn902,56379433,65654688,9275255,NBS
chr01,Bn903,13287913,96098194,82810281,RLP
chr01,Bn904,25225642,41125939,15900297,RLP
chr01,Bn905,7676199,51112247,43436048,CN
chr01,Bn906,4438048,94331799,89893751,TN
chr01,Bn907,91700363,96719674,5019311,NBS
chr01,Bn908,92493091,95874303,3381212,RLK
chr01,Bn909,71608479,97917830,26309351,RLK
chr01,Bn910,1883803,84219968,82336165,NBS
chr01,Bn911,92110927,95252125,3141198,NBS
chr01,Bn912,5439035,13528552,8089517,NBS
chr01,Bn913,35551715,86193341,50641626,CNL
chr01,Bn914,17728395,28108222,10379827,CNL
chr01,Bn915,15358583,25012593,9654010,NBS
chr01,Bn916,60754275,84294258,23539983,TN
chr01,Bn917,97191493,99008020,1816527,RLK
chr01,Bn918,57920876,89074537,31153661,TN
chr01,Bn919,26445317,27081231,635914,RLP
chr01,Bn920,42830662,45572059,2741397,TNL
chr01,Bn921,95282458,97694115,2411657,TNL
chr01,Bn922,34486674,70726112,36239438,NBS
chr01,Bn923,99012298,99985995,973697,RLK
chr01,Bn924,21590664,36019225,14428561,CN
chr01,Bn925,74871032,87333262,12462230,RLP
chr01,Bn926,27276269,71266180,43989911,RLK
chr01,Bn927,60317528,66739206,6421678,CNL
chr01,Bn928,14547954,88505379,73957425,RLK
chr01,Bn929,49290516,73256378,23965862,RLK
chr01,Bn930,36574898,51192399,14617501,NBS
chr01,Bn931,24095894,92241553,68145659,CN
chr01,Bn932,92228978,99963880,7734902,CNL
chr01,Bn933,82155723,87518163,5362440,CN
chr01,Bn934,58479822,98724704,40244882,NBS
chr01,Bn935,79669927,86953019,7283092,RLK
chr01,Bn936,48798025,79373905,30575880,RLK
chr01,Bn937,77334636,87395582,10060946,RLK
chr01,Bn938,13793441,80289642,66496201,CN
chr01,Bn939,82504288,91680837,9176549,CN
chr01,Bn940,43015856,80866483,37850627,RLK
chr01,Bn941,62200840,92929735,30728895,CNL
chr01,Bn942,31672657,76040594,44367937,CN
chr01,Bn943,95746157,96269505,523348,RLK
chr01,Bn944,98540788,99290408,749620,CNL
chr01,Bn945,47564992,57548993,9984001,RLK
chr01,Bn946,34593502,73484487,38890985,CN
chr01,Bn947,7283944,83774702,76490758,RLK
chr01,Bn948,40477432,40953797,476365,TNL
chr01,Bn949,17651873,98192664,80540791,NBS
chr01,Bn950,28255758,85174822,56919064,TNL
chr01,Bn951,84470352,86185068,1714716,TNL
chr01,Bn952,52898887,84407490,31508603,NBS
chr01,Bn953,44267090,51157878,6890788,TN
chr01,Bn954,86330741,86363351,32610,NBS
chr01,Bn955,64230803,72072911,7842108,TN
chr01,Bn956,3452604,34594714,31142110,NBS
chr01,Bn957,43553359,89095525,45542166,RLK
chr01,Bn958,64450258,99079557,34629299,RLK
chr01,Bn959,74712278,98089200,23376922,TNL
chr01,Bn960,82985366,95019193,12033827,TN
chr01,Bn961,82360249,91010038,8649789,CN
chr01,Bn962,86168816,94206107,8037291,RLK
chr01,Bn963,18550640,37976933,19426293,TN
chr01,Bn964,69207134,79927014,10719880,CNL
chr01,Bn965,99045029,99990661,945632,CN
chr01,Bn966,89618974,98934477,9315503,CNL
chr01,Bn967,8722046,66728905,58006859,TNL
chr01,Bn968,76295356,86783053,10487697,CN
chr01,Bn969,85758445,90774808,5016363,RLK
chr01,Bn970,52469560,86751448,34281888,RLP
chr01,Bn971,94810602,99672211,4861609,RLK
chr01,Bn972,69254863,82184480,12929617,RLK
chr01,Bn973,83533442,85944634,2411192,NBS
chr01,Bn974,33492583,81752505,48259922,RLP
chr01,Bn975,73634101,93767193,20133092,NBS
chr01,Bn976,32204676,82185781,49981105,NBS
chr01,Bn977,29424498,84070220,54645722,RLP
chr01,Bn978,12618275,44254558,31636283,CN
chr01,Bn979,16607079,98604198,81997119,NBS
chr01,Bn980,25327717,50320589,24992872,CNL
chr01,Bn981,69061788,73707294,4645506,RLK
chr01,Bn982,90783050,91693228,910178,TNL
chr01,Bn983,45327014,71387822,26060808,CN
chr01,Bn984,31311005,99542224,68231219,RLK
chr01,Bn985,19998003,99627581,79629578,RLP
chr01,Bn986,76554973,93577528,17022555,CNL
chr01,Bn987,22756657,64564744,41808087,TN
chr01,Bn988,37976932,73574942,35598010,CN
chr01,Bn989,79728048,86539334,6811286,CN
chr01,Bn990,12162306,20212954,8050648,TNL
chr01,Bn991,54258553,83156149,28897596,RLP
chr01,Bn992,2561089,45672252,43111163,CN
chr01,Bn993,83600263,86122499,2522236,CN
chr01,Bn994,5710842,18135626,12424784,TNL
chr01,Bn995,48022885,88220875,40197990,RLK
chr01,Bn996,98356015,98735673,379658,TN
chr01,Bn997,32445360,81397476,48952116,RLK
chr01,Bn998,80606280,86518650,5912370,CN
chr01,Bn999,42380448,77555482,35175034,NBS
chr01,Bn1000,9656019,9981374,325355,CNL
chr01,Bn1001,75524296,89603225,14078929,NBS
chr01,Bn1002,52795607,66048001,13252394,NBS
chr01,Bn1003,91463447,98985170,7521723,CNL
chr01,Bn1004,19106859,20704232,1597373,RLP
chr01,Bn1005,38872320,48083402,9211082,RLK
chr01,Bn1006,2860476,95919746,93059270,NBS
chr01,Bn1007,65744511,89091240,23346729,CN
chr01,Bn1008,9598017,56235380,46637363,RLK
chr01,Bn1009,15236123,61076445,45840322,RLP
chr01,Bn1010,8527599,18863720,10336121,CNL
chr01,Bn1011,76269883,97568697,21298814,TNL
chr01,Bn1012,82753296,90450732,7697436,RLK
chr01,Bn1013,16168084,42526191,26358107,CNL
chr01,Bn1014,58667296,87158765,28491469,NBS
chr01,Bn1015,79540265,97728751,18188486,TN
chr01,Bn1016,90973490,96893497,5920007,TN
chr01,Bn1017,75204862,75773463,568601,RLP
chr01,Bn1018,66130249,82533494,16403245,CNL
chr01,Bn1019,90236682,95298946,5062264,TNL
chr01,Bn1020,53046810,92752664,39705854,RLP
chr01,Bn1021,2877314,38762552,35885238,TN
chr01,Bn1022,18749818,76505554,57755736,RLP
chr01,Bn1023,74143269,99010472,24867203,NBS
chr01,Bn1024,77695491,78986978,1291487,CNL
chr01,Bn1025,64266104,93307571,29041467,CN
chr01,Bn1026,26133281,61802233,35668952,RLK
chr01,Bn1027,82127301,85247324,3120023,NBS
chr01,Bn1028,65194768,83676450,18481682,CN
chr01,Bn1029,15146059,54996089,39850030,CN
chr01,Bn1030,81916313,88531442,6615129,TNL
chr01,Bn1031,51890660,52031189,140529,TN
chr01,Bn1032,19604388,36781658,17177270,RLP
chr01,Bn1033,1182242,71551723,70369481,CN
chr01,Bn1034,95036102,96897309,1861207,CN
chr01,Bn1035,57852449,93840482,35988033,CNL
chr01,Bn1036,28979743,60271610,31291867,RLP
chr01,Bn1037,70479932,97848103,27368171,RLP
chr01,Bn1038,77007182,80161253,3154071,RLP
chr01,Bn1039,69703038,93552151,23849113,RLP
chr01,Bn1040,84750693,85263357,512664,CN
chr01,Bn1041,27506684,41062550,13555866,NBS
chr01,Bn1042,73950556,94375919,20425363,CNL
chr01,Bn1043,55551017,71449161,15898144,TN
chr01,Bn1044,75161496,95409184,20247688,CN
chr01,Bn1045,27494110,56572202,29078092,CNL
chr01,Bn1046,61915247,88352538,26437291,RLK
chr01,Bn1047,51904961,78198311,26293350,TN
chr01,Bn1048,34701643,87644236,52942593,NBS
chr01,Bn1049,76527190,94233346,17706156,TNL
chr01,Bn1050,95296052,97759373,2463321,TN
chr01,Bn1051,83723084,95606718,11883634,RLK
chr01,Bn1052,36706328,69797454,33091126,TNL
chr01,Bn1053,64184882,69163912,4979030,RLP
chr01,Bn1054,33579672,98463937,64884265,CN
chr01,Bn1055,65394297,76895449,11501152,RLK
chr01,Bn1056,26353224,73338258,46985034,RLP
chr01,Bn1057,13646594,78871096,65224502,TNL
chr01,Bn1058,87260054,92004333,4744279,TNL
chr01,Bn1059,10949957,30233511,19283554,NBS
chr01,Bn1060,86568093,98385267,11817174,RLK
chr01,Bn1061,57094520,81809515,24714995,CN
chr01,Bn1062,69482639,77954326,8471687,RLK
chr01,Bn1063,23311577,97210775,73899198,CN
chr01,Bn1064,33321768,79932215,46610447,RLP
chr01,Bn1065,63962099,96807436,32845337,CN
chr01,Bn1066,35151313,65486294,30334981,TNL
chr01,Bn1067,12931893,68825931,55894038,TN
chr01,Bn1068,96461139,99888278,3427139,CN
chr01,Bn1069,25888028,48876267,22988239,CNL
chr01,Bn1070,16953597,74740069,57786472,RLK
chr01,Bn1071,40969574,92203975,51234401,CN
chr01,Bn1072,84993435,94932325,9938890,TNL
chr01,Bn1073,16011390,52670195,36658805,TNL
chr01,Bn1074,53716037,84421120,30705083,CNL
chr01,Bn1075,64970515,75334781,10364266,NBS
chr01,Bn1076,46114659,99048691,52934032,RLP
chr01,Bn1077,31521347,43073082,11551735,CN
chr01,Bn1078,3746515,84357595,80611080,TNL
chr01,Bn1079,16734538,51349290,34614752,RLP
chr01,Bn1080,90225143,94464311,4239168,NBS
chr01,Bn1081,18292045,89632544,71340499,RLP
chr01,Bn1082,12324935,39740180,27415245,CN
chr01,Bn1083,48563069,53475881,4912812,TNL
chr01,Bn1084,16801959,95148224,78346265,CN
chr01,Bn1085,86099616,96371590,10271974,CNL
chr01,Bn1086,71372304,82428529,11056225,TN
chr01,Bn1087,43199393,81459804,38260411,CNL
chr01,Bn1088,55499360,87361702,31862342,NBS
chr01,Bn1089,95652256,97577804,1925548,RLP
chr01,Bn1090,87518817,95156589,7637772,NBS
chr01,Bn1091,29284788,84667730,55382942,RLK
chr01,Bn1092,12169297,14961740,2792443,RLP
chr01,Bn1093,56368102,73735199,17367097,RLP
chr01,Bn1094,56796843,76770455,19973612,CNL
chr01,Bn1095,44157166,44744140,586974,NBS
chr01,Bn1096,34245650,77114270,42868620,TN
chr01,Bn1097,37975463,50177346,12201883,RLP
chr01,Bn1098,97226590,99625821,2399231,CNL
chr01,Bn1099,91657863,96757277,5099414,RLK
chr01,Bn1100,29867811,97534944,67667133,TNL
chr01,Bn1101,6896757,67638693,60741936,RLK
chr01,Bn1102,53887512,75096750,21209238,CNL
chr01,Bn1103,23413819,75221487,51807668,RLP
chr01,Bn1104,74744773,95012110,20267337,RLP
chr01,Bn1105,27394360,48723084,21328724,CN
chr01,Bn1106,51038521,51264423,225902,RLP
chr01,Bn1107,34364379,85075046,50710667,RLP
chr01,Bn1108,19702011,69135363,49433352,NBS
chr01,Bn1109,46164992,79339396,33174404,CN
chr01,Bn1110,37113302,51460912,14347610,TNL
chr01,Bn1111,24589989,54261547,29671558,CN
chr01,Bn1112,73271043,83611146,10340103,CN
chr01,Bn1113,46319659,70380735,24061076,CN
chr01,Bn1114,94853066,98267421,3414355,RLK
chr01,Bn1115,1298880,2689534,1390654,CNL
chr01,Bn1116,74973758,97558023,22584265,CN
chr01,Bn1117,54515500,81892954,27377454,TNL
chr01,Bn1118,22435143,23478609,1043466,CN
chr01,Bn1119,93452395,96665796,3213401,TN
chr01,Bn1120,71554153,72472869,918716,TNL
chr01,Bn1121,72403505,78238746,5835241,RLP
chr01,Bn1122,52124314,61122963,8998649,RLP
chr01,Bn1123,92199006,99621061,7422055,TNL
chr01,Bn1124,3021672,13202866,10181194,CN
chr01,Bn1125,24882517,37411201,12528684,CN
chr01,Bn1126,71386307,77276981,5890674,NBS
chr01,Bn1127,24675658,64187097,39511439,NBS
chr01,Bn1128,2545704,28906748,26361044,RLP
chr01,Bn1129,35696442,96771431,61074989,RLK
chr01,Bn1130,46130926,57582636,11451710,RLP
chr01,Bn1131,78925351,97652659,18727308,TNL
chr01,Bn1132,68725724,94548964,25823240,CN
chr01,Bn1133,86850547,90479326,3628779,CNL
chr01,Bn1134,50607389,74959193,24351804,TNL
chr01,Bn1135,38340538,47110013,8769475,NBS
chr01,Bn1136,73083399,91656230,18572831,CN
chr01,Bn1137,40047964,89647439,49599475,RLP
chr01,Bn1138,1312806,95496997,94184191,RLP
chr01,Bn1139,49073341,88571810,39498469,RLP
chr01,Bn1140,9820826,35667875,25847049,CN
chr01,Bn1141,97243837,98294157,1050320,RLP
chr01,Bn1142,68896194,90065393,21169199,CNL
chr01,Bn1143,17897705,21386945,3489240,TNL
chr01,Bn1144,67999100,98206704,30207604,NBS
chr01,Bn1145,35889178,44609820,8720642,TNL
chr01,Bn1146,45806577,84207655,38401078,CN
chr01,Bn1147,50012675,80984997,30972322,NBS
chr01,Bn1148,88584734,97822811,9238077,RLK
chr01,Bn1149,26459901,92494800,66034899,NBS
chr01,Bn1150,52277237,62591885,10314648,RLP
chr01,Bn1151,44116911,58842521,14725610,TNL
chr01,Bn1152,63294320,79300153,16005833,RLK
chr01,Bn1153,31676533,51888198,20211665,RLK
chr01,Bn1154,31655957,74028128,42372171,TN
chr01,Bn1155,27485101,92031228,64546127,RLP
chr01,Bn1156,36106960,74646129,38539169,TNL
chr01,Bn1157,13869232,46556414,32687182,CNL
chr01,Bn1158,31946597,80949139,49002542,TNL
chr01,Bn1159,2406626,55031211,52624585,CN
chr01,Bn1160,28271024,52315697,24044673,RLK
chr01,Bn1161,43816135,70808125,26991990,RLP
chr01,Bn1162,4155560,91822407,87666847,NBS
chr01,Bn1163,54295376,87456556,33161180,CNL
chr01,Bn1164,29618325,42755927,13137602,NBS
chr01,Bn1165,87215453,96330048,9114595,CNL
chr01,Bn1166,95118985,95749508,630523,CNL
chr01,Bn1167,36690601,96044557,59353956,NBS
chr01,Bn1168,39519804,52663007,13143203,CN
chr01,Bn1169,6141019,80046599,73905580,TNL
chr01,Bn1170,64639085,76482779,11843694,CNL
chr01,Bn1171,44145879,83754343,39608464,TN
chr01,Bn1172,17028096,90118310,73090214,NBS
chr01,Bn1173,26188184,48479030,22290846,RLP
chr01,Bn1174,81000164,86765660,5765496,TNL
chr01,Bn1175,50081134,56151710,6070576,CNL
chr01,Bn1176,1412309,78538742,77126433,CNL
chr01,Bn1177,55476607,62346294,6869687,TNL
chr01,Bn1178,93672813,93694925,22112,CN
chr01,Bn1179,35319393,99477670,64158277,TN
chr01,Bn1180,65128937,67810536,2681599,TN
chr01,Bn1181,99073376,99122637,49261,CNL
chr01,Bn1182,16698536,40504240,23805704,TN
chr01,Bn1183,13555623,28753452,15197829,CN
chr01,Bn1184,45708228,46689838,981610,CNL
chr01,Bn1185,49871341,77215674,27344333,RLP
chr01,Bn1186,8151072,29780036,21628964,TN
chr01,Bn1187,41200398,65322966,24122568,TNL
chr01,Bn1188,27552287,76974643,49422356,TNL
chr01,Bn1189,47629947,53553144,5923197,RLK
chr01,Bn1190,98855825,99403854,548029,CNL
chr01,Bn1191,81969301,90355243,8385942,RLK
chr01,Bn1192,62460864,66823118,4362254,NBS
chr01,Bn1193,47698829,83513964,35815135,TNL
chr01,Bn1194,99516655,99823922,307267,RLK
chr01,Bn1195,1920134,13683077,11762943,CNL
chr01,Bn1196,66967015,70722177,3755162,TNL
chr01,Bn1197,86301747,89776254,3474507,CN
chr01,Bn1198,60221242,79771305,19550063,RLP
chr01,Bn1199,36459088,44778328,8319240,RLP
chr01,Bn1200,92699409,93845997,1146588,RLP
chr01,Bn1201,60929130,89147355,28218225,RLK
chr01,Bn1202,74759559,93117088,18357529,CN
chr01,Bn1203,94084455,97302181,3217726,RLK
chr01,Bn1204,82090611,82246915,156304,NBS
chr01,Bn1205,74417667,93793922,19376255,RLK
chr01,Bn1206,88072380,99016095,10943715,TNL
chr01,Bn1207,83073059,98730539,15657480,RLP
chr01,Bn1208,13880943,30772093,16891150,CNL
chr01,Bn1209,88694092,95363250,6669158,CNL
chr01,Bn1210,13904823,92294293,78389470,RLP
chr01,Bn1211,17739720,94924854,77185134,RLP
chr01,Bn1212,74163810,88930417,14766607,RLK
chr01,Bn1213,67071490,98588542,31517052,TN
chr01,Bn1214,3202521,23361539,20159018,CNL
chr01,Bn1215,7636760,81338083,73701323,RLK
chr01,Bn1216,17573008,87236075,69663067,CN
chr01,Bn1217,50549147,57257114,6707967,RLP
chr01,Bn1218,88069394,93515743,5446349,TN
chr01,Bn1219,79840522,95625311,15784789,TN
chr01,Bn1220,84692663,99974677,15282014,RLP
chr01,Bn1221,81909876,94854849,12944973,CNL
chr01,Bn1222,10059256,95428236,85368980,TN
chr01,Bn1223,4163123,9185368,5022245,CN
chr01,Bn1224,39276941,51824710,12547769,CN
chr01,Bn1225,62433179,89004938,26571759,CNL
chr01,Bn1226,61777936,82517060,20739124,RLP
chr01,Bn1227,89928518,90539588,611070,TNL
chr01,Bn1228,88462081,98319572,9857491,TN
chr01,Bn1229,28354530,72434546,44080016,TNL
chr01,Bn1230,65981945,82583579,16601634,RLK
chr01,Bn1231,3322255,5864879,2542624,RLP
chr01,Bn1232,76325517,88898512,12572995,RLP
chr01,Bn1233,5573440,96879715,91306275,CNL
chr01,Bn1234,6367542,42513896,36146354,TN
chr01,Bn1235,69960605,82196481,12235876,RLP
chr01,Bn1236,43527698,64067673,20539975,RLP
chr01,Bn1237,16766874,61217833,44450959,TNL
chr01,Bn1238,89648990,97595652,7946662,NBS
chr01,Bn1239,3934195,53098981,49164786,CN
chr01,Bn1240,68163146,72714855,4551709,CNL
chr01,Bn1241,60110805,83939506,23828701,RLP
chr01,Bn1242,11991950,55025491,43033541,NBS
chr01,Bn1243,70425538,82014280,11588742,RLK
chr01,Bn1244,49128984,80426119,31297135,RLK
chr01,Bn1245,85157955,98020512,12862557,CNL
chr01,Bn1246,26086994,55282028,29195034,TN
chr01,Bn1247,26586839,96599130,70012291,RLK
chr01,Bn1248,78313308,83403023,5089715,RLP
chr01,Bn1249,93179428,95831165,2651737,RLK
chr01,Bn1250,69159186,89235307,20076121,CNL
chr01,Bn1251,3949799,32006026,28056227,CNL
chr01,Bn1252,45815298,65901542,20086244,RLK
chr01,Bn1253,36641267,39860764,3219497,TNL
chr01,Bn1254,2412829,6617201,4204372,CNL
chr01,Bn1255,25711526,30007981,4296455,TNL
chr01,Bn1256,89992003,95968966,5976963,CNL
chr01,Bn1257,61868118,90703660,28835542,TN
chr01,Bn1258,29053155,86539602,57486447,RLP
chr01,Bn1259,95277632,95545892,268260,RLK
chr01,Bn1260,61510325,95510246,33999921,NBS
chr01,Bn1261,89501347,94524808,5023461,CN
chr01,Bn1262,88552146,96622440,8070294,NBS
chr01,Bn1263,17442800,86264858,68822058,RLP
chr01,Bn1264,41851889,50883164,9031275,CNL
chr01,Bn1265,60041840,64485736,4443896,RLK
chr01,Bn1266,79107454,91562000,12454546,NBS
chr01,Bn1267,50730167,86634284,35904117,CNL
chr01,Bn1268,46662521,70073249,23410728,RLP
chr01,Bn1269,99950757,99962746,11989,RLP
chr01,Bn1270,69702510,73695080,3992570,TNL
chr01,Bn1271,68578506,79168739,10590233,NBS
chr01,Bn1272,21657074,76535817,54878743,CNL
chr01,Bn1273,57430787,85783641,28352854,TN
chr01,Bn1274,44811245,66539039,21727794,TNL
chr01,Bn1275,56920283,71700522,14780239,TNL
chr01,Bn1276,91391722,98943125,7551403,CNL
chr01,Bn1277,19843201,25292376,5449175,CN
chr01,Bn1278,62986784,95875144,32888360,TNL
chr01,Bn1279,4579552,17022896,12443344,TNL
chr01,Bn1280,6528313,75248466,68720153,RLP
chr01,Bn1281,32715670,69205682,36490012,RLP
chr01,Bn1282,59804008,80762298,20958290,TN
chr01,Bn1283,27398996,74306714,46907718,RLK
chr01,Bn1284,47758729,57516797,9758068,TN
chr01,Bn1285,14059230,22748595,8689365,RLK
chr01,Bn1286,46984698,55757017,8772319,TN
chr01,Bn1287,74954998,89626884,14671886,CN
chr01,Bn1288,51274549,92021311,40746762,CNL
chr01,Bn1289,15262547,54781452,39518905,CNL
chr01,Bn1290,61391752,69360796,7969044,TNL
chr01,Bn1291,83918383,90851943,6933560,RLP
chr01,Bn1292,1532878,14002720,12469842,CN
chr01,Bn1293,55155151,64860683,9705532,CN
chr01,Bn1294,43720972,81547304,37826332,TNL
chr01,Bn1295,91981242,95786713,3805471,CNL
chr01,Bn1296,24319784,40681457,16361673,NBS
chr01,Bn1297,17648560,39436833,21788273,TNL
chr01,Bn1298,66401528,80446462,14044934,CNL
chr01,Bn1299,58471950,74479982,16008032,NBS
chr01,Bn1300,25195051,75429108,50234057,RLK
chr01,Bn1301,17632077,85541315,67909238,RLP
chr01,Bn1302,75181466,82785863,7604397,RLK
chr01,Bn1303,95562682,98817137,3254455,CN
chr01,Bn1304,21482495,73379228,51896733,NBS
chr01,Bn1305,75504746,91190780,15686034,TNL
chr01,Bn1306,52254912,60439249,8184337,TNL
chr01,Bn1307,33078833,56743170,23664337,CN
chr01,Bn1308,24074042,38202057,14128015,TNL
chr01,Bn1309,71837314,80264128,8426814,CN
chr01,Bn1310,95313283,99926293,4613010,TN
chr01,Bn1311,68588966,77490749,8901783,NBS
chr01,Bn1312,28538200,61637464,33099264,CNL
chr01,Bn1313,22577800,72244438,49666638,CN
chr01,Bn1314,91729205,93393661,1664456,NBS
chr01,Bn1315,50857548,80299270,29441722,RLP
chr01,Bn1316,86952164,91825984,4873820,NBS
chr01,Bn1317,87966879,93843537,5876658,CN
chr01,Bn1318,66205693,69909533,3703840,RLP
chr01,Bn1319,4174985,85832228,81657243,RLP
chr01,Bn1320,71719693,86251182,14531489,TNL
chr01,Bn1321,7996714,75226763,67230049,RLK
chr01,Bn1322,44515685,57589845,13074160,CNL
chr01,Bn1323,34976878,48446666,13469788,TNL
chr01,Bn1324,5062629,29717496,24654867,RLK
chr01,Bn1325,85243220,90106689,4863469,RLP
chr01,Bn1326,15354964,80423130,65068166,RLK
chr01,Bn1327,41709023,46433783,4724760,CN
chr01,Bn1328,95660091,97022439,1362348,CN
chr01,Bn1329,93507031,93889062,382031,CN
chr01,Bn1330,84249117,88785385,4536268,TNL
chr01,Bn1331,83719032,98945978,15226946,RLK
chr01,Bn1332,13335127,81763029,68427902,TNL
chr01,Bn1333,33167028,96456887,63289859,NBS
chr01,Bn1334,30803693,36820952,6017259,CNL
chr01,Bn1335,50719975,94118081,43398106,TNL
chr01,Bn1336,56624355,98502231,41877876,CN
chr01,Bn1337,24908072,97291424,72383352,RLP
chr01,Bn1338,46183044,95858983,49675939,CNL
chr01,Bn1339,85273785,88952019,3678234,NBS
chr01,Bn1340,18180027,77192432,59012405,CNL
chr01,Bn1341,9379290,15232778,5853488,TN
chr01,Bn1342,35248724,96804579,61555855,TNL
chr01,Bn1343,59917745,89554457,29636712,CN
chr01,Bn1344,50374069,54149841,3775772,TNL
chr01,Bn1345,71150941,99788615,28637674,CNL
chr01,Bn1346,6566658,89906963,83340305,TNL
chr01,Bn1347,32386626,36145330,3758704,TN
chr01,Bn1348,69593060,78991042,9397982,RLK
chr01,Bn1349,3254064,38820407,35566343,CNL
chr01,Bn1350,47809938,68421745,20611807,NBS
chr01,Bn1351,1506454,77870646,76364192,CN
chr01,Bn1352,42339390,94784109,52444719,CNL
chr01,Bn1353,54322677,65124301,10801624,TN
chr01,Bn1354,30579027,38913510,8334483,TN
chr01,Bn1355,84685868,97130052,12444184,TNL
chr01,Bn1356,74072689,90242196,16169507,CN
chr01,Bn1357,19104003,79262511,60158508,TN
chr01,Bn1358,79549742,87962159,8412417,CN
chr01,Bn1359,86991922,89402395,2410473,TN
chr01,Bn1360,41005820,69629669,28623849,RLK
chr01,Bn1361,97990953,98292826,301873,TNL
chr01,Bn1362,83167843,85972846,2805003,RLP
chr01,Bn1363,72995181,93781032,20785851,NBS
chr01,Bn1364,10092876,75651087,65558211,RLK
chr01,Bn1365,88195653,93362382,5166729,TN
chr01,Bn1366,23655463,72157448,48501985,TNL
chr01,Bn1367,51111656,61721672,10610016,CNL
chr01,Bn1368,76964387,94530982,17566595,CNL
chr01,Bn1369,89141309,94506928,5365619,TNL
chr01,Bn1370,12263143,30531844,18268701,NBS
chr01,Bn1371,10727812,90605989,79878177,NBS
chr01,Bn1372,34566524,84946405,50379881,CNL
chr01,Bn1373,44373068,72426021,28052953,NBS
chr01,Bn1374,49964336,87315857,37351521,NBS
chr01,Bn1375,96141625,98124044,1982419,CN
chr01,Bn1376,15491747,24392606,8900859,CNL
chr01,Bn1377,35149704,88700736,53551032,CNL
chr01,Bn1378,76396165,88094339,11698174,CNL
chr01,Bn1379,8054260,82788956,74734696,RLP
chr01,Bn1380,36485084,62342729,25857645,NBS
chr01,Bn1381,6306977,45902127,39595150,RLP
chr01,Bn1382,55205158,64173915,8968757,RLP
chr01,Bn1383,59119783,68766383,9646600,NBS
chr01,Bn1384,12858226,37184106,24325880,TNL
chr01,Bn1385,58243998,74180212,15936214,CNL
chr01,Bn1386,45277576,91658205,46380629,RLP
chr01,Bn1387,82898212,87546679,4648467,RLP
chr01,Bn1388,28828968,59703557,30874589,NBS
chr01,Bn1389,69736427,84345629,14609202,CN
chr01,Bn1390,77527497,96958980,19431483,TN
chr01,Bn1391,77008934,77251487,242553,CNL
chr01,Bn1392,27157371,69521875,42364504,TN
chr01,Bn1393,3511034,15737395,12226361,CNL
chr01,Bn1394,30388716,88166354,57777638,RLP
chr01,Bn1395,82424806,90100618,7675812,CN
chr01,Bn1396,13581095,27368196,13787101,RLK
chr01,Bn1397,1747024,4215918,2468894,RLP
chr01,Bn1398,79334330,89877600,10543270,TN
chr01,Bn1399,53397833,78474622,25076789,RLK
chr01,Bn1400,14337688,27106085,12768397,NBS
chr01,Bn1401,2517550,11843547,9325997,CN
chr01,Bn1402,68399720,86886071,18486351,TN
chr01,Bn1403,22926435,66666649,43740214,RLP
chr01,Bn1404,34338254,59399112,25060858,TNL
chr01,Bn1405,62264842,76804060,14539218,RLK
chr01,Bn1406,26024429,85799715,59775286,TNL
chr01,Bn1407,57275999,78998644,21722645,TNL
chr01,Bn1408,3594314,8179092,4584778,CN
chr01,Bn1409,61263578,94498079,33234501,RLK
chr01,Bn1410,64235770,82085132,17849362,NBS
chr01,Bn1411,87526186,93675284,6149098,NBS
chr01,Bn1412,80351028,83106926,2755898,CN
chr01,Bn1413,33747507,74435656,40688149,CNL
chr01,Bn1414,60147893,73876438,13728545,TNL
chr01,Bn1415,12141203,94901660,82760457,TNL
chr01,Bn1416,82221892,91579894,9358002,TN
chr01,Bn1417,12219197,12741143,521946,NBS
chr01,Bn1418,5703357,10165268,4461911,CN
chr01,Bn1419,75511177,95040426,19529249,CN
chr01,Bn1420,76732206,90390238,13658032,TN
chr01,Bn1421,22396851,63408001,41011150,NBS
chr01,Bn1422,75514557,79009475,3494918,CN
chr01,Bn1423,79036754,96879295,17842541,CNL
chr01,Bn1424,65273164,73278102,8004938,TN
chr01,Bn1425,14591245,51593626,37002381,RLP
chr01,Bn1426,39924409,95650067,55725658,TNL
chr01,Bn1427,2547794,64418636,61870842,CN
chr01,Bn1428,16690136,50715509,34025373,RLP
chr01,Bn1429,26554377,57349325,30794948,TNL
chr01,Bn1430,99907299,99973053,65754,NBS
chr01,Bn1431,33795333,37224982,3429649,TNL
chr01,Bn1432,51602813,72926969,21324156,RLK
chr01,Bn1433,43045818,94337980,51292162,CN
chr01,Bn1434,74015555,79439121,5423566,NBS
chr01,Bn1435,73888052,94618532,20730480,TNL
chr01,Bn1436,92799262,99198162,6398900,TNL
chr01,Bn1437,4390741,80927778,76537037,CN
chr01,Bn1438,28516013,81659208,53143195,CNL
chr01,Bn1439,5104595,11876368,6771773,RLK
chr01,Bn1440,20021774,53998881,33977107,NBS
chr01,Bn1441,40964383,44716589,3752206,NBS
chr01,Bn1442,63434109,69866039,6431930,NBS
chr01,Bn1443,41638057,69858932,28220875,CN
chr01,Bn1444,82630966,82812374,181408,NBS
chr01,Bn1445,93195382,95135649,1940267,CN
chr01,Bn1446,96524821,98052311,1527490,RLK
chr01,Bn1447,1045344,30547461,29502117,TNL
chr01,Bn1448,85544776,93692476,8147700,RLP
chr01,Bn1449,53982869,54183760,200891,NBS
chr01,Bn1450,6428954,68856693,62427739,TN
chr01,Bn1451,58208093,59362066,1153973,RLK
chr01,Bn1452,50162958,53873028,3710070,CN
chr01,Bn1453,40460354,77379639,36919285,RLK
chr01,Bn1454,88835507,94202352,5366845,RLP
chr01,Bn1455,92085304,95074661,2989357,CNL
chr01,Bn1456,29894609,39314479,9419870,RLK
chr01,Bn1457,68501234,99238932,30737698,TNL
chr01,Bn1458,62022998,66678401,4655403,RLP
chr01,Bn1459,50777211,65112480,14335269,CN
chr01,Bn1460,64652232,85127676,20475444,RLP
chr01,Bn1461,47973317,69800170,21826853,CN
chr01,Bn1462,5169506,45540345,40370839,RLK
chr01,Bn1463,51865511,67618473,15752962,TN
chr01,Bn1464,88608978,94327341,5718363,CNL
chr01,Bn1465,62714411,83764590,21050179,NBS
chr01,Bn1466,83897240,88372037,4474797,RLP
chr01,Bn1467,48179066,62397170,14218104,TN
chr01,Bn1468,46597128,71305339,24708211,CNL
chr01,Bn1469,20381225,78475049,58093824,CN
chr01,Bn1470,85512811,92467285,6954474,NBS
chr01,Bn1471,34639230,46459101,11819871,TN
chr01,Bn1472,44136809,70540989,26404180,TN
chr01,Bn1473,20836506,47439911,26603405,NBS
chr01,Bn1474,59062448,88798359,29735911,RLP
chr01,Bn1475,48513375,64882714,16369339,CN
chr01,Bn1476,85717848,88530926,2813078,CNL
chr01,Bn1477,60151234,95758353,35607119,CN
chr01,Bn1478,46175336,61883551,15708215,NBS
chr01,Bn1479,26091165,38833496,12742331,TNL
chr01,Bn1480,65044963,99468771,34423808,CN
chr01,Bn1481,57626981,86552836,28925855,CNL
chr01,Bn1482,92592135,92663842,71707,RLK
chr01,Bn1483,92928022,94270196,1342174,RLP
chr01,Bn1484,21310614,77818702,56508088,NBS
chr01,Bn1485,45413455,48864571,3451116,TN
chr01,Bn1486,64037553,82331768,18294215,CN
chr01,Bn1487,96897129,99046078,2148949,TN
chr01,Bn1488,21392607,55357848,33965241,NBS
chr01,Bn1489,91713857,98389090,6675233,CN
chr01,Bn1490,71639874,83299436,11659562,CN
chr01,Bn1491,44266254,61769970,17503716,TN
chr01,Bn1492,55999467,61163362,5163895,NBS
chr01,Bn1493,7763648,50742882,42979234,CN
chr01,Bn1494,43797342,85060453,41263111,NBS
chr01,Bn1495,40672274,59241789,18569515,TN
chr01,Bn1496,94120047,98373218,4253171,TN
chr01,Bn1497,58141333,96316419,38175086,CNL
chr01,Bn1498,28601985,80749845,52147860,CNL
chr01,Bn1499,48652317,88772146,40119829,TNL
chr01,Bn1500,47832614,61479061,13646447,RLP
chr01,Bn1501,20417013,48062817,27645804,CN
chr01,Bn1502,52986369,59194947,6208578,TN
chr01,Bn1503,58315487,90783066,32467579,TN
chr01,Bn1504,42525272,79547443,37022171,RLP
chr01,Bn1505,77687434,90480196,12792762,CNL
chr01,Bn1506,16464960,38369768,21904808,RLP
chr01,Bn1507,36634309,98291998,61657689,NBS
chr01,Bn1508,4915035,36586118,31671083,CN
chr01,Bn1509,7508262,65094275,57586013,CNL
chr01,Bn1510,70829361,87860837,17031476,CN
chr01,Bn1511,82132924,85324671,3191747,CNL
chr01,Bn1512,78675828,91818328,13142500,TNL
chr01,Bn1513,74778374,83505144,8726770,TNL
chr01,Bn1514,14730707,98943451,84212744,CN
chr01,Bn1515,81208372,97403289,16194917,TN
chr01,Bn1516,22959653,40566990,17607337,CNL
chr01,Bn1517,95296184,97492303,2196119,NBS
chr01,Bn1518,3236815,94103797,90866982,TNL
chr01,Bn1519,21098459,25013885,3915426,TN
chr01,Bn1520,17967130,53022148,35055018,TN
chr01,Bn1521,39085551,44265065,5179514,TNL
chr01,Bn1522,59913755,64447397,4533642,CNL
chr01,Bn1523,16424754,49971163,33546409,RLP
chr01,Bn1524,12344704,22101368,9756664,CN
chr01,Bn1525,77482121,83237201,5755080,TN
chr01,Bn1526,62664107,82601130,19937023,TNL
chr01,Bn1527,79639710,88531427,8891717,NBS
chr01,Bn1528,71761330,82193379,10432049,RLP
chr01,Bn1529,10969688,54672682,43702994,TN
chr01,Bn1530,4974659,45519324,40544665,NBS
chr01,Bn1531,50047684,77308159,27260475,CNL
chr01,Bn1532,39801109,92671836,52870727,RLP
chr01,Bn1533,76217615,81964024,5746409,NBS
chr01,Bn1534,1751152,65014787,63263635,RLP
chr01,Bn1535,84084590,89054408,4969818,NBS
chr01,Bn1536,29968818,43911261,13942443,CN
chr01,Bn1537,10269547,39620634,29351087,NBS
chr01,Bn1538,3889072,20594640,16705568,TNL
chr01,Bn1539,62360995,92644261,30283266,NBS
chr01,Bn1540,20143048,38387157,18244109,TN
chr01,Bn1541,32131545,83203922,51072377,TN
chr01,Bn1542,65429592,79295056,13865464,NBS
chr01,Bn1543,53704773,84219853,30515080,TNL
chr01,Bn1544,86456660,95742548,9285888,TN
chr01,Bn1545,38460118,84884841,46424723,NBS
chr01,Bn1546,67765747,88524471,20758724,TN
chr01,Bn1547,50145351,51510453,1365102,CN
chr01,Bn1548,52935858,61657096,8721238,NBS
chr01,Bn1549,74390207,87021676,12631469,TN
chr01,Bn1550,13663987,88771441,75107454,TN
chr01,Bn1551,32675281,96618558,63943277,NBS
chr01,Bn1552,69588602,96887520,27298918,TNL
chr01,Bn1553,37932380,42241378,4308998,NBS
chr01,Bn1554,85287466,93331741,8044275,RLK
chr01,Bn1555,89381046,92486062,3105016,RLK
chr01,Bn1556,36646870,50381811,13734941,NBS
chr01,Bn1557,72572043,73504425,932382,TN
chr01,Bn1558,32315952,55986056,23670104,TN
chr01,Bn1559,55140592,99982771,44842179,RLK
chr01,Bn1560,20136095,22496503,2360408,TNL
chr01,Bn1561,54702426,84518241,29815815,CN
chr01,Bn1562,26863131,60066141,33203010,TN
chr01,Bn1563,14694970,90689235,75994265,TNL
chr01,Bn1564,3491302,7594709,4103407,CNL
chr01,Bn1565,83828530,96889172,13060642,TNL
chr01,Bn1566,93773035,96536514,2763479,TNL
chr01,Bn1567,45317752,83060443,37742691,RLK
chr01,Bn1568,58583475,88839068,30255593,CN
chr01,Bn1569,64077001,96415660,32338659,NBS
chr01,Bn1570,25230253,53291219,28060966,CN
chr01,Bn1571,15068890,57926981,42858091,NBS
chr01,Bn1572,64304684,98309480,34004796,TN
chr01,Bn1573,67707912,69633978,1926066,TN
chr01,Bn1574,33356009,60473784,27117775,NBS
chr01,Bn1575,29195436,50581438,21386002,TNL
chr01,Bn1576,58715625,81026171,22310546,RLK
chr01,Bn1577,54879939,93058604,38178665,TNL
chr01,Bn1578,89167378,89944298,776920,RLP
chr01,Bn1579,62360740,95186871,32826131,RLP
chr01,Bn1580,17842562,93283008,75440446,TN
chr01,Bn1581,12884395,83518553,70634158,TN
chr01,Bn1582,61562031,65639266,4077235,RLP
chr01,Bn1583,35210091,59491612,24281521,NBS
chr01,Bn1584,86999773,97774289,10774516,TN
chr01,Bn1585,5208923,11809060,6600137,TNL
chr01,Bn1586,78170110,81980970,3810860,TN
chr01,Bn1587,48071594,56468170,8396576,TNL
chr01,Bn1588,16039497,79120168,63080671,CNL
chr01,Bn1589,76992283,86428544,9436261,NBS
chr01,Bn1590,41500479,67849317,26348838,RLK
chr01,Bn1591,46264582,96623830,50359248,TNL
chr01,Bn1592,14732926,56365903,41632977,NBS
chr01,Bn1593,1467391,35937274,34469883,CN
chr01,Bn1594,56047151,94935621,38888470,CN
chr01,Bn1595,73333870,85999043,12665173,RLK
chr01,Bn1596,33020587,76558851,43538264,NBS
chr01,Bn1597,17897294,70231937,52334643,RLK
chr01,Bn1598,7372679,20515577,13142898,TNL
chr01,Bn1599,13621835,22913744,9291909,NBS
chr01,Bn1600,21363883,25945424,4581541,TN
chr01,Bn1601,10618983,85931070,75312087,CN
chr01,Bn1602,42149033,93771033,51622000,RLP
chr01,Bn1603,31306203,80582071,49275868,CNL
chr01,Bn1604,14589526,77823584,63234058,RLK
chr01,Bn1605,8847488,37727570,28880082,TN
chr01,Bn1606,66737063,99422405,32685342,RLK
chr01,Bn1607,1664266,76878263,75213997,CNL
chr01,Bn1608,32050267,39969593,7919326,CN
chr01,Bn1609,91053270,97129572,6076302,CN
chr01,Bn1610,30833248,35196657,4363409,TNL
chr01,Bn1611,26399522,93689610,67290088,TN
chr01,Bn1612,68501077,89938617,21437540,RLK
chr01,Bn1613,13082920,69552934,56470014,CNL
chr01,Bn1614,2976004,26369134,23393130,CN
chr01,Bn1615,92975978,99948059,6972081,CN
chr01,Bn1616,67977528,74451755,6474227,CNL
chr01,Bn1617,29616924,52984642,23367718,RLK
chr01,Bn1618,70100530,98979719,28879189,NBS
chr01,Bn1619,64977844,74588641,9610797,RLK
chr01,Bn1620,50238751,76496670,26257919,NBS
chr01,Bn1621,90326065,96566822,6240757,RLK
chr01,Bn1622,62084637,63660593,1575956,TNL
chr01,Bn1623,77708828,99761606,22052778,CNL
chr01,Bn1624,75289328,79578393,4289065,NBS
chr01,Bn1625,84228583,91494342,7265759,RLK
chr01,Bn1626,75996815,91387325,15390510,TN
chr01,Bn1627,85394524,91166826,5772302,CN
chr01,Bn1628,73255808,75036320,1780512,RLK
chr01,Bn1629,18774773,35431244,16656471,CNL
chr01,Bn1630,35749986,92511839,56761853,CNL
chr01,Bn1631,48274588,83633325,35358737,TNL
chr01,Bn1632,83841568,86610161,2768593,TNL
chr01,Bn1633,85973893,94722230,8748337,CN
chr01,Bn1634,35582915,75403227,39820312,CN
chr01,Bn1635,94519889,94763917,244028,RLK
chr01,Bn1636,7664668,91231382,83566714,RLK
chr01,Bn1637,53876685,89225446,35348761,RLK
chr01,Bn1638,65056526,68484759,3428233,CNL
chr01,Bn1639,15199111,16509516,1310405,TNL
chr01,Bn1640,3492069,57738320,54246251,NBS
chr01,Bn1641,90922852,92750334,1827482,TN
chr01,Bn1642,39222292,44915180,5692888,CNL
chr01,Bn1643,7073206,91484083,84410877,RLP
chr01,Bn1644,88848586,95589616,6741030,CN
chr01,Bn1645,13479357,41689326,28209969,CNL
chr01,Bn1646,36393906,46892103,10498197,TN
chr01,Bn1647,1039599,21331752,20292153,CNL
chr01,Bn1648,83626354,90995874,7369520,RLK
chr01,Bn1649,78983684,92027344,13043660,RLK
chr01,Bn1650,9777788,72289805,62512017,CNL
chr01,Bn1651,86562151,92980338,6418187,NBS
chr01,Bn1652,94210326,98545423,4335097,CN
chr01,Bn1653,6336367,21412455,15076088,TN
chr01,Bn1654,94326896,96487775,2160879,TN
chr01,Bn1655,86138963,95154415,9015452,NBS
chr01,Bn1656,10015821,18662208,8646387,TN
chr01,Bn1657,1651983,48956683,47304700,RLK
chr01,Bn1658,64929719,77189562,12259843,NBS
chr01,Bn1659,54985813,69556405,14570592,TNL
chr01,Bn1660,50040804,89238551,39197747,NBS
chr01,Bn1661,86389468,97708941,11319473,CN
chr01,Bn1662,82405479,90314391,7908912,TN
chr01,Bn1663,4040755,57724406,53683651,RLP
chr01,Bn1664,94906947,99409771,4502824,CNL
chr01,Bn1665,2410112,76050777,73640665,NBS
chr01,Bn1666,35802197,66237701,30435504,TN
chr01,Bn1667,96701477,99586523,2885046,TNL
chr01,Bn1668,95292041,98047041,2755000,CNL
chr01,Bn1669,71933257,91840380,19907123,TNL
chr01,Bn1670,17834477,84992964,67158487,CNL
chr01,Bn1671,57884842,96428639,38543797,TN
chr01,Bn1672,56459258,63717632,7258374,CNL
chr01,Bn1673,51494745,56837871,5343126,CNL
chr01,Bn1674,83659051,99702371,16043320,TNL
chr01,Bn1675,91586646,93866626,2279980,TNL
chr01,Bn1676,71921161,92249187,20328026,TN
chr01,Bn1677,73845485,86864330,13018845,TN
chr01,Bn1678,39168707,75779462,36610755,TN
chr01,Bn1679,45781658,49442184,3660526,RLK
chr01,Bn1680,52650181,62795485,10145304,CN
chr01,Bn1681,44248190,96866892,52618702,RLP
chr01,Bn1682,64197776,90572931,26375155,RLK
chr01,Bn1683,20723938,79875403,59151465,RLK
chr01,Bn1684,77367156,85965186,8598030,TN
chr01,Bn1685,12620121,45887635,33267514,TN
chr01,Bn1686,58378749,95730432,37351683,RLP
chr01,Bn1687,38541646,56395198,17853552,CNL
chr01,Bn1688,95744773,98794813,3050040,CN
chr01,Bn1689,26463647,53882194,27418547,RLK
chr01,Bn1690,76378129,83732477,7354348,NBS
chr01,Bn1691,17950825,39581608,21630783,NBS
chr01,Bn1692,15675572,58533160,42857588,RLK
chr01,Bn1693,35390872,65900427,30509555,RLK
chr01,Bn1694,51277365,60686328,9408963,NBS
chr01,Bn1695,91767819,97489550,5721731,RLP
chr01,Bn1696,44324732,89894564,45569832,CN
chr01,Bn1697,6574668,75704116,69129448,TNL
chr01,Bn1698,38456526,39811649,1355123,CNL
chr01,Bn1699,7852937,24602453,16749516,CNL
chr01,Bn1700,94719187,99239764,4520577,NBS
chr01,Bn1701,2393789,44261029,41867240,TNL
chr01,Bn1702,68805975,82857381,14051406,CNL
chr01,Bn1703,41813376,44675002,2861626,TN
chr01,Bn1704,59343551,71065676,11722125,NBS
chr01,Bn1705,73710968,81451105,7740137,RLP
chr01,Bn1706,92406024,98030769,5624745,TN
chr01,Bn1707,45345731,64912184,19566453,NBS
chr01,Bn1708,69397124,86082171,16685047,TN
chr01,Bn1709,59809846,73202266,13392420,CNL
chr01,Bn1710,44405936,63649902,19243966,RLP
chr01,Bn1711,6516068,45073806,38557738,RLP
chr01,Bn1712,32191211,99612758,67421547,NBS
chr01,Bn1713,60353607,71966925,11613318,RLP
chr01,Bn1714,22397639,72440890,50043251,TNL
chr01,Bn1715,56803257,86859150,30055893,RLK
chr01,Bn1716,58231474,78066909,19835435,TNL
chr01,Bn1717,58363646,67356977,8993331,CNL
chr01,Bn1718,56447177,58899759,2452582,TN
chr01,Bn1719,92728510,98377218,5648708,CNL
chr01,Bn1720,91967612,95862859,3895247,CNL
chr01,Bn1721,30015820,44261645,14245825,TNL
chr01,Bn1722,16848543,73472856,56624313,CNL
chr01,Bn1723,50519411,96823447,46304036,TN
chr01,Bn1724,34643254,64310311,29667057,NBS
chr01,Bn1725,2986086,95153476,92167390,CN
chr01,Bn1726,46153889,54278842,8124953,CNL
chr01,Bn1727,10135674,43281975,33146301,TNL
chr01,Bn1728,47813935,68684631,20870696,NBS
chr01,Bn1729,90054839,95864557,5809718,CNL
chr01,Bn1730,53912025,58996703,5084678,TNL
chr01,Bn1731,27436971,74271315,46834344,NBS
chr01,Bn1732,37094507,70324674,33230167,CNL
chr01,Bn1733,52907060,66856454,13949394,TNL
chr01,Bn1734,28143313,34739400,6596087,RLP
chr01,Bn1735,93371533,98493565,5122032,TN
chr01,Bn1736,41500838,87105989,45605151,NBS
chr01,Bn1737,90416491,95496320,5079829,RLP
chr01,Bn1738,29516438,78885982,49369544,TNL
chr01,Bn1739,27154423,34215705,7061282,RLK
chr01,Bn1740,69107623,71229113,2121490,TNL
chr01,Bn1741,93709026,95307487,1598461,TNL
chr01,Bn1742,54439438,68764948,14325510,CN
chr01,Bn1743,67006343,83426640,16420297,RLK
chr01,Bn1744,20832399,64068833,43236434,TN
chr01,Bn1745,92561680,94656466,2094786,RLP
chr01,Bn1746,57115571,85470863,28355292,CN
chr01,Bn1747,56864624,85036276,28171652,TNL
chr01,Bn1748,38772159,94922338,56150179,CN
chr01,Bn1749,66036880,71221033,5184153,NBS
chr01,Bn1750,9653142,74526352,64873210,TN
chr01,Bn1751,49778825,93328507,43549682,RLK
chr01,Bn1752,11099215,96942842,85843627,CN
chr01,Bn1753,95004742,96778102,1773360,RLP
chr01,Bn1754,68213068,76837742,8624674,NBS
chr01,Bn1755,16025006,66811865,50786859,RLK
chr01,Bn1756,10228974,64062639,53833665,CN
chr01,Bn1757,79802997,89940814,10137817,TN
chr01,Bn1758,3229813,55964739,52734926,CNL
chr01,Bn1759,12577046,20805045,8227999,TN
chr01,Bn1760,88265861,99287602,11021741,RLK
chr01,Bn1761,83285072,91487742,8202670,NBS
chr01,Bn1762,72107033,82366630,10259597,TNL
chr01,Bn1763,22434584,45442081,23007497,RLP
chr01,Bn1764,11136177,47306656,36170479,RLP
chr01,Bn1765,49106676,51089613,1982937,TNL
chr01,Bn1766,31178381,34996479,3818098,TNL
chr01,Bn1767,23525668,24098844,573176,TN
chr01,Bn1768,5463753,86142117,80678364,CNL
chr01,Bn1769,33294496,48148442,14853946,NBS
chr01,Bn1770,98607175,99930886,1323711,TN
chr01,Bn1771,46705433,78708819,32003386,TN
chr01,Bn1772,70210653,70968497,757844,CN
chr01,Bn1773,67748301,93126782,25378481,TN
chr01,Bn1774,20249941,76595502,56345561,RLP
chr01,Bn1775,98329788,98752492,422704,TN
chr01,Bn1776,43112518,65555152,22442634,RLK
chr01,Bn1777,38652692,43666946,5014254,CNL
chr01,Bn1778,2156547,37412393,35255846,TN
chr01,Bn1779,9428567,34722687,25294120,TN
chr01,Bn1780,53353490,93660245,40306755,TNL
chr01,Bn1781,39972653,41372284,1399631,RLK
chr01,Bn1782,16684793,70338602,53653809,RLP
chr01,Bn1783,4680472,78486725,73806253,TNL
chr01,Bn1784,55250598,88590844,33340246,NBS
chr01,Bn1785,77784795,88845806,11061011,RLK
chr01,Bn1786,36972169,77117631,40145462,CN
chr01,Bn1787,64475425,80471827,15996402,RLP
chr01,Bn1788,2462476,80453773,77991297,NBS
chr01,Bn1789,2584874,46556032,43971158,NBS
chr01,Bn1790,19474531,46809412,27334881,CN
chr01,Bn1791,24759281,67976872,43217591,TN
chr01,Bn1792,92348276,97406938,5058662,TN
chr01,Bn1793,36812503,39627789,2815286,CNL
chr01,Bn1794,35778799,60993792,25214993,NBS
chr01,Bn1795,12196902,43317266,31120364,CN
chr01,Bn1796,39648094,63742372,24094278,RLP
chr01,Bn1797,94930060,95936974,1006914,NBS
chr01,Bn1798,62312014,78331303,16019289,TNL
chr01,Bn1799,72999778,99193877,26194099,CNL
chr01,Bn1800,36786673,84728023,47941350,CN
chr01,Bn1801,31615643,43890046,12274403,CNL
chr01,Bn1802,5642831,61356707,55713876,CNL
chr01,Bn1803,9281768,54387709,45105941,RLK
chr01,Bn1804,77766269,79096356,1330087,CN
chr01,Bn1805,46252501,79863521,33611020,CNL
chr01,Bn1806,75732517,89717654,13985137,RLP
chr01,Bn1807,14164291,59938462,45774171,TNL
chr01,Bn1808,70214913,98054578,27839665,TN
chr01,Bn1809,55884711,64981658,9096947,TN
chr01,Bn1810,11340085,17780153,6440068,RLP
chr01,Bn1811,11571299,63556415,51985116,TNL
chr01,Bn1812,98081416,98225121,143705,RLP
chr01,Bn1813,59558346,71631811,12073465,RLK
chr01,Bn1814,38208794,99828174,61619380,NBS
chr01,Bn1815,98513683,98746750,233067,CNL
chr01,Bn1816,47843090,61167538,13324448,NBS
chr01,Bn1817,42857109,67622222,24765113,RLK
chr01,Bn1818,72761656,73559739,798083,NBS
chr01,Bn1819,87501847,91070059,3568212,RLK
chr01,Bn1820,10713054,12964845,2251791,TN
chr01,Bn1821,16565124,75382822,58817698,TNL
chr01,Bn1822,25508695,85684301,60175606,NBS
chr01,Bn1823,10280146,79979548,69699402,CN
chr01,Bn1824,45728045,73038003,27309958,RLP
chr01,Bn1825,37974174,42513261,4539087,TNL
chr01,Bn1826,45681136,93134016,47452880,CNL
chr01,Bn1827,9269135,34471575,25202440,CN
chr01,Bn1828,62219281,67461534,5242253,TNL
chr01,Bn1829,2137276,30404632,28267356,NBS
chr01,Bn1830,88611175,94851765,6240590,RLP
chr01,Bn1831,29821636,65252304,35430668,NBS
chr01,Bn1832,99344716,99627077,282361,CNL
chr01,Bn1833,66748155,79953657,13205502,CNL
chr01,Bn1834,75731446,89102108,13370662,NBS
chr01,Bn1835,27582984,33224874,5641890,TNL
chr01,Bn1836,27953876,66887240,38933364,TN
chr01,Bn1837,73925573,81743126,7817553,TN
chr01,Bn1838,20501303,33286912,12785609,CNL
chr01,Bn1839,77860557,88105518,10244961,RLP
chr01,Bn1840,20856153,37316340,16460187,TNL
chr01,Bn1841,73850313,93254541,19404228,RLP
chr01,Bn1842,14552270,76745028,62192758,RLP
chr01,Bn1843,27959608,42567610,14608002,TN
chr01,Bn1844,71404341,75084066,3679725,RLK
chr01,Bn1845,73088315,85088266,11999951,RLK
chr01,Bn1846,63592528,80340846,16748318,RLK
chr01,Bn1847,92810776,95217240,2406464,TN
chr01,Bn1848,68064084,85162924,17098840,RLP
chr01,Bn1849,6398899,39129727,32730828,CNL
chr01,Bn1850,39858568,71596107,31737539,RLP
chr01,Bn1851,60406838,71320576,10913738,TNL
chr01,Bn1852,3468995,46133338,42664343,TN
chr01,Bn1853,61605426,63033259,1427833,TNL
chr01,Bn1854,64756552,79848796,15092244,CN
chr01,Bn1855,76288703,83352895,7064192,TN
chr01,Bn1856,73509561,88879355,15369794,TNL
chr01,Bn1857,83768922,90635625,6866703,TNL
chr01,Bn1858,51356052,98318754,46962702,RLP
chr01,Bn1859,72191783,75560892,3369109,RLP
chr01,Bn1860,78775667,89595746,10820079,RLK
chr01,Bn1861,58314274,64571705,6257431,RLP
chr01,Bn1862,86070223,99472777,13402554,NBS
chr01,Bn1863,56688332,66077479,9389147,CN
chr01,Bn1864,87437992,94742826,7304834,CN
chr01,Bn1865,2422578,81473489,79050911,CN
chr01,Bn1866,61879352,91754059,29874707,NBS
chr01,Bn1867,59199059,83887126,24688067,TNL
chr01,Bn1868,81129239,90085309,8956070,TN
chr01,Bn1869,91024646,96552520,5527874,RLP
chr01,Bn1870,12790399,60049163,47258764,CN
chr01,Bn1871,72253091,77724038,5470947,RLK
chr01,Bn1872,34275876,60374675,26098799,RLP
chr01,Bn1873,10875671,77242360,66366689,RLK
chr01,Bn1874,9139541,44151104,35011563,CN
chr01,Bn1875,79558443,94155146,14596703,RLP
chr01,Bn1876,72681193,96188561,23507368,TNL
chr01,Bn1877,38574138,95941249,57367111,TNL
chr01,Bn1878,74220779,74731372,510593,CNL
chr01,Bn1879,43128217,87177474,44049257,RLK
chr01,Bn1880,98221701,99260628,1038927,TNL
chr01,Bn1881,87306134,91236783,3930649,CN
chr01,Bn1882,16469117,60487897,44018780,TN
chr01,Bn1883,48587558,85463014,36875456,RLP
chr01,Bn1884,20239568,85195169,64955601,NBS
chr01,Bn1885,58896694,97882198,38985504,RLP
chr01,Bn1886,89959743,95771919,5812176,RLP
chr01,Bn1887,28283559,98337943,70054384,TN
chr01,Bn1888,35222838,87458565,52235727,NBS
chr01,Bn1889,62185587,91027029,28841442,NBS
chr01,Bn1890,20270892,99279970,79009078,TNL
chr01,Bn1891,38368633,72798651,34430018,RLK
chr01,Bn1892,90611030,93756236,3145206,RLP
chr01,Bn1893,20076757,59337413,39260656,NBS
chr01,Bn1894,97968363,99609154,1640791,TNL
chr01,Bn1895,32541564,70683048,38141484,TNL
chr01,Bn1896,50837601,59535597,8697996,RLP
chr01,Bn1897,85910489,92761569,6851080,TN
chr01,Bn1898,16116000,20528866,4412866,TNL
chr01,Bn1899,2473879,88947647,86473768,TN
chr01,Bn1900,55260571,80284682,25024111,NBS
chr01,Bn1901,73990797,74596757,605960,CNL
chr01,Bn1902,88287818,95999265,7711447,CN
chr01,Bn1903,82627555,87764917,5137362,CN
chr01,Bn1904,25043227,28546840,3503613,CN
chr01,Bn1905,57297090,57430786,133696,CN
chr01,Bn1906,30034993,93614320,63579327,RLK
chr01,Bn1907,99341068,99964908,623840,CNL
chr01,Bn1908,39768843,56437244,16668401,NBS
chr01,Bn1909,18367711,75557141,57189430,RLP
chr01,Bn1910,18225086,36526743,18301657,TNL
chr01,Bn1911,88296960,96117855,7820895,TNL
chr01,Bn1912,53891132,83273323,29382191,TNL
chr01,Bn1913,24131352,28174298,4042946,CN
chr01,Bn1914,4256899,63641417,59384518,CN
chr01,Bn1915,26751558,76873902,50122344,TNL
chr01,Bn1916,69920155,88972261,19052106,TNL
chr01,Bn1917,42911308,93598088,50686780,TN
chr01,Bn1918,64062664,95871884,31809220,TNL
chr01,Bn1919,28515730,64502524,35986794,RLK
chr01,Bn1920,48041915,88491115,40449200,TNL
chr01,Bn1921,83340757,89031139,5690382,NBS
chr01,Bn1922,22964103,33335742,10371639,RLP
chr01,Bn1923,45966766,72505734,26538968,RLP
chr01,Bn1924,69888150,88124077,18235927,TN
chr01,Bn1925,88768005,99302682,10534677,RLK
chr01,Bn1926,63606766,84869409,21262643,NBS
chr01,Bn1927,98271845,99717702,1445857,TNL
chr01,Bn1928,25799871,40316182,14516311,TN
chr01,Bn1929,29686840,98135507,68448667,TNL
chr01,Bn1930,59569074,96705034,37135960,CN
chr01,Bn1931,50335510,83686394,33350884,RLP
chr01,Bn1932,63666632,90384753,26718121,CNL
chr01,Bn1933,93317038,93990454,673416,TNL
chr01,Bn1934,89325557,97768203,8442646,TN
chr01,Bn1935,5074946,52718659,47643713,TNL
chr01,Bn1936,3842609,81923895,78081286,CNL
chr01,Bn1937,95647911,98447833,2799922,CNL
chr01,Bn1938,99934697,99961659,26962,RLK
chr01,Bn1939,69549407,89653282,20103875,TNL
chr01,Bn1940,53582767,85538356,31955589,CNL
chr01,Bn1941,96689275,98115275,1426000,NBS
chr01,Bn1942,44499048,92783661,48284613,RLK
chr01,Bn1943,23331186,87728702,64397516,CNL
chr01,Bn1944,43173389,89369518,46196129,RLK
chr01,Bn1945,11865978,37772306,25906328,CN
chr01,Bn1946,42191272,42332863,141591,TN
chr01,Bn1947,32474209,89522258,57048049,CN
chr01,Bn1948,98772052,99888086,1116034,RLK
chr01,Bn1949,83172740,92680375,9507635,RLP
chr01,Bn1950,30338594,31392882,1054288,NBS
chr01,Bn1951,96572195,97377780,805585,NBS
chr01,Bn1952,26130571,60425174,34294603,TNL
chr01,Bn1953,62396617,98350008,35953391,TNL
chr01,Bn1954,29953992,97299275,67345283,CN
chr01,Bn1955,83653753,97875823,14222070,TN
chr01,Bn1956,33737730,97624204,63886474,RLK
chr01,Bn1957,99869506,99872878,3372,TNL
chr01,Bn1958,43504669,86833447,43328778,CNL
chr01,Bn1959,92081343,96133230,4051887,RLP
chr01,Bn1960,62649586,97649027,34999441,CN
chr01,Bn1961,31061845,90939767,59877922,TNL
chr01,Bn1962,44798298,83642243,38843945,CNL
chr01,Bn1963,7152563,28657712,21505149,TN
chr01,Bn1964,69056445,94905980,25849535,TNL
chr01,Bn1965,12810405,76036432,63226027,NBS
chr01,Bn1966,12104292,37555808,25451516,RLK
chr01,Bn1967,48184022,69500750,21316728,CNL
chr01,Bn1968,50474294,55883146,5408852,CN
chr01,Bn1969,3488848,8284610,4795762,CN
chr01,Bn1970,80798660,88229174,7430514,TN
chr01,Bn1971,10684309,57243942,46559633,CNL
chr01,Bn1972,63449128,77989001,14539873,RLK
chr01,Bn1973,48188393,82688698,34500305,TN
chr01,Bn1974,85202656,94266875,9064219,TNL
chr01,Bn1975,16464968,30333731,13868763,RLP
chr01,Bn1976,92846809,99207084,6360275,RLP
chr01,Bn1977,27968317,78605322,50637005,TN
chr01,Bn1978,20241636,80515032,60273396,NBS
chr01,Bn1979,10001197,59453215,49452018,TN
chr01,Bn1980,18921638,22200794,3279156,TN
chr01,Bn1981,8422443,54832324,46409881,RLP
chr01,Bn1982,93346133,99895206,6549073,RLP
chr01,Bn1983,46116777,56685587,10568810,CN
chr01,Bn1984,3169177,65483338,62314161,RLK
chr01,Bn1985,25348007,63511639,38163632,NBS
chr01,Bn1986,70953330,84188544,13235214,NBS
chr01,Bn1987,8383843,93272185,84888342,NBS
chr01,Bn1988,42106128,74678673,32572545,TNL
chr01,Bn1989,71893921,87971176,16077255,RLK
chr01,Bn1990,81641759,97531821,15890062,CNL
chr01,Bn1991,37023373,98117274,61093901,CN
chr01,Bn1992,54188398,97326571,43138173,TNL
chr01,Bn1993,96448821,99400342,2951521,CNL
chr01,Bn1994,91220483,97124508,5904025,CNL
chr01,Bn1995,62367811,62906356,538545,RLP
chr01,Bn1996,92157437,97854493,5697056,RLP
chr01,Bn1997,27670657,31335181,3664524,TNL
chr01,Bn1998,20498385,38771255,18272870,RLP
chr01,Bn1999,70934804,77517349,6582545,CNL
chr01,Bn2000,21076068,81395960,60319892,CNL
chr01,Bn2001,63049666,65546793,2497127,CN
chr01,Bn2002,59789335,81295531,21506196,TNL
chr01,Bn2003,23834713,28507927,4673214,RLP
chr01,Bn2004,84962424,93509592,8547168,NBS
chr01,Bn2005,61298092,78672855,17374763,NBS
chr01,Bn2006,43442656,91105893,47663237,RLK
chr01,Bn2007,84912095,89374607,4462512,RLK
chr01,Bn2008,32671234,38629462,5958228,CN
chr01,Bn2009,35618833,53004711,17385878,RLK
chr01,Bn2010,57335559,68268308,10932749,NBS
chr01,Bn2011,37037435,67438711,30401276,RLK
chr01,Bn2012,81005390,91084067,10078677,TN
chr01,Bn2013,1407028,41832379,40425351,TN
chr01,Bn2014,63495225,91864585,28369360,CNL
chr01,Bn2015,6398661,18502333,12103672,TNL
chr01,Bn2016,23067940,79224373,56156433,TN
chr01,Bn2017,60669426,83527695,22858269,NBS
chr01,Bn2018,8625554,81127979,72502425,RLP
chr01,Bn2019,80780529,83460746,2680217,RLP
chr01,Bn2020,23978371,82458969,58480598,CNL
chr01,Bn2021,46485124,83854912,37369788,TNL
chr01,Bn2022,72441787,74037618,1595831,TN
chr01,Bn2023,53366291,65840353,12474062,RLP
chr01,Bn2024,54459263,81068272,26609009,CNL
chr01,Bn2025,6552052,35915570,29363518,NBS
chr01,Bn2026,87893001,91751103,3858102,RLP
chr01,Bn2027,78619213,92208060,13588847,TN
chr01,Bn2028,62686867,96967569,34280702,NBS
chr01,Bn2029,15032974,17782066,2749092,RLK
chr01,Bn2030,1507134,87107874,85600740,RLP
chr01,Bn2031,71403486,86396809,14993323,TN
chr01,Bn2032,20522324,70013413,49491089,TNL
chr01,Bn2033,6054160,15742962,9688802,RLP
chr01,Bn2034,42940831,77090622,34149791,CNL
chr01,Bn2035,48868535,70279147,21410612,RLK
chr01,Bn2036,15880544,33719554,17839010,TN
chr01,Bn2037,99228232,99387812,159580,CNL
chr01,Bn2038,8443682,13727241,5283559,RLP
chr01,Bn2039,85909136,90713614,4804478,NBS
chr01,Bn2040,94437041,97722216,3285175,TN
chr01,Bn2041,48361573,62155075,13793502,TN
chr01,Bn2042,16766111,22173153,5407042,RLP
chr01,Bn2043,27645188,56407141,28761953,NBS
chr01,Bn2044,25858145,37766951,11908806,RLK
chr01,Bn2045,1009962,10581452,9571490,CNL
chr01,Bn2046,29571348,74381540,44810192,CN
chr01,Bn2047,96449371,99160791,2711420,CN
chr01,Bn2048,65454301,98843102,33388801,RLK
chr01,Bn2049,30026128,67040147,37014019,TNL
chr01,Bn2050,50326436,80552302,30225866,CNL
chr01,Bn2051,58221340,79196421,20975081,TNL
chr01,Bn2052,47435817,78770897,31335080,CNL
chr01,Bn2053,60430740,76359352,15928612,RLP
chr01,Bn2054,17870888,38056450,20185562,TN
chr01,Bn2055,27797975,64858383,37060408,NBS
chr01,Bn2056,30469884,83489784,53019900,NBS
chr01,Bn2057,97182789,99561115,2378326,CN
chr01,Bn2058,91773045,96084391,4311346,TN
chr01,Bn2059,95683291,96068751,385460,RLP
chr01,Bn2060,82618588,99356385,16737797,TNL
chr01,Bn2061,20921904,50236974,29315070,TNL
chr01,Bn2062,75778005,92757904,16979899,TN
chr01,Bn2063,76989520,95215398,18225878,RLK
chr01,Bn2064,77385482,94253328,16867846,RLP
chr01,Bn2065,23963548,43227281,19263733,CN
chr01,Bn2066,11318423,30522036,19203613,CN
chr01,Bn2067,82948687,99824408,16875721,RLP
chr01,Bn2068,22520025,43316087,20796062,RLP
chr01,Bn2069,6645164,82156018,75510854,TNL
chr01,Bn2070,21134788,49546584,28411796,TN
chr01,Bn2071,78353049,89410288,11057239,NBS
chr01,Bn2072,43954995,63010551,19055556,NBS
chr01,Bn2073,16378669,43597095,27218426,NBS
chr01,Bn2074,56428942,56442126,13184,RLK
chr01,Bn2075,29210389,93641326,64430937,NBS
chr01,Bn2076,87477031,96224464,8747433,NBS
chr01,Bn2077,13513158,53366573,39853415,CN
chr01,Bn2078,69664315,89400815,19736500,CN
chr01,Bn2079,63876089,72617778,8741689,NBS
chr01,Bn2080,89096005,89301376,205371,TNL
chr01,Bn2081,48123196,70121460,21998264,NBS
chr01,Bn2082,3498952,16568664,13069712,CNL
chr01,Bn2083,35747689,86410306,50662617,TN
chr01,Bn2084,73405406,84792770,11387364,TN
chr01,Bn2085,55333616,81379901,26046285,CN
chr01,Bn2086,37154066,82801025,45646959,RLP
chr01,Bn2087,44681803,92916551,48234748,CNL
chr01,Bn2088,75288400,86411091,11122691,RLK
chr01,Bn2089,36422731,95030396,58607665,CNL
chr01,Bn2090,43139156,72345766,29206610,RLP
chr01,Bn2091,13173463,44256763,31083300,CNL
chr01,Bn2092,91562375,96064777,4502402,CNL
chr01,Bn2093,12143317,34466640,22323323,NBS
chr01,Bn2094,50894540,73110212,22215672,TN
chr01,Bn2095,97486750,98834228,1347478,TNL
chr01,Bn2096,15286244,92598953,77312709,NBS
chr01,Bn2097,66782617,86622244,19839627,RLP
chr01,Bn2098,31294170,73761508,42467338,CN
chr01,Bn2099,50592298,75270394,24678096,CN
chr01,Bn2100,93694501,99982813,6288312,CN
chr01,Bn2101,80556621,93817433,13260812,CNL
chr01,Bn2102,40888193,41415711,527518,RLP
chr01,Bn2103,18382833,93521441,75138608,RLP
chr01,Bn2104,35221863,89455766,54233903,NBS
chr01,Bn2105,52973869,98873530,45899661,NBS
chr01,Bn2106,57530962,87925483,30394521,NBS
chr01,Bn2107,16688554,56039549,39350995,NBS
chr01,Bn2108,40792315,72250228,31457913,TNL
chr01,Bn2109,54160719,93429103,39268384,NBS
chr01,Bn2110,88691240,90468221,1776981,CNL
chr01,Bn2111,34217382,98402109,64184727,CNL
chr01,Bn2112,42479190,71681014,29201824,RLK
chr01,Bn2113,37384401,57674643,20290242,CN
chr01,Bn2114,83843818,85440626,1596808,TNL
chr01,Bn2115,53295516,62909896,9614380,RLK
chr01,Bn2116,73037776,94071132,21033356,RLP
chr01,Bn2117,90039661,93016672,2977011,CN
chr01,Bn2118,87641529,89836841,2195312,CNL
chr01,Bn2119,74921053,80576434,5655381,RLP
chr01,Bn2120,28366550,56726173,28359623,TN
chr01,Bn2121,65396014,78766633,13370619,RLK
chr01,Bn2122,19771176,33628495,13857319,TNL
chr01,Bn2123,18401450,67399776,48998326,TNL
chr01,Bn2124,83382731,90416034,7033303,RLP
chr01,Bn2125,55385449,60365559,4980110,CNL
chr01,Bn2126,78152951,86445328,8292377,RLK
chr01,Bn2127,21154247,58273703,37119456,RLK
chr01,Bn2128,58211723,97301521,39089798,TN
chr01,Bn2129,87833208,95418116,7584908,TNL
chr01,Bn2130,98884660,99633290,748630,CNL
chr01,Bn2131,36812048,91638183,54826135,CN
chr01,Bn2132,40717143,44323106,3605963,TNL
chr01,Bn2133,94692268,96421320,1729052,NBS
chr01,Bn2134,39376312,68630600,29254288,CNL
chr01,Bn2135,73827127,90205180,16378053,NBS
chr01,Bn2136,80936256,95716569,14780313,CNL
chr01,Bn2137,2867482,87817833,84950351,NBS
chr01,Bn2138,90495815,91996427,1500612,RLK
chr01,Bn2139,5167301,31790772,26623471,RLP
chr01,Bn2140,87657032,89940006,2282974,NBS
chr01,Bn2141,48555743,49215286,659543,CNL
chr01,Bn2142,78404978,98802309,20397331,RLP
chr01,Bn2143,25457515,57528813,32071298,NBS
chr01,Bn2144,59192052,68414476,9222424,CNL
chr01,Bn2145,96238605,96846082,607477,RLK
chr01,Bn2146,95403441,96122613,719172,CN
chr01,Bn2147,41487721,84598556,43110835,RLK
chr01,Bn2148,53549397,65608930,12059533,TN
chr01,Bn2149,24626559,48298144,23671585,RLK
chr01,Bn2150,65034272,98533374,33499102,RLP
chr01,Bn2151,19577816,40257434,20679618,RLK
chr01,Bn2152,37030865,93451736,56420871,TN
chr01,Bn2153,46806869,94533539,47726670,TN
chr01,Bn2154,86226515,89574625,3348110,CN
chr01,Bn2155,69227184,69478854,251670,TN
chr01,Bn2156,90197159,91676065,1478906,TN
chr01,Bn2157,29314352,55025120,25710768,CNL
chr01,Bn2158,47133584,92599142,45465558,RLP
chr01,Bn2159,5516508,8051725,2535217,TN
chr01,Bn2160,91515478,96976024,5460546,RLP
chr01,Bn2161,95028906,99313395,4284489,RLP
chr01,Bn2162,35935347,67271342,31335995,NBS
chr01,Bn2163,52469091,87363028,34893937,TNL
chr01,Bn2164,48119254,54159564,6040310,NBS
chr01,Bn2165,48637754,68450817,19813063,TNL
chr01,Bn2166,73855652,86892651,13036999,NBS
chr01,Bn2167,80877492,92695547,11818055,CN
chr01,Bn2168,62900621,66337463,3436842,CNL
chr01,Bn2169,9380418,41075784,31695366,TN
chr01,Bn2170,59828068,63640212,3812144,TN
chr01,Bn2171,39791904,85505984,45714080,TNL
chr01,Bn2172,36824311,56458932,19634621,CNL
chr01,Bn2173,6735260,98325700,91590440,CNL
chr01,Bn2174,99853720,99970411,116691,TNL
chr01,Bn2175,62864400,82938645,20074245,RLP
chr01,Bn2176,38494696,84902407,46407711,RLP
chr01,Bn2177,95623238,97135806,1512568,CNL
chr01,Bn2178,33352867,93681618,60328751,CNL
chr01,Bn2179,35393469,43406859,8013390,CNL
chr01,Bn2180,5946971,77435070,71488099,RLP
chr01,Bn2181,48406260,70349800,21943540,RLK
chr01,Bn2182,79663301,85615172,5951871,TNL
chr01,Bn2183,34855466,56496524,21641058,CNL
chr01,Bn2184,16548861,38317942,21769081,RLP
chr01,Bn2185,88399904,99325597,10925693,NBS
chr01,Bn2186,76334234,94842163,18507929,CNL
chr01,Bn2187,76995791,83653856,6658065,CNL
chr01,Bn2188,43414750,80018563,36603813,RLP
chr01,Bn2189,87943608,99102256,11158648,RLP
chr01,Bn2190,92009063,98964082,6955019,TNL
chr01,Bn2191,77254322,95844935,18590613,CN
chr01,Bn2192,34838563,91732112,56893549,NBS
chr01,Bn2193,78815934,87900995,9085061,RLP
chr01,Bn2194,25752645,97000567,71247922,RLP
chr01,Bn2195,24715354,64177048,39461694,CN
chr01,Bn2196,28717455,38889001,10171546,TNL
chr01,Bn2197,42194497,69280403,27085906,RLP
chr01,Bn2198,89553131,97678613,8125482,NBS
chr01,Bn2199,67805066,69816338,2011272,TN
chr01,Bn2200,89874287,96948731,7074444,CNL
chr01,Bn2201,79820934,84268441,4447507,CNL
chr01,Bn2202,14846839,67521893,52675054,RLK
chr01,Bn2203,37879849,49569060,11689211,TN
chr01,Bn2204,9255229,68849926,59594697,TNL
chr01,Bn2205,11921147,42635213,30714066,CN
chr01,Bn2206,47586115,69483921,21897806,TN
chr01,Bn2207,11416978,20682593,9265615,CN
chr01,Bn2208,25271495,39575208,14303713,CNL
chr01,Bn2209,57773276,67555213,9781937,RLP
chr01,Bn2210,55971822,60983830,5012008,RLP
chr01,Bn2211,55652004,72497103,16845099,CNL
chr01,Bn2212,95454127,96918570,1464443,TNL
chr01,Bn2213,40904276,97417456,56513180,RLK
chr01,Bn2214,64459694,94280209,29820515,CNL
chr01,Bn2215,65850402,69671888,3821486,NBS
chr01,Bn2216,54341809,91016725,36674916,NBS
chr01,Bn2217,14016937,31623290,17606353,NBS
chr01,Bn2218,76345322,76930106,584784,CN
chr01,Bn2219,52736134,56049183,3313049,RLK
chr01,Bn2220,71288837,79589322,8300485,TNL
chr01,Bn2221,54350502,69775953,15425451,RLP
chr01,Bn2222,34366608,42457834,8091226,TNL
chr01,Bn2223,20857400,99038331,78180931,TNL
chr01,Bn2224,25159202,46079917,20920715,TN
chr01,Bn2225,94940952,96378092,1437140,RLP
chr01,Bn2226,88276333,96939841,8663508,NBS
chr01,Bn2227,80313005,87809002,7495997,NBS
chr01,Bn2228,15793804,64645598,48851794,RLP
chr01,Bn2229,27550814,31720061,4169247,CN
chr01,Bn2230,44726064,52005187,7279123,TNL
chr01,Bn2231,18990298,39646234,20655936,TNL
chr01,Bn2232,92087066,96618744,4531678,TNL
chr01,Bn2233,55415589,91701668,36286079,TN
chr01,Bn2234,2348070,19128876,16780806,RLK
chr01,Bn2235,53344549,63343029,9998480,NBS
chr01,Bn2236,73686521,86176958,12490437,CNL
chr01,Bn2237,5682681,67879680,62196999,CN
chr01,Bn2238,39621953,98570124,58948171,CNL
chr01,Bn2239,99733264,99795519,62255,RLP
chr01,Bn2240,32285997,55006066,22720069,RLP
chr01,Bn2241,65054964,69051393,3996429,TNL
chr01,Bn2242,59664492,66611281,6946789,RLK
chr01,Bn2243,99725527,99982498,256971,TNL
chr01,Bn2244,90532909,95936562,5403653,TNL
chr01,Bn2245,57271938,66496001,9224063,TNL
chr01,Bn2246,10835195,51750160,40914965,RLP
chr01,Bn2247,83666850,85099541,1432691,RLP
chr01,Bn2248,47544801,50308341,2763540,CN
chr01,Bn2249,48770335,82438662,33668327,NBS
chr01,Bn2250,3516846,95943311,92426465,RLP
chr01,Bn2251,95331108,97388512,2057404,RLP
chr01,Bn2252,53424804,65376803,11951999,NBS
chr01,Bn2253,90060376,90194343,133967,CN
chr01,Bn2254,28677783,50272499,21594716,TNL
chr01,Bn2255,28337717,42997269,14659552,NBS
chr01,Bn2256,47794894,58270736,10475842,CN
chr01,Bn2257,85402862,99053438,13650576,TNL
chr01,Bn2258,4263761,71282036,67018275,TNL
chr01,Bn2259,45171357,83880567,38709210,TNL
chr01,Bn2260,17231159,64625770,47394611,CN
chr01,Bn2261,44397046,95714810,51317764,RLK
chr01,Bn2262,40610329,47694301,7083972,RLK
chr01,Bn2263,79113701,84746355,5632654,RLP
chr01,Bn2264,81058773,81988727,929954,CN
chr01,Bn2265,85403245,92967671,7564426,CNL
chr01,Bn2266,32066022,69101764,37035742,RLP
chr01,Bn2267,34655122,92119787,57464665,RLP
chr01,Bn2268,22298812,72750560,50451748,RLP
chr01,Bn2269,87147743,96431314,9283571,RLP
chr01,Bn2270,28675934,93641777,64965843,NBS
chr01,Bn2271,71605856,86476055,14870199,NBS
chr01,Bn2272,43060230,98591530,55531300,CN
chr01,Bn2273,85450134,96001721,10551587,NBS
chr01,Bn2274,3067225,74195598,71128373,CN
chr01,Bn2275,36879590,54315879,17436289,TN
chr01,Bn2276,58431126,80777946,22346820,RLK
chr01,Bn2277,70758539,82799342,12040803,CNL
chr01,Bn2278,42978094,75490025,32511931,TN
chr01,Bn2279,33112215,33432425,320210,TNL
chr01,Bn2280,78385055,98163771,19778716,CN
chr01,Bn2281,19252426,44393210,25140784,RLP
chr01,Bn2282,87996163,89430912,1434749,NBS
chr01,Bn2283,53804550,82937560,29133010,RLK
chr01,Bn2284,94672654,99445605,4772951,RLP
chr01,Bn2285,36864220,67617101,30752881,RLK
chr01,Bn2286,36923074,41655383,4732309,TNL
chr01,Bn2287,97548486,99263560,1715074,TN
chr01,Bn2288,1418432,73018301,71599869,TN
chr01,Bn2289,41132678,43666233,2533555,CN
chr01,Bn2290,70464832,99733904,29269072,NBS
chr01,Bn2291,48031064,49536318,1505254,RLP
chr01,Bn2292,49463212,90675393,41212181,RLK
chr01,Bn2293,1003702,17548098,16544396,RLP
chr01,Bn2294,48155532,79815059,31659527,NBS
chr01,Bn2295,38024404,61262394,23237990,RLP
chr01,Bn2296,56087154,62458213,6371059,TN
chr01,Bn2297,5688534,61234830,55546296,NBS
chr01,Bn2298,37285005,62878337,25593332,CN
chr01,Bn2299,87712187,88870947,1158760,TNL
chr01,Bn2300,25456910,85898391,60441481,CN
chr01,Bn2301,89056697,98296385,9239688,RLP
chr01,Bn2302,66355642,71105427,4749785,RLK
chr01,Bn2303,23611052,95943034,72331982,CNL
chr01,Bn2304,31096822,94070053,62973231,RLP
chr01,Bn2305,36040812,58821521,22780709,CN
chr01,Bn2306,31317897,31896254,578357,NBS
chr01,Bn2307,54551156,77989875,23438719,TN
chr01,Bn2308,8342397,27662511,19320114,TNL
chr01,Bn2309,76449522,82687858,6238336,RLK
chr01,Bn2310,9061142,70667379,61606237,TN
chr01,Bn2311,66334133,83107907,16773774,TN
chr01,Bn2312,1908052,86843459,84935407,CNL
chr01,Bn2313,5045638,86032907,80987269,TNL
chr01,Bn2314,99812678,99903022,90344,RLK
chr01,Bn2315,65933819,89547360,23613541,TN
chr01,Bn2316,80064394,90437788,10373394,TNL
chr01,Bn2317,74056567,96809977,22753410,TNL
chr01,Bn2318,32467971,78885188,46417217,RLP
chr01,Bn2319,35323091,62393350,27070259,TN
chr01,Bn2320,75819709,77306333,1486624,RLK
chr01,Bn2321,63871162,95506511,31635349,CN
chr01,Bn2322,60047766,93802849,33755083,CN
chr01,Bn2323,30594223,54907890,24313667,TNL
chr01,Bn2324,76801222,83194734,6393512,TN
chr01,Bn2325,58161956,87601037,29439081,CNL
chr01,Bn2326,56810483,93622173,36811690,TNL
chr01,Bn2327,99863805,99916864,53059,TN
chr01,Bn2328,94101236,99922401,5821165,CNL
chr01,Bn2329,95875663,97981948,2106285,RLK
chr01,Bn2330,53104944,57268226,4163282,NBS
chr01,Bn2331,51535070,60855699,9320629,TN
chr01,Bn2332,8445065,12284354,3839289,NBS
chr01,Bn2333,19041849,73506235,54464386,TN
chr01,Bn2334,16817068,48511174,31694106,CNL
chr01,Bn2335,48728399,98537947,49809548,RLK
chr01,Bn2336,68818930,75369294,6550364,RLK
chr01,Bn2337,14036410,71837432,57801022,CN
chr01,Bn2338,65553886,85320020,19766134,TNL
chr01,Bn2339,53639819,77318407,23678588,RLK
chr01,Bn2340,6523452,87715880,81192428,NBS
chr01,Bn2341,1131492,65232732,64101240,CN
chr01,Bn2342,22336296,72809631,50473335,RLK
chr01,Bn2343,75338104,92994320,17656216,RLP
chr01,Bn2344,50587178,76450586,25863408,TN
chr01,Bn2345,27286702,78280621,50993919,NBS
chr01,Bn2346,43768509,66976846,23208337,CNL
chr01,Bn2347,69914059,97109365,27195306,TN
chr01,Bn2348,98725240,99617665,892425,CNL
chr01,Bn2349,5903737,40679517,34775780,TN
chr01,Bn2350,44971880,54613214,9641334,CN
chr01,Bn2351,77459883,83225718,5765835,TN
chr01,Bn2352,47067916,79541735,32473819,TNL
chr01,Bn2353,35308973,59769684,24460711,TN
chr01,Bn2354,96849546,98264450,1414904,TN
chr01,Bn2355,27382398,78435825,51053427,NBS
chr01,Bn2356,44971043,78897440,33926397,RLP
chr01,Bn2357,51390466,83872959,32482493,CN
chr01,Bn2358,70086985,90916782,20829797,RLK
chr01,Bn2359,95099734,97062370,1962636,CNL
chr01,Bn2360,62019323,76876997,14857674,TN
chr01,Bn2361,2582398,70107280,67524882,NBS
chr01,Bn2362,60874387,69815223,8940836,RLK
chr01,Bn2363,49533211,92336220,42803009,RLK
chr01,Bn2364,52976727,75596986,22620259,NBS
chr01,Bn2365,75583314,94898752,19315438,RLP
chr01,Bn2366,79276771,93790495,14513724,CN
chr01,Bn2367,20800885,87216044,66415159,TNL
chr01,Bn2368,29632055,74310650,44678595,CNL
chr01,Bn2369,17829225,21879089,4049864,TNL
chr01,Bn2370,75619588,84654360,9034772,CN
chr01,Bn2371,84768391,91983383,7214992,CN
chr01,Bn2372,97553375,99016207,1462832,RLK
chr01,Bn2373,98754518,99123108,368590,CNL
chr01,Bn2374,90123860,96334206,6210346,CN
chr01,Bn2375,30689425,53079344,22389919,CN
chr01,Bn2376,85276330,92251476,6975146,NBS
chr01,Bn2377,11573740,72142830,60569090,NBS
chr01,Bn2378,73521344,90528032,17006688,RLP
chr01,Bn2379,97016561,99075295,2058734,RLP
chr01,Bn2380,48157544,94922071,46764527,NBS
chr01,Bn2381,1669977,68571086,66901109,RLK
chr01,Bn2382,99334674,99426741,92067,TNL
chr01,Bn2383,23805645,26365740,2560095,CNL
chr01,Bn2384,14435548,65564937,51129389,CN
chr01,Bn2385,11591541,37154921,25563380,RLP
chr01,Bn2386,62344394,89036345,26691951,RLK
chr01,Bn2387,19708337,99872378,80164041,CNL
chr01,Bn2388,74377717,83190152,8812435,TN
chr01,Bn2389,53319328,88947214,35627886,CN
chr01,Bn2390,37246016,88483434,51237418,CNL
chr01,Bn2391,27770442,40127080,12356638,RLK
chr01,Bn2392,17390654,81521908,64131254,CN
chr01,Bn2393,87129982,98438262,11308280,RLP
chr01,Bn2394,65527089,82495165,16968076,TNL
chr01,Bn2395,4762692,72448531,67685839,RLP
chr01,Bn2396,27582233,38511471,10929238,CN
chr01,Bn2397,52598772,81286134,28687362,TN
chr01,Bn2398,66816950,99193671,32376721,TN
chr01,Bn2399,39561616,71709707,32148091,NBS
chr01,Bn2400,30242330,44997213,14754883,CNL
chr01,Bn2401,56943570,99573714,42630144,NBS
chr01,Bn2402,51110743,53365250,2254507,CNL
chr01,Bn2403,22057849,31047567,8989718,RLK
chr01,Bn2404,76466197,83246939,6780742,TNL
chr01,Bn2405,12161727,84477509,72315782,RLK
chr01,Bn2406,62902018,75992482,13090464,CN
chr01,Bn2407,57661069,65182612,7521543,TNL
chr01,Bn2408,26199431,76349678,50150247,RLK
chr01,Bn2409,13904948,96943870,83038922,TNL
chr01,Bn2410,95746334,99112271,3365937,CN
chr01,Bn2411,74558398,94833162,20274764,TNL
chr01,Bn2412,12308576,29035622,16727046,CNL
chr01,Bn2413,49485978,60852226,11366248,TNL
chr01,Bn2414,32230247,57996216,25765969,TN
chr01,Bn2415,59579962,91736008,32156046,TNL
chr01,Bn2416,2354128,74376907,72022779,NBS
chr01,Bn2417,46219150,87376242,41157092,RLP
chr01,Bn2418,25018872,57042291,32023419,CNL
chr01,Bn2419,98974989,99593382,618393,TN
chr01,Bn2420,42029973,58922937,16892964,RLP
chr01,Bn2421,67467266,79863035,12395769,RLP
chr01,Bn2422,20080722,33795733,13715011,CN
chr01,Bn2423,80185390,95444125,15258735,CNL
chr01,Bn2424,85550031,92663372,7113341,RLK
chr01,Bn2425,13123979,32848721,19724742,CN
chr01,Bn2426,13653143,61123273,47470130,RLP
chr01,Bn2427,84777873,97132645,12354772,NBS
chr01,Bn2428,18191116,79624206,61433090,CNL
chr01,Bn2429,12719274,67096037,54376763,NBS
chr01,Bn2430,2830543,26602917,23772374,RLK
chr01,Bn2431,84787872,87880171,3092299,TN
chr01,Bn2432,38873860,43302522,4428662,CN
chr01,Bn2433,80134699,85532158,5397459,NBS
chr01,Bn2434,75945151,97737564,21792413,CN
chr01,Bn2435,84669785,99776958,15107173,RLK
chr01,Bn2436,70016583,89712958,19696375,NBS
chr01,Bn2437,29182721,91168913,61986192,TN
chr01,Bn2438,15665954,97690439,82024485,TN
chr01,Bn2439,40490310,43531843,3041533,RLP
chr01,Bn2440,93468229,99492032,6023803,CN
chr01,Bn2441,39666569,86247093,46580524,CNL
chr01,Bn2442,49374204,68292779,18918575,CNL
chr01,Bn2443,29244832,36492183,7247351,RLK
chr01,Bn2444,61360915,64652602,3291687,CNL
chr01,Bn2445,78835673,98811051,19975378,CN
chr01,Bn2446,49017410,98089414,49072004,CNL
chr01,Bn2447,58998724,85400493,26401769,RLK
chr01,Bn2448,18111519,22872255,4760736,CNL
chr01,Bn2449,26641265,70276707,43635442,TN
chr01,Bn2450,40577954,92990286,52412332,NBS
chr01,Bn2451,38986942,77231262,38244320,NBS
chr01,Bn2452,77198951,98707254,21508303,CN
chr01,Bn2453,39968030,82775333,42807303,TNL
chr01,Bn2454,89243785,91592755,2348970,CNL
chr01,Bn2455,71173980,94228463,23054483,NBS
chr01,Bn2456,49488286,51545562,2057276,TN
chr01,Bn2457,18520494,49861703,31341209,CNL
chr01,Bn2458,48261664,63990506,15728842,NBS
chr01,Bn2459,64930918,85701638,20770720,TNL
chr01,Bn2460,84451550,91108768,6657218,CNL
chr01,Bn2461,63155870,83707543,20551673,TNL
chr01,Bn2462,1984464,20615457,18630993,CNL
chr01,Bn2463,67058621,74044437,6985816,TN
chr01,Bn2464,15576795,28199559,12622764,RLK
chr01,Bn2465,50691422,82341011,31649589,TNL
chr01,Bn2466,82583756,86239650,3655894,CNL
chr01,Bn2467,68248305,74811044,6562739,RLP
chr01,Bn2468,56343925,79151137,22807212,CNL
chr01,Bn2469,48342368,51895572,3553204,CN
chr01,Bn2470,6276170,24189633,17913463,CN
chr01,Bn2471,8782175,87622625,78840450,CNL
chr01,Bn2472,8686719,13028596,4341877,CNL
chr01,Bn2473,5871842,85746796,79874954,TN
chr01,Bn2474,46393297,82890384,36497087,NBS
chr01,Bn2475,7093414,68646103,61552689,TN
chr01,Bn2476,72405573,96421819,24016246,CNL
chr01,Bn2477,50877271,57053727,6176456,CNL
chr01,Bn2478,76786404,79112374,2325970,CNL
chr01,Bn2479,60787435,69096246,8308811,RLP
chr01,Bn2480,21004378,91238961,70234583,NBS
chr01,Bn2481,54409545,91738050,37328505,TN
chr01,Bn2482,44192509,73334701,29142192,RLP
chr01,Bn2483,20222730,56627256,36404526,TNL
chr01,Bn2484,30761936,69612492,38850556,RLP
chr01,Bn2485,86734271,93943979,7209708,TN
chr01,Bn2486,7275942,67972532,60696590,CNL
chr01,Bn2487,62094061,88945006,26850945,TNL
chr01,Bn2488,63815276,74554590,10739314,TN
chr01,Bn2489,81912119,95906279,13994160,TNL
chr01,Bn2490,64597034,77415768,12818734,RLP
chr01,Bn2491,71494536,94077882,22583346,TN
chr01,Bn2492,64820319,93034044,28213725,CNL
chr01,Bn2493,90233049,96587084,6354035,RLP
chr01,Bn2494,95519270,99069368,3550098,NBS
chr01,Bn2495,93341322,99240501,5899179,TNL
chr01,Bn2496,54263504,89376140,35112636,RLP
chr01,Bn2497,48545655,97491193,48945538,RLK
chr01,Bn2498,69620258,95273457,25653199,RLK
chr01,Bn2499,42695414,78182073,35486659,TNL
chr01,Bn2500,15848411,84988406,69139995,TNL
chr01,Bn2501,94295005,96842328,2547323,TNL
chr01,Bn2502,21434072,72456172,51022100,TNL
chr01,Bn2503,62465964,94784739,32318775,RLK
chr01,Bn2504,79644152,91920092,12275940,TN
chr01,Bn2505,10102118,53085622,42983504,CN
chr01,Bn2506,13092837,56573036,43480199,TNL
chr01,Bn2507,85312774,88431679,3118905,NBS
chr01,Bn2508,88495572,98812119,10316547,RLP
chr01,Bn2509,64213634,77354980,13141346,CNL
chr01,Bn2510,33858712,64075178,30216466,CN
chr01,Bn2511,90532304,98382441,7850137,CN
chr01,Bn2512,88870987,99344687,10473700,TN
chr01,Bn2513,74276612,86169000,11892388,TNL
chr01,Bn2514,41084211,59747448,18663237,RLP
chr01,Bn2515,61650800,74817998,13167198,RLK
chr01,Bn2516,91609859,93389921,1780062,CNL
chr01,Bn2517,83877194,92455359,8578165,RLP
chr01,Bn2518,19220136,89720786,70500650,CNL
chr01,Bn2519,90866473,92289407,1422934,CNL
chr01,Bn2520,77317796,81871458,4553662,RLK
chr01,Bn2521,13507650,85086084,71578434,TN
chr01,Bn2522,2293689,6698579,4404890,RLP
chr01,Bn2523,33022485,45383371,12360886,CN
chr01,Bn2524,95147796,96782141,1634345,NBS
chr01,Bn2525,53435788,55825691,2389903,CNL
chr01,Bn2526,93118076,96338549,3220473,RLK
chr01,Bn2527,33631148,56075828,22444680,RLP
chr01,Bn2528,49887451,85588713,35701262,RLK
chr01,Bn2529,68751419,93645475,24894056,RLK
chr01,Bn2530,61705628,69337678,7632050,NBS
chr01,Bn2531,1143447,74065080,72921633,NBS
chr01,Bn2532,77248712,80893966,3645254,RLK
chr01,Bn2533,17497835,24709893,7212058,RLK
chr01,Bn2534,35868138,68991155,33123017,TN
chr01,Bn2535,2409181,52966229,50557048,CNL
chr01,Bn2536,36293265,99750638,63457373,RLP
chr01,Bn2537,24694531,64246256,39551725,TNL
chr01,Bn2538,62695532,76674980,13979448,TN
chr01,Bn2539,51119646,55747069,4627423,TNL
chr01,Bn2540,78694989,83282743,4587754,RLP
chr01,Bn2541,7012302,57700019,50687717,RLP
chr01,Bn2542,68184614,94488624,26304010,CNL
chr01,Bn2543,56461896,68569361,12107465,NBS
chr01,Bn2544,23785055,78127648,54342593,TNL
chr01,Bn2545,66908601,94552907,27644306,TNL
chr01,Bn2546,18862876,39690584,20827708,CN
chr01,Bn2547,52827671,81486310,28658639,NBS
chr01,Bn2548,48790369,92301843,43511474,CN
chr01,Bn2549,74677185,94605242,19928057,RLK
chr01,Bn2550,63732685,68926013,5193328,CNL
chr01,Bn2551,69977826,97821930,27844104,NBS
chr01,Bn2552,40843902,59816912,18973010,TN
chr01,Bn2553,3472013,82085494,78613481,RLK
chr01,Bn2554,22412885,59040136,36627251,RLP
chr01,Bn2555,29755428,30959760,1204332,RLP
chr01,Bn2556,65174814,99270845,34096031,CN
chr01,Bn2557,67836714,89713268,21876554,CNL
chr01,Bn2558,74380279,87430017,13049738,NBS
chr01,Bn2559,24047069,28413340,4366271,RLP
chr01,Bn2560,4622105,66151622,61529517,TN
chr01,Bn2561,9228206,89013016,79784810,RLK
chr01,Bn2562,99003402,99061732,58330,TNL
chr01,Bn2563,61712068,88487832,26775764,RLP
chr01,Bn2564,47928795,91531630,43602835,CNL
chr01,Bn2565,30901786,36964921,6063135,TNL
chr01,Bn2566,71778421,74372065,2593644,CNL
chr01,Bn2567,9046548,19485165,10438617,CNL
chr01,Bn2568,98210176,99965650,1755474,TNL
chr01,Bn2569,81556359,94533271,12976912,CNL
chr01,Bn2570,82751596,84983915,2232319,NBS
chr01,Bn2571,40341123,76456110,36114987,TNL
chr01,Bn2572,36995698,57747753,20752055,CNL
chr01,Bn2573,65765750,69807193,4041443,RLK
chr01,Bn2574,36125864,87212137,51086273,CNL
chr01,Bn2575,20500183,62224465,41724282,TNL
chr01,Bn2576,57826900,93507969,35681069,RLK
chr01,Bn2577,50385181,64635149,14249968,TNL
chr01,Bn2578,48173790,75246217,27072427,RLP
chr01,Bn2579,72026736,93363093,21336357,TNL
chr01,Bn2580,87712393,92098209,4385816,TNL
chr01,Bn2581,13700150,42370556,28670406,TN
chr01,Bn2582,81240613,82023288,782675,TNL
chr01,Bn2583,77478448,88597190,11118742,CNL
chr01,Bn2584,60852521,65462819,4610298,RLP
chr01,Bn2585,86310991,92946477,6635486,TN
chr01,Bn2586,20470049,46534450,26064401,CN
chr01,Bn2587,24958992,27277746,2318754,RLP
chr01,Bn2588,44874772,89326709,44451937,RLP
chr01,Bn2589,81803731,95451495,13647764,TNL
chr01,Bn2590,13972901,48954461,34981560,TN
chr01,Bn2591,4154890,79779882,75624992,CNL
chr01,Bn2592,93075670,98292831,5217161,CNL
chr01,Bn2593,17593479,66124959,48531480,RLK
chr01,Bn2594,82959518,86439269,3479751,RLP
chr01,Bn2595,53202520,86216769,33014249,RLP
chr01,Bn2596,13810219,18208114,4397895,TNL
chr01,Bn2597,15134347,69075829,53941482,RLK
chr01,Bn2598,82407554,92961824,10554270,CNL
chr01,Bn2599,57535818,63234239,5698421,CNL
chr01,Bn2600,94347827,96936144,2588317,CN
chr01,Bn2601,69295119,88407771,19112652,CNL
chr01,Bn2602,20051027,68166309,48115282,TN
chr01,Bn2603,18668398,67165979,48497581,TN
chr01,Bn2604,75884478,95371985,19487507,NBS
chr01,Bn2605,91973915,93342106,1368191,RLK
chr01,Bn2606,11380429,55138729,43758300,CN
chr01,Bn2607,98692095,99920712,1228617,RLP
chr01,Bn2608,16700967,83697434,66996467,TNL
chr01,Bn2609,16018006,75509125,59491119,NBS
chr01,Bn2610,67540659,93289784,25749125,RLP
chr01,Bn2611,91430286,93906528,2476242,TNL
chr01,Bn2612,77230760,85359745,8128985,TN
chr01,Bn2613,52537117,79416498,26879381,TN
chr01,Bn2614,64811243,75522208,10710965,TNL
chr01,Bn2615,10243573,79578526,69334953,TN
chr01,Bn2616,47550689,88780207,41229518,NBS
chr01,Bn2617,50616333,80382090,29765757,TN
chr01,Bn2618,19859766,97804801,77945035,RLK
chr01,Bn2619,23080034,49625015,26544981,RLK
chr01,Bn2620,45163903,98073229,52909326,TN
chr01,Bn2621,89312806,89323223,10417,RLK
chr01,Bn2622,62682091,66965228,4283137,TN
chr01,Bn2623,29272915,65057232,35784317,TNL
chr01,Bn2624,76723207,96226417,19503210,CNL
chr01,Bn2625,90124062,96545809,6421747,TNL
chr01,Bn2626,66360065,97757894,31397829,NBS
chr01,Bn2627,48557285,54393166,5835881,RLP
chr01,Bn2628,89293372,95594088,6300716,RLP
chr01,Bn2629,73915493,75169462,1253969,RLP
chr01,Bn2630,41529218,95079471,53550253,TNL
chr01,Bn2631,88246593,97270790,9024197,RLK
chr01,Bn2632,7701048,98509125,90808077,RLP
chr01,Bn2633,78694993,94836793,16141800,NBS
chr01,Bn2634,58611822,79937177,21325355,RLK
chr01,Bn2635,50512503,87464886,36952383,TNL
chr01,Bn2636,65234164,98249464,33015300,RLK
chr01,Bn2637,82486255,91383402,8897147,RLK
chr01,Bn2638,61025367,85781461,24756094,TNL
chr01,Bn2639,34741709,76077997,41336288,CN
chr01,Bn2640,43424208,87151522,43727314,CNL
chr01,Bn2641,12180400,19333955,7153555,RLP
chr01,Bn2642,84801844,98585103,13783259,CNL
chr01,Bn2643,17028855,20447419,3418564,NBS
chr01,Bn2644,23724564,60879451,37154887,RLP
chr01,Bn2645,92327407,98038590,5711183,CNL
chr01,Bn2646,98522625,98756310,233685,RLP
chr01,Bn2647,4226465,95390828,91164363,RLK
chr01,Bn2648,61111186,63973376,2862190,TN
chr01,Bn2649,83642235,86978596,3336361,RLP
chr01,Bn2650,98307691,98950838,643147,CN
chr01,Bn2651,86899066,91122755,4223689,RLK
chr01,Bn2652,18059877,36965389,18905512,RLP
chr01,Bn2653,26012942,82431884,56418942,CNL
chr01,Bn2654,41988414,77758955,35770541,CN
chr01,Bn2655,48329022,84634236,36305214,RLP
chr01,Bn2656,99937136,99971373,34237,CN
chr01,Bn2657,91819272,95203693,3384421,RLP
chr01,Bn2658,86633011,92660261,6027250,TN
chr01,Bn2659,26908745,67912686,41003941,CNL
chr01,Bn2660,55476391,77923269,22446878,CN
chr01,Bn2661,56508538,81326415,24817877,RLP
chr01,Bn2662,96253340,99932218,3678878,CN
chr01,Bn2663,61754229,93031986,31277757,RLK
chr01,Bn2664,98062249,98186838,124589,CN
chr01,Bn2665,10558219,93843468,83285249,TNL
chr01,Bn2666,16887345,85607022,68719677,RLK
chr01,Bn2667,49988824,63989630,14000806,CN
chr01,Bn2668,96983146,97525825,542679,NBS
chr01,Bn2669,68742735,99216658,30473923,RLK
chr01,Bn2670,22423391,78811795,56388404,RLP
chr01,Bn2671,56350513,93914911,37564398,CN
chr01,Bn2672,77131456,82675237,5543781,CN
chr01,Bn2673,55799875,59403146,3603271,NBS
chr01,Bn2674,59279622,60882312,1602690,NBS
chr01,Bn2675,54793999,56306240,1512241,TNL
chr01,Bn2676,26176353,84010826,57834473,TNL
chr01,Bn2677,80792085,86245315,5453230,NBS
chr01,Bn2678,72566832,81918374,9351542,RLK
chr01,Bn2679,50841372,60283141,9441769,CN
chr01,Bn2680,86915691,95939376,9023685,CNL
chr01,Bn2681,43008152,68803926,25795774,CNL
chr01,Bn2682,97031823,97572517,540694,TNL
chr01,Bn2683,31838068,47785100,15947032,TNL
chr01,Bn2684,43539394,62554912,19015518,TNL
chr01,Bn2685,63977149,73233486,9256337,NBS
chr01,Bn2686,40500624,69656012,29155388,RLP
chr01,Bn2687,91470545,93436002,1965457,NBS
chr01,Bn2688,8130389,10668925,2538536,CNL
chr01,Bn2689,15564210,42255071,26690861,RLP
chr01,Bn2690,29914314,72408965,42494651,TNL
chr01,Bn2691,60734328,73189417,12455089,CN
chr01,Bn2692,37543114,60881394,23338280,NBS
chr01,Bn2693,18634589,86247204,67612615,TN
chr01,Bn2694,21269060,37268654,15999594,CNL
chr01,Bn2695,49380964,50565756,1184792,CN
chr01,Bn2696,75688298,88680196,12991898,RLK
chr01,Bn2697,42811684,62731055,19919371,RLP
chr01,Bn2698,71275572,99288118,28012546,TNL
chr01,Bn2699,17934409,19694214,1759805,RLP
chr01,Bn2700,85493534,97912412,12418878,RLP
chr01,Bn2701,64902005,74940688,10038683,CN
chr01,Bn2702,34534626,70253672,35719046,RLP
chr01,Bn2703,77987840,91256348,13268508,CN
chr01,Bn2704,10694974,23972315,13277341,TN
chr01,Bn2705,58963763,90191914,31228151,RLK
chr01,Bn2706,27631736,81063198,53431462,RLK
chr01,Bn2707,49899234,79635488,29736254,RLK
chr01,Bn2708,10299056,94531409,84232353,RLK
chr01,Bn2709,37779146,51615905,13836759,TN
chr01,Bn2710,10845924,84122701,73276777,CNL
chr01,Bn2711,30204907,87371912,57167005,CN
chr01,Bn2712,77629952,88001057,10371105,TNL
chr01,Bn2713,23254878,30790139,7535261,CNL
chr01,Bn2714,63459320,82159750,18700430,RLK
chr01,Bn2715,54524285,55219610,695325,TN
chr01,Bn2716,26170101,88271991,62101890,NBS
chr01,Bn2717,13091257,95725954,82634697,RLP
chr01,Bn2718,57985274,95988937,38003663,TN
chr01,Bn2719,95879550,97664020,1784470,TN
chr01,Bn2720,37246475,49493240,12246765,CNL
chr01,Bn2721,75530165,80689466,5159301,RLK
chr01,Bn2722,38840511,74821105,35980594,CNL
chr01,Bn2723,86868701,97175489,10306788,CNL
chr01,Bn2724,7813305,11473111,3659806,TN
chr01,Bn2725,12619866,58423567,45803701,RLK
chr01,Bn2726,33287438,96232543,62945105,TN
chr01,Bn2727,11542403,40780271,29237868,RLP
chr01,Bn2728,21867268,27015398,5148130,TNL
chr01,Bn2729,99622195,99652435,30240,RLP
chr01,Bn2730,58072819,92471866,34399047,CNL
chr01,Bn2731,97683532,99539489,1855957,CNL
chr01,Bn2732,33738912,63666172,29927260,CNL
chr01,Bn2733,23694027,29838200,6144173,TN
chr01,Bn2734,89524691,94435221,4910530,CNL
chr01,Bn2735,90649131,99350035,8700904,TN
chr01,Bn2736,19294455,58713930,39419475,NBS
chr01,Bn2737,11977029,81398975,69421946,TN
chr01,Bn2738,61677665,80569499,18891834,TN
chr01,Bn2739,20025629,22500695,2475066,RLP
chr01,Bn2740,74846530,77548043,2701513,CNL
chr01,Bn2741,85415680,96088111,10672431,RLP
chr01,Bn2742,39486619,59266741,19780122,RLK
chr01,Bn2743,79449928,80101480,651552,RLP
chr01,Bn2744,66779758,75012912,8233154,NBS
chr01,Bn2745,84649162,88184945,3535783,RLP
chr01,Bn2746,99239985,99399995,160010,CN
chr01,Bn2747,93193375,94022054,828679,TNL
chr01,Bn2748,82595088,82611558,16470,NBS
chr01,Bn2749,21300085,99228042,77927957,TN
chr01,Bn2750,80650761,92126935,11476174,TN
chr01,Bn2751,76866246,89029536,12163290,CNL
chr01,Bn2752,29184292,96565574,67381282,CNL
chr01,Bn2753,91977981,92788567,810586,CN
chr01,Bn2754,83203301,86296441,3093140,RLP
chr01,Bn2755,14137757,90538537,76400780,TNL
chr01,Bn2756,85640427,99284919,13644492,TN
chr01,Bn2757,72633635,89829424,17195789,RLP
chr01,Bn2758,49542499,56308331,6765832,RLK
chr01,Bn2759,9269935,76983928,67713993,CNL
chr01,Bn2760,57799695,87780540,29980845,RLP
chr01,Bn2761,10416034,80377390,69961356,RLK
chr01,Bn2762,52495916,54480547,1984631,TN
chr01,Bn2763,4357247,23977795,19620548,CNL
chr01,Bn2764,73419324,77609059,4189735,RLP
chr01,Bn2765,62809115,70698407,7889292,CNL
chr01,Bn2766,11020394,34293438,23273044,TN
chr01,Bn2767,34539734,91785783,57246049,CN
chr01,Bn2768,50029389,66149674,16120285,NBS
chr01,Bn2769,68059405,92313728,24254323,CN
chr01,Bn2770,79364043,85017088,5653045,TN
chr01,Bn2771,96250462,96777225,526763,TNL
chr01,Bn2772,2216374,29852975,27636601,TNL
chr01,Bn2773,90247005,90894299,647294,TNL
chr01,Bn2774,18245039,73242855,54997816,TNL
chr01,Bn2775,68441435,78679023,10237588,NBS
chr01,Bn2776,21465976,29398461,7932485,TN
chr01,Bn2777,88275831,94962091,6686260,TNL
chr01,Bn2778,13518553,40962253,27443700,TN
chr01,Bn2779,46613912,93241944,46628032,NBS
chr01,Bn2780,47895293,62911220,15015927,TNL
chr01,Bn2781,58629116,86000153,27371037,NBS
chr01,Bn2782,50352134,97993435,47641301,CN
chr01,Bn2783,65936369,71888156,5951787,RLK
chr01,Bn2784,26236444,91849138,65612694,TNL
chr01,Bn2785,70236816,92098836,21862020,RLP
chr01,Bn2786,86635457,92769028,6133571,CNL
chr01,Bn2787,35199033,90619796,55420763,NBS
chr01,Bn2788,65870422,85918198,20047776,RLP
chr01,Bn2789,20233449,89297575,69064126,NBS
chr01,Bn2790,61877032,68038300,6161268,NBS
chr01,Bn2791,67751011,98355155,30604144,RLP
chr01,Bn2792,93043318,94755614,1712296,TNL
chr01,Bn2793,26571105,29876955,3305850,RLP
chr01,Bn2794,46428961,91735350,45306389,RLK
chr01,Bn2795,46993989,49943265,2949276,RLP
chr01,Bn2796,22312850,38225436,15912586,NBS
chr01,Bn2797,19127971,89088192,69960221,RLK
chr01,Bn2798,48970974,51515895,2544921,RLK
chr01,Bn2799,12703760,80418432,67714672,TNL
chr01,Bn2800,31117938,50542986,19425048,TN
chr01,Bn2801,34316165,93036849,58720684,RLK
chr01,Bn2802,19564106,66451865,46887759,RLK
chr01,Bn2803,83671293,91028991,7357698,TNL
chr01,Bn2804,93705359,96508668,2803309,TN
chr01,Bn2805,73536052,97656796,24120744,RLP
chr01,Bn2806,86146847,89506160,3359313,TN
chr01,Bn2807,23521314,65721477,42200163,TNL
chr01,Bn2808,99646781,99839094,192313,CN
chr01,Bn2809,89470433,98605511,9135078,NBS
chr01,Bn2810,63342896,77675573,14332677,RLK
chr01,Bn2811,38745343,97326560,58581217,TN
chr01,Bn2812,46817644,77984935,31167291,RLK
chr01,Bn2813,11370447,87457357,76086910,RLK
chr01,Bn2814,98777168,99751314,974146,NBS
chr01,Bn2815,90555481,98552958,7997477,CN
chr01,Bn2816,38510539,43628872,5118333,CN
chr01,Bn2817,50902041,67367547,16465506,RLP
chr01,Bn2818,63539650,87756949,24217299,CN
chr01,Bn2819,81117257,86565655,5448398,TNL
chr01,Bn2820,60835086,79379847,18544761,TNL
chr01,Bn2821,89959232,99053355,9094123,CN
chr01,Bn2822,33065047,83626277,50561230,RLP
chr01,Bn2823,41336562,71576475,30239913,TNL
chr01,Bn2824,30527308,41812071,11284763,TNL
chr01,Bn2825,6260344,27629462,21369118,CNL
chr01,Bn2826,3277943,21232149,17954206,RLK
chr01,Bn2827,52542235,83136557,30594322,NBS
chr01,Bn2828,64479230,92432396,27953166,RLP
chr01,Bn2829,3100779,8653137,5552358,TN
chr01,Bn2830,71665431,94439811,22774380,TN
chr01,Bn2831,69575193,79449641,9874448,NBS
chr01,Bn2832,19237743,84344577,65106834,NBS
chr01,Bn2833,16917971,67870075,50952104,RLK
chr01,Bn2834,82150076,88682378,6532302,CNL
chr01,Bn2835,81098393,92425178,11326785,CNL
chr01,Bn2836,50422139,82330203,31908064,CNL
chr01,Bn2837,10956334,71418752,60462418,TNL
chr01,Bn2838,46066829,79635906,33569077,CN
chr01,Bn2839,14357081,84909124,70552043,TNL
chr01,Bn2840,40964506,69056155,28091649,CN
chr01,Bn2841,85272502,97199547,11927045,CNL
chr01,Bn2842,97250745,99977259,2726514,NBS
chr01,Bn2843,35019064,82685425,47666361,TNL
chr01,Bn2844,94871201,97001462,2130261,RLK
chr01,Bn2845,8532431,70689519,62157088,CN
chr01,Bn2846,36889272,51509599,14620327,TN
chr01,Bn2847,61854166,88668447,26814281,CNL
chr01,Bn2848,50929140,88195485,37266345,RLP
chr01,Bn2849,31704278,46216179,14511901,TNL
chr01,Bn2850,50657204,96210649,45553445,CN
chr01,Bn2851,45945432,56183005,10237573,RLP
chr01,Bn2852,81576581,92224386,10647805,RLP
chr01,Bn2853,8844772,70862877,62018105,TN
chr01,Bn2854,13715582,14747696,1032114,TN
chr01,Bn2855,55025672,72398336,17372664,NBS
chr01,Bn2856,82496233,99588356,17092123,CN
chr01,Bn2857,54842973,78626838,23783865,TN
chr01,Bn2858,45733932,63700173,17966241,RLP
chr01,Bn2859,97039289,99048807,2009518,CNL
chr01,Bn2860,73659005,90501162,16842157,RLK
chr01,Bn2861,77096741,78074568,977827,TNL
chr01,Bn2862,47421162,83593748,36172586,NBS
chr01,Bn2863,29007922,74019498,45011576,RLP
chr01,Bn2864,64044004,74629627,10585623,RLK
chr01,Bn2865,18287666,67238569,48950903,TNL
chr01,Bn2866,18233800,73824479,55590679,TN
chr01,Bn2867,3242242,23216913,19974671,TNL
chr01,Bn2868,56407294,84253680,27846386,TNL
chr01,Bn2869,10830736,89880247,79049511,TNL
chr01,Bn2870,59369997,76373146,17003149,CN
chr01,Bn2871,49693236,50719507,1026271,CNL
chr01,Bn2872,15177961,90059341,74881380,NBS
chr01,Bn2873,36479949,75244359,38764410,TN
chr01,Bn2874,63153591,78652299,15498708,NBS
chr01,Bn2875,43369554,78245829,34876275,TNL
chr01,Bn2876,78852919,87263005,8410086,RLK
chr01,Bn2877,35619018,81073425,45454407,RLK
chr01,Bn2878,77662806,88940914,11278108,NBS
chr01,Bn2879,73794876,79574761,5779885,RLK
chr01,Bn2880,10728413,67904217,57175804,CNL
chr01,Bn2881,27225854,94890448,67664594,CNL
chr01,Bn2882,13520103,94033555,80513452,TNL
chr01,Bn2883,86641584,98974513,12332929,TNL
chr01,Bn2884,4243972,99407153,95163181,CNL
chr01,Bn2885,51150209,66457764,15307555,RLP
chr01,Bn2886,81451170,88711981,7260811,NBS
chr01,Bn2887,21840592,97223330,75382738,CNL
chr01,Bn2888,4536768,42895577,38358809,RLK
chr01,Bn2889,76917887,77902242,984355,CN
chr01,Bn2890,31765447,52541705,20776258,TNL
chr01,Bn2891,41901147,92895524,50994377,TN
chr01,Bn2892,42600454,77411301,34810847,RLK
chr01,Bn2893,32397291,96670900,64273609,TN
chr01,Bn2894,99817223,99830929,13706,NBS
chr01,Bn2895,60509425,77515577,17006152,CN
chr01,Bn2896,28008431,40607686,12599255,NBS
chr01,Bn2897,47389698,68188345,20798647,TN
chr01,Bn2898,12761458,43575185,30813727,RLP
chr01,Bn2899,2661664,54896064,52234400,TNL
chr01,Bn2900,72889044,96034494,23145450,TN
chr01,Bn2901,38387926,99485454,61097528,RLP
chr01,Bn2902,27833778,60814559,32980781,TN
chr01,Bn2903,38460897,54772410,16311513,NBS
chr01,Bn2904,79560264,95606281,16046017,TN
chr01,Bn2905,19573760,68542309,48968549,RLP
chr01,Bn2906,26445763,53952915,27507152,CN
chr01,Bn2907,54706938,75650087,20943149,TN
chr01,Bn2908,26750595,31873009,5122414,RLK
chr01,Bn2909,3550205,46946568,43396363,NBS
chr01,Bn2910,65356466,76237042,10880576,RLP
chr01,Bn2911,29495055,79354913,49859858,NBS
chr01,Bn2912,15068851,86274448,71205597,CNL
chr01,Bn2913,34756568,35447633,691065,CN
chr01,Bn2914,14256276,28678225,14421949,TNL
chr01,Bn2915,67290931,84709807,17418876,TN
chr01,Bn2916,81962368,99581620,17619252,CN
chr01,Bn2917,48750189,80772588,32022399,CNL
chr01,Bn2918,82160766,87401458,5240692,TN
chr01,Bn2919,19475978,39805636,20329658,CN
chr01,Bn2920,92600284,97724070,5123786,NBS
chr01,Bn2921,68209075,72484624,4275549,TNL
chr01,Bn2922,33691480,57734469,24042989,CN
chr01,Bn2923,86295682,97955135,11659453,TNL
chr01,Bn2924,16250346,68094982,51844636,RLK
chr01,Bn2925,34954031,43007196,8053165,TNL
chr01,Bn2926,29485464,88081426,58595962,TN
chr01,Bn2927,69807384,93514484,23707100,RLP
chr01,Bn2928,88896440,96466761,7570321,RLP
chr01,Bn2929,15828805,47560280,31731475,CN
chr01,Bn2930,11025035,85258237,74233202,NBS
chr01,Bn2931,65591341,86001681,20410340,RLP
chr01,Bn2932,89119647,93879568,4759921,TN
chr01,Bn2933,59001421,85636959,26635538,TN
chr01,Bn2934,40625355,41564935,939580,CN
chr01,Bn2935,34936915,92538569,57601654,NBS
chr01,Bn2936,57763691,65064804,7301113,TN
chr01,Bn2937,47479119,89601903,42122784,CN
chr01,Bn2938,25131213,79189973,54058760,CN
chr01,Bn2939,83541158,91997827,8456669,RLK
chr01,Bn2940,81819239,96597127,14777888,RLK
chr01,Bn2941,23203222,60120754,36917532,NBS
chr01,Bn2942,1645352,73334282,71688930,RLP
chr01,Bn2943,67027650,78521178,11493528,CNL
chr01,Bn2944,81529018,89839245,8310227,TN
chr01,Bn2945,22406166,75116607,52710441,CN
chr01,Bn2946,95180065,98734801,3554736,RLP
chr01,Bn2947,63447027,70583077,7136050,CNL
chr01,Bn2948,70758202,96516919,25758717,RLP
chr01,Bn2949,1654081,75212199,73558118,NBS
chr01,Bn2950,96191496,99612791,3421295,NBS
chr01,Bn2951,24880563,48640714,23760151,CNL
chr01,Bn2952,44412414,45800068,1387654,RLK
chr01,Bn2953,80857720,82918621,2060901,CNL
chr01,Bn2954,68035174,93569112,25533938,RLP
chr01,Bn2955,38759395,58535517,19776122,CNL
chr01,Bn2956,6924488,36740645,29816157,NBS
chr01,Bn2957,59713083,59870168,157085,CNL
chr01,Bn2958,49458565,50323726,865161,TN
chr01,Bn2959,87524566,90210720,2686154,NBS
chr01,Bn2960,72099151,82723664,10624513,TN
chr01,Bn2961,39116013,71120634,32004621,TN
chr01,Bn2962,94991530,97509970,2518440,RLK
chr01,Bn2963,63977139,81267286,17290147,TN
chr01,Bn2964,44090490,51768295,7677805,RLP
chr01,Bn2965,2990919,89291774,86300855,RLK
chr01,Bn2966,97097148,97348936,251788,CNL
chr01,Bn2967,16438231,87826085,71387854,CN
chr01,Bn2968,6161446,83837532,77676086,TNL
chr01,Bn2969,66443949,87111042,20667093,TNL
chr01,Bn2970,11869021,34755738,22886717,CN
chr01,Bn2971,39741893,39958312,216419,TNL
chr01,Bn2972,70073375,74786322,4712947,RLK
chr01,Bn2973,95610228,96800823,1190595,NBS
chr01,Bn2974,80782828,96569244,15786416,RLK
chr01,Bn2975,43511993,62190571,18678578,TNL
chr01,Bn2976,75635306,93263018,17627712,CNL
chr01,Bn2977,12732691,54940273,42207582,RLK
chr01,Bn2978,68084796,95217091,27132295,TNL
chr01,Bn2979,9320401,68099367,58778966,RLK
chr01,Bn2980,52909087,57344807,4435720,RLP
chr01,Bn2981,92246206,98595093,6348887,NBS
chr01,Bn2982,1920664,18282112,16361448,TN
chr01,Bn2983,69076747,91509414,22432667,TNL
chr01,Bn2984,26332801,52079957,25747156,RLP
chr01,Bn2985,62417973,68662108,6244135,RLK
chr01,Bn2986,69823675,82984377,13160702,CN
chr01,Bn2987,92018578,97037227,5018649,NBS
chr01,Bn2988,21793213,48855530,27062317,RLK
chr01,Bn2989,42023585,87959514,45935929,RLP
chr01,Bn2990,8122236,41468347,33346111,TNL
chr01,Bn2991,81785701,88666805,6881104,RLP
chr01,Bn2992,11539633,86581407,75041774,NBS
chr01,Bn2993,34255060,91885125,57630065,RLP
chr01,Bn2994,97322944,99573480,2250536,NBS
chr01,Bn2995,26146794,84392652,58245858,TNL
chr01,Bn2996,21990320,49639011,27648691,TN
chr01,Bn2997,9827574,41676905,31849331,TNL
chr01,Bn2998,32366289,71661708,39295419,CNL
chr01,Bn2999,18134540,25035260,6900720,CN
chr01,Bn3000,40033100,55120849,15087749,CN
chr01,Bn3001,69284844,74007718,4722874,TN
chr01,Bn3002,22994382,96811804,73817422,TN
chr01,Bn3003,63518687,89831782,26313095,TN
chr01,Bn3004,33676373,84852269,51175896,TN
chr01,Bn3005,43465154,50121174,6656020,TN
chr01,Bn3006,11950597,38351070,26400473,TN
chr01,Bn3007,51967680,58173503,6205823,RLP
chr01,Bn3008,16131145,28902392,12771247,NBS
chr01,Bn3009,95226886,99667208,4440322,RLK
chr01,Bn3010,11263111,33236397,21973286,CN
chr01,Bn3011,17902408,76768200,58865792,TNL
chr01,Bn3012,95315388,99028106,3712718,TNL
chr01,Bn3013,48182270,97184412,49002142,CNL
chr01,Bn3014,65424565,81851268,16426703,TNL
chr01,Bn3015,29286793,31486717,2199924,CNL
chr01,Bn3016,87781321,98989629,11208308,TN
chr01,Bn3017,97654344,99265665,1611321,NBS
chr01,Bn3018,15934308,32189117,16254809,TNL
chr01,Bn3019,18933994,26330506,7396512,RLK
chr01,Bn3020,59200380,85696755,26496375,CNL
chr01,Bn3021,22672430,31580507,8908077,RLP
chr01,Bn3022,80221722,93802023,13580301,RLK
chr01,Bn3023,42983175,82680319,39697144,CNL
chr01,Bn3024,88872951,99023905,10150954,CNL
chr01,Bn3025,13201628,40338873,27137245,RLK
chr01,Bn3026,94145280,97847838,3702558,CNL
chr01,Bn3027,66112537,79922867,13810330,RLP
chr01,Bn3028,17847299,89243666,71396367,CNL
chr01,Bn3029,58051697,95678599,37626902,TN
chr01,Bn3030,29935828,72490383,42554555,RLP
chr01,Bn3031,79590057,88048643,8458586,TN
chr01,Bn3032,83537122,95798026,12260904,RLP
chr01,Bn3033,14513577,26892408,12378831,NBS
chr01,Bn3034,76447769,93242784,16795015,RLP
chr01,Bn3035,61950619,96440462,34489843,CNL
chr01,Bn3036,14375665,79341147,64965482,RLP
chr01,Bn3037,26137325,49631994,23494669,TN
chr01,Bn3038,52442987,54242128,1799141,RLP
chr01,Bn3039,99658743,99783694,124951,NBS
chr01,Bn3040,39362314,66330193,26967879,RLP
chr01,Bn3041,77438844,94699368,17260524,NBS
chr01,Bn3042,30335285,93814017,63478732,TNL
chr01,Bn3043,4110159,19884498,15774339,CNL
chr01,Bn3044,65674826,92267194,26592368,CNL
chr01,Bn3045,30315448,75563526,45248078,TNL
chr01,Bn3046,81662755,86517555,4854800,TNL
chr01,Bn3047,41366492,67062681,25696189,TN
chr01,Bn3048,51028266,75792116,24763850,RLP
chr01,Bn3049,67647649,81019402,13371753,CNL
chr01,Bn3050,67178843,75572001,8393158,TNL
chr01,Bn3051,61882018,62455355,573337,TN
chr01,Bn3052,26543811,42644853,16101042,TNL
chr01,Bn3053,50771789,84077425,33305636,CN
chr01,Bn3054,70718292,80024900,9306608,NBS
chr01,Bn3055,24577415,48272985,23695570,RLK
chr01,Bn3056,54695555,74645347,19949792,CNL
chr01,Bn3057,38143076,93219282,55076206,NBS
chr01,Bn3058,87876632,91229476,3352844,RLK
chr01,Bn3059,63457134,65485116,2027982,RLP
chr01,Bn3060,50189560,59513904,9324344,CNL
chr01,Bn3061,5041529,40393658,35352129,NBS
chr01,Bn3062,11778827,62573272,50794445,NBS
chr01,Bn3063,74735580,79480566,4744986,RLP
chr01,Bn3064,86547508,99493468,12945960,RLP
chr01,Bn3065,44157656,62655826,18498170,TN
chr01,Bn3066,47972138,65589266,17617128,CN
chr01,Bn3067,65107281,75780614,10673333,RLK
chr01,Bn3068,54817508,88354925,33537417,RLK
chr01,Bn3069,64557674,96876690,32319016,TNL
chr01,Bn3070,43270007,75572260,32302253,TNL
chr01,Bn3071,8971469,54130634,45159165,RLK
chr01,Bn3072,28263570,60604411,32340841,RLK
chr01,Bn3073,93248860,96855673,3606813,RLK
chr01,Bn3074,1553999,61153493,59599494,CNL
chr01,Bn3075,23470840,98035077,74564237,CNL
chr01,Bn3076,54789481,64992826,10203345,RLK
chr01,Bn3077,28122822,87971984,59849162,TN
chr01,Bn3078,59321366,83731753,24410387,RLP
chr01,Bn3079,72016839,74186914,2170075,TNL
chr01,Bn3080,48529006,73158345,24629339,TN
chr01,Bn3081,38916401,52184898,13268497,NBS
chr01,Bn3082,15122946,98037214,82914268,CN
chr01,Bn3083,22317302,82737753,60420451,TNL
chr01,Bn3084,84406415,92589993,8183578,RLP
chr01,Bn3085,88247295,92995882,4748587,NBS
chr01,Bn3086,38938697,66361528,27422831,NBS
chr01,Bn3087,70959014,87476617,16517603,RLK
chr01,Bn3088,61442412,78308368,16865956,RLK
chr01,Bn3089,35983290,41811822,5828532,TN
chr01,Bn3090,50502757,94837124,44334367,RLP
chr01,Bn3091,16867285,43648699,26781414,RLK
chr01,Bn3092,72746440,74191484,1445044,TN
chr01,Bn3093,86456528,93118002,6661474,CN
chr01,Bn3094,42228588,73916457,31687869,CNL
chr01,Bn3095,70126452,80016534,9890082,TN
chr01,Bn3096,16778960,27484581,10705621,NBS
chr01,Bn3097,55896649,66049683,10153034,CN
chr01,Bn3098,64491385,77245569,12754184,RLK
chr01,Bn3099,1142541,54422412,53279871,CNL
chr01,Bn3100,53980155,64227333,10247178,TN
chr01,Bn3101,39033589,86057128,47023539,RLK
chr01,Bn3102,99429622,99740467,310845,CN
chr01,Bn3103,9298089,16300702,7002613,TN
chr01,Bn3104,74668987,79607273,4938286,RLP
chr01,Bn3105,69131488,74467978,5336490,CN
chr01,Bn3106,93596294,97146746,3550452,CN
chr01,Bn3107,51637656,66750267,15112611,TNL
chr01,Bn3108,9551906,32948119,23396213,CNL
chr01,Bn3109,63742277,87009724,23267447,NBS
chr01,Bn3110,25913048,31949590,6036542,CNL
chr01,Bn3111,55531700,61810614,6278914,TNL
chr01,Bn3112,78200069,90979044,12778975,NBS
chr01,Bn3113,55113932,62560747,7446815,NBS
chr01,Bn3114,73277460,81757872,8480412,TNL
chr01,Bn3115,8086055,60442983,52356928,CN
chr01,Bn3116,54355808,63642017,9286209,RLK
chr01,Bn3117,30198096,44050963,13852867,RLK
chr01,Bn3118,95755021,99028321,3273300,TN
chr01,Bn3119,31564901,75994765,44429864,RLP
chr01,Bn3120,49290052,85504305,36214253,RLK
chr01,Bn3121,42778475,74210479,31432004,RLP
chr01,Bn3122,70584571,73897554,3312983,TN
chr01,Bn3123,32127513,48657138,16529625,CNL
chr01,Bn3124,8072131,52847514,44775383,TNL
chr01,Bn3125,21188525,71559387,50370862,RLP
chr01,Bn3126,58413901,79795058,21381157,NBS
chr01,Bn3127,92301519,99562914,7261395,RLP
chr01,Bn3128,57126309,75747469,18621160,TN
chr01,Bn3129,36931455,52239161,15307706,RLP
chr01,Bn3130,90068222,92182627,2114405,CNL
chr01,Bn3131,8789012,92521607,83732595,NBS
chr01,Bn3132,53766621,68648415,14881794,RLK
chr01,Bn3133,35706541,92684243,56977702,RLK
chr01,Bn3134,90036653,92294782,2258129,NBS
chr01,Bn3135,38898336,92528669,53630333,NBS
chr01,Bn3136,86624555,92961833,6337278,TN
chr01,Bn3137,38269918,70291508,32021590,RLK
chr01,Bn3138,72512727,80381843,7869116,CN
chr01,Bn3139,29298819,43780092,14481273,NBS
chr01,Bn3140,14696124,52546905,37850781,TN
chr01,Bn3141,95820868,99086188,3265320,CN
chr01,Bn3142,42709907,80490217,37780310,TN
chr01,Bn3143,13503089,71322616,57819527,TNL
chr01,Bn3144,8139165,77291649,69152484,CN
chr01,Bn3145,75673768,83270856,7597088,CNL
chr01,Bn3146,57471692,80569834,23098142,NBS
chr01,Bn3147,37421968,41131118,3709150,TN
chr01,Bn3148,45448999,57882897,12433898,CNL
chr01,Bn3149,29772806,32076017,2303211,CNL
chr01,Bn3150,1680031,80122402,78442371,RLK
chr01,Bn3151,22224899,24773430,2548531,NBS
chr01,Bn3152,32103575,92134962,60031387,CNL
chr01,Bn3153,42511804,81817574,39305770,RLK
chr01,Bn3154,95787505,99785910,3998405,NBS
chr01,Bn3155,71383449,77750569,6367120,TNL
chr01,Bn3156,64369013,67063119,2694106,RLP
chr01,Bn3157,1469143,39966925,38497782,RLP
chr01,Bn3158,37488540,79618697,42130157,CNL
chr01,Bn3159,5713142,79539699,73826557,CN
chr01,Bn3160,61986387,99800215,37813828,RLP
chr01,Bn3161,24361647,73035734,48674087,TNL
chr01,Bn3162,3327666,74653577,71325911,NBS
chr01,Bn3163,62239877,65927975,3688098,TN
chr01,Bn3164,18595522,47004904,28409382,CNL
chr01,Bn3165,42687507,86857077,44169570,CN
chr01,Bn3166,33982483,53288877,19306394,CN
chr01,Bn3167,25181299,99150352,73969053,TN
chr01,Bn3168,47317101,84513449,37196348,CNL
chr01,Bn3169,68501323,94694930,26193607,TN
chr01,Bn3170,17880260,69990953,52110693,TNL
chr01,Bn3171,26845867,61850836,35004969,RLP
chr01,Bn3172,54217730,71998121,17780391,TN
chr01,Bn3173,17874610,63333705,45459095,RLK
chr01,Bn3174,66726665,81875666,15149001,CN
chr01,Bn3175,18793440,60703023,41909583,CNL
chr01,Bn3176,58797033,86115691,27318658,CN
chr01,Bn3177,20896146,53459015,32562869,CNL
chr01,Bn3178,6484243,51311503,44827260,NBS
chr01,Bn3179,43400309,44118860,718551,CN
chr01,Bn3180,97381819,99311815,1929996,CNL
chr01,Bn3181,88399596,90594029,2194433,RLK
chr01,Bn3182,70887032,90625659,19738627,CN
chr01,Bn3183,72625850,80529933,7904083,TNL
chr01,Bn3184,95962025,98148374,2186349,CNL
chr01,Bn3185,32178091,57440436,25262345,NBS
chr01,Bn3186,77188817,95073622,17884805,RLK
chr01,Bn3187,33826564,82301560,48474996,RLK
chr01,Bn3188,11901241,34992083,23090842,TNL
chr01,Bn3189,69315519,85095858,15780339,TNL
chr01,Bn3190,58474321,72441018,13966697,NBS
chr01,Bn3191,69605670,90328781,20723111,NBS
chr01,Bn3192,46808028,55363943,8555915,TN
chr01,Bn3193,27779350,58321432,30542082,CNL
chr01,Bn3194,2413727,80540672,78126945,RLP
chr01,Bn3195,29985748,58939695,28953947,RLK
chr01,Bn3196,24491345,31039191,6547846,TN
chr01,Bn3197,56104750,86283965,30179215,NBS
chr01,Bn3198,74792442,79045617,4253175,TN
chr01,Bn3199,38646222,95407825,56761603,NBS
chr01,Bn3200,48398056,85064003,36665947,CN
chr01,Bn3201,43534025,94156276,50622251,CN
chr01,Bn3202,38769240,45609260,6840020,CN
chr01,Bn3203,64033893,83649652,19615759,TNL
chr01,Bn3204,33368055,76747553,43379498,NBS
chr01,Bn3205,72750967,85125130,12374163,TN
chr01,Bn3206,84370319,90000986,5630667,RLP
chr01,Bn3207,32650631,76099280,43448649,NBS
chr01,Bn3208,33500242,78048955,44548713,RLK
chr01,Bn3209,74597660,74864920,267260,RLP
chr01,Bn3210,92933366,95967965,3034599,CNL
chr01,Bn3211,41615932,54961718,13345786,RLK
chr01,Bn3212,24931783,45819370,20887587,CN
chr01,Bn3213,93032997,93596716,563719,TNL
chr01,Bn3214,46562864,95452426,48889562,TN
chr01,Bn3215,43909749,66768285,22858536,RLK
chr01,Bn3216,67382048,96677337,29295289,RLK
chr01,Bn3217,7257819,20620335,13362516,CN
chr01,Bn3218,8312773,23596724,15283951,RLK
chr01,Bn3219,12898165,29128423,16230258,CN
chr01,Bn3220,47912095,76645283,28733188,TNL
chr01,Bn3221,54024347,82965612,28941265,TN
chr01,Bn3222,79126056,95756575,16630519,RLP
chr01,Bn3223,71106913,84273913,13167000,CNL
chr01,Bn3224,35548831,56989483,21440652,RLP
chr01,Bn3225,67077522,84228118,17150596,CN
chr01,Bn3226,1141768,1647713,505945,TN
chr01,Bn3227,71204019,77410199,6206180,RLK
chr01,Bn3228,33032712,90550619,57517907,CNL
chr01,Bn3229,46466035,83798597,37332562,RLP
chr01,Bn3230,87890881,92947659,5056778,TNL
chr01,Bn3231,61326922,69398919,8071997,NBS
chr01,Bn3232,36688687,76169418,39480731,RLP
chr01,Bn3233,50141381,54942736,4801355,RLP
chr01,Bn3234,73286254,94137769,20851515,RLP
chr01,Bn3235,12845324,87026859,74181535,CN
chr01,Bn3236,33559744,77800995,44241251,NBS
chr01,Bn3237,85444049,85932928,488879,CNL
chr01,Bn3238,6931666,95633435,88701769,RLP
chr01,Bn3239,15009377,59084736,44075359,TNL
chr01,Bn3240,5542388,79996132,74453744,TN
chr01,Bn3241,58553496,66588600,8035104,TN
chr01,Bn3242,11524020,50150912,38626892,CNL
chr01,Bn3243,41144956,96016979,54872023,CN
chr01,Bn3244,82477285,86603542,4126257,RLK
chr01,Bn3245,85108510,98223773,13115263,CNL
chr01,Bn3246,24968983,73658693,48689710,NBS
chr01,Bn3247,81114683,88128784,7014101,CN
chr01,Bn3248,36441069,74292247,37851178,NBS
chr01,Bn3249,11103733,81181979,70078246,NBS
chr01,Bn3250,3567710,39274747,35707037,CNL
chr01,Bn3251,39000007,74636841,35636834,TN
chr01,Bn3252,46355811,97069667,50713856,RLK
chr01,Bn3253,35548120,70994080,35445960,RLP
chr01,Bn3254,63034988,64555704,1520716,NBS
chr01,Bn3255,46811203,75307832,28496629,NBS
chr01,Bn3256,34282894,43361748,9078854,CN
chr01,Bn3257,81199760,90570414,9370654,RLK
chr01,Bn3258,64204632,96372797,32168165,CNL
chr01,Bn3259,73065692,93475464,20409772,TN
chr01,Bn3260,76620890,98274894,21654004,RLP
chr01,Bn3261,4564534,43251664,38687130,CN
chr01,Bn3262,91713539,99647578,7934039,RLP
chr01,Bn3263,56104317,67635815,11531498,CN
chr01,Bn3264,15146546,46543095,31396549,TN
chr01,Bn3265,63106859,93829217,30722358,RLP
chr01,Bn3266,89918611,99158901,9240290,CN
chr01,Bn3267,98805208,99210484,405276,NBS
chr01,Bn3268,70344625,74882048,4537423,RLP
chr01,Bn3269,36684489,50400723,13716234,TNL
chr01,Bn3270,83605624,98902460,15296836,TNL
chr01,Bn3271,38720070,95627389,56907319,RLP
chr01,Bn3272,32733536,69246073,36512537,RLP
chr01,Bn3273,75313040,83960373,8647333,TNL
chr01,Bn3274,76176676,94502349,18325673,RLK
chr01,Bn3275,8154571,83047638,74893067,TNL
chr01,Bn3276,86961641,97276443,10314802,CNL
chr01,Bn3277,58776127,86856471,28080344,CN
chr01,Bn3278,12788430,29936329,17147899,TN
chr01,Bn3279,66874989,98231877,31356888,TN
chr01,Bn3280,44567543,75696128,31128585,NBS
chr01,Bn3281,37284838,57625822,20340984,CN
chr01,Bn3282,3235319,32157961,28922642,NBS
chr01,Bn3283,82298027,92182584,9884557,CNL
chr01,Bn3284,54037457,71811700,17774243,RLK
chr01,Bn3285,54514544,93266255,38751711,RLK
chr01,Bn3286,95643236,99072362,3429126,NBS
chr01,Bn3287,95875760,99184723,3308963,NBS
chr01,Bn3288,7582093,69548611,61966518,RLK
chr01,Bn3289,90601426,90744142,142716,CN
chr01,Bn3290,49063575,85095717,36032142,RLK
chr01,Bn3291,76185021,90419710,14234689,NBS
chr01,Bn3292,78831924,81525574,2693650,NBS
chr01,Bn3293,10925590,19255040,8329450,NBS
chr01,Bn3294,22359271,74970871,52611600,CN
chr01,Bn3295,9246231,66187715,56941484,TNL
chr01,Bn3296,16429309,58097533,41668224,TNL
chr01,Bn3297,26574074,43064443,16490369,CN
chr01,Bn3298,6356379,75593379,69237000,TNL
chr01,Bn3299,66095008,71489035,5394027,NBS
chr01,Bn3300,9508039,97855724,88347685,NBS
chr01,Bn3301,5380628,35444760,30064132,CN
chr01,Bn3302,22535091,38676912,16141821,NBS
chr01,Bn3303,39345729,76180777,36835048,CN
chr01,Bn3304,22464257,37677788,15213531,TNL
chr01,Bn3305,23015039,82106821,59091782,TNL
chr01,Bn3306,82293596,86471302,4177706,TN
chr01,Bn3307,8046314,24408786,16362472,TNL
chr01,Bn3308,66472960,93714827,27241867,CNL
chr01,Bn3309,45782757,48052537,2269780,RLK
chr01,Bn3310,71271963,85147794,13875831,CNL
chr01,Bn3311,35902339,39643503,3741164,RLK
chr01,Bn3312,91202592,91880903,678311,TN
chr01,Bn3313,95523215,98159997,2636782,TN
chr01,Bn3314,41654486,42657385,1002899,NBS
chr01,Bn3315,97486489,99951853,2465364,NBS
chr01,Bn3316,63030534,72594313,9563779,TNL
chr01,Bn3317,41750088,43966748,2216660,CNL
chr01,Bn3318,54046240,99514227,45467987,RLK
chr01,Bn3319,87570110,94000981,6430871,CN
chr01,Bn3320,12847899,99492875,86644976,RLK
chr01,Bn3321,73719538,77001355,3281817,TN
chr01,Bn3322,94393251,95680719,1287468,NBS
chr01,Bn3323,47288557,64664566,17376009,TN
chr01,Bn3324,87696242,89153316,1457074,TNL
chr01,Bn3325,80277240,98367628,18090388,RLK
chr01,Bn3326,45349787,70521938,25172151,NBS
chr01,Bn3327,69399170,69982735,583565,RLK
chr01,Bn3328,54628050,79536093,24908043,TNL
chr01,Bn3329,44475039,77957191,33482152,CNL
chr01,Bn3330,77487343,89254377,11767034,NBS
chr01,Bn3331,18817845,37831673,19013828,TN
chr01,Bn3332,8086256,67066423,58980167,TNL
chr01,Bn3333,27790657,47249450,19458793,TN
chr01,Bn3334,30647522,31308900,661378,RLK
chr01,Bn3335,24381372,95255260,70873888,RLK
chr01,Bn3336,85290567,99004260,13713693,NBS
chr01,Bn3337,62292882,82232393,19939511,NBS
chr01,Bn3338,38344690,42052965,3708275,TNL
chr01,Bn3339,34116137,47472747,13356610,TNL
chr01,Bn3340,31342067,43428650,12086583,RLP
chr01,Bn3341,17294408,28993972,11699564,TN
chr01,Bn3342,83634359,98222172,14587813,TN
chr01,Bn3343,86746508,94768285,8021777,RLP
chr01,Bn3344,26386076,66485896,40099820,TNL
chr01,Bn3345,36270422,81799657,45529235,CNL
chr01,Bn3346,4708552,84556497,79847945,CNL
chr01,Bn3347,69595778,92255500,22659722,CNL
chr01,Bn3348,86744780,99673643,12928863,TNL
chr01,Bn3349,69989961,81428808,11438847,TNL
chr01,Bn3350,84706059,95036215,10330156,CN
chr01,Bn3351,86384661,90679911,4295250,CNL
chr01,Bn3352,92317564,93273687,956123,TN
chr01,Bn3353,29255409,57527528,28272119,TN
chr01,Bn3354,14654185,46267078,31612893,RLP
chr01,Bn3355,23877131,49556592,25679461,CN
chr01,Bn3356,64091906,87259943,23168037,RLP
chr01,Bn3357,2158209,75510452,73352243,CNL
chr01,Bn3358,44508134,75345399,30837265,CNL
chr01,Bn3359,46960029,55493919,8533890,CN
chr01,Bn3360,79943884,85431827,5487943,TN
chr01,Bn3361,98962852,99678335,715483,CN
chr01,Bn3362,88659649,95945948,7286299,TNL
chr01,Bn3363,92257960,94730037,2472077,RLK
chr01,Bn3364,43857480,54226161,10368681,CN
chr01,Bn3365,12605626,86157610,73551984,RLK
chr01,Bn3366,81286028,86083336,4797308,TNL
chr01,Bn3367,4136704,23957828,19821124,RLP
chr01,Bn3368,61030536,63812340,2781804,RLK
chr01,Bn3369,41325875,75024859,33698984,CNL
chr01,Bn3370,38853716,63899212,25045496,RLP
chr01,Bn3371,71881283,78757303,6876020,TNL
chr01,Bn3372,86205166,98398391,12193225,TNL
chr01,Bn3373,89350658,91614027,2263369,TN
chr01,Bn3374,20841629,25614835,4773206,NBS
chr01,Bn3375,91553756,96387529,4833773,CNL
chr01,Bn3376,35091370,37383763,2292393,NBS
chr01,Bn3377,13941120,77506627,63565507,NBS
chr01,Bn3378,26655439,58951557,32296118,NBS
chr01,Bn3379,39296434,99809589,60513155,TN
chr01,Bn3380,84299697,86787540,2487843,NBS
chr01,Bn3381,82889312,97602705,14713393,RLP
chr01,Bn3382,57707234,78642251,20935017,TN
chr01,Bn3383,75667242,92378091,16710849,CNL
chr01,Bn3384,23212141,73237127,50024986,RLP
chr01,Bn3385,71042853,82711580,11668727,CN
chr01,Bn3386,33247932,90213316,56965384,TN
chr01,Bn3387,55449597,68770955,13321358,CNL
chr01,Bn3388,76394185,85469425,9075240,CNL
chr01,Bn3389,84289750,84671177,381427,CNL
chr01,Bn3390,67253341,81191780,13938439,NBS
chr01,Bn3391,82767353,89641395,6874042,RLK
chr01,Bn3392,31394128,99589560,68195432,CN
chr01,Bn3393,82447761,95755750,13307989,TN
chr01,Bn3394,39599657,70740315,31140658,RLP
chr01,Bn3395,32194815,90967212,58772397,CN
chr01,Bn3396,24712469,34505025,9792556,TN
chr01,Bn3397,50779508,57967640,7188132,RLK
chr01,Bn3398,44781759,57389138,12607379,NBS
chr01,Bn3399,2884289,66888652,64004363,TNL
chr01,Bn3400,35631901,86396926,50765025,RLK
chr01,Bn3401,11714243,12893757,1179514,CN
chr01,Bn3402,48283245,59213662,10930417,CN
chr01,Bn3403,75722812,86452771,10729959,RLP
chr01,Bn3404,10312891,15523890,5210999,CNL
chr01,Bn3405,9074886,47921347,38846461,RLP
chr01,Bn3406,27961135,42051530,14090395,TNL
chr01,Bn3407,66798696,71685980,4887284,TN
chr01,Bn3408,72296385,92729515,20433130,RLP
chr01,Bn3409,8393668,67658699,59265031,RLK
chr01,Bn3410,2297109,55183269,52886160,RLK
chr01,Bn3411,63162765,76801781,13639016,TNL
chr01,Bn3412,43246798,80135052,36888254,CN
chr01,Bn3413,33023517,35662730,2639213,NBS
chr01,Bn3414,25492990,73791893,48298903,CNL
chr01,Bn3415,88610854,95226664,6615810,RLK
chr01,Bn3416,56095727,88453101,32357374,RLK
chr01,Bn3417,76258864,80089304,3830440,RLK
chr01,Bn3418,58663162,95922761,37259599,NBS
chr01,Bn3419,85963086,90892933,4929847,TN
chr01,Bn3420,8479935,11205474,2725539,NBS
chr01,Bn3421,26216686,51088052,24871366,NBS
chr01,Bn3422,31603572,40651748,9048176,CN
chr01,Bn3423,52486080,85482807,32996727,TN
chr01,Bn3424,27016118,69446764,42430646,RLK
chr01,Bn3425,56469932,92273982,35804050,NBS
chr01,Bn3426,69643153,75160143,5516990,CNL
chr01,Bn3427,56211559,67309877,11098318,NBS
chr01,Bn3428,50602608,87704065,37101457,RLP
chr01,Bn3429,70243816,93376923,23133107,RLP
chr01,Bn3430,16135072,47191634,31056562,CNL
chr01,Bn3431,74012194,83804519,9792325,RLP
chr01,Bn3432,50872539,75682172,24809633,TN
chr01,Bn3433,60423919,94635058,34211139,TNL
chr01,Bn3434,27105529,39070764,11965235,RLP
chr01,Bn3435,3808533,36078547,32270014,TN
chr01,Bn3436,14822769,67531583,52708814,TN
chr01,Bn3437,15638457,80290758,64652301,CN
chr01,Bn3438,78279563,96044891,17765328,TN
chr01,Bn3439,44170477,70607510,26437033,RLP
chr01,Bn3440,86804316,95837582,9033266,RLP
chr01,Bn3441,88228080,93158097,4930017,NBS
chr01,Bn3442,15415103,74301102,58885999,RLK
chr01,Bn3443,68413210,80448932,12035722,RLP
chr01,Bn3444,29727243,42385637,12658394,TNL
chr01,Bn3445,64277553,69508601,5231048,TNL
chr01,Bn3446,94120837,94737215,616378,RLP
chr01,Bn3447,89715113,92111727,2396614,RLP
chr01,Bn3448,21918847,93493388,71574541,CNL
chr01,Bn3449,9885266,53692417,43807151,CN
chr01,Bn3450,73692688,86428652,12735964,CNL
chr01,Bn3451,24023033,69352782,45329749,NBS
chr01,Bn3452,39324699,78460899,39136200,CN
chr01,Bn3453,89271279,95123829,5852550,CN
chr01,Bn3454,30631613,51543078,20911465,CN
chr01,Bn3455,82838239,85095481,2257242,RLP
chr01,Bn3456,23291319,56854856,33563537,RLP
chr01,Bn3457,50745731,62640640,11894909,NBS
chr01,Bn3458,50203878,56568959,6365081,CN
chr01,Bn3459,74207940,86756672,12548732,RLK
chr01,Bn3460,75210196,86986582,11776386,RLK
chr01,Bn3461,10909324,68849522,57940198,RLK
chr01,Bn3462,2043182,14379115,12335933,CN
chr01,Bn3463,64777697,89614278,24836581,RLK
chr01,Bn3464,49237754,65130093,15892339,RLK
chr01,Bn3465,23704942,73698188,49993246,CNL
chr01,Bn3466,26864932,85071524,58206592,TN
chr01,Bn3467,2499985,63337570,60837585,RLK
chr01,Bn3468,52564234,69723407,17159173,RLP
chr01,Bn3469,81786576,83750543,1963967,RLK
chr01,Bn3470,69560938,97704509,28143571,TNL
chr01,Bn3471,61798500,64864290,3065790,CN
chr01,Bn3472,65178592,90008915,24830323,CN
chr01,Bn3473,32804630,96754306,63949676,TN
chr01,Bn3474,55127794,81922525,26794731,RLK
chr01,Bn3475,79341462,98209899,18868437,NBS
chr01,Bn3476,98396247,99294549,898302,TNL
chr01,Bn3477,75606510,92062832,16456322,RLK
chr01,Bn3478,48614222,90162941,41548719,CNL
chr01,Bn3479,79770021,96435104,16665083,TN
chr01,Bn3480,19651468,88813015,69161547,TNL
chr01,Bn3481,57933501,79100610,21167109,RLK
chr01,Bn3482,24620358,42260683,17640325,TNL
chr01,Bn3483,80310510,94396763,14086253,CN
chr01,Bn3484,58935623,99397531,40461908,TNL
chr01,Bn3485,99068769,99181425,112656,TN
chr01,Bn3486,64541446,90606569,26065123,RLK
chr01,Bn3487,6796686,38881909,32085223,CNL
chr01,Bn3488,61291439,95480684,34189245,RLP
chr01,Bn3489,17947047,58821520,40874473,CN
chr01,Bn3490,50543213,90579886,40036673,TNL
chr01,Bn3491,29482502,51305668,21823166,NBS
chr01,Bn3492,87208806,87240839,32033,NBS
chr01,Bn3493,17743122,96726186,78983064,NBS
chr01,Bn3494,21745614,51052273,29306659,RLP
chr01,Bn3495,19465126,54858357,35393231,RLK
chr01,Bn3496,25602924,50308566,24705642,RLK
chr01,Bn3497,5214792,31512318,26297526,CNL
chr01,Bn3498,41580248,45019864,3439616,CN
chr01,Bn3499,41809907,85543714,43733807,RLK
chr01,Bn3500,23510388,59837934,36327546,RLK
chr01,Bn3501,30310695,58592126,28281431,CNL
chr01,Bn3502,23523747,97063720,73539973,CN
chr01,Bn3503,36193389,72503215,36309826,NBS
chr01,Bn3504,65521530,75101903,9580373,RLP
chr01,Bn3505,5024601,67349650,62325049,RLP
chr01,Bn3506,83424066,84936788,1512722,TNL
chr01,Bn3507,48241067,91954324,43713257,RLK
chr01,Bn3508,74363361,88165647,13802286,NBS
chr01,Bn3509,68324411,90298405,21973994,CN
chr01,Bn3510,42222218,68211877,25989659,NBS
chr01,Bn3511,39994256,63558732,23564476,CNL
chr01,Bn3512,44554621,97161903,52607282,RLP
chr01,Bn3513,69367850,94163214,24795364,TN
chr01,Bn3514,60564622,69854625,9290003,TN
chr01,Bn3515,27005370,30412737,3407367,NBS
chr01,Bn3516,85577152,94117234,8540082,CNL
chr01,Bn3517,20300301,76175049,55874748,RLP
chr01,Bn3518,11617176,74472765,62855589,RLK
chr01,Bn3519,60886880,67864338,6977458,NBS
chr01,Bn3520,34599962,45125319,10525357,CNL
chr01,Bn3521,38779046,89354913,50575867,TN
chr01,Bn3522,75868782,84614014,8745232,CNL
chr01,Bn3523,48079568,89983271,41903703,RLP
chr01,Bn3524,9968406,12083970,2115564,RLK
chr01,Bn3525,1427906,72615032,71187126,RLP
chr01,Bn3526,21304783,71563866,50259083,TN
chr01,Bn3527,10051006,22599830,12548824,CNL
chr01,Bn3528,21295968,56524961,35228993,TNL
chr01,Bn3529,82227591,93749517,11521926,RLP
chr01,Bn3530,94469867,95885017,1415150,RLK
chr01,Bn3531,47524691,53339351,5814660,RLK
chr01,Bn3532,2370419,62925490,60555071,RLK
chr01,Bn3533,50311327,63808559,13497232,NBS
chr01,Bn3534,33896488,88662894,54766406,TN
chr01,Bn3535,94946461,99660982,4714521,NBS
chr01,Bn3536,59111199,87338008,28226809,RLK
chr01,Bn3537,37135227,95260111,58124884,CNL
chr01,Bn3538,1366464,87831212,86464748,TN
chr01,Bn3539,18982466,53057280,34074814,RLK
chr01,Bn3540,26968440,29277506,2309066,NBS
chr01,Bn3541,95386475,96911410,1524935,NBS
chr01,Bn3542,52071568,81778046,29706478,TN
chr01,Bn3543,39595734,57757027,18161293,NBS
chr01,Bn3544,75385364,85905297,10519933,NBS
chr01,Bn3545,61594083,74388448,12794365,RLK
chr01,Bn3546,88570573,91684117,3113544,NBS
chr01,Bn3547,17636707,35338817,17702110,RLK
chr01,Bn3548,64094339,75240090,11145751,CNL
chr01,Bn3549,59250664,65653493,6402829,TNL
chr01,Bn3550,87621255,96850059,9228804,RLK
chr01,Bn3551,50206536,64882846,14676310,TN
chr01,Bn3552,53276158,83133251,29857093,TNL
chr01,Bn3553,53477254,67815870,14338616,NBS
chr01,Bn3554,27177270,48687319,21510049,TN
chr01,Bn3555,36563512,56317309,19753797,RLK
chr01,Bn3556,27885470,86611722,58726252,NBS
chr01,Bn3557,75498122,98746376,23248254,TNL
chr01,Bn3558,55259846,74850742,19590896,NBS
chr01,Bn3559,86950775,88490213,1539438,RLK
chr01,Bn3560,3596405,34041850,30445445,RLP
chr01,Bn3561,91931658,93286153,1354495,RLP
chr01,Bn3562,26785670,27750342,964672,RLP
chr01,Bn3563,61446594,97286137,35839543,RLP
chr01,Bn3564,36332504,70977622,34645118,TNL
chr01,Bn3565,67441760,78205147,10763387,CN
chr01,Bn3566,58108037,70555046,12447009,TNL
chr01,Bn3567,29856129,87525864,57669735,RLK
chr01,Bn3568,22983351,31326733,8343382,CN
chr01,Bn3569,57190903,80846340,23655437,RLP
chr01,Bn3570,84238017,94758864,10520847,CNL
chr01,Bn3571,76565190,98960932,22395742,CNL
chr01,Bn3572,61426506,62263598,837092,TNL
chr01,Bn3573,58531324,65753907,7222583,TNL
chr01,Bn3574,6834953,12724800,5889847,TNL
chr01,Bn3575,58364681,75134436,16769755,TN
chr01,Bn3576,60342808,80511575,20168767,NBS
chr01,Bn3577,43366881,45407287,2040406,TN
chr01,Bn3578,64202630,93741037,29538407,RLK
chr01,Bn3579,6787516,71081978,64294462,CNL
chr01,Bn3580,93155286,93989489,834203,RLK
chr01,Bn3581,96248393,96942480,694087,TN
chr01,Bn3582,68446241,91828774,23382533,CNL
chr01,Bn3583,6711431,63226206,56514775,RLK
chr01,Bn3584,31815790,45323625,13507835,TN
chr01,Bn3585,41661557,44145650,2484093,RLK
chr01,Bn3586,15712383,53919981,38207598,RLP
chr01,Bn3587,44656751,70323742,25666991,TNL
chr01,Bn3588,10807145,42480970,31673825,NBS
chr01,Bn3589,26335927,73549314,47213387,RLP
chr01,Bn3590,67117510,95533919,28416409,RLP
chr01,Bn3591,19860872,24316299,4455427,TNL
chr01,Bn3592,37598468,75711243,38112775,TN
chr01,Bn3593,97953560,99850050,1896490,TN
chr01,Bn3594,51329980,52216494,886514,TNL
chr01,Bn3595,45847426,52523005,6675579,CNL
chr01,Bn3596,23881376,94798294,70916918,TNL
chr01,Bn3597,14076415,93129434,79053019,CNL
chr01,Bn3598,25229550,90286057,65056507,RLP
chr01,Bn3599,45895850,70413671,24517821,TNL
chr01,Bn3600,32565805,70064783,37498978,RLK
chr01,Bn3601,62909732,81581029,18671297,CNL
chr01,Bn3602,40214495,80340820,40126325,NBS
chr01,Bn3603,51141372,51494944,353572,CN
chr01,Bn3604,19887567,59469286,39581719,CNL
chr01,Bn3605,98178356,98349217,170861,NBS
chr01,Bn3606,82647333,90481988,7834655,CNL
chr01,Bn3607,41512889,89420050,47907161,TN
chr01,Bn3608,56572349,67195412,10623063,TNL
chr01,Bn3609,54724176,56092096,1367920,TNL
chr01,Bn3610,8705141,23526068,14820927,CN
chr01,Bn3611,65985240,88140265,22155025,TN
chr01,Bn3612,93251494,99019378,5767884,TN
chr01,Bn3613,84371216,92120351,7749135,CNL
chr01,Bn3614,36655224,95096383,58441159,RLP
chr01,Bn3615,86447880,93433719,6985839,RLP
chr01,Bn3616,34421373,55296222,20874849,CNL
chr01,Bn3617,22715644,69691631,46975987,RLP
chr01,Bn3618,38016684,57763361,19746677,RLP
chr01,Bn3619,3927339,65530611,61603272,RLK
chr01,Bn3620,29081259,93701827,64620568,RLK
chr01,Bn3621,42131060,66898656,24767596,RLP
chr01,Bn3622,23511811,61056128,37544317,TNL
chr01,Bn3623,87337265,87408184,70919,CN
chr01,Bn3624,56696005,93654236,36958231,CN
chr01,Bn3625,98256886,98737538,480652,NBS
chr01,Bn3626,76699033,93443981,16744948,NBS
chr01,Bn3627,50108395,60286167,10177772,TN
chr01,Bn3628,52885321,89054615,36169294,TNL
chr01,Bn3629,20246030,50221860,29975830,RLP
chr01,Bn3630,22886227,58007729,35121502,RLP
chr01,Bn3631,97097352,97924021,826669,CNL
chr01,Bn3632,44990896,87268317,42277421,NBS
chr01,Bn3633,61545289,88593832,27048543,TN
chr01,Bn3634,28826587,55330295,26503708,TN
chr01,Bn3635,39103692,41967134,2863442,CN
chr01,Bn3636,85816162,95372770,9556608,CNL
chr01,Bn3637,58273368,63948981,5675613,NBS
chr01,Bn3638,67388958,73266372,5877414,RLP
chr01,Bn3639,22005841,52658392,30652551,CNL
chr01,Bn3640,74398268,80653253,6254985,CN
chr01,Bn3641,84057559,94858149,10800590,CNL
chr01,Bn3642,57010580,98364308,41353728,CNL
chr01,Bn3643,88680805,95186011,6505206,RLP
chr01,Bn3644,10187539,80439836,70252297,TNL
chr01,Bn3645,92415328,96374633,3959305,RLP
chr01,Bn3646,4171506,99916083,95744577,TNL
chr01,Bn3647,91411468,96634389,5222921,TNL
chr01,Bn3648,56969313,72565955,15596642,TNL
chr01,Bn3649,63840820,74980018,11139198,TNL
chr01,Bn3650,3323668,79282054,75958386,RLP
chr01,Bn3651,50652524,93961182,43308658,TN
chr01,Bn3652,25580397,58624223,33043826,CN
chr01,Bn3653,99860831,99957550,96719,NBS
chr01,Bn3654,51622067,62100620,10478553,TNL
chr01,Bn3655,70371854,84685984,14314130,NBS
chr01,Bn3656,75583843,77397775,1813932,RLK
chr01,Bn3657,97366986,99451325,2084339,NBS
chr01,Bn3658,22826368,51882121,29055753,RLP
chr01,Bn3659,70810957,89480398,18669441,RLP
chr01,Bn3660,56057448,99942958,43885510,TN
chr01,Bn3661,8499395,39824694,31325299,NBS
chr01,Bn3662,10465908,29672562,19206654,RLP
chr01,Bn3663,46645738,49640380,2994642,CNL
chr01,Bn3664,92909438,94895109,1985671,NBS
chr01,Bn3665,80145619,81966777,1821158,RLP
chr01,Bn3666,49508853,53715058,4206205,RLK
chr01,Bn3667,2408096,52840347,50432251,CN
chr01,Bn3668,71398826,86771778,15372952,RLK
chr01,Bn3669,83166240,83615838,449598,CN
chr01,Bn3670,95474680,96966406,1491726,NBS
chr01,Bn3671,72640611,98998070,26357459,TNL
chr01,Bn3672,75570164,95207865,19637701,TN
chr01,Bn3673,96127895,97003631,875736,RLP
chr01,Bn3674,69707787,94409091,24701304,CN
chr01,Bn3675,82145278,83240954,1095676,RLK
chr01,Bn3676,19380477,69136899,49756422,RLP
chr01,Bn3677,20387962,31121177,10733215,CN
chr01,Bn3678,56994314,71886055,14891741,NBS
chr01,Bn3679,89785333,96342521,6557188,NBS
chr01,Bn3680,15630205,76885681,61255476,RLK
chr01,Bn3681,7578723,17050963,9472240,CN
chr01,Bn3682,68422723,77815760,9393037,NBS
chr01,Bn3683,88663701,99804140,11140439,CN
chr01,Bn3684,46943574,69669320,22725746,RLK
chr01,Bn3685,7353132,8670179,1317047,CNL
chr01,Bn3686,46319433,82630585,36311152,CNL
chr01,Bn3687,16762212,56458090,39695878,NBS
chr01,Bn3688,42279379,45662511,3383132,CN
chr01,Bn3689,30141272,61091895,30950623,NBS
chr01,Bn3690,94636429,97028867,2392438,CNL
chr01,Bn3691,97583416,99434677,1851261,RLK
chr01,Bn3692,47534875,54685911,7151036,RLK
chr01,Bn3693,59283620,93504100,34220480,RLK
chr01,Bn3694,44756092,75041961,30285869,CNL
chr01,Bn3695,61766879,67976484,6209605,RLP
chr01,Bn3696,87069096,87146842,77746,RLP
chr01,Bn3697,6204129,78820831,72616702,NBS
chr01,Bn3698,27331551,82257206,54925655,TNL
chr01,Bn3699,73728565,89974123,16245558,NBS
chr01,Bn3700,55662749,58543253,2880504,RLP
chr01,Bn3701,82775294,88007267,5231973,RLK
chr01,Bn3702,12954297,82801784,69847487,TNL
chr01,Bn3703,2157507,96761260,94603753,TNL
chr01,Bn3704,66795967,81974688,15178721,NBS
chr01,Bn3705,16266725,52508700,36241975,RLK
chr01,Bn3706,75122816,92343391,17220575,RLK
chr01,Bn3707,28694975,34327690,5632715,CN
chr01,Bn3708,16333514,35684605,19351091,TNL
chr01,Bn3709,31432418,42847828,11415410,TNL
chr01,Bn3710,60141467,87685007,27543540,RLK
chr01,Bn3711,90961721,96943924,5982203,NBS
chr01,Bn3712,90817957,95886679,5068722,CNL
chr01,Bn3713,68853646,89924110,21070464,RLP
chr01,Bn3714,36315165,49144748,12829583,TN
chr01,Bn3715,77058322,87710585,10652263,CN
chr01,Bn3716,17195410,79547780,62352370,RLP
chr01,Bn3717,38414359,70319660,31905301,RLK
chr01,Bn3718,25526642,26692578,1165936,NBS
chr01,Bn3719,97126158,98072590,946432,RLK
chr01,Bn3720,56323247,88097905,31774658,RLK
chr01,Bn3721,71691990,80847498,9155508,NBS
chr01,Bn3722,26754336,77939303,51184967,NBS
chr01,Bn3723,26112963,41819200,15706237,RLP
chr01,Bn3724,12608753,50192488,37583735,RLK
chr01,Bn3725,99367069,99822362,455293,RLK
chr01,Bn3726,84556760,91690109,7133349,NBS
chr01,Bn3727,9785471,67666212,57880741,TNL
chr01,Bn3728,19993260,72574175,52580915,NBS
chr01,Bn3729,24649649,48311566,23661917,TNL
chr01,Bn3730,89393007,95905924,6512917,TNL
chr01,Bn3731,23326562,54149937,30823375,TN
chr01,Bn3732,59524616,69119871,9595255,RLP
chr01,Bn3733,48872343,52353993,3481650,RLP
chr01,Bn3734,37728517,63691321,25962804,CN
chr01,Bn3735,36445659,84341950,47896291,RLK
chr01,Bn3736,67597466,73108482,5511016,TN
chr01,Bn3737,78385720,85979947,7594227,TN
chr01,Bn3738,88165702,98356039,10190337,CNL
chr01,Bn3739,29256193,37050768,7794575,NBS
chr01,Bn3740,38234740,40053666,1818926,TNL
chr01,Bn3741,39893584,54399248,14505664,CNL
chr01,Bn3742,40960226,70154258,29194032,RLP
chr01,Bn3743,58162602,75718165,17555563,TNL
chr01,Bn3744,78131230,92157842,14026612,NBS
chr01,Bn3745,48090292,86078774,37988482,RLP
chr01,Bn3746,64280307,99254167,34973860,TN
chr01,Bn3747,61797527,82884565,21087038,TNL
chr01,Bn3748,9381630,85914619,76532989,TN
chr01,Bn3749,56803087,97339327,40536240,TNL
chr01,Bn3750,40760214,96634201,55873987,TNL
chr01,Bn3751,22069699,42570099,20500400,NBS
chr01,Bn3752,8244079,57695527,49451448,NBS
chr01,Bn3753,94739984,96368562,1628578,RLK
chr01,Bn3754,65560818,97197490,31636672,NBS
chr01,Bn3755,27837028,83638331,55801303,NBS
chr01,Bn3756,97967589,99045555,1077966,RLK
chr01,Bn3757,61399711,77628002,16228291,RLK
chr01,Bn3758,14386476,88366639,73980163,TNL
chr01,Bn3759,11723969,58029438,46305469,NBS
chr01,Bn3760,46804172,87296827,40492655,CN
chr01,Bn3761,77704151,94594037,16889886,NBS
chr01,Bn3762,58009525,82162669,24153144,RLK
chr01,Bn3763,5014777,63875799,58861022,RLK
chr01,Bn3764,28179500,33967488,5787988,CN
chr01,Bn3765,38868239,48765931,9897692,TNL
chr01,Bn3766,96428203,97734899,1306696,RLK
chr01,Bn3767,6082746,49228611,43145865,TNL
chr01,Bn3768,88613768,95357546,6743778,RLK
chr01,Bn3769,30344414,69627365,39282951,CN
chr01,Bn3770,51650761,55422535,3771774,TNL
chr01,Bn3771,33051468,47727651,14676183,RLP
chr01,Bn3772,90140547,96872414,6731867,TN
chr01,Bn3773,10708944,41777762,31068818,NBS
chr01,Bn3774,19760210,66573134,46812924,CN
chr01,Bn3775,86485857,87712377,1226520,CN
chr01,Bn3776,23252021,59576813,36324792,CN
chr01,Bn3777,3517310,21848012,18330702,TN
chr01,Bn3778,81981303,93615149,11633846,CNL
chr01,Bn3779,81758469,87811262,6052793,TNL
chr01,Bn3780,6175234,54354045,48178811,CN
chr01,Bn3781,44876205,59335831,14459626,CN
chr01,Bn3782,14854256,96530532,81676276,TN
chr01,Bn3783,18470676,75826921,57356245,CN
chr01,Bn3784,46562770,65826927,19264157,NBS
chr01,Bn3785,1034659,36800671,35766012,TN
chr01,Bn3786,17102826,40578302,23475476,NBS
chr01,Bn3787,62130146,98924392,36794246,RLP
chr01,Bn3788,34595916,53698882,19102966,RLP
chr01,Bn3789,73105807,76755849,3650042,RLP
chr01,Bn3790,4365138,64197789,59832651,TNL
chr01,Bn3791,23329610,95561298,72231688,RLK
chr01,Bn3792,67252761,85110150,17857389,RLP
chr01,Bn3793,73697092,85414798,11717706,CNL
chr01,Bn3794,80957114,91302636,10345522,CN
chr01,Bn3795,62748474,97078505,34330031,TNL
chr01,Bn3796,32510049,75216432,42706383,CNL
chr01,Bn3797,32802524,67203082,34400558,TN
chr01,Bn3798,38463887,74362378,35898491,TNL
chr01,Bn3799,67780103,69561415,1781312,TNL
chr01,Bn3800,68586402,88814941,20228539,NBS
chr01,Bn3801,65531060,75770567,10239507,NBS
chr01,Bn3802,53298289,68916529,15618240,CN
chr01,Bn3803,53519780,77128537,23608757,CNL
chr01,Bn3804,68439653,86347623,17907970,NBS
chr01,Bn3805,61840236,78849195,17008959,RLK
chr01,Bn3806,85852975,86106019,253044,RLP
chr01,Bn3807,2845527,83436841,80591314,CNL
chr01,Bn3808,38960373,56844421,17884048,NBS
chr01,Bn3809,99695186,99829531,134345,NBS
chr01,Bn3810,20834798,26593458,5758660,RLP
chr01,Bn3811,88635774,98410817,9775043,RLP
chr01,Bn3812,59787090,88898877,29111787,RLP
chr01,Bn3813,83833980,84983075,1149095,CN
chr01,Bn3814,71300880,71531095,230215,CNL
chr01,Bn3815,81631470,91945658,10314188,CNL
chr01,Bn3816,83420678,85357392,1936714,CNL
chr01,Bn3817,59423551,92903014,33479463,RLK
chr01,Bn3818,34557332,84775283,50217951,CNL
chr01,Bn3819,92532121,98936420,6404299,TNL
chr01,Bn3820,10334620,58538805,48204185,RLK
chr02,Bn3821,81136203,95554755,14418552,CN
chr02,Bn3822,22800147,48396852,25596705,RLK
chr02,Bn3823,94692605,96373709,1681104,TN
chr02,Bn3824,24674410,87108801,62434391,CNL
chr02,Bn3825,99456528,99649235,192707,NBS
chr02,Bn3826,99483758,99996512,512754,NBS
chr02,Bn3827,10343194,52873028,42529834,TN
chr02,Bn3828,17988213,96813745,78825532,CNL
chr02,Bn3829,67295053,93176289,25881236,TNL
chr02,Bn3830,9531593,12869497,3337904,TN
chr02,Bn3831,16459383,68726530,52267147,TN
chr02,Bn3832,16797450,56882255,40084805,TNL
chr02,Bn3833,1384183,12910848,11526665,RLP
chr02,Bn3834,58334642,94771290,36436648,RLK
chr02,Bn3835,22915693,33645258,10729565,TN
chr02,Bn3836,2819754,9366568,6546814,CN
chr02,Bn3837,31160629,72721184,41560555,RLP
chr02,Bn3838,11234054,12571179,1337125,CN
chr02,Bn3839,57334895,80579230,23244335,CN
chr02,Bn3840,35054591,84881834,49827243,CNL
chr02,Bn3841,17987420,81539231,63551811,TNL
chr02,Bn3842,42410079,45990018,3579939,NBS
chr02,Bn3843,15197248,36632452,21435204,RLP
chr02,Bn3844,7088182,44365824,37277642,CN
chr02,Bn3845,63650952,80532513,16881561,TNL
chr02,Bn3846,71960783,99810229,27849446,TNL
chr02,Bn3847,47616923,52489863,4872940,CN
chr02,Bn3848,65538915,85007534,19468619,RLP
chr02,Bn3849,6023465,17222326,11198861,CN
chr02,Bn3850,52287726,95526477,43238751,RLK
chr02,Bn3851,19583239,86419965,66836726,RLK
chr02,Bn3852,47751243,83542942,35791699,TNL
chr02,Bn3853,12908933,99837212,86928279,CN
chr02,Bn3854,52606376,96790263,44183887,TN
chr02,Bn3855,29308527,88675394,59366867,CNL
chr02,Bn3856,50150142,94618417,44468275,CNL
chr02,Bn3857,78468474,81044762,2576288,CN
chr02,Bn3858,61273036,75170470,13897434,TNL
chr02,Bn3859,80053256,85025987,4972731,TNL
chr02,Bn3860,20334609,47751253,27416644,CNL
chr02,Bn3861,43186670,60487527,17300857,TN
chr02,Bn3862,93851106,96927271,3076165,NBS
chr02,Bn3863,83070028,85748121,2678093,TNL
chr02,Bn3864,62350468,86212441,23861973,CNL
chr02,Bn3865,42030358,42670041,639683,TNL
chr02,Bn3866,72326715,91129246,18802531,CNL
chr02,Bn3867,48015229,71188764,23173535,RLK
chr02,Bn3868,87573242,99686509,12113267,TNL
chr02,Bn3869,98566250,99149359,583109,TNL
chr02,Bn3870,18032616,21669275,3636659,RLK
chr02,Bn3871,67828717,89976268,22147551,RLK
chr02,Bn3872,73275355,89598652,16323297,CN
chr02,Bn3873,93285152,96446371,3161219,TN
chr02,Bn3874,78216547,87309150,9092603,CNL
chr02,Bn3875,62155631,73803273,11647642,CNL
chr02,Bn3876,7839343,18659381,10820038,RLK
chr02,Bn3877,89422585,96443078,7020493,RLK
chr02,Bn3878,60115672,99735641,39619969,CN
chr02,Bn3879,54841748,71604238,16762490,TNL
chr02,Bn3880,37172433,68472647,31300214,CN
chr02,Bn3881,44576380,98541128,53964748,CN
chr02,Bn3882,88367574,99157559,10789985,NBS
chr02,Bn3883,46267493,48807544,2540051,CNL
chr02,Bn3884,73498055,89567912,16069857,TN
chr02,Bn3885,22108950,39873164,17764214,RLP
chr02,Bn3886,91162998,96779500,5616502,TN
chr02,Bn3887,14320381,50151055,35830674,TNL
chr02,Bn3888,5569396,71284875,65715479,RLP
chr02,Bn3889,6058956,32438927,26379971,CNL
chr02,Bn3890,10724621,30271546,19546925,RLK
chr02,Bn3891,39829842,60609013,20779171,TN
chr02,Bn3892,3642684,35228641,31585957,RLP
chr02,Bn3893,52100526,60268374,8167848,TN
chr02,Bn3894,37828318,99773662,61945344,NBS
chr02,Bn3895,50315456,74121211,23805755,NBS
chr02,Bn3896,87661211,98964418,11303207,CNL
chr02,Bn3897,45939792,73456854,27517062,RLK
chr02,Bn3898,1662840,34076574,32413734,TN
chr02,Bn3899,67687792,69147048,1459256,RLK
chr02,Bn3900,36912283,85207882,48295599,TNL
chr02,Bn3901,47500857,98344118,50843261,CNL
chr02,Bn3902,83150185,91544444,8394259,RLK
chr02,Bn3903,25495104,27967150,2472046,RLK
chr02,Bn3904,4904455,28252323,23347868,NBS
chr02,Bn3905,92132948,98739779,6606831,NBS
chr02,Bn3906,73175842,96737755,23561913,TN
chr02,Bn3907,94945321,96588011,1642690,RLK
chr02,Bn3908,74607871,99171166,24563295,CN
chr02,Bn3909,21750560,32954670,11204110,CN
chr02,Bn3910,40880715,94081925,53201210,TNL
chr02,Bn3911,70763610,76930111,6166501,TN
chr02,Bn3912,17625192,87122272,69497080,TNL
chr02,Bn3913,76810450,99280384,22469934,NBS
chr02,Bn3914,22954508,44231384,21276876,CNL
chr02,Bn3915,81753922,95768385,14014463,RLK
chr02,Bn3916,79078062,83810019,4731957,NBS
chr02,Bn3917,18091741,23994984,5903243,TNL
chr02,Bn3918,45375409,50203971,4828562,RLK
chr02,Bn3919,15980380,67452176,51471796,CNL
chr02,Bn3920,37025197,46718494,9693297,TNL
chr02,Bn3921,26958667,68185879,41227212,CNL
chr02,Bn3922,17807972,49189498,31381526,RLP
chr02,Bn3923,47278566,85620467,38341901,TN
chr02,Bn3924,52663808,75701407,23037599,CN
chr02,Bn3925,57661731,85967921,28306190,RLK
chr02,Bn3926,29326524,99527732,70201208,TNL
chr02,Bn3927,69779548,76855107,7075559,NBS
chr02,Bn3928,11519236,50001115,38481879,TN
chr02,Bn3929,11833710,85032691,73198981,NBS
chr02,Bn3930,55736789,91400292,35663503,CNL
chr02,Bn3931,80207444,83849879,3642435,RLK
chr02,Bn3932,33499713,74137934,40638221,CNL
chr02,Bn3933,29620611,85617290,55996679,RLK
chr02,Bn3934,39261671,56889292,17627621,TN
chr02,Bn3935,5800711,74660259,68859548,CNL
chr02,Bn3936,8942928,35253397,26310469,RLK
chr02,Bn3937,40599832,71590571,30990739,RLK
chr02,Bn3938,35048756,54573613,19524857,TNL
chr02,Bn3939,17800734,80638554,62837820,TNL
chr02,Bn3940,69222984,89535385,20312401,TNL
chr02,Bn3941,74109128,91372666,17263538,TN
chr02,Bn3942,43030730,74135324,31104594,TNL
chr02,Bn3943,26249999,94019731,67769732,NBS
chr02,Bn3944,13847308,99007584,85160276,NBS
chr02,Bn3945,1745531,96559570,94814039,NBS
chr02,Bn3946,8619573,61682523,53062950,CNL
chr02,Bn3947,65714622,76612853,10898231,TNL
chr02,Bn3948,6595006,69844210,63249204,TNL
chr02,Bn3949,69707781,90994492,21286711,CNL
chr02,Bn3950,44467399,59708375,15240976,CN
chr02,Bn3951,50896786,58422822,7526036,CNL
chr02,Bn3952,46336754,87710467,41373713,RLK
chr02,Bn3953,86925706,98855969,11930263,CNL
chr02,Bn3954,90703587,91048994,345407,CN
chr02,Bn3955,22409646,80426849,58017203,RLP
chr02,Bn3956,96696164,97745794,1049630,CNL
chr02,Bn3957,85097929,89684155,4586226,TNL
chr02,Bn3958,53246061,98279829,45033768,NBS
chr02,Bn3959,51277794,97173642,45895848,CN
chr02,Bn3960,73739864,94368246,20628382,RLK
chr02,Bn3961,80771429,95193542,14422113,RLK
chr02,Bn3962,28349706,92524656,64174950,RLP
chr02,Bn3963,38490357,49091976,10601619,RLK
chr02,Bn3964,69943231,76470921,6527690,TNL
chr02,Bn3965,96856440,97682055,825615,TNL
chr02,Bn3966,6172131,35244039,29071908,NBS
chr02,Bn3967,45861488,57167907,11306419,NBS
chr02,Bn3968,51964322,61414147,9449825,TN
chr02,Bn3969,14166755,26245338,12078583,CN
chr02,Bn3970,24896280,98623674,73727394,TNL
chr02,Bn3971,20462571,56943359,36480788,RLP
chr02,Bn3972,77589065,98663218,21074153,RLP
chr02,Bn3973,84045205,90536157,6490952,CNL
chr02,Bn3974,42159372,71792010,29632638,CN
chr02,Bn3975,6441088,44330591,37889503,CN
chr02,Bn3976,26948260,74092427,47144167,TNL
chr02,Bn3977,16237944,19246569,3008625,CN
chr02,Bn3978,52112034,93534121,41422087,NBS
chr02,Bn3979,52829979,65500726,12670747,CN
chr02,Bn3980,4351028,65447914,61096886,CNL
chr02,Bn3981,42151081,65452726,23301645,NBS
chr02,Bn3982,15200317,82667494,67467177,NBS
chr02,Bn3983,30491398,45327030,14835632,CNL
chr02,Bn3984,53009695,73126629,20116934,TNL
chr02,Bn3985,24936701,84325446,59388745,TN
chr02,Bn3986,90836082,97718593,6882511,TNL
chr02,Bn3987,94358943,95966374,1607431,TN
chr02,Bn3988,5990704,98168165,92177461,RLP
chr02,Bn3989,85091114,87329044,2237930,NBS
chr02,Bn3990,62409548,84154612,21745064,NBS
chr02,Bn3991,77128851,83369028,6240177,RLK
chr02,Bn3992,99005695,99205538,199843,RLK
chr02,Bn3993,70914534,98649369,27734835,NBS
chr02,Bn3994,34680408,69863370,35182962,TN
chr02,Bn3995,40138218,69033205,28894987,CN
chr02,Bn3996,38740385,47222527,8482142,CN
chr02,Bn3997,5268909,36099753,30830844,TNL
chr02,Bn3998,23938966,25457794,1518828,NBS
chr02,Bn3999,65323971,91264696,25940725,TN
chr02,Bn4000,14282665,86592929,72310264,CN
chr02,Bn4001,12603519,34260382,21656863,NBS
chr02,Bn4002,65693035,76131399,10438364,CNL
chr02,Bn4003,77606552,86732926,9126374,RLK
chr02,Bn4004,33049493,92301928,59252435,CN
chr02,Bn4005,23264028,76736335,53472307,TNL
chr02,Bn4006,47510343,98125439,50615096,RLP
chr02,Bn4007,70042223,86904382,16862159,RLP
chr02,Bn4008,58735284,78718789,19983505,RLK
chr02,Bn4009,64226325,78679258,14452933,CNL
chr02,Bn4010,85207283,98124137,12916854,TN
chr02,Bn4011,3410336,63456026,60045690,NBS
chr02,Bn4012,63864089,83283098,19419009,RLP
chr02,Bn4013,21847320,23324956,1477636,NBS
chr02,Bn4014,63347994,75545006,12197012,RLK
chr02,Bn4015,15295999,93176890,77880891,TN
chr02,Bn4016,10774866,46578718,35803852,CN
chr02,Bn4017,12529440,81669271,69139831,TNL
chr02,Bn4018,57130509,97283161,40152652,CN
chr02,Bn4019,24932275,30212919,5280644,TNL
chr02,Bn4020,69217431,82996619,13779188,RLK
chr02,Bn4021,35375778,88582567,53206789,CNL
chr02,Bn4022,91077706,92971024,1893318,TN
chr02,Bn4023,84023738,98035834,14012096,TN
chr02,Bn4024,78838753,80261241,1422488,RLK
chr02,Bn4025,97969805,99389004,1419199,RLK
chr02,Bn4026,88154225,96316887,8162662,RLP
chr02,Bn4027,1939508,55238160,53298652,TN
chr02,Bn4028,27223210,41043198,13819988,NBS
chr02,Bn4029,46144592,98128751,51984159,TN
chr02,Bn4030,50327348,89187497,38860149,RLP
chr02,Bn4031,12952902,72445757,59492855,TN
chr02,Bn4032,96796793,96936162,139369,NBS
chr02,Bn4033,58724304,70271803,11547499,TNL
chr02,Bn4034,10706472,78642969,67936497,RLP
chr02,Bn4035,4219471,30842468,26622997,CN
chr02,Bn4036,7074714,10068620,2993906,CNL
chr02,Bn4037,45279042,88147716,42868674,TN
chr02,Bn4038,69374712,83402800,14028088,RLK
chr02,Bn4039,26429698,97032518,70602820,TN
chr02,Bn4040,89330048,95015882,5685834,NBS
chr02,Bn4041,75874223,85480694,9606471,CN
chr02,Bn4042,58863748,85596739,26732991,TN
chr02,Bn4043,79857234,91455319,11598085,NBS
chr02,Bn4044,89055136,97633655,8578519,NBS
chr02,Bn4045,58157081,69355504,11198423,RLP
chr02,Bn4046,58375778,65407955,7032177,RLP
chr02,Bn4047,15907448,67800656,51893208,TN
chr02,Bn4048,25572345,69557159,43984814,NBS
chr02,Bn4049,79551974,95784875,16232901,NBS
chr02,Bn4050,56488565,61553360,5064795,RLP
chr02,Bn4051,19691861,75052431,55360570,RLP
chr02,Bn4052,35281417,92627378,57345961,NBS
chr02,Bn4053,39887518,66474948,26587430,RLK
chr02,Bn4054,96708719,99871716,3162997,CN
chr02,Bn4055,6748459,88239309,81490850,TNL
chr02,Bn4056,45079535,78026797,32947262,CN
chr02,Bn4057,53355824,75769653,22413829,RLK
chr02,Bn4058,95687831,97074034,1386203,RLK
chr02,Bn4059,32576811,68815864,36239053,CNL
chr02,Bn4060,55734293,73102909,17368616,TNL
chr02,Bn4061,57687523,88162998,30475475,NBS
chr02,Bn4062,42006119,48684892,6678773,RLK
chr02,Bn4063,62152538,72494616,10342078,TN
chr02,Bn4064,58840559,95151009,36310450,RLP
chr02,Bn4065,95316716,96775783,1459067,NBS
chr02,Bn4066,54607176,87696520,33089344,RLP
chr02,Bn4067,29502293,96381609,66879316,TN
chr02,Bn4068,49115625,83150623,34034998,CN
chr02,Bn4069,52921629,56595713,3674084,RLP
chr02,Bn4070,29922748,86122474,56199726,NBS
chr02,Bn4071,93563276,98090810,4527534,TN
chr02,Bn4072,54524482,70878198,16353716,RLK
chr02,Bn4073,57677142,86962370,29285228,RLP
chr02,Bn4074,63938702,71969129,8030427,RLP
chr02,Bn4075,44915729,50235722,5319993,RLK
chr02,Bn4076,83459287,84610790,1151503,TNL
chr02,Bn4077,92364954,95925296,3560342,CNL
chr02,Bn4078,73289306,94208654,20919348,TNL
chr02,Bn4079,12309851,18536082,6226231,NBS
chr02,Bn4080,96526026,99933231,3407205,TN
chr02,Bn4081,28352900,70084143,41731243,TN
chr02,Bn4082,63531483,85013435,21481952,TNL
chr02,Bn4083,88415592,89912996,1497404,RLK
chr02,Bn4084,23616346,51615363,27999017,TN
chr02,Bn4085,37374995,46830746,9455751,TNL
chr02,Bn4086,40691490,82235006,41543516,RLP
chr02,Bn4087,9058905,71236077,62177172,CN
chr02,Bn4088,90585351,92998533,2413182,CN
chr02,Bn4089,9454865,60874588,51419723,CNL
chr02,Bn4090,98259297,98518891,259594,CNL
chr02,Bn4091,34567178,36897435,2330257,NBS
chr02,Bn4092,4077876,74511571,70433695,NBS
chr02,Bn4093,70355131,99346016,28990885,CNL
chr02,Bn4094,61909789,90811078,28901289,CNL
chr02,Bn4095,36649778,85851502,49201724,CNL
chr02,Bn4096,5386292,30952081,25565789,RLP
chr02,Bn4097,51397477,99314842,47917365,CN
chr02,Bn4098,42780914,81483767,38702853,NBS
chr02,Bn4099,19500161,71926527,52426366,TN
chr02,Bn4100,17698499,75283051,57584552,CNL
chr02,Bn4101,16626304,17170151,543847,RLK
chr02,Bn4102,75440887,89600277,14159390,TNL
chr02,Bn4103,86372484,93549000,7176516,CNL
chr02,Bn4104,50761417,95050190,44288773,RLP
chr02,Bn4105,12918386,32221653,19303267,NBS
chr02,Bn4106,93531676,96927757,3396081,CNL
chr02,Bn4107,52957910,88519505,35561595,RLP
chr02,Bn4108,80989413,83794236,2804823,NBS
chr02,Bn4109,25451497,78754555,53303058,NBS
chr02,Bn4110,27660338,65372089,37711751,CNL
chr02,Bn4111,48278885,53557904,5279019,RLK
chr02,Bn4112,88722137,89812070,1089933,RLK
chr02,Bn4113,28866926,36947693,8080767,RLK
chr02,Bn4114,61474592,92323878,30849286,RLP
chr02,Bn4115,51069180,58761694,7692514,RLK
chr02,Bn4116,2554080,34218167,31664087,CN
chr02,Bn4117,92141845,97111932,4970087,CNL
chr02,Bn4118,60783475,65887020,5103545,CN
chr02,Bn4119,27535955,71656756,44120801,CNL
chr02,Bn4120,46008379,47560382,1552003,CN
chr02,Bn4121,9389426,95096768,85707342,NBS
chr02,Bn4122,87912191,90834089,2921898,CNL
chr02,Bn4123,44552064,66446759,21894695,RLK
chr02,Bn4124,18716751,29515622,10798871,TNL
chr02,Bn4125,18520328,43708693,25188365,RLP
chr02,Bn4126,57405367,73949106,16543739,RLK
chr02,Bn4127,29200049,71104201,41904152,TNL
chr02,Bn4128,52213209,89413917,37200708,CNL
chr02,Bn4129,82620867,99490626,16869759,RLK
chr02,Bn4130,56390482,62379276,5988794,TN
chr02,Bn4131,4304975,99207264,94902289,CNL
chr02,Bn4132,35830315,68179925,32349610,RLK
chr02,Bn4133,10081836,13690606,3608770,CN
chr02,Bn4134,90847897,99576792,8728895,TN
chr02,Bn4135,45252605,90679569,45426964,CN
chr02,Bn4136,53179795,99913354,46733559,CN
chr02,Bn4137,83972536,94096302,10123766,RLK
chr02,Bn4138,77539613,90555953,13016340,RLK
chr02,Bn4139,32688189,63270788,30582599,CN
chr02,Bn4140,96587961,96732729,144768,NBS
chr02,Bn4141,89031780,99372204,10340424,TNL
chr02,Bn4142,28999987,51968254,22968267,CNL
chr02,Bn4143,24544283,35263981,10719698,TN
chr02,Bn4144,96562539,98998472,2435933,NBS
chr02,Bn4145,6216613,20373116,14156503,CN
chr02,Bn4146,61278017,88134528,26856511,TN
chr02,Bn4147,42465776,96126560,53660784,CN
chr02,Bn4148,61569093,91427005,29857912,CNL
chr02,Bn4149,96752888,97385700,632812,CN
chr02,Bn4150,22820746,60489485,37668739,NBS
chr02,Bn4151,17901581,35788432,17886851,RLP
chr02,Bn4152,29347923,74372503,45024580,TNL
chr02,Bn4153,60885208,65285527,4400319,NBS
chr02,Bn4154,38991257,53795751,14804494,NBS
chr02,Bn4155,28518311,37004234,8485923,TN
chr02,Bn4156,5891923,92519372,86627449,NBS
chr02,Bn4157,74888053,81193358,6305305,TNL
chr02,Bn4158,21470024,70128879,48658855,TN
chr02,Bn4159,59001909,64296702,5294793,CN
chr02,Bn4160,87659363,89034732,1375369,TN
chr02,Bn4161,66614603,79364162,12749559,RLP
chr02,Bn4162,9610954,91630111,82019157,RLP
chr02,Bn4163,10074374,61608747,51534373,TN
chr02,Bn4164,77903237,81485900,3582663,RLK
chr02,Bn4165,63538613,85806811,22268198,NBS
chr02,Bn4166,11503179,42209123,30705944,TN
chr02,Bn4167,76249651,91780888,15531237,TN
chr02,Bn4168,19782350,50688147,30905797,NBS
chr02,Bn4169,43988907,95461029,51472122,RLK
chr02,Bn4170,14466756,49592244,35125488,TNL
chr02,Bn4171,77294654,83759368,6464714,RLP
chr02,Bn4172,27682088,85860724,58178636,CNL
chr02,Bn4173,28505168,83254409,54749241,TN
chr02,Bn4174,47529780,52288764,4758984,TN
chr02,Bn4175,59865771,68213008,8347237,NBS
chr02,Bn4176,53373003,60000310,6627307,TN
chr02,Bn4177,30925824,62266429,31340605,CN
chr02,Bn4178,82319511,91690292,9370781,NBS
chr02,Bn4179,50254821,92706627,42451806,CNL
chr02,Bn4180,80259755,91645037,11385282,RLK
chr02,Bn4181,91785042,95492821,3707779,RLP
chr02,Bn4182,1092712,87095627,86002915,CNL
chr02,Bn4183,44995169,48139613,3144444,RLP
chr02,Bn4184,90037141,97808458,7771317,RLK
chr02,Bn4185,37472286,68047735,30575449,CNL
chr02,Bn4186,3712881,53042187,49329306,RLP
chr02,Bn4187,28733408,92497236,63763828,RLP
chr02,Bn4188,41740613,56485708,14745095,CNL
chr02,Bn4189,75990954,87361144,11370190,RLP
chr02,Bn4190,95337962,96761464,1423502,RLK
chr02,Bn4191,88228067,97534717,9306650,RLK
chr02,Bn4192,51148406,90409538,39261132,CN
chr02,Bn4193,45227665,80428730,35201065,CNL
chr02,Bn4194,22430021,72981448,50551427,TN
chr02,Bn4195,1655341,66369029,64713688,CN
chr02,Bn4196,63852168,86274962,22422794,TN
chr02,Bn4197,66211511,88393541,22182030,TNL
chr02,Bn4198,46201990,61519248,15317258,NBS
chr02,Bn4199,38490862,87650254,49159392,CNL
chr02,Bn4200,34942274,91517647,56575373,RLK
chr02,Bn4201,35204275,72481842,37277567,CN
chr02,Bn4202,79618634,79734959,116325,TN
chr02,Bn4203,36510435,76569658,40059223,NBS
chr02,Bn4204,15488386,75834590,60346204,CNL
chr02,Bn4205,63540653,80224705,16684052,TN
chr02,Bn4206,8993938,84834804,75840866,CNL
chr02,Bn4207,25206173,87420766,62214593,TNL
chr02,Bn4208,38402838,68249891,29847053,RLP
chr02,Bn4209,75720434,88486912,12766478,NBS
chr02,Bn4210,65330646,94898895,29568249,TN
chr02,Bn4211,70332119,86282898,15950779,TN
chr02,Bn4212,26306269,66664339,40358070,TN
chr02,Bn4213,40449299,41550503,1101204,CNL
chr02,Bn4214,98224490,99721505,1497015,RLK
chr02,Bn4215,59752137,80366339,20614202,RLP
chr02,Bn4216,31094256,48218007,17123751,CNL
chr02,Bn4217,29390084,33534140,4144056,RLP
chr02,Bn4218,54963670,89097061,34133391,CN
chr02,Bn4219,45910257,76299770,30389513,RLK
chr02,Bn4220,57476620,71637816,14161196,TNL
chr02,Bn4221,27168683,28807258,1638575,RLK
chr02,Bn4222,9338738,12307788,2969050,RLP
chr02,Bn4223,25327879,35859357,10531478,TNL
chr02,Bn4224,65208980,75457768,10248788,CN
chr02,Bn4225,86644269,93292565,6648296,CN
chr02,Bn4226,48309772,94400350,46090578,RLK
chr02,Bn4227,70485361,71401779,916418,TN
chr02,Bn4228,79398116,83873663,4475547,CNL
chr02,Bn4229,28913889,49243846,20329957,TNL
chr02,Bn4230,53750274,76182753,22432479,CN
chr02,Bn4231,49862497,82959904,33097407,CNL
chr02,Bn4232,47349812,59143674,11793862,CN
chr02,Bn4233,84756819,97908483,13151664,CNL
chr02,Bn4234,11409333,55503506,44094173,RLP
chr02,Bn4235,10841220,71241417,60400197,TNL
chr02,Bn4236,21888417,39495324,17606907,TNL
chr02,Bn4237,80995356,83908690,2913334,RLK
chr02,Bn4238,35413932,40977331,5563399,NBS
chr02,Bn4239,31276947,46637669,15360722,NBS
chr02,Bn4240,73072996,85973834,12900838,RLK
chr02,Bn4241,21282849,24999119,3716270,NBS
chr02,Bn4242,49130412,73731493,24601081,CNL
chr02,Bn4243,47110362,70146909,23036547,CNL
chr02,Bn4244,22860482,51757952,28897470,CNL
chr02,Bn4245,61040516,97188945,36148429,NBS
chr02,Bn4246,32227733,33186434,958701,CNL
chr02,Bn4247,26599047,51488812,24889765,TNL
chr02,Bn4248,6086947,44747278,38660331,TN
chr02,Bn4249,62364259,82886582,20522323,CN
chr02,Bn4250,38534781,46120579,7585798,CN
chr02,Bn4251,14243821,87232745,72988924,TNL
chr02,Bn4252,40348614,66885207,26536593,CNL
chr02,Bn4253,20342733,23974117,3631384,NBS
chr02,Bn4254,47098773,96574546,49475773,TN
chr02,Bn4255,68788348,74689130,5900782,NBS
chr02,Bn4256,78220754,82259711,4038957,RLP
chr02,Bn4257,12440793,44343126,31902333,NBS
chr02,Bn4258,58028438,65556913,7528475,RLK
chr02,Bn4259,21828509,36022272,14193763,RLP
chr02,Bn4260,26014642,35990520,9975878,TN
chr02,Bn4261,34730639,87892018,53161379,CN
chr02,Bn4262,66252487,71902830,5650343,RLK
chr02,Bn4263,69247859,85885195,16637336,CN
chr02,Bn4264,65453452,83801523,18348071,TNL
chr02,Bn4265,49816221,80327153,30510932,CN
chr02,Bn4266,98950382,99535757,585375,TNL
chr02,Bn4267,59001305,89852216,30850911,NBS
chr02,Bn4268,41754527,67902853,26148326,NBS
chr02,Bn4269,87916387,95257080,7340693,CN
chr02,Bn4270,75774679,78038507,2263828,CN
chr02,Bn4271,90281841,98228418,7946577,TN
chr02,Bn4272,98196313,99333910,1137597,TN
chr02,Bn4273,26021317,30889177,4867860,RLK
chr02,Bn4274,53250544,71739877,18489333,RLP
chr02,Bn4275,14229165,94634653,80405488,CNL
chr02,Bn4276,26433580,57785954,31352374,TNL
chr02,Bn4277,43861972,71340158,27478186,RLP
chr02,Bn4278,81100840,87724924,6624084,RLP
chr02,Bn4279,44612055,75828222,31216167,CN
chr02,Bn4280,22674457,65189168,42514711,RLP
chr02,Bn4281,68536567,84779943,16243376,TN
chr02,Bn4282,50936432,92695898,41759466,NBS
chr02,Bn4283,43673077,76436150,32763073,RLP
chr02,Bn4284,14229680,52647664,38417984,TNL
chr02,Bn4285,3193955,83235585,80041630,CNL
chr02,Bn4286,83984612,94543202,10558590,RLK
chr02,Bn4287,66734769,90418302,23683533,TN
chr02,Bn4288,94779435,97593738,2814303,CNL
chr02,Bn4289,67475014,89976581,22501567,RLK
chr02,Bn4290,92833668,95413916,2580248,TN
chr02,Bn4291,28957436,76110000,47152564,TN
chr02,Bn4292,89344895,96392227,7047332,RLK
chr02,Bn4293,18854274,83119058,64264784,RLK
chr02,Bn4294,25006510,29608498,4601988,TN
chr02,Bn4295,73641033,76974160,3333127,CNL
chr02,Bn4296,6617160,91670901,85053741,TN
chr02,Bn4297,81566382,86198277,4631895,TNL
chr02,Bn4298,38423375,80942190,42518815,NBS
chr02,Bn4299,71946571,87757430,15810859,RLP
chr02,Bn4300,28092128,41094958,13002830,RLK
chr02,Bn4301,50179427,85159689,34980262,CNL
chr02,Bn4302,41392880,55385023,13992143,TN
chr02,Bn4303,87439068,88304705,865637,RLP
chr02,Bn4304,49411461,49914768,503307,NBS
chr02,Bn4305,44395659,51713132,7317473,CNL
chr02,Bn4306,91384718,94799587,3414869,NBS
chr02,Bn4307,37023562,43949429,6925867,CNL
chr02,Bn4308,82096360,90857329,8760969,NBS
chr02,Bn4309,4926375,43063661,38137286,TN
chr02,Bn4310,26505280,74789598,48284318,TN
chr02,Bn4311,57931114,70615751,12684637,RLK
chr02,Bn4312,87870715,87904357,33642,RLK
chr02,Bn4313,46437641,53618961,7181320,CN
chr02,Bn4314,48726610,64724360,15997750,CN
chr02,Bn4315,84387236,88150716,3763480,RLP
chr02,Bn4316,3547228,28647888,25100660,CN
chr02,Bn4317,11990620,51954111,39963491,NBS
chr02,Bn4318,75065986,85004033,9938047,TNL
chr02,Bn4319,17951666,44300182,26348516,RLP
chr02,Bn4320,13014040,54047679,41033639,TNL
chr02,Bn4321,15495295,40874739,25379444,TN
chr02,Bn4322,86853630,87675248,821618,RLP
chr02,Bn4323,16737125,77687368,60950243,RLK
chr02,Bn4324,19246543,87593935,68347392,TN
chr02,Bn4325,72655717,76193534,3537817,RLK
chr02,Bn4326,14246883,83603921,69357038,TN
chr02,Bn4327,92041062,97870911,5829849,TN
chr02,Bn4328,1997651,19861694,17864043,CN
chr02,Bn4329,91321195,94030021,2708826,NBS
chr02,Bn4330,20951470,62861114,41909644,RLK
chr02,Bn4331,39524729,73761707,34236978,NBS
chr02,Bn4332,34235152,78287687,44052535,NBS
chr02,Bn4333,42268218,73201093,30932875,TNL
chr02,Bn4334,66438582,87871347,21432765,CNL
chr02,Bn4335,90454695,91071029,616334,TN
chr02,Bn4336,13328534,29874211,16545677,NBS
chr02,Bn4337,55999855,66376690,10376835,RLP
chr02,Bn4338,90646850,99726214,9079364,TN
chr02,Bn4339,77356572,80960798,3604226,CN
chr02,Bn4340,19516305,65831917,46315612,CNL
chr02,Bn4341,82828326,88190042,5361716,CNL
chr02,Bn4342,78175855,79065318,889463,RLP
chr02,Bn4343,62044788,95643470,33598682,CN
chr02,Bn4344,11451442,25115675,13664233,CNL
chr02,Bn4345,99080050,99083188,3138,TNL
chr02,Bn4346,44202908,56604177,12401269,RLK
chr02,Bn4347,8779224,71299811,62520587,RLP
chr02,Bn4348,53575848,93304093,39728245,TNL
chr02,Bn4349,31554673,82096187,50541514,CNL
chr02,Bn4350,9167270,71268378,62101108,TN
chr02,Bn4351,98809264,99298358,489094,NBS
chr02,Bn4352,69171617,91542471,22370854,CN
chr02,Bn4353,21972736,48467946,26495210,CN
chr02,Bn4354,41285212,73528537,32243325,TN
chr02,Bn4355,67375765,79016469,11640704,TN
chr02,Bn4356,50054584,90876073,40821489,TNL
chr02,Bn4357,46444158,68483253,22039095,RLK
chr02,Bn4358,58087730,86427075,28339345,NBS
chr02,Bn4359,23585098,57399855,33814757,RLK
chr02,Bn4360,72366575,75369776,3003201,CNL
chr02,Bn4361,30689061,71586190,40897129,CN
chr02,Bn4362,74586939,78672231,4085292,RLP
chr02,Bn4363,91840728,99765410,7924682,CN
chr02,Bn4364,81008488,86624799,5616311,CN
chr02,Bn4365,78581428,87777511,9196083,TNL
chr02,Bn4366,86876038,87406973,530935,TN
chr02,Bn4367,4540894,52745093,48204199,TN
chr02,Bn4368,8965693,84899196,75933503,CNL
chr02,Bn4369,67683825,72582772,4898947,RLP
chr02,Bn4370,3184279,7303024,4118745,CNL
chr02,Bn4371,15461633,32940403,17478770,TNL
chr02,Bn4372,37541404,83745672,46204268,TN
chr02,Bn4373,66720319,90735114,24014795,NBS
chr02,Bn4374,98728190,99690101,961911,RLK
chr02,Bn4375,28256317,84312966,56056649,RLK
chr02,Bn4376,59817533,99465367,39647834,RLP
chr02,Bn4377,85823928,93234098,7410170,RLP
chr02,Bn4378,94003430,97119398,3115968,TNL
chr02,Bn4379,25565017,79367939,53802922,TNL
chr02,Bn4380,32874279,69016113,36141834,CNL
chr02,Bn4381,11790002,27335204,15545202,NBS
chr02,Bn4382,1349095,86982750,85633655,TNL
chr02,Bn4383,97322176,99234010,1911834,TN
chr02,Bn4384,4830725,42760143,37929418,TN
chr02,Bn4385,60885707,69142393,8256686,TNL
chr02,Bn4386,43953876,49177027,5223151,CN
chr02,Bn4387,43258643,45948667,2690024,CN
chr02,Bn4388,59220980,74522372,15301392,NBS
chr02,Bn4389,69722895,73264457,3541562,CNL
chr02,Bn4390,96744656,99927471,3182815,TNL
chr02,Bn4391,52701543,96408860,43707317,TN
chr02,Bn4392,38844711,93090108,54245397,RLK
chr02,Bn4393,83193417,92189440,8996023,TNL
chr02,Bn4394,20673529,71386220,50712691,RLP
chr02,Bn4395,2188918,35420161,33231243,CN
chr02,Bn4396,30021258,37455081,7433823,CN
chr02,Bn4397,8485794,75058088,66572294,RLK
chr02,Bn4398,69932506,69934793,2287,RLK
chr02,Bn4399,93859714,95021324,1161610,TN
chr02,Bn4400,18711750,78383157,59671407,NBS
chr02,Bn4401,84508254,85150178,641924,NBS
chr02,Bn4402,93898564,99062737,5164173,RLK
chr02,Bn4403,31584874,40180598,8595724,RLP
chr02,Bn4404,79080169,80875931,1795762,NBS
chr02,Bn4405,88891490,99192738,10301248,RLK
chr02,Bn4406,8590772,27324143,18733371,NBS
chr02,Bn4407,6103490,96697294,90593804,TNL
chr02,Bn4408,98491816,99632389,1140573,CN
chr02,Bn4409,52643241,92258294,39615053,RLP
chr02,Bn4410,85932768,93367806,7435038,RLP
chr02,Bn4411,64321226,81868024,17546798,CN
chr02,Bn4412,1981427,96048947,94067520,NBS
chr02,Bn4413,76857450,95314794,18457344,RLP
chr02,Bn4414,27209249,70298350,43089101,RLP
chr02,Bn4415,71824828,82577240,10752412,TNL
chr02,Bn4416,44452621,54794049,10341428,TN
chr02,Bn4417,73077720,74109107,1031387,RLK
chr02,Bn4418,66133507,99973756,33840249,CN
chr02,Bn4419,35908623,44558166,8649543,RLK
chr02,Bn4420,84244529,84441775,197246,RLP
chr02,Bn4421,82665882,91986098,9320216,CNL
chr02,Bn4422,81707455,92775868,11068413,TNL
chr02,Bn4423,79069294,96447672,17378378,RLP
chr02,Bn4424,74981826,99033653,24051827,CN
chr02,Bn4425,98488579,98970055,481476,CN
chr02,Bn4426,6563509,90836415,84272906,RLK
chr02,Bn4427,47785625,88121524,40335899,RLP
chr02,Bn4428,79399882,89900536,10500654,CNL
chr02,Bn4429,36348973,42581910,6232937,TN
chr02,Bn4430,65690357,81540031,15849674,RLP
chr02,Bn4431,17208469,26106135,8897666,CN
chr02,Bn4432,79535200,86156321,6621121,TNL
chr02,Bn4433,26552979,27350115,797136,RLP
chr02,Bn4434,99479194,99567263,88069,NBS
chr02,Bn4435,76261612,94283501,18021889,CNL
chr02,Bn4436,52157837,85572489,33414652,RLP
chr02,Bn4437,23367067,91019499,67652432,NBS
chr02,Bn4438,61107045,86734282,25627237,TN
chr02,Bn4439,7119968,75901485,68781517,CNL
chr02,Bn4440,98647268,98821005,173737,CNL
chr02,Bn4441,83981297,93380732,9399435,RLP
chr02,Bn4442,18059716,67142393,49082677,TNL
chr02,Bn4443,37927967,87353801,49425834,TN
chr02,Bn4444,96980864,98853516,1872652,NBS
chr02,Bn4445,51978778,89184834,37206056,CNL
chr02,Bn4446,17005505,28943511,11938006,CNL
chr02,Bn4447,54170976,79655870,25484894,NBS
chr02,Bn4448,33446178,72039597,38593419,TNL
chr02,Bn4449,41867461,48084822,6217361,RLP
chr02,Bn4450,11435343,91323942,79888599,CN
chr02,Bn4451,6601018,91896222,85295204,NBS
chr02,Bn4452,25804934,89582038,63777104,RLK
chr02,Bn4453,61210629,87149915,25939286,CNL
chr02,Bn4454,18891641,23955832,5064191,RLP
chr02,Bn4455,67252058,73215243,5963185,CN
chr02,Bn4456,19553223,90759489,71206266,CNL
chr02,Bn4457,46955216,99013917,52058701,CN
chr02,Bn4458,93452106,93612072,159966,CNL
chr02,Bn4459,95834642,98577224,2742582,RLK
chr02,Bn4460,71062767,94411159,23348392,RLP
chr02,Bn4461,45044960,95373957,50328997,TN
chr02,Bn4462,68960151,83011302,14051151,TNL
chr02,Bn4463,6679291,66783958,60104667,RLK
chr02,Bn4464,56339289,99194306,42855017,NBS
chr02,Bn4465,49243034,85059398,35816364,RLP
chr02,Bn4466,39154416,66269181,27114765,RLK
chr02,Bn4467,27388725,88812702,61423977,TNL
chr02,Bn4468,30038714,82364797,52326083,TN
chr02,Bn4469,52708919,92853675,40144756,NBS
chr02,Bn4470,55479350,93638241,38158891,CN
chr02,Bn4471,61884482,68986882,7102400,NBS
chr02,Bn4472,30649242,35515368,4866126,CNL
chr02,Bn4473,90738365,94369761,3631396,CNL
chr02,Bn4474,39479747,77453693,37973946,TNL
chr02,Bn4475,22453742,37848687,15394945,CNL
chr02,Bn4476,92977508,99980409,7002901,RLP
chr02,Bn4477,12968880,76392726,63423846,NBS
chr02,Bn4478,29070280,91554829,62484549,CN
chr02,Bn4479,52892834,56265687,3372853,NBS
chr02,Bn4480,83786737,96297813,12511076,TNL
chr02,Bn4481,52982460,59436080,6453620,TNL
chr02,Bn4482,86034897,98902633,12867736,CN
chr02,Bn4483,91869003,93433355,1564352,RLP
chr02,Bn4484,63104936,77442010,14337074,CNL
chr02,Bn4485,43122561,53855492,10732931,NBS
chr02,Bn4486,73812029,90565885,16753856,TN
chr02,Bn4487,16189571,84262738,68073167,TNL
chr02,Bn4488,58443074,64122213,5679139,RLP
chr02,Bn4489,32207653,37571805,5364152,RLP
chr02,Bn4490,18838054,23305807,4467753,TN
chr02,Bn4491,38467232,86751381,48284149,RLK
chr02,Bn4492,46104344,50801172,4696828,RLP
chr02,Bn4493,98933818,99308963,375145,CN
chr02,Bn4494,48719680,54707459,5987779,CN
chr02,Bn4495,80882356,87329822,6447466,NBS
chr02,Bn4496,54222377,70083517,15861140,RLK
chr02,Bn4497,35598901,69213623,33614722,RLK
chr02,Bn4498,52628782,61790903,9162121,CN
chr02,Bn4499,68387886,91670520,23282634,NBS
chr02,Bn4500,23717198,30104047,6386849,NBS
chr02,Bn4501,62386778,65880490,3493712,TN
chr02,Bn4502,63218400,83672164,20453764,NBS
chr02,Bn4503,22251916,49518167,27266251,TNL
chr02,Bn4504,45140779,77404361,32263582,CN
chr02,Bn4505,63577669,79069870,15492201,TN
chr02,Bn4506,11291504,36363848,25072344,CNL
chr02,Bn4507,34065658,82215702,48150044,RLK
chr02,Bn4508,53606976,74097749,20490773,RLP
chr02,Bn4509,68725242,79015723,10290481,CNL
chr02,Bn4510,90487989,92126579,1638590,NBS
chr02,Bn4511,38251889,43096746,4844857,NBS
chr02,Bn4512,50731960,98152764,47420804,TNL
chr02,Bn4513,49413442,54123420,4709978,TN
chr02,Bn4514,58652375,80189102,21536727,TNL
chr02,Bn4515,87407035,94618092,7211057,CN
chr02,Bn4516,67874872,77532084,9657212,TNL
chr02,Bn4517,60781927,79971162,19189235,CN
chr02,Bn4518,33118871,56774983,23656112,CNL
chr02,Bn4519,68390984,94825325,26434341,RLK
chr02,Bn4520,79663688,94236200,14572512,CNL
chr02,Bn4521,1313065,51021256,49708191,RLK
chr02,Bn4522,97996983,99811179,1814196,TN
chr02,Bn4523,53427233,63584465,10157232,RLP
chr02,Bn4524,6310914,66882336,60571422,CN
chr02,Bn4525,6588624,89358219,82769595,TNL
chr02,Bn4526,53369132,97698846,44329714,CN
chr02,Bn4527,36295351,44968825,8673474,CNL
chr02,Bn4528,45150729,75253781,30103052,NBS
chr02,Bn4529,93717641,96919159,3201518,TN
chr02,Bn4530,94761886,97962850,3200964,RLK
chr02,Bn4531,9751445,67710760,57959315,RLP
chr02,Bn4532,90802493,95665620,4863127,RLK
chr02,Bn4533,43012240,54318238,11305998,NBS
chr02,Bn4534,75668187,77882662,2214475,TN
chr02,Bn4535,98558907,99832047,1273140,NBS
chr02,Bn4536,82150328,99096162,16945834,RLK
chr02,Bn4537,67056499,88768296,21711797,TN
chr02,Bn4538,59920311,74210503,14290192,CN
chr02,Bn4539,48580728,53829583,5248855,CN
chr02,Bn4540,13576439,22977874,9401435,TNL
chr02,Bn4541,4218755,97264983,93046228,RLK
chr02,Bn4542,99661955,99888303,226348,CN
chr02,Bn4543,26821971,57013335,30191364,RLK
chr02,Bn4544,14834272,43210440,28376168,CNL
chr02,Bn4545,30347869,74060627,43712758,TNL
chr02,Bn4546,93698118,98531529,4833411,RLK
chr02,Bn4547,80150775,83301237,3150462,RLK
chr02,Bn4548,3154791,67414183,64259392,CNL
chr02,Bn4549,57579083,61790068,4210985,RLK
chr02,Bn4550,93197976,94627781,1429805,TNL
chr02,Bn4551,52058163,52380324,322161,CNL
chr02,Bn4552,12205413,62811399,50605986,NBS
chr02,Bn4553,62838889,69062209,6223320,TNL
chr02,Bn4554,77051611,92139003,15087392,RLK
chr02,Bn4555,7305388,89720695,82415307,RLK
chr02,Bn4556,43640108,94639156,50999048,RLP
chr02,Bn4557,10139588,88000087,77860499,TNL
chr02,Bn4558,21256913,76999925,55743012,TN
chr02,Bn4559,9316769,75658435,66341666,RLK
chr02,Bn4560,82445267,88810690,6365423,RLK
chr02,Bn4561,84643803,96705867,12062064,TNL
chr02,Bn4562,43977417,82283305,38305888,RLP
chr02,Bn4563,48460543,82719714,34259171,CN
chr02,Bn4564,74287545,87928043,13640498,TNL
chr02,Bn4565,24361798,57549485,33187687,RLP
chr02,Bn4566,42372742,56190081,13817339,TNL
chr02,Bn4567,62289154,71667797,9378643,NBS
chr02,Bn4568,69748561,95293318,25544757,RLK
chr02,Bn4569,56707092,91393601,34686509,RLP
chr02,Bn4570,72522121,75829194,3307073,TN
chr02,Bn4571,74947910,90622393,15674483,RLK
chr02,Bn4572,95163579,97218901,2055322,TNL
chr02,Bn4573,36759702,60962201,24202499,TNL
chr02,Bn4574,71372954,85656650,14283696,TN
chr02,Bn4575,6030079,30328465,24298386,TNL
chr02,Bn4576,41628234,63736711,22108477,TNL
chr02,Bn4577,60135343,85634694,25499351,CN
chr02,Bn4578,74791224,85981142,11189918,TNL
chr02,Bn4579,14519324,84391708,69872384,CN
chr02,Bn4580,47311613,63582259,16270646,TN
chr02,Bn4581,76146405,90349266,14202861,TN
chr02,Bn4582,40172843,87549954,47377111,CN
chr02,Bn4583,56871058,64786205,7915147,RLK
chr02,Bn4584,61122237,94022975,32900738,TN
chr02,Bn4585,16443414,25825678,9382264,NBS
chr02,Bn4586,19749865,24101803,4351938,TNL
chr02,Bn4587,6412723,17659694,11246971,CN
chr02,Bn4588,35443266,43336982,7893716,CN
chr02,Bn4589,46522258,96129894,49607636,CNL
chr02,Bn4590,74280491,91958606,17678115,RLK
chr02,Bn4591,60550521,79693796,19143275,CNL
chr02,Bn4592,27021511,84456412,57434901,NBS
chr02,Bn4593,46154496,93602839,47448343,NBS
chr02,Bn4594,44341899,67873696,23531797,RLP
chr02,Bn4595,60645718,94966190,34320472,CN
chr02,Bn4596,48430561,95837236,47406675,RLP
chr02,Bn4597,3481499,31637678,28156179,CNL
chr02,Bn4598,46891868,89027830,42135962,CNL
chr02,Bn4599,38901665,94463564,55561899,RLK
chr02,Bn4600,89915973,93144184,3228211,CNL
chr02,Bn4601,39244332,61033409,21789077,RLP
chr02,Bn4602,94104821,95651318,1546497,NBS
chr02,Bn4603,41474561,50588627,9114066,RLK
chr02,Bn4604,95706076,98552407,2846331,TN
chr02,Bn4605,8899639,19563893,10664254,TNL
chr02,Bn4606,33644296,35895606,2251310,RLP
chr02,Bn4607,76102523,88508013,12405490,RLK
chr02,Bn4608,44128407,95790520,51662113,RLK
chr02,Bn4609,28619765,35569187,6949422,CN
chr02,Bn4610,69306967,77832146,8525179,CN
chr02,Bn4611,14549842,39942753,25392911,RLP
chr02,Bn4612,92556699,96406855,3850156,TNL
chr02,Bn4613,82931835,90800185,7868350,RLP
chr02,Bn4614,13506119,74764342,61258223,RLK
chr02,Bn4615,43354915,97147338,53792423,NBS
chr02,Bn4616,43788999,80344006,36555007,RLP
chr02,Bn4617,13296290,96485413,83189123,TN
chr02,Bn4618,28135470,94240396,66104926,TNL
chr02,Bn4619,60951924,98446448,37494524,TNL
chr02,Bn4620,90757108,93431270,2674162,RLK
chr02,Bn4621,26204566,85605411,59400845,CNL
chr02,Bn4622,68834417,74680828,5846411,TN
chr02,Bn4623,31284128,90244914,58960786,RLP
chr02,Bn4624,65396231,88421194,23024963,RLP
chr02,Bn4625,15828032,19614486,3786454,CN
chr02,Bn4626,60060712,85244175,25183463,NBS
chr02,Bn4627,38942608,49914539,10971931,RLK
chr02,Bn4628,23813969,32595189,8781220,CNL
chr02,Bn4629,21591340,44060899,22469559,NBS
chr02,Bn4630,14856504,94517737,79661233,CNL
chr02,Bn4631,56568681,66812964,10244283,CN
chr02,Bn4632,2813904,91519394,88705490,RLP
chr02,Bn4633,95918667,99049180,3130513,CNL
chr02,Bn4634,27307561,80988326,53680765,RLP
chr02,Bn4635,11163189,28594823,17431634,RLK
chr02,Bn4636,55694365,85447015,29752650,RLK
chr02,Bn4637,85038031,94016838,8978807,TN
chr02,Bn4638,35493002,77534494,42041492,RLK
chr02,Bn4639,28495112,50401717,21906605,NBS
chr02,Bn4640,44983787,95344552,50360765,CN
chr02,Bn4641,75476156,87754723,12278567,TN
chr02,Bn4642,36801010,44843755,8042745,RLK
chr02,Bn4643,79528707,94084197,14555490,RLP
chr02,Bn4644,45353992,49673619,4319627,CNL
chr02,Bn4645,5557952,77954710,72396758,TN
chr02,Bn4646,77390017,85350802,7960785,NBS
chr02,Bn4647,83417957,95343176,11925219,RLK
chr02,Bn4648,81326997,90894657,9567660,TN
chr02,Bn4649,47417879,91215978,43798099,CNL
chr02,Bn4650,26905234,59343910,32438676,TNL
chr02,Bn4651,62567578,90079674,27512096,CN
chr02,Bn4652,62591168,96515660,33924492,TN
chr02,Bn4653,22452079,61929816,39477737,NBS
chr02,Bn4654,95082431,98977543,3895112,CN
chr02,Bn4655,70286963,72219405,1932442,TN
chr02,Bn4656,46176315,61531648,15355333,TNL
chr02,Bn4657,82678332,94232521,11554189,TN
chr02,Bn4658,66925324,89240819,22315495,RLK
chr02,Bn4659,60430800,72354962,11924162,CNL
chr02,Bn4660,51405328,84997120,33591792,TN
chr02,Bn4661,61268192,93665564,32397372,TNL
chr02,Bn4662,7187869,72801735,65613866,CN
chr02,Bn4663,73845451,76564492,2719041,TNL
chr02,Bn4664,92652760,94378299,1725539,RLK
chr02,Bn4665,83942857,99667832,15724975,RLP
chr02,Bn4666,36145966,68037604,31891638,TNL
chr02,Bn4667,79893365,97265454,17372089,TNL
chr02,Bn4668,91339351,97015850,5676499,NBS
chr02,Bn4669,90924192,93213646,2289454,CN
chr02,Bn4670,6490745,48504426,42013681,CN
chr02,Bn4671,27151172,97643498,70492326,NBS
chr02,Bn4672,21524225,65588934,44064709,TNL
chr02,Bn4673,95601715,96346485,744770,NBS
chr02,Bn4674,42365129,98780080,56414951,CNL
chr02,Bn4675,96949267,98550304,1601037,RLP
chr02,Bn4676,19625832,70253748,50627916,TN
chr02,Bn4677,31083113,33844646,2761533,TNL
chr02,Bn4678,83614769,99085767,15470998,NBS
chr02,Bn4679,48383389,59126647,10743258,CN
chr02,Bn4680,46587506,74214549,27627043,CNL
chr02,Bn4681,93146056,97349493,4203437,CNL
chr02,Bn4682,8968391,93515625,84547234,RLK
chr02,Bn4683,78196877,83860135,5663258,TNL
chr02,Bn4684,71424919,81160726,9735807,RLK
chr02,Bn4685,12745332,40968118,28222786,NBS
chr02,Bn4686,45496255,65570815,20074560,RLP
chr02,Bn4687,8860878,32642846,23781968,TNL
chr02,Bn4688,90182899,99110914,8928015,TN
chr02,Bn4689,10606625,92061017,81454392,RLP
chr02,Bn4690,30850102,69524036,38673934,CN
chr02,Bn4691,50126540,85728089,35601549,RLP
chr02,Bn4692,27469736,90580370,63110634,TN
chr02,Bn4693,82077334,83325569,1248235,NBS
chr02,Bn4694,26109249,50582773,24473524,TNL
chr02,Bn4695,74618021,92109412,17491391,TNL
chr02,Bn4696,44659720,49129121,4469401,NBS
chr02,Bn4697,88661660,97558675,8897015,TNL
chr02,Bn4698,65543947,82538093,16994146,CN
chr02,Bn4699,33182503,49197424,16014921,NBS
chr02,Bn4700,32915414,61223690,28308276,CNL
chr02,Bn4701,51253624,77837980,26584356,CNL
chr02,Bn4702,31430212,75588029,44157817,RLK
chr02,Bn4703,20081369,64875193,44793824,RLP
chr02,Bn4704,33674771,56428953,22754182,RLK
chr02,Bn4705,18175265,56665636,38490371,TNL
chr02,Bn4706,46897111,76712349,29815238,RLK
chr02,Bn4707,72121979,85081150,12959171,RLK
chr02,Bn4708,25887464,51801879,25914415,CN
chr02,Bn4709,77081476,94786208,17704732,NBS
chr02,Bn4710,22306023,45442070,23136047,RLP
chr02,Bn4711,12015093,52401363,40386270,TNL
chr02,Bn4712,17129877,25123015,7993138,RLP
chr02,Bn4713,6290114,78642328,72352214,RLP
chr02,Bn4714,27391225,71308171,43916946,CN
chr02,Bn4715,20166805,29844024,9677219,TNL
chr02,Bn4716,86389054,90303337,3914283,CN
chr02,Bn4717,38463080,77897590,39434510,TN
chr02,Bn4718,69646708,83588029,13941321,CNL
chr02,Bn4719,8988478,38350218,29361740,TN
chr02,Bn4720,23932076,69772139,45840063,TNL
chr02,Bn4721,87428204,98962820,11534616,CNL
chr02,Bn4722,23284562,29796167,6511605,TN
chr02,Bn4723,53755019,73321366,19566347,CNL
chr02,Bn4724,34703819,66007140,31303321,RLK
chr02,Bn4725,90716334,96980651,6264317,NBS
chr02,Bn4726,38781720,87733121,48951401,RLP
chr02,Bn4727,11665616,94296026,82630410,RLK
chr02,Bn4728,87436921,94635131,7198210,NBS
chr02,Bn4729,51646357,62689876,11043519,RLK
chr02,Bn4730,65898826,88238781,22339955,RLK
chr02,Bn4731,10089931,15644892,5554961,TNL
chr02,Bn4732,89969288,94019910,4050622,TNL
chr02,Bn4733,97852817,98806516,953699,CN
chr02,Bn4734,30193475,90472617,60279142,TN
chr02,Bn4735,78090727,99939215,21848488,TN
chr02,Bn4736,41080641,79160608,38079967,TN
chr02,Bn4737,91637800,94498144,2860344,NBS
chr02,Bn4738,9016837,25040385,16023548,RLK
chr02,Bn4739,96319337,96822611,503274,CN
chr02,Bn4740,64452338,65360221,907883,NBS
chr02,Bn4741,71073068,93199441,22126373,NBS
chr02,Bn4742,98933721,99312031,378310,TNL
chr02,Bn4743,53137007,71426975,18289968,RLP
chr02,Bn4744,80495232,80996822,501590,CNL
chr02,Bn4745,45208760,99145961,53937201,RLP
chr02,Bn4746,60777797,99510961,38733164,CN
chr02,Bn4747,66202148,96669025,30466877,RLK
chr02,Bn4748,23398277,87076082,63677805,RLP
chr02,Bn4749,81522524,87638991,6116467,TNL
chr02,Bn4750,60444234,63601112,3156878,CN
chr02,Bn4751,40838935,91831528,50992593,CN
chr02,Bn4752,2969829,81196511,78226682,NBS
chr02,Bn4753,4324913,94128490,89803577,TN
chr02,Bn4754,39462573,96935047,57472474,NBS
chr02,Bn4755,63592344,64414588,822244,CNL
chr02,Bn4756,91120445,91598580,478135,TNL
chr02,Bn4757,53071974,96793645,43721671,RLK
chr02,Bn4758,69490390,73264856,3774466,RLP
chr02,Bn4759,50615005,69101451,18486446,NBS
chr02,Bn4760,4298456,65166581,60868125,CN
chr02,Bn4761,85174168,98253795,13079627,RLP
chr02,Bn4762,55136795,79826543,24689748,RLK
chr02,Bn4763,69233798,89455525,20221727,CN
chr02,Bn4764,80080216,96458312,16378096,RLP
chr02,Bn4765,84703677,86331297,1627620,CN
chr02,Bn4766,30903832,52242574,21338742,NBS
chr02,Bn4767,25747788,59608482,33860694,CN
chr02,Bn4768,10207042,71054525,60847483,CNL
chr02,Bn4769,97494259,98683022,1188763,TN
chr02,Bn4770,47375231,51104232,3729001,RLK
chr02,Bn4771,15120848,17975003,2854155,CN
chr02,Bn4772,10943351,33482214,22538863,TNL
chr02,Bn4773,94212906,95956142,1743236,CNL
chr02,Bn4774,49485294,68118447,18633153,RLK
chr02,Bn4775,66967228,68579055,1611827,TNL
chr02,Bn4776,43982076,54341486,10359410,CNL
chr02,Bn4777,83965047,95242146,11277099,RLP
chr02,Bn4778,98482760,98829384,346624,TN
chr02,Bn4779,39982474,41352642,1370168,RLK
chr02,Bn4780,65158974,94098201,28939227,TN
chr02,Bn4781,26588857,54919291,28330434,RLK
chr02,Bn4782,25121230,34708045,9586815,TN
chr02,Bn4783,52277282,91172835,38895553,CNL
chr02,Bn4784,20303594,22309985,2006391,TNL
chr02,Bn4785,81472727,88953842,7481115,NBS
chr02,Bn4786,93716739,94909560,1192821,CN
chr02,Bn4787,86616955,99870330,13253375,RLK
chr02,Bn4788,74656903,85700036,11043133,NBS
chr02,Bn4789,90624534,96276560,5652026,NBS
chr02,Bn4790,79087965,97070671,17982706,TN
chr02,Bn4791,50660973,72718470,22057497,CN
chr02,Bn4792,77682292,88158644,10476352,TNL
chr02,Bn4793,55208962,86640858,31431896,NBS
chr02,Bn4794,27442915,43985533,16542618,CNL
chr02,Bn4795,31274178,96227848,64953670,RLK
chr02,Bn4796,13297566,42109555,28811989,RLP
chr02,Bn4797,79307278,91037382,11730104,RLK
chr02,Bn4798,41692477,78006870,36314393,CNL
chr02,Bn4799,7911290,21907261,13995971,TNL
chr02,Bn4800,96063709,96579319,515610,CNL
chr02,Bn4801,59809635,63758030,3948395,RLK
chr02,Bn4802,15667026,92828608,77161582,NBS
chr02,Bn4803,94223810,97844127,3620317,RLP
chr02,Bn4804,15638719,43373314,27734595,CN
chr02,Bn4805,23608148,74828166,51220018,TN
chr02,Bn4806,8358010,94910982,86552972,CN
chr02,Bn4807,56407989,67956510,11548521,RLK
chr02,Bn4808,88321676,93167162,4845486,RLK
chr02,Bn4809,99344086,99629138,285052,RLK
chr02,Bn4810,51490228,59146299,7656071,RLK
chr02,Bn4811,42110637,63020978,20910341,CNL
chr02,Bn4812,24395918,89615523,65219605,CNL
chr02,Bn4813,78526141,98990184,20464043,TNL
chr02,Bn4814,9841086,17870571,8029485,RLK
chr02,Bn4815,69716525,90052246,20335721,TNL
chr02,Bn4816,86635345,98438021,11802676,CN
chr02,Bn4817,4213875,83850008,79636133,TN
chr02,Bn4818,66323189,78911614,12588425,NBS
chr02,Bn4819,88610302,93128128,4517826,CNL
chr02,Bn4820,27483659,51856692,24373033,TN
chr02,Bn4821,80815136,81321629,506493,CNL
chr02,Bn4822,39501436,46977156,7475720,CNL
chr02,Bn4823,80996102,86675352,5679250,TNL
chr02,Bn4824,73191174,84594453,11403279,NBS
chr02,Bn4825,57713981,96584967,38870986,TNL
chr02,Bn4826,40422007,61538706,21116699,NBS
chr02,Bn4827,59266680,85233802,25967122,TNL
chr02,Bn4828,28101709,66986021,38884312,CNL
chr02,Bn4829,33348877,73066214,39717337,RLP
chr02,Bn4830,59356032,78019370,18663338,RLK
chr02,Bn4831,20245811,29436382,9190571,RLK
chr02,Bn4832,3406058,65193358,61787300,TN
chr02,Bn4833,47243612,52022092,4778480,CN
chr02,Bn4834,38620086,70683647,32063561,TNL
chr02,Bn4835,58307723,66959876,8652153,TN
chr02,Bn4836,47905842,76601402,28695560,RLK
chr02,Bn4837,72596783,76768890,4172107,NBS
chr02,Bn4838,80776146,92856067,12079921,RLP
chr02,Bn4839,74271120,94190128,19919008,RLP
chr02,Bn4840,86284758,90213089,3928331,RLK
chr02,Bn4841,10211030,66538845,56327815,CN
chr02,Bn4842,63194305,66736059,3541754,RLP
chr02,Bn4843,74319687,82370390,8050703,CNL
chr02,Bn4844,76262289,88434602,12172313,CNL
chr02,Bn4845,64700551,85647552,20947001,CNL
chr02,Bn4846,80031216,80070065,38849,CN
chr02,Bn4847,76920959,81054318,4133359,CN
chr02,Bn4848,24308041,80004171,55696130,RLP
chr02,Bn4849,61973733,70343971,8370238,CN
chr02,Bn4850,46517662,82894036,36376374,CNL
chr02,Bn4851,22929755,59156920,36227165,TNL
chr02,Bn4852,97576917,98731608,1154691,CN
chr02,Bn4853,40055750,57018116,16962366,NBS
chr02,Bn4854,35817729,77018907,41201178,RLP
chr02,Bn4855,98954851,99103765,148914,RLP
chr02,Bn4856,29701790,50820115,21118325,CN
chr02,Bn4857,93251241,95839690,2588449,TN
chr02,Bn4858,21984326,57947320,35962994,RLP
chr02,Bn4859,1260827,60496134,59235307,RLK
chr02,Bn4860,76181899,91630559,15448660,RLK
chr02,Bn4861,55327719,85307920,29980201,CN
chr02,Bn4862,11356662,32519822,21163160,TN
chr02,Bn4863,65166160,99687461,34521301,RLK
chr02,Bn4864,17316170,90965346,73649176,TNL
chr02,Bn4865,60766642,67732259,6965617,TN
chr02,Bn4866,42126622,89951678,47825056,CNL
chr02,Bn4867,38649840,38675970,26130,RLP
chr02,Bn4868,32989902,52472569,19482667,CN
chr02,Bn4869,45979710,55727405,9747695,TN
chr02,Bn4870,48732317,89548073,40815756,RLP
chr02,Bn4871,90205773,98333846,8128073,RLK
chr02,Bn4872,86639334,97190754,10551420,CNL
chr02,Bn4873,58279858,80409332,22129474,TNL
chr02,Bn4874,7356204,83648679,76292475,CN
chr02,Bn4875,43687846,76243730,32555884,CNL
chr02,Bn4876,30204814,45094029,14889215,NBS
chr02,Bn4877,12313053,27772586,15459533,TNL
chr02,Bn4878,88638743,96360667,7721924,RLK
chr02,Bn4879,42548356,80158203,37609847,RLK
chr02,Bn4880,52535074,56011088,3476014,RLK
chr02,Bn4881,99107045,99829156,722111,RLK
chr02,Bn4882,14728825,70707444,55978619,CNL
chr02,Bn4883,56248729,93458180,37209451,RLK
chr02,Bn4884,15990582,67074282,51083700,NBS
chr02,Bn4885,52483554,93707496,41223942,RLP
chr02,Bn4886,72339740,99365113,27025373,RLP
chr02,Bn4887,11538629,40459060,28920431,NBS
chr02,Bn4888,13369753,56531812,43162059,CN
chr02,Bn4889,67165128,91082179,23917051,CNL
chr02,Bn4890,74325378,82438143,8112765,CNL
chr02,Bn4891,78421977,82071824,3649847,TN
chr02,Bn4892,91375500,92180872,805372,TN
chr02,Bn4893,63819604,82649213,18829609,TN
chr02,Bn4894,13295069,81949325,68654256,TNL
chr02,Bn4895,51847360,75596368,23749008,RLP
chr02,Bn4896,75297101,81837745,6540644,CNL
chr02,Bn4897,61020555,88032265,27011710,RLP
chr02,Bn4898,66201847,66586693,384846,TNL
chr02,Bn4899,23121467,77292592,54171125,RLK
chr02,Bn4900,96360613,99044879,2684266,RLK
chr02,Bn4901,42281796,85548845,43267049,CN
chr02,Bn4902,4931629,91121553,86189924,CNL
chr02,Bn4903,57801739,95444320,37642581,RLP
chr02,Bn4904,84288197,96236237,11948040,NBS
chr02,Bn4905,20469050,34341013,13871963,RLP
chr02,Bn4906,1029024,50802690,49773666,NBS
chr02,Bn4907,25567908,82346552,56778644,RLK
chr02,Bn4908,16030506,19681342,3650836,CN
chr02,Bn4909,72917279,76235423,3318144,NBS
chr02,Bn4910,5153254,48849771,43696517,RLP
chr02,Bn4911,82496000,91037581,8541581,NBS
chr02,Bn4912,14147705,18829726,4682021,RLK
chr02,Bn4913,83827410,91437218,7609808,CNL
chr02,Bn4914,50353934,82256970,31903036,RLK
chr02,Bn4915,17556449,95715107,78158658,TNL
chr02,Bn4916,48311805,55765053,7453248,TN
chr02,Bn4917,42832091,45120731,2288640,CNL
chr02,Bn4918,51039454,89804321,38764867,NBS
chr02,Bn4919,28052310,53276754,25224444,CN
chr02,Bn4920,32281388,67357248,35075860,CN
chr02,Bn4921,95683863,96498204,814341,CNL
chr02,Bn4922,84733913,97297254,12563341,RLK
chr02,Bn4923,27172761,58974517,31801756,TNL
chr02,Bn4924,26388860,72453357,46064497,RLK
chr02,Bn4925,49577241,87674414,38097173,TN
chr02,Bn4926,91668204,94751544,3083340,RLP
chr02,Bn4927,90401410,95944424,5543014,RLK
chr02,Bn4928,55434898,55755034,320136,TNL
chr02,Bn4929,21814287,49269955,27455668,TN
chr02,Bn4930,33386538,85622899,52236361,TN
chr02,Bn4931,31961346,92770643,60809297,RLP
chr02,Bn4932,43493603,69397513,25903910,TNL
chr02,Bn4933,99005173,99465247,460074,CN
chr02,Bn4934,80724104,89977335,9253231,TN
chr02,Bn4935,38877729,79533123,40655394,NBS
chr02,Bn4936,66198988,93056275,26857287,RLK
chr02,Bn4937,6747751,37617847,30870096,TN
chr02,Bn4938,52495217,83026615,30531398,RLK
chr02,Bn4939,78045074,79717885,1672811,RLP
chr02,Bn4940,86563087,92766533,6203446,RLP
chr02,Bn4941,86485684,95559039,9073355,RLK
chr02,Bn4942,20756983,31667114,10910131,TNL
chr02,Bn4943,7609338,40965049,33355711,TN
chr02,Bn4944,38874695,80407331,41532636,RLP
chr02,Bn4945,49024103,78821368,29797265,CNL
chr02,Bn4946,76309355,95225002,18915647,NBS
chr02,Bn4947,97010853,97241649,230796,CNL
chr02,Bn4948,31129948,87813332,56683384,TN
chr02,Bn4949,29816407,52690652,22874245,TN
chr02,Bn4950,36684844,77024887,40340043,RLP
chr02,Bn4951,79297691,99440044,20142353,RLK
chr02,Bn4952,80459678,87039779,6580101,CNL
chr02,Bn4953,78622323,94233876,15611553,TNL
chr02,Bn4954,79639350,96620344,16980994,CNL
chr02,Bn4955,56152403,97169997,41017594,NBS
chr02,Bn4956,37270016,80020984,42750968,NBS
chr02,Bn4957,25462074,55191225,29729151,CNL
chr02,Bn4958,7943486,84627078,76683592,TN
chr02,Bn4959,35116676,58473904,23357228,RLK
chr02,Bn4960,24829963,52292050,27462087,CN
chr02,Bn4961,42446914,58077996,15631082,RLP
chr02,Bn4962,79906955,95482693,15575738,RLK
chr02,Bn4963,64746836,68445602,3698766,TN
chr02,Bn4964,40477790,81376917,40899127,RLP
chr02,Bn4965,3360171,5704763,2344592,TNL
chr02,Bn4966,2305950,85509143,83203193,TN
chr02,Bn4967,19143357,62515467,43372110,CNL
chr02,Bn4968,41267252,94487469,53220217,NBS
chr02,Bn4969,51351116,99686578,48335462,CN
chr02,Bn4970,19296673,35186774,15890101,NBS
chr02,Bn4971,53432825,59469300,6036475,NBS
chr02,Bn4972,8069680,61498592,53428912,CNL
chr02,Bn4973,20947956,44506935,23558979,RLP
chr02,Bn4974,22625292,34900164,12274872,NBS
chr02,Bn4975,37032794,60332097,23299303,TN
chr02,Bn4976,93436095,99973771,6537676,NBS
chr02,Bn4977,3609859,60191193,56581334,RLP
chr02,Bn4978,50765754,81676641,30910887,RLK
chr02,Bn4979,33936304,85514179,51577875,CNL
chr02,Bn4980,78177475,85090398,6912923,NBS
chr02,Bn4981,88688167,91432836,2744669,RLP
chr02,Bn4982,97360425,99892766,2532341,TN
chr02,Bn4983,23167611,59220984,36053373,NBS
chr02,Bn4984,18694967,65002056,46307089,RLP
chr02,Bn4985,19333953,73759975,54426022,RLK
chr02,Bn4986,27367607,30561886,3194279,TNL
chr02,Bn4987,20152574,20304821,152247,TNL
chr02,Bn4988,94430998,99776759,5345761,CN
chr02,Bn4989,69735648,82835321,13099673,NBS
chr02,Bn4990,24530603,56035853,31505250,CNL
chr02,Bn4991,28563441,48481488,19918047,RLK
chr02,Bn4992,60347447,88722262,28374815,RLK
chr02,Bn4993,93344040,97606155,4262115,TN
chr02,Bn4994,69762691,74047610,4284919,TNL
chr02,Bn4995,3312238,45987464,42675226,CN
chr02,Bn4996,26050843,58754469,32703626,TN
chr02,Bn4997,39645550,71013913,31368363,RLK
chr02,Bn4998,32775428,49161418,16385990,TNL
chr02,Bn4999,40178888,63866453,23687565,TN
chr02,Bn5000,93561709,96808606,3246897,CN
chr02,Bn5001,41169978,58551633,17381655,TNL
chr02,Bn5002,48074180,70437231,22363051,CNL
chr02,Bn5003,97808291,99585738,1777447,RLK
chr02,Bn5004,46948651,86459123,39510472,CNL
chr02,Bn5005,15775409,38767683,22992274,RLP
chr02,Bn5006,34879545,75380054,40500509,RLK
chr02,Bn5007,45695870,53928838,8232968,TN
chr02,Bn5008,29319986,82872841,53552855,CN
chr02,Bn5009,81827943,99589470,17761527,RLP
chr02,Bn5010,46823744,88471059,41647315,RLK
chr02,Bn5011,74624542,83896449,9271907,CN
chr02,Bn5012,33883653,70150000,36266347,CN
chr02,Bn5013,99150205,99762963,612758,RLK
chr02,Bn5014,32815699,65115705,32300006,CN
chr02,Bn5015,15443566,82893973,67450407,CN
chr02,Bn5016,82516560,86009315,3492755,TNL
chr02,Bn5017,23755731,92032806,68277075,TN
chr02,Bn5018,8198701,78240967,70042266,RLP
chr02,Bn5019,69365423,76530536,7165113,CN
chr02,Bn5020,3585973,8506745,4920772,CN
chr02,Bn5021,16816912,38523620,21706708,CNL
chr02,Bn5022,36593047,59006090,22413043,RLK
chr02,Bn5023,31878675,85003891,53125216,TNL
chr02,Bn5024,30297139,89508507,59211368,TNL
chr02,Bn5025,52687502,73479544,20792042,NBS
chr02,Bn5026,1915904,31538752,29622848,CNL
chr02,Bn5027,21753005,72250856,50497851,TN
chr02,Bn5028,46881743,76859499,29977756,CN
chr02,Bn5029,39732359,52459776,12727417,TN
chr02,Bn5030,45660627,97841566,52180939,CNL
chr02,Bn5031,12281578,50176664,37895086,CNL
chr02,Bn5032,64450533,96146397,31695864,TNL
chr02,Bn5033,29659580,30572765,913185,TNL
chr02,Bn5034,40880980,56354452,15473472,TNL
chr02,Bn5035,64983520,87789592,22806072,RLP
chr02,Bn5036,26302433,73603337,47300904,RLK
chr02,Bn5037,87151505,90173598,3022093,NBS
chr02,Bn5038,98596758,99034540,437782,CN
chr02,Bn5039,99754910,99814222,59312,CN
chr02,Bn5040,23349938,29670897,6320959,CN
chr02,Bn5041,27221083,86345263,59124180,CN
chr02,Bn5042,45226735,78436308,33209573,RLP
chr02,Bn5043,91812744,97392259,5579515,CNL
chr02,Bn5044,51665975,71642198,19976223,TNL
chr02,Bn5045,64522875,73706339,9183464,RLP
chr02,Bn5046,11204092,95968911,84764819,RLK
chr02,Bn5047,62725046,75040333,12315287,RLP
chr02,Bn5048,8685966,60226384,51540418,CN
chr02,Bn5049,81472813,89289244,7816431,CNL
chr02,Bn5050,53714301,64202465,10488164,TN
chr02,Bn5051,90238989,98500480,8261491,TN
chr02,Bn5052,32089338,34284713,2195375,RLK
chr02,Bn5053,58107568,77689006,19581438,RLK
chr02,Bn5054,64239813,79285918,15046105,NBS
chr02,Bn5055,18208524,50107707,31899183,NBS
chr02,Bn5056,16369942,16908523,538581,TN
chr02,Bn5057,36480294,72375009,35894715,CN
chr02,Bn5058,19890898,49286389,29395491,TN
chr02,Bn5059,66642122,94167189,27525067,NBS
chr02,Bn5060,70889370,85000455,14111085,RLK
chr02,Bn5061,89944650,91968126,2023476,CN
chr02,Bn5062,34078382,93554340,59475958,NBS
chr02,Bn5063,1384667,50825018,49440351,TNL
chr02,Bn5064,44709902,74276874,29566972,CN
chr02,Bn5065,54671575,83462197,28790622,CN
chr02,Bn5066,60634703,74269543,13634840,RLP
chr02,Bn5067,6380986,87774124,81393138,TNL
chr02,Bn5068,35509493,78573867,43064374,CN
chr02,Bn5069,79074933,91348058,12273125,TN
chr02,Bn5070,46965199,73064079,26098880,RLK
chr02,Bn5071,39480695,53088282,13607587,RLP
chr02,Bn5072,48762529,87462315,38699786,RLK
chr02,Bn5073,83357561,98497231,15139670,CN
chr02,Bn5074,33827142,68095097,34267955,RLP
chr02,Bn5075,73773491,92057854,18284363,RLK
chr02,Bn5076,74413795,93270861,18857066,CN
chr02,Bn5077,7825840,56547100,48721260,CNL
chr02,Bn5078,19498194,39577260,20079066,TNL
chr02,Bn5079,25552054,29639098,4087044,CNL
chr02,Bn5080,22905069,75951044,53045975,RLK
chr02,Bn5081,84975296,85948757,973461,CN
chr02,Bn5082,93060818,96473177,3412359,TN
chr02,Bn5083,67638292,75695370,8057078,RLP
chr02,Bn5084,78098633,90026528,11927895,RLP
chr02,Bn5085,23569104,32956826,9387722,TNL
chr02,Bn5086,25353958,82404185,57050227,RLP
chr02,Bn5087,6323028,11249662,4926634,NBS
chr02,Bn5088,90606827,99856073,9249246,RLP
chr02,Bn5089,30678180,65570795,34892615,TNL
chr02,Bn5090,56700035,61938940,5238905,TNL
chr02,Bn5091,11395401,61551637,50156236,NBS
chr02,Bn5092,45468184,51431506,5963322,CN
chr02,Bn5093,63018652,81232245,18213593,TNL
chr02,Bn5094,59795259,99797400,40002141,RLK
chr02,Bn5095,70853145,78620518,7767373,TN
chr02,Bn5096,68209541,76557042,8347501,TN
chr02,Bn5097,72624180,98038385,25414205,RLK
chr02,Bn5098,73747783,78509038,4761255,CN
chr02,Bn5099,26748177,44111185,17363008,CN
chr02,Bn5100,12969927,38275783,25305856,TNL
chr02,Bn5101,91355869,99593418,8237549,RLP
chr02,Bn5102,56723551,91433648,34710097,RLK
chr02,Bn5103,48689598,67485013,18795415,TN
chr02,Bn5104,10481214,44892470,34411256,CNL
chr02,Bn5105,48963928,91600679,42636751,NBS
chr02,Bn5106,24670187,79705423,55035236,CNL
chr02,Bn5107,17673603,43962479,26288876,NBS
chr02,Bn5108,49663376,52252660,2589284,NBS
chr02,Bn5109,91115994,97866104,6750110,NBS
chr02,Bn5110,15775873,87051729,71275856,NBS
chr02,Bn5111,91395366,92740433,1345067,RLP
chr02,Bn5112,94888882,96985110,2096228,CN
chr02,Bn5113,97094670,97687810,593140,CN
chr02,Bn5114,55724345,57521021,1796676,RLK
chr02,Bn5115,86379772,89228880,2849108,TNL
chr02,Bn5116,68838574,88460879,19622305,CNL
chr02,Bn5117,59988770,73097066,13108296,TNL
chr02,Bn5118,38236707,65172894,26936187,RLP
chr02,Bn5119,92935714,95265156,2329442,RLK
chr02,Bn5120,31339875,96145256,64805381,NBS
chr02,Bn5121,38999198,70647165,31647967,TN
chr02,Bn5122,64719553,89564222,24844669,TN
chr02,Bn5123,60735280,83921853,23186573,RLP
chr02,Bn5124,93098812,94761179,1662367,RLP
chr02,Bn5125,33361481,96500903,63139422,CNL
chr02,Bn5126,30963293,89030720,58067427,CN
chr02,Bn5127,77184982,98375873,21190891,RLK
chr02,Bn5128,40555890,48060528,7504638,NBS
chr02,Bn5129,39058989,93103212,54044223,CN
chr02,Bn5130,77066782,86689666,9622884,RLP
chr02,Bn5131,94514751,94868495,353744,NBS
chr02,Bn5132,42538025,82267323,39729298,CN
chr02,Bn5133,14500259,40633664,26133405,CNL
chr02,Bn5134,73725992,76242244,2516252,CN
chr02,Bn5135,52524135,61052518,8528383,RLK
chr02,Bn5136,85809291,99425731,13616440,NBS
chr02,Bn5137,88053199,90960873,2907674,TNL
chr02,Bn5138,56983672,75766668,18782996,CN
chr02,Bn5139,31983621,43463288,11479667,TNL
chr02,Bn5140,23807623,33689230,9881607,CNL
chr02,Bn5141,97696398,98490962,794564,RLP
chr02,Bn5142,67153897,89981710,22827813,RLK
chr02,Bn5143,68080772,81477047,13396275,TN
chr02,Bn5144,49058718,56677067,7618349,TNL
chr02,Bn5145,41264905,90717126,49452221,TNL
chr02,Bn5146,85054529,93373330,8318801,NBS
chr02,Bn5147,68092319,77313557,9221238,CN
chr02,Bn5148,45307363,52137243,6829880,CN
chr02,Bn5149,47724595,80798164,33073569,TNL
chr02,Bn5150,93613670,94476926,863256,TN
chr02,Bn5151,35192362,78436724,43244362,CNL
chr02,Bn5152,9754082,82697683,72943601,CN
chr02,Bn5153,81793960,86834842,5040882,RLP
chr02,Bn5154,82899061,87226632,4327571,CNL
chr02,Bn5155,14283691,85853825,71570134,RLP
chr02,Bn5156,34527752,45778682,11250930,TN
chr02,Bn5157,84090741,99841954,15751213,TNL
chr02,Bn5158,77204304,85333263,8128959,RLK
chr02,Bn5159,25308471,63239461,37930990,CN
chr02,Bn5160,35838338,55805121,19966783,CNL
chr02,Bn5161,96680113,99695879,3015766,RLP
chr02,Bn5162,72466248,76435935,3969687,RLP
chr02,Bn5163,75033235,80094060,5060825,RLK
chr02,Bn5164,15290336,49060362,33770026,NBS
chr02,Bn5165,62228629,71882528,9653899,CN
chr02,Bn5166,3858811,87585851,83727040,CNL
chr02,Bn5167,23362101,44853518,21491417,CN
chr02,Bn5168,45724931,65985228,20260297,TNL
chr02,Bn5169,43355776,74413177,31057401,RLK
chr02,Bn5170,18332933,18843215,510282,RLK
chr02,Bn5171,70656234,76075934,5419700,RLP
chr02,Bn5172,44254735,65990828,21736093,TN
chr02,Bn5173,94270730,95249070,978340,NBS
chr02,Bn5174,12080956,59778760,47697804,TN
chr02,Bn5175,69765667,74536497,4770830,TN
chr02,Bn5176,35931599,77008003,41076404,RLP
chr02,Bn5177,42545243,87024096,44478853,RLP
chr02,Bn5178,83563210,88565209,5001999,RLP
chr02,Bn5179,83196821,97582988,14386167,RLK
chr02,Bn5180,6908354,39955649,33047295,TN
chr02,Bn5181,1094246,74186792,73092546,RLP
chr02,Bn5182,94364253,94454899,90646,CNL
chr02,Bn5183,41612791,68211553,26598762,RLK
chr02,Bn5184,43950338,94846081,50895743,CN
chr02,Bn5185,97810933,98377954,567021,CN
chr02,Bn5186,86928822,99511464,12582642,RLP
chr02,Bn5187,30058317,89364787,59306470,CN
chr02,Bn5188,56481905,81499020,25017115,CN
chr02,Bn5189,17574790,46987120,29412330,NBS
chr02,Bn5190,19884635,74924185,55039550,CNL
chr02,Bn5191,91380449,99774726,8394277,NBS
chr02,Bn5192,67749200,96808521,29059321,RLP
chr02,Bn5193,61495700,99650763,38155063,RLP
chr02,Bn5194,59754479,62087287,2332808,TNL
chr02,Bn5195,86324536,91936010,5611474,RLK
chr02,Bn5196,42850990,50028207,7177217,CNL
chr02,Bn5197,25026521,69167727,44141206,TN
chr02,Bn5198,59877478,87014628,27137150,CN
chr02,Bn5199,49184459,58592970,9408511,TN
chr02,Bn5200,14344092,42835486,28491394,RLK
chr02,Bn5201,1261064,79633367,78372303,NBS
chr02,Bn5202,51544074,94818817,43274743,NBS
chr02,Bn5203,22219597,84719443,62499846,CNL
chr02,Bn5204,89412971,90283318,870347,TN
chr02,Bn5205,46382409,79847126,33464717,CN
chr02,Bn5206,46829962,65531056,18701094,TN
chr02,Bn5207,63519651,71785708,8266057,RLP
chr02,Bn5208,87486304,99944667,12458363,TN
chr02,Bn5209,21732310,74013746,52281436,CN
chr02,Bn5210,44095974,84636025,40540051,TN
chr02,Bn5211,61879232,70165186,8285954,NBS
chr02,Bn5212,64952133,85813392,20861259,NBS
chr02,Bn5213,7985404,92024818,84039414,TN
chr02,Bn5214,24747961,65023478,40275517,TNL
chr02,Bn5215,1943233,32840231,30896998,RLK
chr02,Bn5216,27218059,42746285,15528226,CNL
chr02,Bn5217,63066547,89360617,26294070,NBS
chr02,Bn5218,12022249,24127109,12104860,TNL
chr02,Bn5219,43223877,63389328,20165451,TN
chr02,Bn5220,86946128,90073554,3127426,RLP
chr02,Bn5221,40574593,70617015,30042422,RLP
chr02,Bn5222,82519804,93892441,11372637,CN
chr02,Bn5223,33673339,97479771,63806432,RLK
chr02,Bn5224,4577066,88358831,83781765,TNL
chr02,Bn5225,61331511,82820411,21488900,TNL
chr02,Bn5226,94640616,95598065,957449,RLP
chr02,Bn5227,51197215,55754800,4557585,CN
chr02,Bn5228,7075095,98589326,91514231,CNL
chr02,Bn5229,17189554,72582620,55393066,RLP
chr02,Bn5230,76227293,78396039,2168746,NBS
chr02,Bn5231,92580592,99897470,7316878,NBS
chr02,Bn5232,17493791,25047618,7553827,NBS
chr02,Bn5233,16260673,50113912,33853239,TN
chr02,Bn5234,90090806,93697454,3606648,CN
chr02,Bn5235,16486819,88707553,72220734,TNL
chr02,Bn5236,52547071,55840015,3292944,TNL
chr02,Bn5237,86213558,99880327,13666769,RLK
chr02,Bn5238,63504814,90780024,27275210,CNL
chr02,Bn5239,83472421,86953468,3481047,CN
chr02,Bn5240,79308376,87121770,7813394,CNL
chr02,Bn5241,17707651,73363559,55655908,CN
chr02,Bn5242,12728052,41978788,29250736,TNL
chr02,Bn5243,84571983,97194628,12622645,RLP
chr02,Bn5244,62833607,78819493,15985886,TNL
chr02,Bn5245,95061689,95461192,399503,RLK
chr02,Bn5246,65910454,66519842,609388,TNL
chr02,Bn5247,76652290,99344213,22691923,TN
chr02,Bn5248,36659977,56101203,19441226,CNL
chr02,Bn5249,62797469,62805045,7576,TN
chr02,Bn5250,98726484,99830825,1104341,TN
chr02,Bn5251,42431660,53016782,10585122,TNL
chr02,Bn5252,65473173,80010864,14537691,RLK
chr02,Bn5253,50005599,99512625,49507026,TN
chr02,Bn5254,3329866,51641299,48311433,RLK
chr02,Bn5255,61448552,73260959,11812407,CNL
chr02,Bn5256,23377759,58160260,34782501,RLP
chr02,Bn5257,70317097,80115021,9797924,CNL
chr02,Bn5258,67144872,79108351,11963479,CNL
chr02,Bn5259,7560691,46661808,39101117,NBS
chr02,Bn5260,36523764,79070300,42546536,CN
chr02,Bn5261,32964902,83252024,50287122,TNL
chr02,Bn5262,85120814,92243607,7122793,CN
chr02,Bn5263,88757951,94800418,6042467,TN
chr02,Bn5264,42507971,84543821,42035850,NBS
chr02,Bn5265,78263669,86998615,8734946,NBS
chr02,Bn5266,26352603,88837261,62484658,TN
chr02,Bn5267,71439256,87482633,16043377,TN
chr02,Bn5268,11788113,61554408,49766295,CN
chr02,Bn5269,97278144,99347386,2069242,CNL
chr02,Bn5270,19428633,92953039,73524406,TNL
chr02,Bn5271,22343109,78689633,56346524,TNL
chr02,Bn5272,38231685,66177911,27946226,TNL
chr02,Bn5273,22196870,64781221,42584351,CN
chr02,Bn5274,53218571,72812279,19593708,NBS
chr02,Bn5275,87225912,97330171,10104259,TNL
chr02,Bn5276,87815603,94313619,6498016,CN
chr02,Bn5277,11857668,20298046,8440378,CNL
chr02,Bn5278,16186256,53305751,37119495,CN
chr02,Bn5279,36776449,73752238,36975789,TN
chr02,Bn5280,80342580,97163595,16821015,CNL
chr02,Bn5281,43015544,80592859,37577315,CN
chr02,Bn5282,42042466,62414796,20372330,RLP
chr02,Bn5283,13120010,70447738,57327728,NBS
chr02,Bn5284,34686971,39191095,4504124,CN
chr02,Bn5285,14706921,98543023,83836102,TN
chr02,Bn5286,77501826,81374420,3872594,TNL
chr02,Bn5287,45476159,55243301,9767142,RLK
chr02,Bn5288,19317760,93154057,73836297,TNL
chr02,Bn5289,24708358,65883114,41174756,NBS
chr02,Bn5290,87142014,98801506,11659492,NBS
chr02,Bn5291,98336957,99037800,700843,RLK
chr02,Bn5292,84844107,95898737,11054630,TNL
chr02,Bn5293,15402682,80304139,64901457,RLK
chr02,Bn5294,58088721,68085994,9997273,CN
chr02,Bn5295,68029526,95297270,27267744,RLK
chr02,Bn5296,76978622,86321578,9342956,RLP
chr02,Bn5297,71817791,74584264,2766473,TN
chr02,Bn5298,87992128,96054502,8062374,NBS
chr02,Bn5299,49589273,58550749,8961476,RLP
chr02,Bn5300,2192014,13560601,11368587,TN
chr02,Bn5301,54599778,64811164,10211386,TNL
chr02,Bn5302,62671815,98122181,35450366,NBS
chr02,Bn5303,64462903,99543896,35080993,TN
chr02,Bn5304,68775674,80867968,12092294,NBS
chr02,Bn5305,63343046,81594662,18251616,CN
chr02,Bn5306,32198339,54210382,22012043,TNL
chr02,Bn5307,73155243,94300947,21145704,NBS
chr02,Bn5308,9183353,68250229,59066876,TNL
chr02,Bn5309,64768804,77418671,12649867,NBS
chr02,Bn5310,44134931,77792307,33657376,RLK
chr02,Bn5311,78878747,82526856,3648109,RLP
chr02,Bn5312,24705561,89647691,64942130,RLP
chr02,Bn5313,99476174,99566321,90147,TN
chr02,Bn5314,16060713,48601528,32540815,TNL
chr02,Bn5315,21282163,24261844,2979681,TN
chr02,Bn5316,20641527,23684687,3043160,NBS
chr02,Bn5317,17683714,47257839,29574125,RLP
chr02,Bn5318,61123461,68709335,7585874,TNL
chr02,Bn5319,27623209,36412225,8789016,TNL
chr02,Bn5320,61830378,65079864,3249486,NBS
chr02,Bn5321,54137653,54213211,75558,NBS
chr02,Bn5322,72578307,83423972,10845665,RLP
chr02,Bn5323,93259788,96392083,3132295,TNL
chr02,Bn5324,8872083,20139852,11267769,TNL
chr02,Bn5325,49532283,66034905,16502622,TNL
chr02,Bn5326,70442067,89833544,19391477,TNL
chr02,Bn5327,29446570,93649260,64202690,CNL
chr02,Bn5328,33510809,91378610,57867801,RLP
chr02,Bn5329,4258995,75882586,71623591,RLP
chr02,Bn5330,59172345,68153897,8981552,TNL
chr02,Bn5331,21292706,64697651,43404945,NBS
chr02,Bn5332,93521616,98143723,4622107,TN
chr02,Bn5333,39213201,89196584,49983383,NBS
chr02,Bn5334,65074077,86726076,21651999,RLP
chr02,Bn5335,10725425,79096154,68370729,CN
chr02,Bn5336,52498088,91239940,38741852,NBS
chr02,Bn5337,69059296,86137294,17077998,RLK
chr02,Bn5338,13708736,57943713,44234977,NBS
chr02,Bn5339,93127753,99918680,6790927,CNL
chr02,Bn5340,95177576,99003620,3826044,NBS
chr02,Bn5341,50505064,63275780,12770716,CN
chr02,Bn5342,55029911,93125529,38095618,RLK
chr02,Bn5343,18253396,68895589,50642193,TN
chr02,Bn5344,85722651,88811727,3089076,RLP
chr02,Bn5345,85566035,99514952,13948917,CN
chr02,Bn5346,30548773,46203417,15654644,TN
chr02,Bn5347,76039131,93306263,17267132,NBS
chr02,Bn5348,72762208,75875827,3113619,RLK
chr02,Bn5349,57237211,68759710,11522499,NBS
chr02,Bn5350,62798734,68692503,5893769,NBS
chr02,Bn5351,1964817,31662230,29697413,RLK
chr02,Bn5352,43272927,56282809,13009882,TN
chr02,Bn5353,91660613,97885453,6224840,RLK
chr02,Bn5354,69375365,96404681,27029316,TN
chr02,Bn5355,90660468,99809694,9149226,RLK
chr02,Bn5356,24183163,55303270,31120107,TNL
chr02,Bn5357,21812363,33807819,11995456,RLP
chr02,Bn5358,34272368,60802350,26529982,TNL
chr02,Bn5359,80572085,94121404,13549319,CNL
chr02,Bn5360,31848752,77754711,45905959,NBS
chr02,Bn5361,37693908,81439728,43745820,RLK
chr02,Bn5362,47391100,53031655,5640555,CN
chr02,Bn5363,15643439,93173871,77530432,CNL
chr02,Bn5364,1074619,54129321,53054702,NBS
chr02,Bn5365,55051634,92846260,37794626,RLK
chr02,Bn5366,48943635,92174409,43230774,RLP
chr02,Bn5367,45713217,71993391,26280174,TNL
chr02,Bn5368,82668777,99086482,16417705,RLP
chr02,Bn5369,11851257,61658215,49806958,NBS
chr02,Bn5370,59946436,84421853,24475417,CNL
chr02,Bn5371,10154249,69823426,59669177,RLP
chr02,Bn5372,97506081,98105583,599502,NBS
chr02,Bn5373,56447402,87225676,30778274,CN
chr02,Bn5374,68831107,80994811,12163704,RLP
chr02,Bn5375,92593228,95757528,3164300,TN
chr02,Bn5376,16401159,93406836,77005677,TN
chr02,Bn5377,58613472,66710854,8097382,TNL
chr02,Bn5378,45786218,88595776,42809558,RLP
chr02,Bn5379,8313538,59057155,50743617,TNL
chr02,Bn5380,64045653,98934558,34888905,NBS
chr02,Bn5381,11711378,85670153,73958775,RLK
chr02,Bn5382,33514956,49694734,16179778,CN
chr02,Bn5383,8112926,21900285,13787359,TN
chr02,Bn5384,97776616,98632165,855549,TNL
chr02,Bn5385,83895711,89325299,5429588,RLK
chr02,Bn5386,43952690,50168831,6216141,RLP
chr02,Bn5387,19518851,53198047,33679196,CN
chr02,Bn5388,66201711,89511940,23310229,NBS
chr02,Bn5389,26608669,78825958,52217289,CNL
chr02,Bn5390,5214920,75548030,70333110,RLP
chr02,Bn5391,23427922,59658841,36230919,CN
chr02,Bn5392,17939973,59576910,41636937,CN
chr02,Bn5393,45827599,53170447,7342848,RLK
chr02,Bn5394,7039811,54915340,47875529,TN
chr02,Bn5395,69086990,90612936,21525946,TNL
chr02,Bn5396,20990653,22485280,1494627,CNL
chr02,Bn5397,11900290,64293992,52393702,CNL
chr02,Bn5398,81912818,83300038,1387220,NBS
chr02,Bn5399,4340075,35758436,31418361,CNL
chr02,Bn5400,12306943,56177877,43870934,NBS
chr02,Bn5401,64581688,88184570,23602882,TNL
chr02,Bn5402,5476217,48976210,43499993,CNL
chr02,Bn5403,13152373,16445227,3292854,RLK
chr02,Bn5404,85276593,89314565,4037972,CNL
chr02,Bn5405,92489704,94287592,1797888,TN
chr02,Bn5406,30579727,69212921,38633194,TN
chr02,Bn5407,26137501,48883237,22745736,RLP
chr02,Bn5408,75063496,79980768,4917272,TNL
chr02,Bn5409,17486928,98348758,80861830,CN
chr02,Bn5410,55321869,94288468,38966599,TN
chr02,Bn5411,84621929,90178918,5556989,NBS
chr02,Bn5412,21135889,96509429,75373540,RLP
chr02,Bn5413,61749015,81508648,19759633,CN
chr02,Bn5414,79404225,97637766,18233541,CN
chr02,Bn5415,4674480,94011665,89337185,TNL
chr02,Bn5416,60428733,86518654,26089921,TN
chr02,Bn5417,10470331,96951487,86481156,CNL
chr02,Bn5418,50374959,57457339,7082380,RLP
chr02,Bn5419,91681794,99699806,8018012,RLK
chr02,Bn5420,10066311,66218235,56151924,CNL
chr02,Bn5421,26955537,80877477,53921940,NBS
chr02,Bn5422,47009578,57607989,10598411,TN
chr02,Bn5423,58057875,75872627,17814752,CNL
chr02,Bn5424,24416150,68358648,43942498,CNL
chr02,Bn5425,30467256,80621313,50154057,NBS
chr02,Bn5426,42104055,91240211,49136156,RLP
chr02,Bn5427,41320503,65008853,23688350,TN
chr02,Bn5428,53579342,70633600,17054258,TN
chr02,Bn5429,46397512,89452222,43054710,RLK
chr02,Bn5430,62325132,97895488,35570356,RLP
chr02,Bn5431,30373680,61724806,31351126,RLK
chr02,Bn5432,52903359,79164066,26260707,CN
chr02,Bn5433,46487939,58631140,12143201,TNL
chr02,Bn5434,36827429,93338166,56510737,NBS
chr02,Bn5435,16927535,57064656,40137121,RLP
chr02,Bn5436,73818493,92877279,19058786,TNL
chr02,Bn5437,82909942,96299666,13389724,CNL
chr02,Bn5438,45122319,71346611,26224292,CN
chr02,Bn5439,81306364,83143832,1837468,TNL
chr02,Bn5440,60852765,69894105,9041340,CNL
chr02,Bn5441,44908780,99182009,54273229,RLK
chr02,Bn5442,70212720,80414624,10201904,TN
chr02,Bn5443,45504912,56162531,10657619,TN
chr02,Bn5444,1777956,14724004,12946048,RLP
chr02,Bn5445,37198493,62194627,24996134,RLK
chr02,Bn5446,80288915,88673068,8384153,CN
chr02,Bn5447,6197005,74823402,68626397,RLP
chr02,Bn5448,34946239,60011609,25065370,CNL
chr02,Bn5449,82015046,84847269,2832223,NBS
chr02,Bn5450,50568541,71524545,20956004,TN
chr02,Bn5451,81101392,85859404,4758012,NBS
chr02,Bn5452,44564613,96683586,52118973,RLK
chr02,Bn5453,19899041,28294964,8395923,RLK
chr02,Bn5454,17440005,46872519,29432514,TN
chr02,Bn5455,51712728,58039923,6327195,TNL
chr02,Bn5456,31995494,37690308,5694814,TN
chr02,Bn5457,12657596,24609480,11951884,CNL
chr02,Bn5458,78847247,79272229,424982,TN
chr02,Bn5459,76536543,88671439,12134896,CN
chr02,Bn5460,73079899,82599963,9520064,RLK
chr02,Bn5461,38747087,75108802,36361715,RLP
chr02,Bn5462,56583547,72833279,16249732,TNL
chr02,Bn5463,76255230,96320201,20064971,CNL
chr02,Bn5464,37974849,94902274,56927425,CN
chr02,Bn5465,48471219,92568023,44096804,CN
chr02,Bn5466,25834352,68677173,42842821,NBS
chr02,Bn5467,60365792,79118531,18752739,CN
chr02,Bn5468,2549818,74907122,72357304,RLP
chr02,Bn5469,26297877,76801961,50504084,CN
chr02,Bn5470,78564972,99400501,20835529,RLP
chr02,Bn5471,29556808,60541901,30985093,RLP
chr02,Bn5472,41654033,97152512,55498479,NBS
chr02,Bn5473,64274989,86632947,22357958,CN
chr02,Bn5474,75242716,75322348,79632,NBS
chr02,Bn5475,31686195,67281394,35595199,RLP
chr02,Bn5476,25517346,25815198,297852,TN
chr02,Bn5477,44585903,94472242,49886339,RLP
chr02,Bn5478,91048033,99171503,8123470,TN
chr02,Bn5479,7077332,75493541,68416209,TN
chr02,Bn5480,80085202,87655189,7569987,TNL
chr02,Bn5481,40934020,97325407,56391387,RLK
chr02,Bn5482,2391439,55748877,53357438,RLK
chr02,Bn5483,96282340,96292622,10282,CN
chr02,Bn5484,13268532,21776443,8507911,TNL
chr02,Bn5485,99700959,99850303,149344,TN
chr02,Bn5486,53293191,64378098,11084907,CN
chr02,Bn5487,30094091,48233150,18139059,RLK
chr02,Bn5488,95134562,96417918,1283356,NBS
chr02,Bn5489,47240922,85052670,37811748,RLP
chr02,Bn5490,99710286,99715821,5535,CN
chr02,Bn5491,31353728,57971613,26617885,TNL
chr02,Bn5492,39387012,65521912,26134900,NBS
chr02,Bn5493,10151736,86896284,76744548,RLP
chr02,Bn5494,92617431,95831687,3214256,CN
chr02,Bn5495,76655677,90110276,13454599,TNL
chr02,Bn5496,38666478,75231870,36565392,TN
chr02,Bn5497,17241378,66546796,49305418,CNL
chr02,Bn5498,35731592,93744184,58012592,TNL
chr02,Bn5499,22943604,74501763,51558159,CNL
chr02,Bn5500,50105709,69820564,19714855,NBS
chr02,Bn5501,13030470,66944958,53914488,NBS
chr02,Bn5502,74274704,79558927,5284223,TNL
chr02,Bn5503,38917697,93507303,54589606,CN
chr02,Bn5504,40205729,97371415,57165686,CNL
chr02,Bn5505,21682875,53214950,31532075,CNL
chr02,Bn5506,51100984,64708404,13607420,CNL
chr02,Bn5507,2341725,90822509,88480784,RLK
chr02,Bn5508,28165089,67966318,39801229,RLP
chr02,Bn5509,57109720,75792496,18682776,RLP
chr02,Bn5510,10458593,23857281,13398688,TN
chr02,Bn5511,84844763,94018874,9174111,RLP
chr02,Bn5512,92144714,92850403,705689,RLK
chr02,Bn5513,87893918,92271439,4377521,CNL
chr02,Bn5514,57181047,79756677,22575630,NBS
chr02,Bn5515,6984432,83356025,76371593,RLK
chr02,Bn5516,41984990,77450411,35465421,TNL
chr02,Bn5517,72735987,88633539,15897552,NBS
chr02,Bn5518,34190825,90681461,56490636,CNL
chr02,Bn5519,16017668,67592843,51575175,TNL
chr02,Bn5520,10050381,40438801,30388420,RLK
chr02,Bn5521,18118770,75237424,57118654,TN
chr02,Bn5522,6651774,97107352,90455578,NBS
chr02,Bn5523,40178955,88352532,48173577,CN
chr02,Bn5524,26085181,67899218,41814037,RLP
chr02,Bn5525,63422246,81224305,17802059,NBS
chr02,Bn5526,19566023,93009159,73443136,RLK
chr02,Bn5527,10321881,46911392,36589511,CNL
chr02,Bn5528,87397247,89915843,2518596,CN
chr02,Bn5529,63443200,97933341,34490141,TNL
chr02,Bn5530,86620688,87286894,666206,CN
chr02,Bn5531,52837062,74409072,21572010,TNL
chr02,Bn5532,88956173,93015682,4059509,RLP
chr02,Bn5533,42404595,97971190,55566595,CN
chr02,Bn5534,69617477,73547528,3930051,TN
chr02,Bn5535,84839922,88450221,3610299,RLP
chr02,Bn5536,91154347,93009184,1854837,TNL
chr02,Bn5537,10371440,18826490,8455050,NBS
chr02,Bn5538,91529965,94421607,2891642,CN
chr02,Bn5539,25663973,36668944,11004971,NBS
chr02,Bn5540,15778072,83904290,68126218,RLK
chr02,Bn5541,9171737,49578460,40406723,TN
chr02,Bn5542,70688985,81889126,11200141,RLP
chr02,Bn5543,91939897,97661382,5721485,RLK
chr02,Bn5544,69725028,69994851,269823,NBS
chr02,Bn5545,61756345,91506559,29750214,CNL
chr02,Bn5546,2884976,84770808,81885832,RLK
chr02,Bn5547,81677031,96178250,14501219,RLP
chr02,Bn5548,26355300,52014777,25659477,NBS
chr02,Bn5549,35258074,69141443,33883369,RLK
chr02,Bn5550,86484199,96091389,9607190,TNL
chr02,Bn5551,16700168,67828045,51127877,TN
chr02,Bn5552,56558359,72111618,15553259,RLP
chr02,Bn5553,8069683,56149072,48079389,RLP
chr02,Bn5554,91766799,94717915,2951116,RLP
chr02,Bn5555,40740545,62290334,21549789,CN
chr02,Bn5556,23793144,48805390,25012246,CN
chr02,Bn5557,66558870,89600215,23041345,NBS
chr02,Bn5558,67117844,68032947,915103,RLP
chr02,Bn5559,36046264,50837988,14791724,RLP
chr02,Bn5560,33000977,97036094,64035117,TN
chr02,Bn5561,38677069,72869668,34192599,CN
chr02,Bn5562,30509829,54212567,23702738,CN
chr02,Bn5563,94537627,96900585,2362958,TNL
chr02,Bn5564,31401622,61120007,29718385,RLK
chr02,Bn5565,34094174,85030148,50935974,CN
chr02,Bn5566,19455478,47633126,28177648,TN
chr02,Bn5567,22833917,88303474,65469557,CN
chr02,Bn5568,5535587,95901203,90365616,TNL
chr02,Bn5569,48775112,92245222,43470110,CN
chr02,Bn5570,67007233,87604582,20597349,RLP
chr02,Bn5571,50466936,63993307,13526371,CN
chr02,Bn5572,65686970,88320157,22633187,RLP
chr02,Bn5573,63338472,81406072,18067600,NBS
chr02,Bn5574,93135956,94090844,954888,RLP
chr02,Bn5575,47248402,57608661,10360259,RLP
chr02,Bn5576,43586084,61197206,17611122,CNL
chr02,Bn5577,86502712,90522092,4019380,RLK
chr02,Bn5578,89847764,98796694,8948930,CNL
chr02,Bn5579,74063622,75497971,1434349,TN
chr02,Bn5580,31540217,86761213,55220996,CNL
chr02,Bn5581,49017812,64941506,15923694,RLK
chr02,Bn5582,39606699,88329948,48723249,CN
chr02,Bn5583,33669786,62824722,29154936,RLP
chr02,Bn5584,68883129,77237634,8354505,RLK
chr02,Bn5585,16388746,50496525,34107779,TN
chr02,Bn5586,54470452,83159587,28689135,RLK
chr02,Bn5587,47661841,67801243,20139402,CNL
chr02,Bn5588,63986424,82582807,18596383,RLK
chr02,Bn5589,33536266,61984882,28448616,RLP
chr02,Bn5590,64735151,74974890,10239739,TNL
chr02,Bn5591,81836605,97266901,15430296,CN
chr02,Bn5592,72232695,88969099,16736404,RLK
chr02,Bn5593,45430483,58709691,13279208,TN
chr02,Bn5594,10565892,89790639,79224747,TNL
chr02,Bn5595,91521823,94502994,2981171,TN
chr02,Bn5596,53033245,69583816,16550571,RLP
chr02,Bn5597,61822227,65968979,4146752,TNL
chr02,Bn5598,18203623,96445536,78241913,TN
chr02,Bn5599,76600741,95547265,18946524,CNL
chr02,Bn5600,65649684,97550935,31901251,TNL
chr02,Bn5601,76337184,92018838,15681654,TN
chr02,Bn5602,36227783,96302437,60074654,TNL
chr02,Bn5603,49104885,80896190,31791305,CNL
chr02,Bn5604,28372129,38796074,10423945,RLK
chr02,Bn5605,8420294,57921000,49500706,TNL
chr02,Bn5606,54859951,92475251,37615300,RLK
chr02,Bn5607,95040629,98298136,3257507,RLP
chr02,Bn5608,7030342,19472388,12442046,CNL
chr02,Bn5609,11808209,32935903,21127694,TNL
chr02,Bn5610,47737578,63240947,15503369,CN
chr02,Bn5611,57198250,67286359,10088109,RLK
chr02,Bn5612,62138145,70605428,8467283,NBS
chr02,Bn5613,93319441,98416510,5097069,TN
chr02,Bn5614,9976414,43161756,33185342,TNL
chr02,Bn5615,95028692,96961297,1932605,CN
chr02,Bn5616,27010126,67505927,40495801,NBS
chr02,Bn5617,35344075,80749261,45405186,TN
chr02,Bn5618,6920423,54213420,47292997,RLP
chr02,Bn5619,90095860,91559137,1463277,TN
chr02,Bn5620,55592542,59147276,3554734,CN
chr02,Bn5621,92027950,97729087,5701137,CNL
chr02,Bn5622,49347962,50024978,677016,NBS
chr02,Bn5623,10881874,79272513,68390639,NBS
chr02,Bn5624,87966679,95679771,7713092,TNL
chr02,Bn5625,41551761,43684872,2133111,RLP
chr02,Bn5626,60014245,65590932,5576687,TNL
chr02,Bn5627,31868293,34441877,2573584,TNL
chr02,Bn5628,27770186,31091193,3321007,TNL
chr02,Bn5629,41143276,78937377,37794101,RLP
chr02,Bn5630,75253754,91841122,16587368,TN
chr02,Bn5631,95592016,99816202,4224186,RLK
chr02,Bn5632,32587410,64601955,32014545,CNL
chr02,Bn5633,44671886,66570202,21898316,CN
chr02,Bn5634,9976153,27970343,17994190,RLP
chr02,Bn5635,69612029,95410976,25798947,RLP
chr02,Bn5636,51546816,89615903,38069087,TNL
chr02,Bn5637,77141360,99698617,22557257,RLP
chr02,Bn5638,3765050,22279595,18514545,RLK
chr02,Bn5639,83619095,85542356,1923261,CN
chr02,Bn5640,21596519,28541735,6945216,RLK
chr02,Bn5641,44321027,98236750,53915723,TNL
chr02,Bn5642,78382854,82730559,4347705,TN
chr02,Bn5643,18184620,98685921,80501301,CN
chr02,Bn5644,80255833,80945538,689705,TN
chr02,Bn5645,18112824,99820943,81708119,CNL
chr02,Bn5646,40019358,66995783,26976425,TN
chr02,Bn5647,5247534,50480854,45233320,CN
chr02,Bn5648,30128637,93308459,63179822,CN
chr02,Bn5649,6418235,45364478,38946243,RLK
chr02,Bn5650,9806160,99268357,89462197,RLP
chr02,Bn5651,18650200,59107115,40456915,NBS
chr02,Bn5652,62112049,86986919,24874870,TNL
chr02,Bn5653,47053270,78358118,31304848,RLK
chr02,Bn5654,95427406,97632367,2204961,NBS
chr02,Bn5655,73912997,74549523,636526,CN
chr02,Bn5656,11084853,46206101,35121248,CN
chr02,Bn5657,70590754,77466386,6875632,CN
chr02,Bn5658,43668794,74520384,30851590,TNL
chr02,Bn5659,44063041,72178590,28115549,RLK
chr02,Bn5660,29491179,71669590,42178411,TN
chr02,Bn5661,98839325,99374065,534740,RLK
chr02,Bn5662,60477568,76100948,15623380,TN
chr02,Bn5663,93088014,95377746,2289732,CNL
chr02,Bn5664,54805488,70836515,16031027,NBS
chr02,Bn5665,78057419,95558673,17501254,RLP
chr02,Bn5666,86334866,99357125,13022259,TNL
chr02,Bn5667,65878600,83759789,17881189,CN
chr02,Bn5668,11339610,61401622,50062012,TN
chr02,Bn5669,53941117,88164760,34223643,RLP
chr02,Bn5670,66366459,94614038,28247579,TNL
chr02,Bn5671,5587644,34397878,28810234,TNL
chr02,Bn5672,1719108,9849137,8130029,RLK
chr02,Bn5673,39860180,74720672,34860492,TN
chr02,Bn5674,43538639,67257563,23718924,CN
chr02,Bn5675,47420080,58270047,10849967,TNL
chr02,Bn5676,18943939,97848848,78904909,CN
chr02,Bn5677,74539170,96645562,22106392,NBS
chr02,Bn5678,8521390,76546357,68024967,CN
chr02,Bn5679,41235244,71646514,30411270,TN
chr02,Bn5680,94472816,96739937,2267121,TNL
chr02,Bn5681,30016656,64391045,34374389,RLK
chr02,Bn5682,33161549,42420311,9258762,CNL
chr02,Bn5683,79348533,91101670,11753137,RLP
chr02,Bn5684,21710457,68337240,46626783,CNL
chr02,Bn5685,44662670,89802477,45139807,TN
chr02,Bn5686,35852576,46268596,10416020,TNL
chr02,Bn5687,13850117,49586953,35736836,CN
chr02,Bn5688,33446676,68400558,34953882,CN
chr02,Bn5689,67769999,84616213,16846214,CN
chr02,Bn5690,4100072,46328296,42228224,RLK
chr02,Bn5691,32406295,82179860,49773565,TN
chr02,Bn5692,32462278,65205349,32743071,TN
chr02,Bn5693,22898583,30576942,7678359,CN
chr02,Bn5694,62831655,87561513,24729858,CNL
chr02,Bn5695,43075897,54669004,11593107,RLK
chr02,Bn5696,66912786,73269579,6356793,CN
chr02,Bn5697,93515020,97257291,3742271,TNL
chr02,Bn5698,92951743,96624034,3672291,RLP
chr02,Bn5699,91329062,93135669,1806607,RLK
chr02,Bn5700,58226628,98887843,40661215,CN
chr02,Bn5701,28510145,64026522,35516377,CNL
chr02,Bn5702,22059428,49064003,27004575,RLK
chr02,Bn5703,35902183,79426076,43523893,TNL
chr02,Bn5704,52832717,96948608,44115891,TNL
chr02,Bn5705,3646774,4466993,820219,TNL
chr02,Bn5706,9733381,20200804,10467423,CN
chr02,Bn5707,39378357,69695129,30316772,NBS
chr02,Bn5708,56248580,98960969,42712389,TN
chr02,Bn5709,26724581,69663609,42939028,NBS
chr02,Bn5710,81404035,94262286,12858251,CN
chr02,Bn5711,80369063,96238086,15869023,CN
chr02,Bn5712,69526054,89129352,19603298,RLK
chr02,Bn5713,7747706,81522952,73775246,CNL
chr02,Bn5714,20054612,67295666,47241054,CN
chr02,Bn5715,59966592,96528764,36562172,RLP
chr02,Bn5716,10839791,98137238,87297447,TNL
chr02,Bn5717,57895145,76548070,18652925,CN
chr02,Bn5718,62177596,66636847,4459251,CNL
chr02,Bn5719,3007814,9493414,6485600,CNL
chr02,Bn5720,3919337,97191180,93271843,NBS
chr02,Bn5721,87715289,99538455,11823166,CN
chr02,Bn5722,12608604,13262875,654271,TNL
chr02,Bn5723,82581475,93633504,11052029,TNL
chr02,Bn5724,92916322,98862431,5946109,CN
chr02,Bn5725,89372204,95879106,6506902,CN
chr02,Bn5726,85054664,87715258,2660594,RLK
chr02,Bn5727,8196093,74783971,66587878,RLP
chr02,Bn5728,57390129,76617816,19227687,RLP
chr02,Bn5729,49260209,58158210,8898001,NBS
chr02,Bn5730,18376112,79533086,61156974,CN
chr02,Bn5731,21555266,43054475,21499209,RLK
chr02,Bn5732,94793339,99425400,4632061,TN
chr02,Bn5733,66513882,91389362,24875480,CNL
chr02,Bn5734,63040473,69243159,6202686,RLK
chr02,Bn5735,59686081,77744239,18058158,TN
chr02,Bn5736,93838070,94878918,1040848,CN
chr02,Bn5737,24031730,87666134,63634404,RLP
chr02,Bn5738,75571812,91293982,15722170,RLK
chr02,Bn5739,22268460,82050159,59781699,RLP
chr02,Bn5740,3520226,57703342,54183116,TN
chr02,Bn5741,67197688,75045760,7848072,RLP
chr02,Bn5742,18313232,99360343,81047111,RLK
chr02,Bn5743,61874364,98752977,36878613,RLK
chr02,Bn5744,8541825,23366050,14824225,CNL
chr02,Bn5745,85056634,98823842,13767208,TN
chr02,Bn5746,77996064,84068245,6072181,NBS
chr02,Bn5747,62770635,62950303,179668,TNL
chr02,Bn5748,98065929,99067817,1001888,NBS
chr02,Bn5749,1361498,26621374,25259876,RLP
chr02,Bn5750,4824628,17069620,12244992,CN
chr02,Bn5751,86553042,88555027,2001985,TNL
chr02,Bn5752,81483974,99803633,18319659,RLP
chr02,Bn5753,98280251,99968130,1687879,CNL
chr02,Bn5754,73974730,91964099,17989369,CNL
chr02,Bn5755,79091602,96463701,17372099,NBS
chr02,Bn5756,36841644,49659152,12817508,CN
chr02,Bn5757,4274164,70853583,66579419,NBS
chr02,Bn5758,77317846,92469444,15151598,CNL
chr02,Bn5759,5735392,56781420,51046028,CNL
chr02,Bn5760,16257590,48252374,31994784,CNL
chr02,Bn5761,4543549,71248097,66704548,CN
chr02,Bn5762,87507656,92323091,4815435,CNL
chr02,Bn5763,54745927,85891496,31145569,TN
chr02,Bn5764,69258612,70367996,1109384,CN
chr02,Bn5765,70100509,93249198,23148689,RLP
chr02,Bn5766,62370425,76212084,13841659,TNL
chr02,Bn5767,38360843,78609445,40248602,CN
chr02,Bn5768,41319595,56431261,15111666,TN
chr02,Bn5769,51336270,58727670,7391400,TNL
chr02,Bn5770,88285793,95157946,6872153,NBS
chr02,Bn5771,90608107,97587108,6979001,CNL
chr02,Bn5772,38458616,55942062,17483446,RLK
chr02,Bn5773,32042308,60846899,28804591,RLK
chr02,Bn5774,21918946,62606096,40687150,TNL
chr02,Bn5775,73415296,91584324,18169028,TNL
chr02,Bn5776,15887024,95065651,79178627,NBS
chr02,Bn5777,22623977,93552467,70928490,TN
chr02,Bn5778,37004400,65619990,28615590,RLK
chr02,Bn5779,13316374,15584821,2268447,TN
chr02,Bn5780,54450004,74480200,20030196,TN
chr02,Bn5781,18187050,42938134,24751084,NBS
chr02,Bn5782,59325145,87694369,28369224,RLP
chr02,Bn5783,83670872,87806673,4135801,TN
chr02,Bn5784,87346193,89150647,1804454,RLK
chr02,Bn5785,74428618,90790873,16362255,RLP
chr02,Bn5786,88076451,94676135,6599684,TNL
chr02,Bn5787,69348800,73521319,4172519,RLK
chr02,Bn5788,60675797,91032766,30356969,TNL
chr02,Bn5789,96648174,99670557,3022383,CNL
chr02,Bn5790,85693566,93839970,8146404,RLK
chr02,Bn5791,42991708,94090492,51098784,CN
chr02,Bn5792,24208101,75229980,51021879,CN
chr02,Bn5793,7862938,13326237,5463299,CN
chr02,Bn5794,44999985,85563598,40563613,TNL
chr02,Bn5795,27237257,56349310,29112053,TNL
chr02,Bn5796,22397905,65402253,43004348,CN
chr02,Bn5797,41261015,52937493,11676478,CN
chr02,Bn5798,70214524,84817185,14602661,NBS
chr02,Bn5799,9539208,81744447,72205239,TNL
chr02,Bn5800,7684410,92029692,84345282,CNL
chr02,Bn5801,22726298,86210452,63484154,RLP
chr02,Bn5802,75319852,97408784,22088932,NBS
chr02,Bn5803,6499455,21580533,15081078,TNL
chr02,Bn5804,79846072,89698760,9852688,RLP
chr02,Bn5805,42851028,53028354,10177326,CNL
chr02,Bn5806,22862650,27728505,4865855,TN
chr02,Bn5807,1465710,45423533,43957823,RLK
chr02,Bn5808,82576590,88136775,5560185,CNL
chr02,Bn5809,51862125,56915666,5053541,CN
chr02,Bn5810,40174553,64127907,23953354,TN
chr02,Bn5811,56736585,89842463,33105878,RLK
chr02,Bn5812,41906677,63465895,21559218,TNL
chr02,Bn5813,31712644,42326392,10613748,TN
chr02,Bn5814,32511894,82178952,49667058,CN
chr02,Bn5815,73250979,96863084,23612105,TN
chr02,Bn5816,6501975,56269543,49767568,CNL
chr02,Bn5817,78435465,89749440,11313975,TNL
chr02,Bn5818,67221507,98459259,31237752,CN
chr02,Bn5819,43024655,80332847,37308192,NBS
chr02,Bn5820,23685966,60166320,36480354,RLP
chr02,Bn5821,31844569,35679867,3835298,RLP
chr02,Bn5822,60766313,80311257,19544944,TNL
chr02,Bn5823,49117533,63672888,14555355,RLK
chr02,Bn5824,46829692,81070993,34241301,CNL
chr02,Bn5825,63792630,87337801,23545171,CNL
chr02,Bn5826,21000022,36957055,15957033,RLP
chr02,Bn5827,39644932,91047362,51402430,RLK
chr02,Bn5828,24187808,59016285,34828477,CN
chr02,Bn5829,86483852,99871692,13387840,CNL
chr02,Bn5830,48699367,66836942,18137575,TN
chr02,Bn5831,39522425,82779385,43256960,RLK
chr02,Bn5832,93105664,93993168,887504,CN
chr02,Bn5833,1769079,17795970,16026891,TN
chr02,Bn5834,87412373,89645025,2232652,CNL
chr02,Bn5835,75628614,78664801,3036187,NBS
chr02,Bn5836,60037918,94476158,34438240,RLK
chr02,Bn5837,9397685,59881508,50483823,TN
chr02,Bn5838,37514529,42076729,4562200,RLK
chr02,Bn5839,96597287,97211403,614116,TN
chr02,Bn5840,3567733,45154071,41586338,NBS
chr02,Bn5841,33342012,70463874,37121862,TNL
chr02,Bn5842,45141499,86098768,40957269,NBS
chr02,Bn5843,44393476,56397080,12003604,RLK
chr02,Bn5844,48634831,87007422,38372591,RLK
chr02,Bn5845,39966798,94013789,54046991,CNL
chr02,Bn5846,45261275,66407447,21146172,RLP
chr02,Bn5847,22640569,50728300,28087731,CNL
chr02,Bn5848,86671149,91316011,4644862,TN
chr02,Bn5849,44392005,86619903,42227898,NBS
chr02,Bn5850,60708453,74467765,13759312,CNL
chr02,Bn5851,29937824,85487308,55549484,TN
chr02,Bn5852,63337771,90471110,27133339,NBS
chr02,Bn5853,94988062,96593920,1605858,CN
chr02,Bn5854,47912205,58995786,11083581,RLP
chr02,Bn5855,93132844,93152348,19504,CN
chr02,Bn5856,89001154,92003959,3002805,TN
chr02,Bn5857,55432373,64017435,8585062,TNL
chr02,Bn5858,16252456,26667871,10415415,RLK
chr02,Bn5859,86980292,89446731,2466439,RLP
chr02,Bn5860,42850362,81419272,38568910,NBS
chr02,Bn5861,51006799,97706599,46699800,NBS
chr02,Bn5862,49362695,53913526,4550831,CNL
chr02,Bn5863,17406049,73492774,56086725,TNL
chr02,Bn5864,20385410,85175343,64789933,CNL
chr02,Bn5865,51386211,99853102,48466891,TN
chr02,Bn5866,60922462,77387240,16464778,TNL
chr02,Bn5867,67148244,77236322,10088078,NBS
chr02,Bn5868,24438000,25774654,1336654,CNL
chr02,Bn5869,45364072,69683669,24319597,TN
chr02,Bn5870,81038612,98891321,17852709,CNL
chr02,Bn5871,74272415,98956584,24684169,RLK
chr02,Bn5872,58145030,59100371,955341,TNL
chr02,Bn5873,15083240,44463325,29380085,TNL
chr02,Bn5874,41855800,99111001,57255201,RLK
chr02,Bn5875,15506894,72873710,57366816,RLP
chr02,Bn5876,55347874,77989809,22641935,NBS
chr02,Bn5877,95006545,99245479,4238934,CN
chr02,Bn5878,89457214,90948442,1491228,TN
chr02,Bn5879,62927156,98916241,35989085,TN
chr02,Bn5880,18632431,68774402,50141971,RLP
chr02,Bn5881,18727604,61722471,42994867,NBS
chr02,Bn5882,3861313,74495130,70633817,TN
chr02,Bn5883,34342111,64366819,30024708,TNL
chr02,Bn5884,39300401,78140053,38839652,RLP
chr02,Bn5885,7694927,61570518,53875591,NBS
chr02,Bn5886,1950610,80954574,79003964,TNL
chr02,Bn5887,85025165,97595938,12570773,RLK
chr02,Bn5888,52760440,71257429,18496989,TN
chr02,Bn5889,75533835,82073404,6539569,TNL
chr02,Bn5890,11661641,77964837,66303196,CN
chr02,Bn5891,85880918,88651822,2770904,NBS
chr02,Bn5892,41428128,83941745,42513617,RLK
chr02,Bn5893,3422471,63916782,60494311,NBS
chr02,Bn5894,77237067,80888561,3651494,CNL
chr02,Bn5895,2358106,45638436,43280330,NBS
chr02,Bn5896,67022386,68050122,1027736,RLP
chr02,Bn5897,48146102,86203992,38057890,RLK
chr02,Bn5898,70477966,81201625,10723659,CNL
chr02,Bn5899,76098906,77980594,1881688,RLP
chr02,Bn5900,98815204,99903076,1087872,TN
chr02,Bn5901,62572167,74808463,12236296,TNL
chr02,Bn5902,19978594,48550596,28572002,TNL
chr02,Bn5903,1128052,77623041,76494989,NBS
chr02,Bn5904,32571778,72471290,39899512,CNL
chr02,Bn5905,21249984,69942840,48692856,NBS
chr02,Bn5906,96186960,99528711,3341751,TNL
chr02,Bn5907,39729032,82643414,42914382,NBS
chr02,Bn5908,64806622,99683473,34876851,NBS
chr02,Bn5909,64743152,94019712,29276560,TNL
chr02,Bn5910,85756743,99827235,14070492,TN
chr02,Bn5911,98863225,99922301,1059076,NBS
chr02,Bn5912,36426933,52226314,15799381,NBS
chr02,Bn5913,25538140,69057910,43519770,NBS
chr02,Bn5914,39931107,56888964,16957857,TN
chr02,Bn5915,92204099,93987969,1783870,TNL
chr02,Bn5916,68677836,81965517,13287681,TN
chr02,Bn5917,20039001,80739761,60700760,TN
chr02,Bn5918,95742708,96004356,261648,TNL
chr02,Bn5919,98462966,99120011,657045,CN
chr02,Bn5920,6313814,49506738,43192924,RLP
chr02,Bn5921,60135093,63256909,3121816,CN
chr02,Bn5922,35871765,73997191,38125426,TNL
chr02,Bn5923,99464101,99682993,218892,RLP
chr02,Bn5924,27961002,88470495,60509493,TNL
chr02,Bn5925,62011589,78902021,16890432,CNL
chr02,Bn5926,49565650,95930384,46364734,NBS
chr02,Bn5927,20978041,23865487,2887446,CNL
chr02,Bn5928,49962733,66660303,16697570,TNL
chr02,Bn5929,79791214,99277294,19486080,RLK
chr02,Bn5930,29739973,99644447,69904474,TN
chr02,Bn5931,69990057,90365845,20375788,RLK
chr02,Bn5932,19302151,97119085,77816934,NBS
chr02,Bn5933,66369321,73827075,7457754,TNL
chr02,Bn5934,35615651,86697042,51081391,RLP
chr02,Bn5935,60838990,66065156,5226166,CN
chr02,Bn5936,78974955,85929055,6954100,RLP
chr02,Bn5937,19136713,60863997,41727284,CNL
chr02,Bn5938,95440872,98411122,2970250,TN
chr02,Bn5939,28387611,90053113,61665502,CNL
chr02,Bn5940,67704725,75764559,8059834,NBS
chr02,Bn5941,46388737,97312081,50923344,TN
chr02,Bn5942,79713978,93274124,13560146,TN
chr02,Bn5943,31533676,92900558,61366882,RLK
chr02,Bn5944,54312928,61717681,7404753,RLP
chr02,Bn5945,23327755,46273735,22945980,CNL
chr02,Bn5946,89492293,90218943,726650,RLK
chr02,Bn5947,54235679,85037851,30802172,CN
chr02,Bn5948,5745121,51745358,46000237,NBS
chr02,Bn5949,79240771,90493900,11253129,TNL
chr02,Bn5950,29810386,76250453,46440067,TN
chr02,Bn5951,13768651,57007483,43238832,NBS
chr02,Bn5952,65796819,94313672,28516853,TNL
chr02,Bn5953,73915025,84829024,10913999,CN
chr02,Bn5954,10835401,11662197,826796,TNL
chr02,Bn5955,89042433,95925784,6883351,CN
chr02,Bn5956,76460624,83899562,7438938,TNL
chr02,Bn5957,95149275,96295956,1146681,RLK
chr02,Bn5958,79004479,83042851,4038372,RLP
chr02,Bn5959,96892404,99867810,2975406,RLP
chr02,Bn5960,15392863,25912387,10519524,TNL
chr02,Bn5961,74146182,98529560,24383378,RLK
chr02,Bn5962,13125119,73973775,60848656,CN
chr02,Bn5963,55154948,67021701,11866753,RLP
chr02,Bn5964,12385870,32373329,19987459,TN
chr02,Bn5965,85068309,88432776,3364467,RLP
chr02,Bn5966,66561304,76144602,9583298,RLK
chr02,Bn5967,27856280,38982906,11126626,RLK
chr02,Bn5968,73928877,94606632,20677755,RLK
chr02,Bn5969,29290450,40801637,11511187,RLK
chr02,Bn5970,43115286,45487145,2371859,TN
chr02,Bn5971,45792550,90552680,44760130,CN
chr02,Bn5972,49827713,58938492,9110779,TNL
chr02,Bn5973,25349715,66487753,41138038,NBS
chr02,Bn5974,18049408,42542492,24493084,CN
chr02,Bn5975,59737411,85295895,25558484,CN
chr02,Bn5976,79253132,84672935,5419803,RLP
chr02,Bn5977,96599212,96686372,87160,CNL
chr02,Bn5978,98849827,98934505,84678,TNL
chr02,Bn5979,9034324,11039675,2005351,TN
chr02,Bn5980,57200728,73901751,16701023,CNL
chr02,Bn5981,70815048,87021131,16206083,RLK
chr02,Bn5982,29516479,93880003,64363524,RLK
chr02,Bn5983,85226751,95366570,10139819,RLK
chr02,Bn5984,54445885,65524242,11078357,RLP
chr02,Bn5985,26368726,89607478,63238752,TNL
chr02,Bn5986,19081959,95771985,76690026,NBS
chr02,Bn5987,46633242,99853970,53220728,NBS
chr02,Bn5988,92344029,96236301,3892272,TNL
chr02,Bn5989,24091422,90963851,66872429,CNL
chr02,Bn5990,98922740,99386669,463929,TN
chr02,Bn5991,7136859,63221650,56084791,TNL
chr02,Bn5992,37247642,61256816,24009174,CNL
chr02,Bn5993,31933789,63244110,31310321,CNL
chr02,Bn5994,10290218,45669182,35378964,RLP
chr02,Bn5995,50797436,57224525,6427089,NBS
chr02,Bn5996,33827868,40786503,6958635,CN
chr02,Bn5997,92011587,98014196,6002609,NBS
chr02,Bn5998,59872790,87984623,28111833,RLP
chr02,Bn5999,30413672,84204500,53790828,NBS
chr02,Bn6000,4664298,42220849,37556551,RLK
chr02,Bn6001,65088577,86956615,21868038,RLK
chr02,Bn6002,99755117,99930073,174956,RLK
chr02,Bn6003,63244270,69511201,6266931,CNL
chr02,Bn6004,85098624,98380412,13281788,RLK
chr02,Bn6005,74484772,76105047,1620275,TNL
chr02,Bn6006,16286417,17810717,1524300,NBS
chr02,Bn6007,18297457,47923116,29625659,CNL
chr02,Bn6008,82582110,87911639,5329529,TNL
chr02,Bn6009,69875654,91627450,21751796,RLK
chr02,Bn6010,36757535,54220429,17462894,TNL
chr02,Bn6011,27282128,67402671,40120543,RLP
chr02,Bn6012,17444461,40363336,22918875,CNL
chr02,Bn6013,99851509,99890886,39377,TNL
chr02,Bn6014,37978724,56212865,18234141,TN
chr02,Bn6015,61852494,96794560,34942066,NBS
chr02,Bn6016,81021516,82896786,1875270,TN
chr02,Bn6017,76844660,80034550,3189890,TN
chr02,Bn6018,69439586,76967804,7528218,RLK
chr02,Bn6019,88045318,90749780,2704462,TN
chr02,Bn6020,38787167,46594355,7807188,TN
chr02,Bn6021,35741210,97229300,61488090,TN
chr02,Bn6022,96448889,98097985,1649096,TN
chr02,Bn6023,67527764,94306762,26778998,CN
chr02,Bn6024,72864699,83967932,11103233,CNL
chr02,Bn6025,22839006,47089268,24250262,RLK
chr02,Bn6026,57471809,58638043,1166234,CNL
chr02,Bn6027,33120732,78413415,45292683,CNL
chr02,Bn6028,18965914,98944241,79978327,TN
chr02,Bn6029,28847726,72761867,43914141,TN
chr02,Bn6030,85988498,86342671,354173,NBS
chr02,Bn6031,45099311,45569754,470443,TN
chr02,Bn6032,73239756,85106333,11866577,RLP
chr02,Bn6033,73979616,94213273,20233657,TN
chr02,Bn6034,77771473,87663079,9891606,CN
chr02,Bn6035,53135204,65167958,12032754,RLK
chr02,Bn6036,78275351,95452184,17176833,TN
chr02,Bn6037,16641620,69626781,52985161,RLK
chr02,Bn6038,11699369,90054041,78354672,RLK
chr02,Bn6039,2386870,82326377,79939507,NBS
chr02,Bn6040,97162466,98668607,1506141,RLK
chr02,Bn6041,3575909,38440666,34864757,RLP
chr02,Bn6042,56336206,77175638,20839432,TNL
chr02,Bn6043,64373559,85027907,20654348,CN
chr02,Bn6044,18932578,33965923,15033345,RLK
chr02,Bn6045,65445775,82827981,17382206,CN
chr02,Bn6046,74891100,77075081,2183981,RLK
chr02,Bn6047,49034203,86743172,37708969,RLP
chr02,Bn6048,56933727,87037246,30103519,RLK
chr02,Bn6049,66943376,68483870,1540494,NBS
chr02,Bn6050,81738970,89854234,8115264,NBS
chr02,Bn6051,67992818,86078327,18085509,TNL
chr02,Bn6052,32274886,50554812,18279926,NBS
chr02,Bn6053,84816600,85446341,629741,CNL
chr02,Bn6054,57414211,63740347,6326136,TNL
chr02,Bn6055,4736845,95093491,90356646,TN
chr02,Bn6056,21994664,74986202,52991538,RLK
chr02,Bn6057,93776709,99969636,6192927,CN
chr02,Bn6058,90184963,97547445,7362482,TNL
chr02,Bn6059,61559741,88661436,27101695,TN
chr02,Bn6060,35582621,73167664,37585043,CN
chr02,Bn6061,86744418,87195407,450989,CNL
chr02,Bn6062,8108598,13554429,5445831,RLK
chr02,Bn6063,1750659,45568876,43818217,RLP
chr02,Bn6064,23082907,82846395,59763488,CN
chr02,Bn6065,51105563,80142690,29037127,TN
chr02,Bn6066,11250448,94717611,83467163,CNL
chr02,Bn6067,10617641,71715043,61097402,RLK
chr02,Bn6068,71077207,95969215,24892008,CN
chr02,Bn6069,40035322,78036136,38000814,NBS
chr02,Bn6070,22548439,50257525,27709086,RLP
chr02,Bn6071,27183060,71364198,44181138,TNL
chr02,Bn6072,86253996,95796182,9542186,CNL
chr02,Bn6073,19854918,55870493,36015575,CN
chr02,Bn6074,97484455,98513970,1029515,CN
chr02,Bn6075,32983135,75547413,42564278,TNL
chr02,Bn6076,55518771,65071697,9552926,CN
chr02,Bn6077,56483954,79412952,22928998,NBS
chr02,Bn6078,17990230,61426394,43436164,CN
chr02,Bn6079,34706294,41120323,6414029,CNL
chr02,Bn6080,81044855,93787801,12742946,NBS
chr02,Bn6081,74375611,78402979,4027368,TN
chr02,Bn6082,45451009,49214229,3763220,TNL
chr02,Bn6083,18247141,62227716,43980575,NBS
chr02,Bn6084,82993353,88306866,5313513,RLP
chr02,Bn6085,29922464,61200002,31277538,TNL
chr02,Bn6086,25325644,30769138,5443494,NBS
chr02,Bn6087,22815497,35426581,12611084,CNL
chr02,Bn6088,24053200,59299828,35246628,CNL
chr02,Bn6089,11944072,80166210,68222138,TNL
chr02,Bn6090,76159680,83140226,6980546,RLP
chr02,Bn6091,55063074,92561664,37498590,NBS
chr02,Bn6092,66395249,84376381,17981132,CNL
chr02,Bn6093,5513416,78444882,72931466,CN
chr02,Bn6094,31943729,91416230,59472501,CN
chr02,Bn6095,28763647,59569580,30805933,RLK
chr02,Bn6096,13596262,77863602,64267340,TNL
chr02,Bn6097,70397804,94425075,24027271,TNL
chr02,Bn6098,37022265,80054866,43032601,RLK
chr02,Bn6099,82545266,84404659,1859393,TN
chr02,Bn6100,22423222,23905895,1482673,CN
chr02,Bn6101,38058010,40296152,2238142,RLK
chr02,Bn6102,96694249,99422508,2728259,TNL
chr02,Bn6103,64272755,78448358,14175603,CNL
chr02,Bn6104,58104479,68832213,10727734,CN
chr02,Bn6105,42423163,87640743,45217580,RLK
chr02,Bn6106,42959747,44872717,1912970,CNL
chr02,Bn6107,16990540,92126746,75136206,TN
chr02,Bn6108,42880197,67568972,24688775,TN
chr02,Bn6109,85988704,96801371,10812667,TN
chr02,Bn6110,36521114,60461903,23940789,CNL
chr02,Bn6111,38126925,47433166,9306241,RLP
chr02,Bn6112,86687412,93674694,6987282,NBS
chr02,Bn6113,87768270,90175237,2406967,TN
chr02,Bn6114,15981000,24887847,8906847,RLP
chr02,Bn6115,14006865,52406608,38399743,NBS
chr02,Bn6116,36959023,48252669,11293646,RLP
chr02,Bn6117,23472570,77044592,53572022,NBS
chr02,Bn6118,99764247,99949073,184826,CNL
chr02,Bn6119,89715892,99587699,9871807,RLK
chr02,Bn6120,29227500,93003371,63775871,TNL
chr02,Bn6121,97101471,98437424,1335953,RLP
chr02,Bn6122,50439863,71583972,21144109,TN
chr02,Bn6123,6182263,11777321,5595058,NBS
chr02,Bn6124,29793988,35323881,5529893,NBS
chr02,Bn6125,60154187,60916191,762004,CN
chr02,Bn6126,55111022,60474400,5363378,CNL
chr02,Bn6127,5358964,13123219,7764255,NBS
chr02,Bn6128,60902143,63912256,3010113,CNL
chr02,Bn6129,39668958,68601475,28932517,NBS
chr02,Bn6130,48635656,60437911,11802255,TNL
chr02,Bn6131,92771694,98897506,6125812,TNL
chr02,Bn6132,71869562,87837226,15967664,RLK
chr02,Bn6133,93982171,98932783,4950612,CNL
chr02,Bn6134,88990109,93259051,4268942,TNL
chr02,Bn6135,48880258,66273220,17392962,TNL
chr02,Bn6136,89465586,97056849,7591263,TNL
chr02,Bn6137,35718582,87356134,51637552,TNL
chr02,Bn6138,18159691,33482413,15322722,CN
chr02,Bn6139,63510829,77817218,14306389,CNL
chr02,Bn6140,5965306,24721032,18755726,NBS
chr02,Bn6141,5108131,35325755,30217624,RLP
chr02,Bn6142,47969581,48295240,325659,NBS
chr02,Bn6143,80214216,87641482,7427266,CNL
chr02,Bn6144,25291996,74746835,49454839,RLK
chr02,Bn6145,80489002,95385044,14896042,NBS
chr02,Bn6146,21804627,84096476,62291849,CN
chr02,Bn6147,3378698,9553658,6174960,TNL
chr02,Bn6148,28764416,59819020,31054604,CN
chr02,Bn6149,2448602,89803720,87355118,CN
chr02,Bn6150,18085072,45953362,27868290,CN
chr02,Bn6151,40426369,58107958,17681589,NBS
chr02,Bn6152,4275934,58804783,54528849,CNL
chr02,Bn6153,32716710,39617575,6900865,RLP
chr02,Bn6154,57151385,73790615,16639230,RLK
chr02,Bn6155,83626799,86482920,2856121,TN
chr02,Bn6156,69912365,90329120,20416755,NBS
chr02,Bn6157,54717281,94362364,39645083,CN
chr02,Bn6158,77882881,82886040,5003159,CN
chr02,Bn6159,74236962,79827809,5590847,TN
chr02,Bn6160,52453879,97503345,45049466,NBS
chr02,Bn6161,77696080,92100027,14403947,RLP
chr02,Bn6162,31201602,98145079,66943477,RLK
chr02,Bn6163,91967182,96088997,4121815,CN
chr02,Bn6164,44752502,50640128,5887626,CNL
chr02,Bn6165,92593711,94577232,1983521,TN
chr02,Bn6166,98237855,99528699,1290844,CNL
chr02,Bn6167,36744560,94415952,57671392,RLP
chr02,Bn6168,66889469,78403285,11513816,CNL
chr02,Bn6169,25759893,40466106,14706213,RLP
chr02,Bn6170,11600959,54546969,42946010,TN
chr02,Bn6171,22699292,67494734,44795442,RLP
chr02,Bn6172,32769422,73095484,40326062,RLP
chr02,Bn6173,84840474,87290991,2450517,TNL
chr02,Bn6174,33465765,66172442,32706677,CNL
chr02,Bn6175,54195755,99922735,45726980,NBS
chr02,Bn6176,59482011,64991443,5509432,CN
chr02,Bn6177,28912692,62758896,33846204,CN
chr02,Bn6178,88105747,99208996,11103249,CN
chr02,Bn6179,53857914,84700576,30842662,TNL
chr02,Bn6180,49892795,55318694,5425899,RLP
chr02,Bn6181,20355050,76699244,56344194,TN
chr02,Bn6182,9807581,31354652,21547071,CNL
chr02,Bn6183,51364903,88636640,37271737,RLP
chr02,Bn6184,58256629,97793218,39536589,CNL
chr02,Bn6185,31644062,68462485,36818423,RLK
chr02,Bn6186,78327749,94376161,16048412,TN
chr02,Bn6187,7829539,31054823,23225284,CNL
chr02,Bn6188,21866326,65246769,43380443,TN
chr02,Bn6189,77590645,83098093,5507448,RLP
chr02,Bn6190,36146403,82182255,46035852,RLK
chr02,Bn6191,40079150,75143354,35064204,TN
chr02,Bn6192,11146020,83009828,71863808,NBS
chr02,Bn6193,62682498,78855700,16173202,TN
chr02,Bn6194,17997423,61310885,43313462,CNL
chr02,Bn6195,1355655,98110081,96754426,CN
chr02,Bn6196,42656092,43725182,1069090,RLP
chr02,Bn6197,98416214,99136894,720680,NBS
chr02,Bn6198,23805396,36807017,13001621,TN
chr02,Bn6199,88469902,92475608,4005706,RLK
chr02,Bn6200,37281252,61303327,24022075,RLP
chr02,Bn6201,62222168,91119905,28897737,TNL
chr02,Bn6202,36428803,98346187,61917384,TN
chr02,Bn6203,90331799,92571708,2239909,NBS
chr02,Bn6204,34170460,87465075,53294615,RLP
chr02,Bn6205,42572418,94099944,51527526,TNL
chr02,Bn6206,2619198,84711572,82092374,CNL
chr02,Bn6207,11318687,75730906,64412219,NBS
chr02,Bn6208,59214331,59883370,669039,RLK
chr02,Bn6209,78360944,84771202,6410258,CN
chr02,Bn6210,57637376,74799234,17161858,CN
chr02,Bn6211,14123295,40866890,26743595,RLK
chr02,Bn6212,47357978,88027488,40669510,CN
chr02,Bn6213,6932745,13281182,6348437,RLP
chr02,Bn6214,76971425,94995561,18024136,RLK
chr02,Bn6215,67631372,70623943,2992571,CNL
chr02,Bn6216,56766337,70119615,13353278,RLK
chr02,Bn6217,91963414,97274076,5310662,NBS
chr02,Bn6218,86771457,89492883,2721426,CNL
chr02,Bn6219,2477377,16902621,14425244,CN
chr02,Bn6220,85029237,96202841,11173604,NBS
chr02,Bn6221,93836054,96315900,2479846,CNL
chr02,Bn6222,11312756,56979901,45667145,CNL
chr02,Bn6223,84581467,93043821,8462354,CN
chr02,Bn6224,81687741,98276685,16588944,NBS
chr02,Bn6225,10612151,33219618,22607467,CNL
chr02,Bn6226,45694518,76613018,30918500,TN
chr02,Bn6227,14377681,52733911,38356230,TNL
chr02,Bn6228,24340061,93440421,69100360,RLK
chr02,Bn6229,14440614,68324276,53883662,TNL
chr02,Bn6230,4182766,71269483,67086717,TNL
chr02,Bn6231,96857150,99148717,2291567,RLK
chr02,Bn6232,87867978,97232671,9364693,NBS
chr02,Bn6233,19609985,35326004,15716019,TNL
chr02,Bn6234,59175680,99094806,39919126,CNL
chr02,Bn6235,92946043,97914737,4968694,CN
chr02,Bn6236,16634656,17193578,558922,NBS
chr02,Bn6237,81069624,88859152,7789528,RLP
chr02,Bn6238,52382381,95531401,43149020,RLK
chr02,Bn6239,65519702,90092137,24572435,NBS
chr02,Bn6240,42967891,65106161,22138270,RLP
chr02,Bn6241,71246280,72245664,999384,RLK
chr02,Bn6242,8085901,54560655,46474754,RLP
chr02,Bn6243,5570834,18665753,13094919,CN
chr02,Bn6244,21994129,44450719,22456590,CNL
chr02,Bn6245,62169434,81675791,19506357,TNL
chr02,Bn6246,76597162,89386661,12789499,RLP
chr02,Bn6247,35880442,45594401,9713959,RLK
chr02,Bn6248,88733875,89144869,410994,CN
chr02,Bn6249,21095835,81524191,60428356,TNL
chr02,Bn6250,94585048,97532792,2947744,TNL
chr02,Bn6251,73565673,83536737,9971064,RLK
chr02,Bn6252,89864289,93406298,3542009,TNL
chr02,Bn6253,33474528,59855517,26380989,CN
chr02,Bn6254,48040028,74251292,26211264,TN
chr02,Bn6255,11008372,38881624,27873252,TN
chr02,Bn6256,11968264,75051112,63082848,TN
chr02,Bn6257,5593881,45979491,40385610,CNL
chr02,Bn6258,31348624,87687419,56338795,CN
chr02,Bn6259,11823131,59871973,48048842,RLK
chr02,Bn6260,52619614,84358022,31738408,NBS
chr02,Bn6261,77609428,98948446,21339018,RLP
chr02,Bn6262,59116231,61376940,2260709,CNL
chr02,Bn6263,62921377,88910362,25988985,RLP
chr02,Bn6264,97845836,97895397,49561,TNL
chr02,Bn6265,74877205,78179925,3302720,RLP
chr02,Bn6266,27193537,49618961,22425424,CN
chr02,Bn6267,33562281,40610611,7048330,RLK
chr02,Bn6268,97278997,99109592,1830595,TN
chr02,Bn6269,76730831,98559676,21828845,NBS
chr02,Bn6270,77234500,95971774,18737274,RLP
chr02,Bn6271,84252393,86073021,1820628,RLK
chr02,Bn6272,60041868,60881403,839535,RLK
chr02,Bn6273,53503160,64729852,11226692,RLP
chr02,Bn6274,16277214,94929623,78652409,NBS
chr02,Bn6275,96614648,99407598,2792950,RLP
chr02,Bn6276,20986889,80733118,59746229,TNL
chr02,Bn6277,97776091,98220763,444672,CNL
chr02,Bn6278,95080391,95661801,581410,CN
chr02,Bn6279,11103007,73568278,62465271,CN
chr02,Bn6280,87025972,95141957,8115985,RLK
chr02,Bn6281,66924780,75239282,8314502,TN
chr02,Bn6282,69178172,89615022,20436850,RLK
chr02,Bn6283,40634469,93232201,52597732,TN
chr02,Bn6284,40206432,58025441,17819009,RLP
chr02,Bn6285,30769224,80870603,50101379,RLK
chr02,Bn6286,90872898,93699022,2826124,NBS
chr02,Bn6287,77965344,85067928,7102584,RLK
chr02,Bn6288,41516544,96161108,54644564,TN
chr02,Bn6289,82019277,87775973,5756696,CN
chr02,Bn6290,28693277,87594574,58901297,CN
chr02,Bn6291,76323029,97744233,21421204,CN
chr02,Bn6292,63011507,92751747,29740240,TN
chr02,Bn6293,11403195,11692646,289451,RLK
chr02,Bn6294,33806249,87837960,54031711,RLP
chr02,Bn6295,33846429,43555358,9708929,NBS
chr02,Bn6296,37361775,98513735,61151960,NBS
chr02,Bn6297,74623018,97053584,22430566,RLP
chr02,Bn6298,42602524,97703673,55101149,TN
chr02,Bn6299,28986358,87186598,58200240,RLP
chr02,Bn6300,10747672,36409078,25661406,TN
chr02,Bn6301,60072884,67365733,7292849,TN
chr02,Bn6302,88376436,92835594,4459158,TNL
chr02,Bn6303,64501127,88118544,23617417,CNL
chr02,Bn6304,60197464,93877100,33679636,CNL
chr02,Bn6305,78955104,96628598,17673494,CNL
chr02,Bn6306,48696677,84568740,35872063,CN
chr02,Bn6307,77078192,94007327,16929135,TN
chr02,Bn6308,14359568,84421117,70061549,NBS
chr02,Bn6309,76421964,90794585,14372621,RLP
chr02,Bn6310,43637370,90163293,46525923,TNL
chr02,Bn6311,28187230,38513746,10326516,NBS
chr02,Bn6312,13604864,34447063,20842199,TNL
chr02,Bn6313,92227858,92787482,559624,RLP
chr02,Bn6314,88240306,99492870,11252564,CNL
chr02,Bn6315,12601977,91013562,78411585,RLP
chr02,Bn6316,46430219,80788845,34358626,CN
chr02,Bn6317,1391028,52105342,50714314,NBS
chr02,Bn6318,58180211,62474004,4293793,CNL
chr02,Bn6319,57509087,98838121,41329034,TNL
chr02,Bn6320,59840070,66667942,6827872,TNL
chr02,Bn6321,38475986,50396817,11920831,CNL
chr02,Bn6322,17776552,20274899,2498347,CN
chr02,Bn6323,63450453,67284089,3833636,CNL
chr02,Bn6324,88585458,90768249,2182791,CNL
chr02,Bn6325,36704225,80547414,43843189,NBS
chr02,Bn6326,28641758,72756423,44114665,RLK
chr02,Bn6327,91558556,98732719,7174163,RLK
chr02,Bn6328,15122533,35252548,20130015,TNL
chr02,Bn6329,39716471,71356600,31640129,TN
chr02,Bn6330,45993977,82061836,36067859,TNL
chr02,Bn6331,81508417,92324385,10815968,TNL
chr02,Bn6332,83175125,94769235,11594110,CNL
chr02,Bn6333,71091108,79416920,8325812,CNL
chr02,Bn6334,34212771,58334098,24121327,NBS
chr02,Bn6335,23412786,38502094,15089308,RLK
chr02,Bn6336,25660047,67044917,41384870,RLP
chr02,Bn6337,65744191,81377189,15632998,RLP
chr02,Bn6338,45620523,52246534,6626011,TNL
chr02,Bn6339,28497106,73047029,44549923,RLK
chr02,Bn6340,47097386,49970668,2873282,NBS
chr02,Bn6341,84225016,84378162,153146,NBS
chr02,Bn6342,86743732,99485423,12741691,CNL
chr02,Bn6343,42351250,86062367,43711117,NBS
chr02,Bn6344,96189078,98795792,2606714,CN
chr02,Bn6345,3263590,12595017,9331427,NBS
chr02,Bn6346,68826819,93119952,24293133,NBS
chr02,Bn6347,24700091,98794751,74094660,CNL
chr02,Bn6348,15991158,97041173,81050015,RLP
chr02,Bn6349,76997763,85932740,8934977,TNL
chr02,Bn6350,72785210,76599704,3814494,CN
chr02,Bn6351,53684695,96907598,43222903,RLP
chr02,Bn6352,62787552,82662640,19875088,CN
chr02,Bn6353,43162191,90788592,47626401,CNL
chr02,Bn6354,29793018,34324278,4531260,RLK
chr02,Bn6355,74553163,94418019,19864856,NBS
chr02,Bn6356,22324886,84555753,62230867,RLK
chr02,Bn6357,48621002,90859925,42238923,TNL
chr02,Bn6358,61191327,70939290,9747963,RLP
chr02,Bn6359,23956596,37812271,13855675,NBS
chr02,Bn6360,64286869,98029963,33743094,CNL
chr02,Bn6361,2614189,68056579,65442390,NBS
chr02,Bn6362,67726788,86273757,18546969,TNL
chr02,Bn6363,68327783,73237794,4910011,RLP
chr02,Bn6364,60715105,73600623,12885518,CNL
chr02,Bn6365,81834929,83024747,1189818,TN
chr02,Bn6366,69326018,93655511,24329493,CN
chr02,Bn6367,35192021,42397345,7205324,CN
chr02,Bn6368,71704549,74270175,2565626,TNL
chr02,Bn6369,45550358,49101050,3550692,TNL
chr02,Bn6370,90212398,92806026,2593628,RLP
chr02,Bn6371,55796584,90994719,35198135,TNL
chr02,Bn6372,84993386,99492340,14498954,RLK
chr02,Bn6373,69727737,86373914,16646177,TNL
chr02,Bn6374,14741010,58352605,43611595,RLK
chr02,Bn6375,87263453,90170219,2906766,TNL
chr02,Bn6376,99108915,99319805,210890,CNL
chr02,Bn6377,11004294,97963632,86959338,NBS
chr02,Bn6378,23444284,26161303,2717019,TN
chr02,Bn6379,67688562,83409142,15720580,TN
chr02,Bn6380,93127402,99903037,6775635,NBS
chr02,Bn6381,34314408,44752427,10438019,TNL
chr02,Bn6382,54784626,80791616,26006990,CN
chr02,Bn6383,2839912,36176530,33336618,TN
chr02,Bn6384,64985707,95610315,30624608,TNL
chr02,Bn6385,23458670,43304303,19845633,NBS
chr02,Bn6386,52811392,80580722,27769330,TNL
chr02,Bn6387,33359911,36932855,3572944,TN
chr02,Bn6388,62043587,82674588,20631001,TNL
chr02,Bn6389,14612723,61077164,46464441,TN
chr02,Bn6390,29521100,64981050,35459950,RLK
chr02,Bn6391,88143917,99834498,11690581,RLP
chr02,Bn6392,72090004,88395932,16305928,CN
chr02,Bn6393,25843469,90009243,64165774,CNL
chr02,Bn6394,77473141,88092247,10619106,CN
chr02,Bn6395,88373659,93544537,5170878,RLP
chr02,Bn6396,92119452,97522052,5402600,CNL
chr02,Bn6397,85126232,87802154,2675922,NBS
chr02,Bn6398,36600758,71679933,35079175,CNL
chr02,Bn6399,80582185,90890235,10308050,CNL
chr02,Bn6400,13938748,70207430,56268682,NBS
chr02,Bn6401,65451184,91385304,25934120,TNL
chr02,Bn6402,98352629,99518694,1166065,CNL
chr02,Bn6403,63351853,68328771,4976918,CNL
chr02,Bn6404,41306403,41976593,670190,CNL
chr02,Bn6405,96001262,97288763,1287501,TNL
chr02,Bn6406,68195939,77267071,9071132,CN
chr02,Bn6407,72130831,79239462,7108631,CNL
chr02,Bn6408,46092068,54778994,8686926,RLK
chr02,Bn6409,32291043,94669386,62378343,TNL
chr02,Bn6410,35447720,80019482,44571762,CNL
chr02,Bn6411,87174491,87400863,226372,NBS
chr02,Bn6412,57500226,60636503,3136277,TN
chr02,Bn6413,13681971,98425812,84743841,NBS
chr02,Bn6414,36569320,41729579,5160259,CNL
chr02,Bn6415,63526401,75876070,12349669,TNL
chr02,Bn6416,67875189,84613339,16738150,TN
chr02,Bn6417,89596294,98005242,8408948,TN
chr02,Bn6418,95331264,96690917,1359653,CNL
chr02,Bn6419,25825040,50114694,24289654,RLK
chr02,Bn6420,95677992,96601068,923076,RLP
chr02,Bn6421,56964667,88245076,31280409,CNL
chr02,Bn6422,18322230,72453430,54131200,RLK
chr02,Bn6423,16716069,50160384,33444315,NBS
chr02,Bn6424,30560836,98066703,67505867,NBS
chr02,Bn6425,31407853,74682298,43274445,CNL
chr02,Bn6426,38107185,81663397,43556212,TN
chr02,Bn6427,3068690,86126220,83057530,RLK
chr02,Bn6428,81814946,97219163,15404217,NBS
chr02,Bn6429,60131789,76085493,15953704,RLK
chr02,Bn6430,70192078,70502870,310792,CN
chr02,Bn6431,17855757,32728012,14872255,TNL
chr02,Bn6432,47040503,66276313,19235810,RLK
chr02,Bn6433,7312308,39803888,32491580,RLP
chr02,Bn6434,84886199,95223943,10337744,CNL
chr02,Bn6435,78017678,84445985,6428307,RLP
chr02,Bn6436,41641934,43509413,1867479,NBS
chr02,Bn6437,7106026,15872255,8766229,CN
chr02,Bn6438,38412239,42086768,3674529,CN
chr02,Bn6439,55946837,73852070,17905233,CNL
chr02,Bn6440,90594548,99755605,9161057,CNL
chr02,Bn6441,84158789,84988911,830122,NBS
chr02,Bn6442,71461714,89346479,17884765,NBS
chr02,Bn6443,12892100,96164280,83272180,NBS
chr02,Bn6444,25937021,67609512,41672491,RLP
chr02,Bn6445,3343118,70184179,66841061,TN
chr02,Bn6446,56516084,71538492,15022408,TN
chr02,Bn6447,16535207,96083736,79548529,CNL
chr02,Bn6448,92396448,95190546,2794098,CN
chr02,Bn6449,32327604,95261413,62933809,CN
chr02,Bn6450,8073966,92330704,84256738,RLP
chr02,Bn6451,65115366,72804971,7689605,CN
chr02,Bn6452,6068881,16272886,10204005,TN
chr02,Bn6453,72131893,99210876,27078983,NBS
chr02,Bn6454,1785929,22669302,20883373,NBS
chr02,Bn6455,65421551,88662888,23241337,RLK
chr02,Bn6456,50948556,86314102,35365546,TN
chr02,Bn6457,53541040,69742374,16201334,TNL
chr02,Bn6458,36221485,90719857,54498372,TN
chr02,Bn6459,84157417,89828155,5670738,RLP
chr02,Bn6460,93483746,96917597,3433851,CN
chr02,Bn6461,62768291,62859955,91664,TN
chr02,Bn6462,90548529,95181141,4632612,NBS
chr02,Bn6463,21605560,72872824,51267264,CN
chr02,Bn6464,19645281,92842453,73197172,TN
chr02,Bn6465,49058217,60571839,11513622,RLP
chr02,Bn6466,70207557,98236738,28029181,TNL
chr02,Bn6467,71604711,84487535,12882824,CN
chr02,Bn6468,37940346,45329568,7389222,NBS
chr02,Bn6469,44121890,61242941,17121051,RLK
chr02,Bn6470,87073577,89091918,2018341,TN
chr02,Bn6471,87599599,95686930,8087331,TN
chr02,Bn6472,17328037,49701090,32373053,TNL
chr02,Bn6473,62721693,91280989,28559296,CNL
chr02,Bn6474,97409319,99181557,1772238,NBS
chr02,Bn6475,1771881,12950671,11178790,NBS
chr02,Bn6476,20705093,51119781,30414688,RLK
chr02,Bn6477,71171471,95313609,24142138,CN
chr02,Bn6478,21787150,71928954,50141804,CNL
chr02,Bn6479,39255941,48933389,9677448,NBS
chr02,Bn6480,64788152,88537980,23749828,RLK
chr02,Bn6481,85836331,90711284,4874953,NBS
chr02,Bn6482,16141288,37909942,21768654,TNL
chr02,Bn6483,37782154,85710447,47928293,NBS
chr02,Bn6484,13739810,83137478,69397668,CNL
chr02,Bn6485,77408968,96397195,18988227,TN
chr02,Bn6486,30095753,59243506,29147753,NBS
chr02,Bn6487,82425188,96718340,14293152,TN
chr02,Bn6488,57289003,90518305,33229302,CN
chr02,Bn6489,9310108,26030394,16720286,CN
chr02,Bn6490,48324034,65698526,17374492,CN
chr02,Bn6491,20805397,91880358,71074961,TN
chr02,Bn6492,82037069,92504446,10467377,TNL
chr02,Bn6493,55618124,83328512,27710388,NBS
chr02,Bn6494,33359939,67433163,34073224,TN
chr02,Bn6495,80402854,94746395,14343541,TNL
chr02,Bn6496,5645177,32017892,26372715,NBS
chr02,Bn6497,35871173,79470627,43599454,TNL
chr02,Bn6498,81946200,87419264,5473064,CNL
chr02,Bn6499,66546156,99224494,32678338,TN
chr02,Bn6500,70504860,74115948,3611088,NBS
chr02,Bn6501,2265740,67515058,65249318,RLK
chr02,Bn6502,26780583,43270389,16489806,TNL
chr02,Bn6503,61676210,82141744,20465534,RLK
chr02,Bn6504,8035710,54474427,46438717,RLK
chr02,Bn6505,87835948,96021423,8185475,TNL
chr02,Bn6506,9345591,96867371,87521780,TNL
chr02,Bn6507,53486972,79643130,26156158,TN
chr02,Bn6508,59771794,69417879,9646085,CNL
chr02,Bn6509,60945923,86980441,26034518,CNL
chr02,Bn6510,64865419,67964385,3098966,TN
chr02,Bn6511,96520752,98695760,2175008,TN
chr02,Bn6512,29530331,56670925,27140594,NBS
chr02,Bn6513,37775277,87034107,49258830,RLK
chr02,Bn6514,21440803,97010338,75569535,RLP
chr02,Bn6515,87250634,95463578,8212944,NBS
chr02,Bn6516,42132506,53737578,11605072,CN
chr02,Bn6517,23212680,24035103,822423,NBS
chr02,Bn6518,63232183,84589040,21356857,CNL
chr02,Bn6519,43275888,93830135,50554247,CN
chr02,Bn6520,75546132,78689021,3142889,NBS
chr02,Bn6521,72913134,79367624,6454490,CN
chr02,Bn6522,95927478,97864076,1936598,CNL
chr02,Bn6523,33609772,96531842,62922070,CN
chr02,Bn6524,65730341,97811862,32081521,CNL
chr02,Bn6525,80726241,95297347,14571106,CN
chr02,Bn6526,52651027,76321745,23670718,RLP
chr02,Bn6527,91131208,92826780,1695572,TN
chr02,Bn6528,72760921,81085487,8324566,TN
chr02,Bn6529,96242409,96867638,625229,RLK
chr02,Bn6530,27167535,87880654,60713119,NBS
chr02,Bn6531,7576490,91875097,84298607,TNL
chr02,Bn6532,92225409,98452167,6226758,NBS
chr02,Bn6533,7552321,66111501,58559180,NBS
chr02,Bn6534,92977506,94720662,1743156,RLK
chr02,Bn6535,63564572,64272616,708044,RLK
chr02,Bn6536,77871017,99097794,21226777,RLP
chr02,Bn6537,63901241,84683816,20782575,CN
chr02,Bn6538,45965277,68704163,22738886,TN
chr02,Bn6539,39464701,79506341,40041640,TNL
chr02,Bn6540,95814498,97155441,1340943,NBS
chr02,Bn6541,41534086,55975140,14441054,TNL
chr02,Bn6542,4002404,31944627,27942223,NBS
chr02,Bn6543,44146924,95584262,51437338,CN
chr02,Bn6544,50676010,71765266,21089256,RLK
chr02,Bn6545,48703966,95605184,46901218,RLK
chr02,Bn6546,25075804,87013639,61937835,RLP
chr02,Bn6547,79583181,86132512,6549331,RLP
chr02,Bn6548,63501317,94745184,31243867,CNL
chr02,Bn6549,97292088,98442122,1150034,RLP
chr02,Bn6550,1665710,95572385,93906675,NBS
chr02,Bn6551,85196793,98362112,13165319,TN
chr02,Bn6552,80015140,95558531,15543391,RLK
chr02,Bn6553,37533013,82579191,45046178,RLP
chr02,Bn6554,14378484,42971854,28593370,RLK
chr02,Bn6555,92208218,97995046,5786828,NBS
chr02,Bn6556,38734772,84202904,45468132,CNL
chr02,Bn6557,47576842,50385808,2808966,CNL
chr02,Bn6558,54951936,55980287,1028351,TNL
chr02,Bn6559,17691310,96930723,79239413,TN
chr02,Bn6560,48922581,80343599,31421018,NBS
chr02,Bn6561,42777693,66559756,23782063,CNL
chr02,Bn6562,32298187,45672062,13373875,TN
chr02,Bn6563,66821805,83614179,16792374,NBS
chr02,Bn6564,43325544,99178313,55852769,NBS
chr02,Bn6565,17815231,87653142,69837911,CNL
chr02,Bn6566,22086420,51751339,29664919,CNL
chr02,Bn6567,26865375,66301028,39435653,CNL
chr02,Bn6568,95338914,97962575,2623661,RLP
chr02,Bn6569,92557383,97179765,4622382,RLK
chr02,Bn6570,16316101,76920880,60604779,RLP
chr02,Bn6571,10685599,65826296,55140697,CNL
chr02,Bn6572,52558908,64922621,12363713,NBS
chr02,Bn6573,6873031,64225813,57352782,NBS
chr02,Bn6574,11564036,63362322,51798286,RLP
chr02,Bn6575,52442822,99342002,46899180,TNL
chr02,Bn6576,98714248,99278161,563913,TN
chr02,Bn6577,32001099,98035382,66034283,RLK
chr02,Bn6578,13056430,72976487,59920057,CN
chr02,Bn6579,78794715,94127445,15332730,CN
chr02,Bn6580,18895346,74080573,55185227,TN
chr02,Bn6581,29539092,96239021,66699929,CNL
chr02,Bn6582,71832514,73476183,1643669,CN
chr02,Bn6583,59893359,85486114,25592755,TNL
chr02,Bn6584,9671854,71328624,61656770,RLK
chr02,Bn6585,23276360,84482367,61206007,TNL
chr02,Bn6586,75258441,88570043,13311602,TN
chr02,Bn6587,49893924,57777283,7883359,RLK
chr02,Bn6588,60956201,99857505,38901304,NBS
chr02,Bn6589,40771320,90559251,49787931,CN
chr02,Bn6590,71459175,76514366,5055191,NBS
chr02,Bn6591,6254424,36471159,30216735,RLP
chr02,Bn6592,80396455,90310608,9914153,TN
chr02,Bn6593,71275905,81113931,9838026,RLP
chr02,Bn6594,35183043,43317071,8134028,TNL
chr02,Bn6595,20512014,78816762,58304748,RLK
chr02,Bn6596,29253750,34801172,5547422,RLK
chr02,Bn6597,6367397,71311705,64944308,RLP
chr02,Bn6598,43276719,88902042,45625323,RLK
chr02,Bn6599,67840593,76850154,9009561,RLK
chr02,Bn6600,78077925,81223777,3145852,NBS
chr02,Bn6601,13887553,75138415,61250862,TNL
chr02,Bn6602,10518205,84786680,74268475,CNL
chr02,Bn6603,65562969,68449791,2886822,RLP
chr02,Bn6604,84464099,95475706,11011607,NBS
chr02,Bn6605,44798743,93140860,48342117,CNL
chr02,Bn6606,27727609,49463279,21735670,CN
chr02,Bn6607,58602899,84644709,26041810,RLK
chr02,Bn6608,35655212,41090486,5435274,CNL
chr02,Bn6609,50378145,82840186,32462041,CN
chr02,Bn6610,69574156,94736645,25162489,NBS
chr02,Bn6611,63805487,76137690,12332203,TNL
chr02,Bn6612,15302909,67020742,51717833,NBS
chr02,Bn6613,24233634,54135173,29901539,NBS
chr02,Bn6614,70142375,88522883,18380508,CNL
chr02,Bn6615,9614637,47357262,37742625,RLP
chr02,Bn6616,22691925,60145609,37453684,TN
chr02,Bn6617,82314291,95092372,12778081,CNL
chr02,Bn6618,42781996,91119566,48337570,CN
chr02,Bn6619,91094069,99036388,7942319,NBS
chr02,Bn6620,43380521,65398174,22017653,NBS
chr02,Bn6621,10996133,17094657,6098524,CN
chr02,Bn6622,33609517,84113650,50504133,NBS
chr02,Bn6623,10063388,84818428,74755040,CNL
chr02,Bn6624,7423705,13078429,5654724,CN
chr02,Bn6625,54136318,58652960,4516642,TNL
chr02,Bn6626,93644752,96950102,3305350,RLK
chr02,Bn6627,36962272,38276533,1314261,NBS
chr02,Bn6628,90193094,91554414,1361320,TNL
chr02,Bn6629,96532040,99322537,2790497,TNL
chr02,Bn6630,11123352,53295900,42172548,RLK
chr02,Bn6631,84281706,91064855,6783149,TN
chr02,Bn6632,79810263,83713776,3903513,NBS
chr02,Bn6633,68816728,87688855,18872127,RLP
chr02,Bn6634,27611675,44306383,16694708,CN
chr02,Bn6635,26786681,50077443,23290762,RLP
chr02,Bn6636,63988430,76542186,12553756,RLP
chr02,Bn6637,94366336,97985570,3619234,TN
chr02,Bn6638,59312966,98212378,38899412,NBS
chr02,Bn6639,40123327,70836407,30713080,CN
chr02,Bn6640,58351610,66227113,7875503,CNL
chr02,Bn6641,9773214,25691547,15918333,CN
chr02,Bn6642,41044630,74161796,33117166,NBS
chr02,Bn6643,99008843,99626861,618018,CNL
chr02,Bn6644,86150731,98147661,11996930,RLK
chr02,Bn6645,28089687,50830486,22740799,RLP
chr02,Bn6646,27689312,85849929,58160617,TNL
chr02,Bn6647,40547831,93969847,53422016,CNL
chr02,Bn6648,60527063,83444304,22917241,CNL
chr02,Bn6649,6783188,97829914,91046726,CNL
chr02,Bn6650,94291129,96030018,1738889,CNL
chr02,Bn6651,82954071,96731061,13776990,RLK
chr02,Bn6652,74520508,96442310,21921802,NBS
chr02,Bn6653,73663998,93474616,19810618,RLK
chr02,Bn6654,22639282,82932874,60293592,RLK
chr02,Bn6655,37546545,58200966,20654421,TNL
chr02,Bn6656,50014043,59633206,9619163,RLK
chr02,Bn6657,86203417,94878323,8674906,TN
chr02,Bn6658,3201987,14797820,11595833,CN
chr02,Bn6659,54397645,60553834,6156189,TNL
chr02,Bn6660,21719976,59390183,37670207,RLP
chr02,Bn6661,78298224,97428501,19130277,NBS
chr02,Bn6662,21580136,34358281,12778145,RLK
chr02,Bn6663,32585651,56851822,24266171,TN
chr02,Bn6664,69073315,93577859,24504544,NBS
chr02,Bn6665,31513648,71796118,40282470,CN
chr02,Bn6666,42639621,66635119,23995498,CN
chr02,Bn6667,62522682,90634929,28112247,RLK
chr02,Bn6668,58145885,96394572,38248687,TNL
chr02,Bn6669,20906101,58338825,37432724,TN
chr02,Bn6670,29141535,30546496,1404961,TNL
chr02,Bn6671,46776458,74338278,27561820,RLP
chr02,Bn6672,88422859,97738852,9315993,TNL
chr02,Bn6673,21826498,25246610,3420112,CNL
chr02,Bn6674,65352464,96655783,31303319,CN
chr02,Bn6675,22552661,99082965,76530304,NBS
chr02,Bn6676,63690570,91571178,27880608,NBS
chr02,Bn6677,68792698,79026943,10234245,RLP
chr02,Bn6678,98918789,99308997,390208,CNL
chr02,Bn6679,15259481,80175493,64916012,RLK
chr02,Bn6680,4065586,76813040,72747454,CN
chr02,Bn6681,36030810,52303948,16273138,RLP
chr02,Bn6682,17133043,95904370,78771327,TNL
chr02,Bn6683,22806180,44349712,21543532,TNL
chr02,Bn6684,31505940,37502524,5996584,CN
chr02,Bn6685,62889454,84255894,21366440,TNL
chr02,Bn6686,32313737,41026594,8712857,TNL
chr02,Bn6687,98078179,98879308,801129,TNL
chr02,Bn6688,75472882,80805340,5332458,CN
chr02,Bn6689,88288880,95425486,7136606,RLP
chr02,Bn6690,40891270,47559679,6668409,NBS
chr02,Bn6691,46393549,75435138,29041589,TNL
chr02,Bn6692,36543947,55367186,18823239,TNL
chr02,Bn6693,23353744,92447476,69093732,CN
chr02,Bn6694,29419175,78128938,48709763,RLK
chr02,Bn6695,85220449,90599764,5379315,NBS
chr02,Bn6696,16787057,62134803,45347746,RLK
chr02,Bn6697,99016406,99388201,371795,RLK
chr02,Bn6698,83797207,88648410,4851203,CN
chr02,Bn6699,9159091,9638325,479234,CN
chr02,Bn6700,58532701,92751019,34218318,TN
chr02,Bn6701,30640069,60613823,29973754,TNL
chr02,Bn6702,28598603,50658352,22059749,CN
chr02,Bn6703,62767639,70927220,8159581,CNL
chr02,Bn6704,84735974,93161704,8425730,CN
chr02,Bn6705,40474370,96240133,55765763,CNL
chr02,Bn6706,39866590,80368614,40502024,CN
chr02,Bn6707,56562158,94804955,38242797,CN
chr02,Bn6708,24660589,73146318,48485729,TN
chr02,Bn6709,61047179,85595123,24547944,CN
chr02,Bn6710,78121958,92485866,14363908,RLK
chr02,Bn6711,80292069,96738311,16446242,RLK
chr02,Bn6712,55929257,59537370,3608113,NBS
chr02,Bn6713,22161201,58878053,36716852,RLP
chr02,Bn6714,70846881,72864415,2017534,TNL
chr02,Bn6715,94885286,99695845,4810559,NBS
chr02,Bn6716,38539419,66692594,28153175,TN
chr02,Bn6717,86828452,95842075,9013623,NBS
chr02,Bn6718,3488817,34078441,30589624,RLK
chr02,Bn6719,20322609,67766040,47443431,NBS
chr02,Bn6720,64139511,68098306,3958795,TN
chr02,Bn6721,84748115,92505117,7757002,TN
chr02,Bn6722,50362291,73088585,22726294,RLP
chr02,Bn6723,28211482,33719064,5507582,CNL
chr02,Bn6724,88637568,97107038,8469470,RLP
chr02,Bn6725,19496224,61111747,41615523,NBS
chr02,Bn6726,95851124,96382538,531414,RLP
chr02,Bn6727,81287730,87818159,6530429,TNL
chr02,Bn6728,58705048,88426059,29721011,CNL
chr02,Bn6729,20860021,44742265,23882244,CN
chr02,Bn6730,50301548,81327868,31026320,RLK
chr02,Bn6731,40681219,97670543,56989324,CNL
chr02,Bn6732,60263663,71612609,11348946,TN
chr02,Bn6733,81627318,99578818,17951500,RLP
chr02,Bn6734,68409327,74254164,5844837,TN
chr02,Bn6735,59566262,95762032,36195770,NBS
chr02,Bn6736,75041365,79513480,4472115,RLK
chr02,Bn6737,16883350,54797093,37913743,TN
chr02,Bn6738,86530718,97189817,10659099,NBS
chr02,Bn6739,37360426,51545214,14184788,CN
chr02,Bn6740,24850991,64434647,39583656,TNL
chr02,Bn6741,52649839,70977041,18327202,CN
chr02,Bn6742,99358765,99660689,301924,RLP
chr02,Bn6743,65981492,90061034,24079542,TNL
chr02,Bn6744,45976572,85209887,39233315,RLK
chr02,Bn6745,8894912,57474057,48579145,RLK
chr02,Bn6746,38416014,87652823,49236809,NBS
chr02,Bn6747,70875997,76491859,5615862,NBS
chr02,Bn6748,15558247,73474918,57916671,RLP
chr02,Bn6749,80677363,87972049,7294686,TN
chr02,Bn6750,37525444,76423239,38897795,NBS
chr02,Bn6751,84554131,94654950,10100819,TN
chr02,Bn6752,84859108,90106702,5247594,TN
chr02,Bn6753,97208576,97652210,443634,RLP
chr02,Bn6754,83080981,88132984,5052003,CNL
chr02,Bn6755,25481503,91755492,66273989,NBS
chr02,Bn6756,19423799,43515552,24091753,NBS
chr02,Bn6757,90265202,93267000,3001798,CNL
chr02,Bn6758,42899722,57803478,14903756,CNL
chr02,Bn6759,41789311,94825776,53036465,RLK
chr02,Bn6760,78084308,79848995,1764687,RLP
chr02,Bn6761,42658346,79953945,37295599,TN
chr02,Bn6762,44179910,75730526,31550616,CNL
chr02,Bn6763,66276043,71217446,4941403,RLP
chr02,Bn6764,93090937,97389522,4298585,CN
chr02,Bn6765,38721237,87339492,48618255,TN
chr02,Bn6766,66798955,67600795,801840,CNL
chr02,Bn6767,14736791,55761046,41024255,RLK
chr02,Bn6768,57117286,72900314,15783028,TNL
chr02,Bn6769,12940848,54529791,41588943,CNL
chr02,Bn6770,37846473,98112778,60266305,TN
chr02,Bn6771,4905076,84764159,79859083,NBS
chr02,Bn6772,70067124,99099752,29032628,TNL
chr02,Bn6773,42100259,68094731,25994472,TN
chr02,Bn6774,47696669,97768652,50071983,RLK
chr02,Bn6775,45669840,45709195,39355,RLK
chr02,Bn6776,51503691,74964432,23460741,TNL
chr02,Bn6777,40952088,75020885,34068797,TN
chr02,Bn6778,67941315,83395864,15454549,RLK
chr02,Bn6779,63894879,68189991,4295112,CNL
chr02,Bn6780,11858696,22294004,10435308,RLK
chr02,Bn6781,35138163,61001642,25863479,TNL
chr02,Bn6782,72695469,78550682,5855213,TN
chr02,Bn6783,97662994,98978553,1315559,NBS
chr02,Bn6784,32358483,59184183,26825700,TN
chr02,Bn6785,93333124,97563672,4230548,CN
chr02,Bn6786,42225718,79704714,37478996,TNL
chr02,Bn6787,46937549,85262625,38325076,CN
chr02,Bn6788,78558137,98750216,20192079,CN
chr02,Bn6789,88549006,88677129,128123,CNL
chr02,Bn6790,1714153,86029599,84315446,TNL
chr02,Bn6791,23840026,76466506,52626480,RLK
chr02,Bn6792,78503349,87443992,8940643,TN
chr02,Bn6793,76712266,81886212,5173946,NBS
chr02,Bn6794,43844968,93932572,50087604,TN
chr02,Bn6795,12758368,73238492,60480124,NBS
chr02,Bn6796,40188810,77244353,37055543,TNL
chr02,Bn6797,26002442,58824432,32821990,CNL
chr02,Bn6798,45317149,58812497,13495348,NBS
chr02,Bn6799,21186776,35133075,13946299,CN
chr02,Bn6800,83136757,98446244,15309487,TN
chr02,Bn6801,10908181,17953406,7045225,RLP
chr02,Bn6802,41321664,58575592,17253928,RLP
chr02,Bn6803,38636506,69993998,31357492,RLK
chr02,Bn6804,83348588,93618805,10270217,RLK
chr02,Bn6805,72033264,81792899,9759635,CN
chr02,Bn6806,22526246,40188649,17662403,RLK
chr02,Bn6807,64187674,74888855,10701181,NBS
chr02,Bn6808,89908236,99596931,9688695,NBS
chr02,Bn6809,75092583,93786519,18693936,CN
chr02,Bn6810,54386271,65097394,10711123,RLP
chr02,Bn6811,98435081,99622810,1187729,RLP
chr02,Bn6812,43338169,97342861,54004692,CNL
chr02,Bn6813,96311386,96466787,155401,TN
chr02,Bn6814,3456304,93260977,89804673,TNL
chr02,Bn6815,99445587,99450838,5251,TN
chr02,Bn6816,62837196,91920605,29083409,NBS
chr02,Bn6817,69908450,78999556,9091106,RLP
chr02,Bn6818,79656466,90122260,10465794,TNL
chr02,Bn6819,9437486,19029340,9591854,RLK
chr02,Bn6820,86318007,91924330,5606323,NBS
chr02,Bn6821,42490416,86382398,43891982,CNL
chr02,Bn6822,57352541,92667874,35315333,RLK
chr02,Bn6823,1713739,54664893,52951154,CN
chr02,Bn6824,21966969,44942075,22975106,CNL
chr02,Bn6825,88523619,90126750,1603131,CN
chr02,Bn6826,16375853,85572713,69196860,CNL
chr02,Bn6827,56264089,81400934,25136845,CN
chr02,Bn6828,2229366,89915561,87686195,TN
chr02,Bn6829,50834355,66289895,15455540,CNL
chr02,Bn6830,78443199,86104005,7660806,CN
chr02,Bn6831,75078620,99542863,24464243,CNL
chr02,Bn6832,73420146,76883303,3463157,TNL
chr02,Bn6833,85164020,87638744,2474724,NBS
chr02,Bn6834,39796107,99658028,59861921,RLP
chr02,Bn6835,95962279,97441648,1479369,NBS
chr02,Bn6836,89697956,92370000,2672044,RLP
chr02,Bn6837,24409420,79771133,55361713,RLP
chr02,Bn6838,79928606,80234106,305500,RLP
chr02,Bn6839,84369027,90603393,6234366,CNL
chr02,Bn6840,28077433,71152092,43074659,RLK
chr02,Bn6841,60073553,94019150,33945597,TN
chr02,Bn6842,80025808,89630203,9604395,RLP
chr02,Bn6843,67580325,89170530,21590205,RLP
chr02,Bn6844,2750261,39597545,36847284,CNL
chr02,Bn6845,24433185,67949559,43516374,RLK
chr02,Bn6846,34719865,39503680,4783815,NBS
chr02,Bn6847,16117762,97065405,80947643,RLK
chr02,Bn6848,50364013,76600785,26236772,TN
chr02,Bn6849,78877588,89414577,10536989,CNL
chr02,Bn6850,53676759,56646406,2969647,RLK
chr02,Bn6851,19318862,39890959,20572097,NBS
chr02,Bn6852,17641043,61374120,43733077,TNL
chr02,Bn6853,67620599,96039891,28419292,CNL
chr02,Bn6854,67750455,73759801,6009346,NBS
chr02,Bn6855,63646939,98404594,34757655,TNL
chr02,Bn6856,19203100,42041629,22838529,CN
chr02,Bn6857,94160329,94708364,548035,RLK
chr02,Bn6858,9533115,20869158,11336043,CN
chr02,Bn6859,94578409,98483258,3904849,RLP
chr02,Bn6860,23489430,77193602,53704172,TN
chr02,Bn6861,37966465,76137263,38170798,CN
chr02,Bn6862,98851546,99902209,1050663,NBS
chr02,Bn6863,4468963,40983282,36514319,TNL
chr02,Bn6864,6355269,90537075,84181806,TNL
chr02,Bn6865,95903538,99531306,3627768,CN
chr02,Bn6866,64392187,89314360,24922173,TNL
chr02,Bn6867,61500381,78000498,16500117,TN
chr02,Bn6868,52328695,97087737,44759042,TN
chr02,Bn6869,60212099,60750959,538860,CNL
chr02,Bn6870,19615823,57084211,37468388,CNL
chr02,Bn6871,33143886,97811229,64667343,CN
chr02,Bn6872,99141139,99858042,716903,CN
chr02,Bn6873,41662182,71218061,29555879,NBS
chr02,Bn6874,32184286,94907888,62723602,CNL
chr02,Bn6875,19371598,81650349,62278751,RLK
chr02,Bn6876,87584278,95798848,8214570,NBS
chr02,Bn6877,84066425,86728607,2662182,CN
chr02,Bn6878,31762668,96592871,64830203,TN
chr02,Bn6879,16586391,32611731,16025340,CN
chr02,Bn6880,35748575,90244253,54495678,TN
chr02,Bn6881,21275609,82740873,61465264,CNL
chr02,Bn6882,8107785,36635918,28528133,TN
chr02,Bn6883,40948457,72051468,31103011,TNL
chr02,Bn6884,60654244,77552904,16898660,CNL
chr02,Bn6885,59869384,69121791,9252407,CNL
chr02,Bn6886,29001504,83150158,54148654,TN
chr02,Bn6887,2125258,69945422,67820164,TN
chr02,Bn6888,63569110,91483358,27914248,NBS
chr02,Bn6889,45162664,95536281,50373617,CNL
chr02,Bn6890,16720562,75306157,58585595,TN
chr02,Bn6891,92236009,93107304,871295,TN
chr02,Bn6892,2679172,22469270,19790098,RLP
chr02,Bn6893,30157054,81848922,51691868,TNL
chr02,Bn6894,22023106,33785410,11762304,TNL
chr02,Bn6895,8343450,8632172,288722,CN
chr02,Bn6896,76221689,88411903,12190214,NBS
chr02,Bn6897,83932486,85870704,1938218,CN
chr02,Bn6898,88415071,97664370,9249299,TNL
chr02,Bn6899,48669286,98240430,49571144,RLP
chr02,Bn6900,14368743,53677622,39308879,NBS
chr02,Bn6901,23960777,72334237,48373460,NBS
chr02,Bn6902,31766635,70451007,38684372,NBS
chr02,Bn6903,22770074,64647434,41877360,TNL
chr02,Bn6904,47702330,87650497,39948167,RLP
chr02,Bn6905,88142233,94939625,6797392,TNL
chr02,Bn6906,89883013,96168916,6285903,CNL
chr02,Bn6907,2147040,65038720,62891680,TN
chr02,Bn6908,27141560,68089141,40947581,CNL
chr02,Bn6909,6207517,72261598,66054081,CN
chr02,Bn6910,82731868,97942867,15210999,RLK
chr02,Bn6911,30521799,79258134,48736335,RLP
chr02,Bn6912,33786439,79344286,45557847,TNL
chr02,Bn6913,73032831,96251878,23219047,TNL
chr02,Bn6914,42634163,54603603,11969440,CNL
chr02,Bn6915,61028496,83392634,22364138,RLK
chr02,Bn6916,80547203,82258419,1711216,TNL
chr02,Bn6917,32351399,90911976,58560577,NBS
chr02,Bn6918,46341443,63374062,17032619,CN
chr02,Bn6919,77717350,81231575,3514225,RLP
chr02,Bn6920,15095057,58245584,43150527,RLK
chr02,Bn6921,60824629,77014517,16189888,NBS
chr02,Bn6922,14753328,80129986,65376658,TN
chr02,Bn6923,63913059,83148794,19235735,NBS
chr02,Bn6924,96380353,98558607,2178254,CN
chr02,Bn6925,45673582,61652118,15978536,CNL
chr02,Bn6926,59786217,83983855,24197638,TN
chr02,Bn6927,36560717,88569219,52008502,RLK
chr02,Bn6928,78460519,89388281,10927762,NBS
chr02,Bn6929,16764627,95485266,78720639,CNL
chr02,Bn6930,92979906,99240189,6260283,NBS
chr02,Bn6931,51213224,54738834,3525610,NBS
chr02,Bn6932,31064146,68588818,37524672,RLK
chr02,Bn6933,96462630,97300585,837955,CNL
chr02,Bn6934,87912029,90901133,2989104,TN
chr02,Bn6935,99866621,99981051,114430,CN
chr02,Bn6936,81681567,92751046,11069479,CNL
chr02,Bn6937,95493151,95750514,257363,NBS
chr02,Bn6938,43838104,47043756,3205652,RLP
chr02,Bn6939,74992833,76454923,1462090,CNL
chr02,Bn6940,10857964,11860297,1002333,CN
chr02,Bn6941,36238492,71971262,35732770,RLP
chr02,Bn6942,70652445,76109842,5457397,CN
chr02,Bn6943,52167453,99318030,47150577,CN
chr02,Bn6944,51208374,70387241,19178867,TNL
chr02,Bn6945,64937821,99057011,34119190,RLP
chr02,Bn6946,54760201,63316743,8556542,RLK
chr02,Bn6947,9833105,17296725,7463620,CN
chr02,Bn6948,15939845,98496072,82556227,RLK
chr02,Bn6949,45042238,49944859,4902621,RLK
chr02,Bn6950,43777920,56154293,12376373,RLK
chr02,Bn6951,17901305,86858176,68956871,CNL
chr02,Bn6952,97141664,97425330,283666,TN
chr02,Bn6953,78685531,97570392,18884861,CNL
chr02,Bn6954,40685643,63590770,22905127,CN
chr02,Bn6955,30171355,95077888,64906533,CN
chr02,Bn6956,96157497,99756293,3598796,CN
chr02,Bn6957,14267519,47081673,32814154,NBS
chr02,Bn6958,63199716,79430834,16231118,TNL
chr02,Bn6959,39784352,59184613,19400261,RLK
chr02,Bn6960,13038314,22147316,9109002,RLK
chr02,Bn6961,17016935,55519943,38503008,NBS
chr02,Bn6962,40910798,41555986,645188,TNL
chr02,Bn6963,58933188,75276525,16343337,NBS
chr02,Bn6964,17872217,27999048,10126831,NBS
chr02,Bn6965,72432105,78183471,5751366,RLP
chr02,Bn6966,81678916,91066922,9388006,RLP
chr02,Bn6967,1578980,9077170,7498190,RLK
chr02,Bn6968,71222798,75665226,4442428,NBS
chr02,Bn6969,72392458,79926553,7534095,TNL
chr02,Bn6970,51414709,99531717,48117008,RLK
chr02,Bn6971,2322521,23982308,21659787,TNL
chr02,Bn6972,82486272,83451342,965070,TNL
chr02,Bn6973,59247722,69453824,10206102,TNL
chr02,Bn6974,10104696,60354219,50249523,CN
chr02,Bn6975,27443345,34140440,6697095,RLK
chr02,Bn6976,1677613,19556879,17879266,RLP
chr02,Bn6977,7269311,96400190,89130879,RLP
chr02,Bn6978,27647232,65715909,38068677,TN
chr02,Bn6979,81421368,96943109,15521741,RLK
chr02,Bn6980,46574310,58119415,11545105,RLP
chr02,Bn6981,63535521,84560394,21024873,CNL
chr02,Bn6982,66096668,75266540,9169872,CN
chr02,Bn6983,44510358,89776645,45266287,TN
chr02,Bn6984,57434004,81954565,24520561,RLK
chr02,Bn6985,63920415,70274042,6353627,CN
chr02,Bn6986,74622020,79469063,4847043,CN
chr02,Bn6987,82669847,99175829,16505982,RLK
chr02,Bn6988,4507256,51014303,46507047,TNL
chr02,Bn6989,31093443,47259136,16165693,RLP
chr02,Bn6990,21626687,58265914,36639227,RLK
chr02,Bn6991,72203934,72716851,512917,NBS
chr02,Bn6992,64210743,64475558,264815,TN
chr02,Bn6993,69995234,85224485,15229251,NBS
chr02,Bn6994,38146385,72481296,34334911,CNL
chr02,Bn6995,83270889,89368783,6097894,RLK
chr02,Bn6996,77413437,91787382,14373945,RLK
chr02,Bn6997,1898544,94665284,92766740,TNL
chr02,Bn6998,97797347,99189309,1391962,CN
chr02,Bn6999,68593473,80566024,11972551,TN
chr02,Bn7000,70863303,93915920,23052617,CNL
chr02,Bn7001,50203632,68071763,17868131,TN
chr02,Bn7002,88031397,94111383,6079986,TNL
chr02,Bn7003,13764372,37341957,23577585,RLK
chr02,Bn7004,38328901,94611620,56282719,TN
chr02,Bn7005,14362418,81484453,67122035,TN
chr02,Bn7006,82317777,95661884,13344107,TNL
chr02,Bn7007,44247317,57092893,12845576,RLK
chr02,Bn7008,96052967,99887745,3834778,CNL
chr02,Bn7009,48848132,81445273,32597141,CNL
chr02,Bn7010,16296293,53884374,37588081,NBS
chr02,Bn7011,70575542,72560257,1984715,CN
chr02,Bn7012,51653293,63846364,12193071,TN
chr02,Bn7013,77042630,80188480,3145850,NBS
chr02,Bn7014,26933917,41259635,14325718,RLP
chr02,Bn7015,31767581,62604990,30837409,TN
chr02,Bn7016,27566591,62457905,34891314,RLP
chr02,Bn7017,31293750,95133165,63839415,RLP
chr02,Bn7018,26091663,27262784,1171121,TN
chr02,Bn7019,10809007,42817775,32008768,RLP
chr02,Bn7020,87332586,93530751,6198165,CN
chr02,Bn7021,18135261,51824116,33688855,RLK
chr02,Bn7022,16737570,52380420,35642850,RLP
chr02,Bn7023,99124223,99271488,147265,RLP
chr02,Bn7024,80353444,87706218,7352774,TN
chr02,Bn7025,30818839,37777445,6958606,NBS
chr02,Bn7026,72004135,77100345,5096210,NBS
chr02,Bn7027,28174247,34452327,6278080,TN
chr02,Bn7028,37003427,94488694,57485267,RLK
chr02,Bn7029,14343739,95126831,80783092,TNL
chr02,Bn7030,45955134,97247004,51291870,TNL
chr02,Bn7031,52077431,85510973,33433542,TN
chr02,Bn7032,18551012,65633238,47082226,CNL
chr02,Bn7033,14572915,68443496,53870581,TN
chr02,Bn7034,83056782,92181474,9124692,TN
chr02,Bn7035,16542496,61792985,45250489,NBS
chr02,Bn7036,40376728,61553380,21176652,CN
chr02,Bn7037,89274819,91966155,2691336,NBS
chr02,Bn7038,87220539,93277626,6057087,NBS
chr02,Bn7039,53434540,63645031,10210491,TN
chr02,Bn7040,84659428,87448215,2788787,CNL
chr02,Bn7041,11195769,55204836,44009067,TNL
chr02,Bn7042,64732225,74367597,9635372,NBS
chr02,Bn7043,59612207,76649446,17037239,NBS
chr02,Bn7044,3527814,78943914,75416100,RLK
chr02,Bn7045,4936762,12277778,7341016,TNL
chr02,Bn7046,27326996,56520117,29193121,CNL
chr02,Bn7047,72750103,76581533,3831430,CNL
chr02,Bn7048,99331191,99973867,642676,CN
chr02,Bn7049,30832260,47799642,16967382,CNL
chr02,Bn7050,16255616,83828056,67572440,TNL
chr02,Bn7051,23883248,28748584,4865336,RLP
chr02,Bn7052,43687829,83093072,39405243,RLP
chr02,Bn7053,82792590,94158296,11365706,NBS
chr02,Bn7054,33937529,63857499,29919970,TNL
chr02,Bn7055,11432178,48759370,37327192,RLP
chr02,Bn7056,5719958,66528914,60808956,RLK
chr02,Bn7057,96210642,96351380,140738,CN
chr02,Bn7058,85820141,95404308,9584167,RLK
chr02,Bn7059,93810907,96701012,2890105,NBS
chr02,Bn7060,82766131,89231481,6465350,TNL
chr02,Bn7061,57264162,60217958,2953796,RLP
chr02,Bn7062,66641776,74987581,8345805,CN
chr02,Bn7063,87112541,92591291,5478750,TN
chr02,Bn7064,70084047,72017797,1933750,RLP
chr02,Bn7065,75637181,88114864,12477683,CNL
chr02,Bn7066,90344065,92232301,1888236,CNL
chr02,Bn7067,16937745,79419947,62482202,RLK
chr02,Bn7068,88321717,96279587,7957870,TNL
chr02,Bn7069,51227091,73520553,22293462,RLK
chr02,Bn7070,50187818,81297726,31109908,CN
chr02,Bn7071,81587884,92681770,11093886,CN
chr02,Bn7072,77474547,99574588,22100041,CNL
chr02,Bn7073,51229441,74270738,23041297,TN
chr02,Bn7074,25168861,35360003,10191142,CNL
chr02,Bn7075,8510223,34178531,25668308,RLP
chr02,Bn7076,20847475,41113788,20266313,CNL
chr02,Bn7077,81532613,92222574,10689961,RLP
chr02,Bn7078,35074892,88157970,53083078,NBS
chr02,Bn7079,1801397,14853188,13051791,TNL
chr02,Bn7080,38477644,90887304,52409660,TNL
chr02,Bn7081,59115724,78965937,19850213,RLP
chr02,Bn7082,57338171,58930357,1592186,CNL
chr02,Bn7083,68420983,87510366,19089383,RLP
chr02,Bn7084,35402800,44259829,8857029,TN
chr02,Bn7085,85878929,92117315,6238386,RLK
chr02,Bn7086,24374224,68904045,44529821,CNL
chr02,Bn7087,74482476,90679050,16196574,RLP
chr02,Bn7088,37525785,43180016,5654231,RLK
chr02,Bn7089,75985995,87920995,11935000,TN
chr02,Bn7090,97309607,97990206,680599,RLK
chr02,Bn7091,28531747,35614917,7083170,TNL
chr02,Bn7092,99553905,99645483,91578,TN
chr02,Bn7093,44557413,44767608,210195,RLK
chr02,Bn7094,11522742,30256491,18733749,CN
chr02,Bn7095,50952887,89872598,38919711,CN
chr02,Bn7096,15176440,68374602,53198162,RLP
chr02,Bn7097,49946925,66072346,16125421,TN
chr02,Bn7098,23381976,85770900,62388924,CN
chr02,Bn7099,29992930,95652600,65659670,TNL
chr02,Bn7100,93979228,97399946,3420718,RLP
chr02,Bn7101,75692361,78161903,2469542,TNL
chr02,Bn7102,53367923,94169115,40801192,RLP
chr02,Bn7103,74824680,79206939,4382259,CN
chr02,Bn7104,90015972,96571664,6555692,RLP
chr02,Bn7105,25200385,36224802,11024417,TNL
chr02,Bn7106,79018630,87679529,8660899,CNL
chr02,Bn7107,36669120,80270475,43601355,CN
chr02,Bn7108,90180452,96071134,5890682,RLP
chr02,Bn7109,84527088,86887045,2359957,TNL
chr02,Bn7110,22063093,78314198,56251105,NBS
chr02,Bn7111,45899063,79289295,33390232,CN
chr02,Bn7112,73153760,89485238,16331478,CN
chr02,Bn7113,83785845,97768763,13982918,CN
chr02,Bn7114,61258609,92560699,31302090,CNL
chr02,Bn7115,70700596,78786551,8085955,RLP
chr02,Bn7116,97171089,99127268,1956179,TNL
chr02,Bn7117,22282964,40593693,18310729,RLP
chr02,Bn7118,90927307,96046574,5119267,TN
chr02,Bn7119,77102522,77784808,682286,RLK
chr02,Bn7120,14164249,63045281,48881032,CNL
chr02,Bn7121,30469027,37282818,6813791,TNL
chr02,Bn7122,29934092,55125497,25191405,CNL
chr02,Bn7123,15484032,63073635,47589603,CNL
chr02,Bn7124,64326212,79382624,15056412,CN
chr02,Bn7125,23427868,60832437,37404569,CNL
chr02,Bn7126,22133792,41802674,19668882,CNL
chr02,Bn7127,97621264,97910686,289422,TN
chr02,Bn7128,92427745,96781166,4353421,CNL
chr02,Bn7129,63946276,76747636,12801360,NBS
chr02,Bn7130,21359995,47607067,26247072,RLK
chr02,Bn7131,15167876,46812379,31644503,NBS
chr02,Bn7132,31696158,71041434,39345276,CNL
chr02,Bn7133,66129030,95874489,29745459,CN
chr02,Bn7134,64872520,92118537,27246017,TN
chr02,Bn7135,39313397,98263222,58949825,TN
chr02,Bn7136,32534471,75100308,42565837,RLP
chr02,Bn7137,9160160,9195382,35222,NBS
chr02,Bn7138,56238227,57747581,1509354,CN
chr02,Bn7139,31251475,39881892,8630417,RLK
chr02,Bn7140,71301078,74880192,3579114,CNL
chr02,Bn7141,38553925,82643581,44089656,CNL
chr02,Bn7142,34539402,93607900,59068498,CNL
chr02,Bn7143,46892313,70219194,23326881,CN
chr02,Bn7144,21057668,36586871,15529203,CNL
chr02,Bn7145,85500182,92209600,6709418,TN
chr02,Bn7146,91538292,99376973,7838681,CN
chr02,Bn7147,3891950,82753254,78861304,RLK
chr02,Bn7148,30850033,79413496,48563463,RLK
chr02,Bn7149,23774307,54023170,30248863,NBS
chr02,Bn7150,90574612,91763186,1188574,NBS
chr02,Bn7151,15353558,42838233,27484675,CN
chr02,Bn7152,37017694,64998733,27981039,CN
chr02,Bn7153,68107723,91466754,23359031,NBS
chr02,Bn7154,35186560,50312457,15125897,RLK
chr02,Bn7155,51952157,81079716,29127559,RLK
chr02,Bn7156,21205574,30604016,9398442,CNL
chr02,Bn7157,42568289,65572741,23004452,TN
chr02,Bn7158,38578373,75378570,36800197,TNL
chr02,Bn7159,46978832,60517203,13538371,NBS
chr02,Bn7160,45551071,96652894,51101823,RLK
chr02,Bn7161,19039755,38966523,19926768,TN
chr02,Bn7162,95428535,96215731,787196,TNL
chr02,Bn7163,27316413,46069415,18753002,NBS
chr02,Bn7164,40559557,46525791,5966234,CNL
chr02,Bn7165,65896021,98946721,33050700,TN
chr02,Bn7166,24980643,61665302,36684659,TNL
chr02,Bn7167,56600490,61872353,5271863,CN
chr02,Bn7168,39922089,91177470,51255381,NBS
chr02,Bn7169,57652544,96097617,38445073,CNL
chr02,Bn7170,74775083,97949212,23174129,CNL
chr02,Bn7171,33462437,56693997,23231560,RLK
chr02,Bn7172,5965012,70470111,64505099,RLP
chr02,Bn7173,47399979,92828267,45428288,RLK
chr02,Bn7174,44648674,68882510,24233836,CN
chr02,Bn7175,62583945,81446625,18862680,CN
chr02,Bn7176,41198960,55005839,13806879,RLP
chr02,Bn7177,34292919,46028339,11735420,CN
chr02,Bn7178,64314760,94514457,30199697,CN
chr02,Bn7179,4374198,5923461,1549263,NBS
chr02,Bn7180,60138930,95982383,35843453,RLP
chr02,Bn7181,65276635,96431293,31154658,CN
chr02,Bn7182,97723228,99537145,1813917,RLP
chr02,Bn7183,83679775,84755095,1075320,TNL
chr02,Bn7184,18324904,45847884,27522980,CN
chr02,Bn7185,52643328,79984726,27341398,CNL
chr02,Bn7186,61842294,94906898,33064604,NBS
chr02,Bn7187,28800513,47159251,18358738,CNL
chr02,Bn7188,2087294,53409005,51321711,CNL
chr02,Bn7189,65811686,89037452,23225766,RLP
chr02,Bn7190,57521226,59662259,2141033,NBS
chr02,Bn7191,35002553,51950315,16947762,RLK
chr02,Bn7192,51555011,72452403,20897392,RLP
chr02,Bn7193,82359460,97341910,14982450,NBS
chr02,Bn7194,69671648,77813506,8141858,CN
chr02,Bn7195,48139523,59373599,11234076,TNL
chr02,Bn7196,38408187,67185564,28777377,RLP
chr02,Bn7197,1751320,9339585,7588265,CN
chr02,Bn7198,51478013,95706328,44228315,NBS
chr02,Bn7199,10694634,15014896,4320262,TN
chr02,Bn7200,92193230,94851013,2657783,TN
chr02,Bn7201,17956541,30024613,12068072,TN
chr02,Bn7202,32178396,55615051,23436655,RLP
chr02,Bn7203,54755453,85545062,30789609,RLK
chr02,Bn7204,8359963,31460600,23100637,RLK
chr02,Bn7205,91509628,98713308,7203680,CN
chr02,Bn7206,2816346,85630608,82814262,CNL
chr02,Bn7207,58548589,91722237,33173648,TNL
chr02,Bn7208,90396807,92596448,2199641,CNL
chr02,Bn7209,54372060,70858927,16486867,NBS
chr02,Bn7210,59359442,71335490,11976048,CNL
chr02,Bn7211,1745187,27383394,25638207,RLP
chr02,Bn7212,45536311,76263620,30727309,NBS
chr02,Bn7213,94921157,99634707,4713550,CNL
chr02,Bn7214,34174477,74150886,39976409,CN
chr02,Bn7215,86521296,89075598,2554302,RLP
chr02,Bn7216,1308267,87026946,85718679,CNL
chr02,Bn7217,92996030,98579090,5583060,RLK
chr02,Bn7218,76863925,89159741,12295816,CN
chr02,Bn7219,80884424,93061958,12177534,TN
chr02,Bn7220,53965421,73596462,19631041,RLK
chr02,Bn7221,63987623,79957391,15969768,RLK
chr02,Bn7222,58405566,85846174,27440608,CNL
chr02,Bn7223,52333486,92038213,39704727,NBS
chr02,Bn7224,23774882,26233341,2458459,TN
chr02,Bn7225,52537174,75778407,23241233,CNL
chr02,Bn7226,91485990,99229119,7743129,CNL
chr02,Bn7227,42935813,55462454,12526641,CNL
chr02,Bn7228,66018075,91070887,25052812,RLP
chr02,Bn7229,62867012,78024798,15157786,CNL
chr02,Bn7230,95290929,99299645,4008716,TN
chr02,Bn7231,84446612,99003703,14557091,CNL
chr02,Bn7232,30999603,37085955,6086352,RLK
chr02,Bn7233,43311031,52500607,9189576,NBS
chr02,Bn7234,27007000,32978757,5971757,TNL
chr02,Bn7235,52590562,72178977,19588415,CN
chr02,Bn7236,96871517,98688475,1816958,RLP
chr02,Bn7237,76485666,86612565,10126899,RLP
chr02,Bn7238,14915424,57828920,42913496,CNL
chr02,Bn7239,91332831,92335979,1003148,CNL
chr02,Bn7240,25285696,47508649,22222953,TN
chr02,Bn7241,80847496,90555971,9708475,NBS
chr02,Bn7242,1530274,71526247,69995973,RLK
chr02,Bn7243,18666307,67676501,49010194,TN
chr02,Bn7244,88150414,98009570,9859156,CNL
chr02,Bn7245,60002516,95877886,35875370,TN
chr02,Bn7246,65197049,89416251,24219202,NBS
chr02,Bn7247,94703960,99667593,4963633,NBS
chr02,Bn7248,42472316,63062422,20590106,NBS
chr02,Bn7249,85117152,89377240,4260088,RLK
chr02,Bn7250,63311807,77096102,13784295,RLP
chr02,Bn7251,29505230,93230030,63724800,RLK
chr02,Bn7252,19320052,58969189,39649137,CNL
chr02,Bn7253,3004828,95557518,92552690,TNL
chr02,Bn7254,75497005,93213494,17716489,RLP
chr02,Bn7255,45701172,99472822,53771650,TNL
chr02,Bn7256,63029633,68832180,5802547,TNL
chr02,Bn7257,10962524,21762185,10799661,NBS
chr02,Bn7258,52058221,54575990,2517769,CN
chr02,Bn7259,94181376,97918333,3736957,CNL
chr02,Bn7260,95878435,98523819,2645384,TNL
chr02,Bn7261,39463192,97065010,57601818,CN
chr02,Bn7262,82168490,89000849,6832359,TN
chr02,Bn7263,90219225,98020589,7801364,RLK
chr02,Bn7264,45499791,69193830,23694039,RLK
chr02,Bn7265,16102807,73140739,57037932,CN
chr02,Bn7266,51071690,86017961,34946271,CNL
chr02,Bn7267,92409696,97238385,4828689,RLK
chr02,Bn7268,91880201,96736079,4855878,RLK
chr02,Bn7269,8870713,99521600,90650887,TN
chr02,Bn7270,17674779,43313777,25638998,CNL
chr02,Bn7271,20532389,44875558,24343169,CNL
chr02,Bn7272,6228802,19968867,13740065,CN
chr02,Bn7273,9669350,87366837,77697487,CNL
chr02,Bn7274,26962929,77208776,50245847,CN
chr02,Bn7275,40677125,68862686,28185561,RLK
chr02,Bn7276,62846713,71175068,8328355,NBS
chr02,Bn7277,13204955,48564414,35359459,NBS
chr02,Bn7278,37953717,44983090,7029373,CN
chr02,Bn7279,41709283,58204041,16494758,TNL
chr02,Bn7280,78912804,82503914,3591110,TN
chr02,Bn7281,54679700,92448379,37768679,CNL
chr02,Bn7282,31110069,78812807,47702738,RLP
chr02,Bn7283,82101304,99836476,17735172,RLP
chr02,Bn7284,3539238,40112152,36572914,CN
chr02,Bn7285,34148333,77115878,42967545,RLK
chr02,Bn7286,18037995,58021907,39983912,TNL
chr02,Bn7287,99688690,99810638,121948,NBS
chr02,Bn7288,44010843,60631545,16620702,CNL
chr02,Bn7289,63717530,70471084,6753554,TNL
chr02,Bn7290,96103229,97007186,903957,NBS
chr02,Bn7291,13830279,91939945,78109666,NBS
chr02,Bn7292,7824429,43034302,35209873,RLP
chr02,Bn7293,35683728,65107485,29423757,TNL
chr02,Bn7294,13614506,42177635,28563129,RLP
chr02,Bn7295,24084182,91165371,67081189,CN
chr02,Bn7296,96498544,97570126,1071582,NBS
chr02,Bn7297,78333494,95627699,17294205,RLK
chr02,Bn7298,40136064,44414021,4277957,RLK
chr02,Bn7299,48240480,97315907,49075427,NBS
chr02,Bn7300,65578401,76256396,10677995,CN
chr02,Bn7301,11394253,85162722,73768469,RLP
chr02,Bn7302,71778212,85641501,13863289,TNL
chr02,Bn7303,17846274,90347445,72501171,RLP
chr02,Bn7304,74372354,86306579,11934225,TNL
chr02,Bn7305,61212529,67737036,6524507,RLP
chr02,Bn7306,85555312,97007017,11451705,NBS
chr02,Bn7307,15329177,87938469,72609292,NBS
chr02,Bn7308,3248418,80720121,77471703,RLP
chr02,Bn7309,69177203,74511788,5334585,RLK
chr02,Bn7310,81275787,91649357,10373570,RLP
chr02,Bn7311,86553042,98007062,11454020,NBS
chr02,Bn7312,28295098,43718833,15423735,TN
chr02,Bn7313,98563539,99689144,1125605,NBS
chr02,Bn7314,75339778,80219736,4879958,TN
chr02,Bn7315,82280544,84909574,2629030,TN
chr02,Bn7316,55368761,87000961,31632200,TN
chr02,Bn7317,85863324,93555752,7692428,RLP
chr02,Bn7318,1217940,50851445,49633505,RLK
chr02,Bn7319,71913443,72560687,647244,CN
chr02,Bn7320,54127882,55090451,962569,NBS
chr02,Bn7321,35228066,56803621,21575555,CNL
chr02,Bn7322,74718252,98427383,23709131,NBS
chr02,Bn7323,46152319,89443746,43291427,NBS
chr02,Bn7324,28851808,31201403,2349595,NBS
chr02,Bn7325,31290504,95052926,63762422,NBS
chr02,Bn7326,52246884,68563702,16316818,NBS
chr02,Bn7327,37321445,92015560,54694115,CNL
chr02,Bn7328,22207207,30374194,8166987,CN
chr02,Bn7329,56769584,69086382,12316798,RLK
chr02,Bn7330,33121122,49507424,16386302,RLK
chr02,Bn7331,47993550,50346827,2353277,TN
chr02,Bn7332,70353759,83968196,13614437,RLP
chr02,Bn7333,79873685,86222005,6348320,RLK
chr02,Bn7334,83248413,88175400,4926987,RLK
chr02,Bn7335,94866895,99139054,4272159,RLP
chr02,Bn7336,45749357,86352931,40603574,RLP
chr02,Bn7337,24669035,79281035,54612000,TNL
chr02,Bn7338,82569296,86853011,4283715,RLK
chr02,Bn7339,79240848,90228364,10987516,TN
chr02,Bn7340,33484982,62674470,29189488,TNL
chr02,Bn7341,22085541,87581891,65496350,RLK
chr02,Bn7342,87590043,97704864,10114821,NBS
chr02,Bn7343,75039288,93118904,18079616,TN
chr02,Bn7344,93038394,95862274,2823880,TNL
chr02,Bn7345,15106665,86547555,71440890,TN
chr02,Bn7346,53223510,69826742,16603232,CNL
chr02,Bn7347,69020387,70544087,1523700,NBS
chr02,Bn7348,83101730,99282607,16180877,TN
chr02,Bn7349,86650039,95156500,8506461,CNL
chr02,Bn7350,64391643,83982778,19591135,RLK
chr02,Bn7351,14847411,56034537,41187126,TNL
chr02,Bn7352,89581081,94515087,4934006,RLP
chr02,Bn7353,85029560,95058166,10028606,CN
chr02,Bn7354,40542896,79154326,38611430,RLP
chr02,Bn7355,64081413,90056880,25975467,RLK
chr02,Bn7356,76256309,91204379,14948070,RLP
chr02,Bn7357,81049570,88413679,7364109,TN
chr02,Bn7358,59685541,95969871,36284330,TN
chr02,Bn7359,63651928,91203881,27551953,RLP
chr02,Bn7360,93101368,95850999,2749631,NBS
chr02,Bn7361,11080386,37948245,26867859,RLK
chr02,Bn7362,5292965,42443339,37150374,TNL
chr02,Bn7363,54126079,71168125,17042046,RLK
chr02,Bn7364,10799282,77339773,66540491,TN
chr02,Bn7365,76028016,97701382,21673366,RLP
chr02,Bn7366,27607199,93722361,66115162,CN
chr02,Bn7367,91671415,98169289,6497874,TNL
chr02,Bn7368,36466513,45063048,8596535,TNL
chr02,Bn7369,12877331,13403279,525948,CNL
chr02,Bn7370,72327746,72484666,156920,TNL
chr02,Bn7371,19402668,66025654,46622986,CN
chr02,Bn7372,30378885,59294167,28915282,CN
chr02,Bn7373,7073471,59928513,52855042,CNL
chr02,Bn7374,71175707,75149635,3973928,CNL
chr02,Bn7375,61382435,73824639,12442204,RLP
chr02,Bn7376,86979349,99375382,12396033,NBS
chr02,Bn7377,75679382,91111622,15432240,NBS
chr02,Bn7378,68085158,91404721,23319563,NBS
chr02,Bn7379,7053897,91558165,84504268,TN
chr02,Bn7380,64709103,88197093,23487990,TN
chr02,Bn7381,71546898,95700952,24154054,RLK
chr02,Bn7382,47062830,82443378,35380548,RLP
chr02,Bn7383,47572507,83304371,35731864,CNL
chr02,Bn7384,64913942,72224576,7310634,RLK
chr02,Bn7385,58651435,70045327,11393892,TNL
chr02,Bn7386,86644945,91190253,4545308,TNL
chr02,Bn7387,83357732,91271767,7914035,RLP
chr02,Bn7388,54168849,83827575,29658726,TN
chr02,Bn7389,98098410,99669144,1570734,RLP
chr02,Bn7390,42601313,48994785,6393472,RLK
chr02,Bn7391,81851865,93764745,11912880,CNL
chr02,Bn7392,45700312,46440366,740054,RLP
chr02,Bn7393,45759899,61770289,16010390,TNL
chr02,Bn7394,89658177,98644058,8985881,NBS
chr02,Bn7395,18208380,50608743,32400363,RLP
chr02,Bn7396,90126673,94833570,4706897,TNL
chr02,Bn7397,60072114,75737425,15665311,NBS
chr02,Bn7398,64077919,95116240,31038321,RLP
chr02,Bn7399,46689000,84914261,38225261,NBS
chr02,Bn7400,93686443,99119832,5433389,TNL
chr02,Bn7401,13998854,64058803,50059949,RLP
chr02,Bn7402,65327103,67725587,2398484,NBS
chr02,Bn7403,18396144,82110429,63714285,RLK
chr02,Bn7404,37114943,39195811,2080868,RLK
chr02,Bn7405,46334125,83832913,37498788,TNL
chr02,Bn7406,11494122,51502784,40008662,CNL
chr02,Bn7407,53011816,58062635,5050819,CNL
chr02,Bn7408,84323813,86747498,2423685,RLP
chr02,Bn7409,25596695,65871637,40274942,CN
chr02,Bn7410,61634901,86667901,25033000,RLK
chr02,Bn7411,96286449,98919994,2633545,TNL
chr02,Bn7412,78949781,83395016,4445235,CN
chr02,Bn7413,16053413,45917561,29864148,CN
chr02,Bn7414,85332165,96710443,11378278,RLK
chr02,Bn7415,12782270,29516356,16734086,CN
chr02,Bn7416,65631268,99057080,33425812,CNL
chr02,Bn7417,85333729,85631470,297741,RLP
chr02,Bn7418,39482908,87608985,48126077,CNL
chr02,Bn7419,28074419,76478311,48403892,RLK
chr02,Bn7420,62309259,69841281,7532022,RLK
chr02,Bn7421,50101057,90025026,39923969,TN
chr02,Bn7422,90208160,94308849,4100689,NBS
chr02,Bn7423,7910741,9415773,1505032,TNL
chr02,Bn7424,11293712,20317598,9023886,TNL
chr02,Bn7425,43612762,97538358,53925596,NBS
chr02,Bn7426,33033757,34286155,1252398,NBS
chr02,Bn7427,88363214,95779595,7416381,RLK
chr02,Bn7428,85060774,88617255,3556481,RLP
chr02,Bn7429,30815165,80556615,49741450,CN
chr02,Bn7430,3970565,12679821,8709256,TN
chr02,Bn7431,4855834,72279804,67423970,RLP
chr02,Bn7432,34250475,65156942,30906467,CNL
chr02,Bn7433,72564980,97486281,24921301,RLP
chr02,Bn7434,65286683,75098053,9811370,TNL
chr02,Bn7435,59375730,94306170,34930440,CN
chr02,Bn7436,21787930,95273354,73485424,CNL
chr02,Bn7437,38737543,44552426,5814883,NBS
chr02,Bn7438,42346833,90290858,47944025,CN
chr02,Bn7439,30016165,77563167,47547002,NBS
chr02,Bn7440,75268554,82145828,6877274,CNL
chr02,Bn7441,41638609,78674278,37035669,CN
chr02,Bn7442,31563316,32738091,1174775,TN
chr02,Bn7443,5492024,94114576,88622552,CN
chr02,Bn7444,1849567,17883483,16033916,CN
chr02,Bn7445,83288805,97073461,13784656,CN
chr02,Bn7446,48937993,57885444,8947451,CN
chr02,Bn7447,80435566,89935111,9499545,RLK
chr02,Bn7448,19924964,39795668,19870704,CNL
chr02,Bn7449,67306565,81384300,14077735,TN
chr02,Bn7450,60432705,97375334,36942629,RLK
chr02,Bn7451,53453576,66702633,13249057,TN
chr02,Bn7452,94048658,95749218,1700560,RLP
chr02,Bn7453,17425764,59583299,42157535,NBS
chr02,Bn7454,82023196,90365820,8342624,TNL
chr02,Bn7455,62872743,64232317,1359574,RLP
chr02,Bn7456,43095653,47749146,4653493,CN
chr02,Bn7457,34187569,36389522,2201953,CNL
chr02,Bn7458,55435683,98286266,42850583,CNL
chr02,Bn7459,95071317,96860952,1789635,TN
chr02,Bn7460,23103794,81017244,57913450,RLP
chr02,Bn7461,15755887,24370032,8614145,NBS
chr02,Bn7462,27026458,43243548,16217090,TNL
chr02,Bn7463,71416859,71591746,174887,CN
chr02,Bn7464,49901827,63889501,13987674,NBS
chr02,Bn7465,44786135,46288668,1502533,TN
chr02,Bn7466,46944302,66004270,19059968,TN
chr02,Bn7467,71923002,82478592,10555590,NBS
chr02,Bn7468,82232531,95121564,12889033,NBS
chr02,Bn7469,49026264,89549462,40523198,TN
chr02,Bn7470,72361707,88907549,16545842,RLK
chr02,Bn7471,20505391,46890028,26384637,CN
chr02,Bn7472,29076319,56815881,27739562,CN
chr02,Bn7473,87635442,99834579,12199137,CN
chr02,Bn7474,38673790,43576609,4902819,RLK
chr02,Bn7475,91730545,99454324,7723779,TNL
chr02,Bn7476,35639400,51837547,16198147,CN
chr02,Bn7477,41361280,43691969,2330689,CN
chr02,Bn7478,49121923,83680905,34558982,CN
chr02,Bn7479,63850286,95253113,31402827,RLK
chr02,Bn7480,52121135,97642012,45520877,CNL
chr02,Bn7481,47441882,94636944,47195062,TN
chr02,Bn7482,7916578,93379678,85463100,RLP
chr02,Bn7483,45291631,88633969,43342338,NBS
chr02,Bn7484,85961729,90542103,4580374,CNL
chr02,Bn7485,37024590,58430030,21405440,RLP
chr02,Bn7486,28028556,56848541,28819985,CN
chr02,Bn7487,1637171,19018633,17381462,CN
chr02,Bn7488,73982064,95211038,21228974,CN
chr02,Bn7489,66864616,84616042,17751426,RLP
chr02,Bn7490,38145732,62176583,24030851,NBS
chr02,Bn7491,16573818,90760340,74186522,CNL
chr02,Bn7492,56733624,91361217,34627593,RLK
chr02,Bn7493,45511867,54038445,8526578,NBS
chr02,Bn7494,9329507,10655248,1325741,RLK
chr02,Bn7495,43801958,60111715,16309757,CNL
chr02,Bn7496,94479052,99255913,4776861,RLP
chr02,Bn7497,25555058,26102355,547297,TNL
chr02,Bn7498,59268895,98907660,39638765,NBS
chr02,Bn7499,3338184,43465864,40127680,RLP
chr02,Bn7500,19031961,64777060,45745099,RLK
chr02,Bn7501,29985389,76483072,46497683,RLK
chr02,Bn7502,93365921,96601884,3235963,CNL
chr02,Bn7503,86453211,90425333,3972122,CN
chr02,Bn7504,64609859,69656363,5046504,RLP
chr02,Bn7505,30175141,80238161,50063020,TN
chr02,Bn7506,17735020,43860029,26125009,TN
chr02,Bn7507,59966055,71386539,11420484,TN
chr02,Bn7508,5713803,90634310,84920507,RLP
chr02,Bn7509,85416057,88591848,3175791,RLK
chr02,Bn7510,1268978,65482824,64213846,RLP
chr02,Bn7511,87072682,99082907,12010225,NBS
chr02,Bn7512,76021643,81291055,5269412,NBS
chr02,Bn7513,3237263,91100182,87862919,CNL
chr02,Bn7514,57756966,63489438,5732472,TN
chr02,Bn7515,25102994,52056880,26953886,RLK
chr02,Bn7516,77018409,83469255,6450846,RLK
chr02,Bn7517,97055529,98283697,1228168,RLK
chr02,Bn7518,66189461,80143337,13953876,CNL
chr02,Bn7519,20914049,80131398,59217349,CNL
chr02,Bn7520,1888316,11457526,9569210,TN
chr02,Bn7521,28451954,61175287,32723333,NBS
chr02,Bn7522,26202325,53079908,26877583,TN
chr02,Bn7523,5920749,81240328,75319579,RLK
chr02,Bn7524,8644546,32285211,23640665,TNL
chr02,Bn7525,73991585,78146084,4154499,CN
chr02,Bn7526,16039202,55383427,39344225,RLK
chr02,Bn7527,59677537,61525013,1847476,RLK
chr02,Bn7528,52067366,86352376,34285010,RLK
chr02,Bn7529,33611025,97427705,63816680,TNL
chr02,Bn7530,25788201,35389635,9601434,TN
chr02,Bn7531,58427598,74283746,15856148,TNL
chr02,Bn7532,39635411,64883589,25248178,NBS
chr02,Bn7533,93509635,94449476,939841,CN
chr02,Bn7534,18694141,20095694,1401553,TNL
chr02,Bn7535,31435191,45624655,14189464,NBS
chr02,Bn7536,18205317,42093518,23888201,CNL
chr02,Bn7537,40588962,76079711,35490749,RLP
chr02,Bn7538,54931883,70928309,15996426,NBS
chr02,Bn7539,26866203,88209888,61343685,NBS
chr02,Bn7540,8272867,78219206,69946339,TNL
chr02,Bn7541,13300972,60899685,47598713,CNL
chr02,Bn7542,3651349,24725403,21074054,RLK
chr02,Bn7543,88032644,90688213,2655569,TNL
chr02,Bn7544,98284832,98838067,553235,CNL
chr02,Bn7545,58196111,74933919,16737808,RLP
chr02,Bn7546,12666026,40467202,27801176,CNL
chr02,Bn7547,68953154,89062768,20109614,RLP
chr02,Bn7548,77711791,80721566,3009775,CN
chr02,Bn7549,73797792,77142000,3344208,RLK
chr02,Bn7550,36817991,94882149,58064158,CNL
chr02,Bn7551,72854606,73517149,662543,RLK
chr02,Bn7552,88073229,88096194,22965,NBS
chr02,Bn7553,49466146,61565971,12099825,TN
chr02,Bn7554,45458576,98593379,53134803,TNL
chr02,Bn7555,87970202,97523472,9553270,RLK
chr02,Bn7556,90937065,97444647,6507582,CNL
chr02,Bn7557,46953410,70597526,23644116,CN
chr02,Bn7558,89476636,92391636,2915000,CN
chr02,Bn7559,15261860,60161129,44899269,NBS
chr02,Bn7560,52237104,70147111,17910007,RLK
chr02,Bn7561,69067071,87698071,18631000,RLK
chr02,Bn7562,49950320,86552935,36602615,RLP
chr02,Bn7563,75249644,75882841,633197,NBS
chr02,Bn7564,55696268,87123820,31427552,TN
chr02,Bn7565,9017652,98448005,89430353,TNL
chr02,Bn7566,71191943,78778483,7586540,TNL
chr02,Bn7567,2246052,76323074,74077022,RLP
chr02,Bn7568,81396369,96409639,15013270,CN
chr02,Bn7569,31230879,67751436,36520557,CNL
chr02,Bn7570,77198406,91928222,14729816,TN
chr02,Bn7571,85466881,97007730,11540849,RLK
chr02,Bn7572,30942815,83102732,52159917,TN
chr02,Bn7573,91298641,93017085,1718444,RLP
chr02,Bn7574,81402894,96121386,14718492,CN
chr02,Bn7575,39582541,55459476,15876935,CN
chr02,Bn7576,50625058,87352335,36727277,CNL
chr02,Bn7577,56643425,84034741,27391316,RLP
chr02,Bn7578,26606172,96118952,69512780,CN
chr02,Bn7579,59307801,86230341,26922540,RLP
chr02,Bn7580,84051912,95299138,11247226,NBS
chr02,Bn7581,21630560,43209408,21578848,TN
chr02,Bn7582,13247342,99600060,86352718,TN
chr02,Bn7583,53570636,88488766,34918130,NBS
chr02,Bn7584,22211849,91484617,69272768,RLP
chr02,Bn7585,3848349,57795516,53947167,RLP
chr02,Bn7586,9578105,20875737,11297632,RLP
chr02,Bn7587,11422693,79765723,68343030,NBS
chr02,Bn7588,28025324,82189560,54164236,TN
chr02,Bn7589,30652108,93666917,63014809,CN
chr02,Bn7590,3725672,44638411,40912739,RLP
chr02,Bn7591,8003358,43980379,35977021,RLP
chr02,Bn7592,37263066,44088630,6825564,NBS
chr02,Bn7593,12424334,21641551,9217217,RLK
chr02,Bn7594,82728382,87761605,5033223,TN
chr02,Bn7595,72235577,90357488,18121911,RLP
chr02,Bn7596,10503313,50925230,40421917,TNL
chr02,Bn7597,91510727,95811877,4301150,RLK
chr02,Bn7598,97478190,98255011,776821,RLK
chr02,Bn7599,64004158,88450646,24446488,CN
chr02,Bn7600,8860246,48428866,39568620,TNL
chr02,Bn7601,89992067,95795046,5802979,TNL
chr02,Bn7602,97418100,98952451,1534351,RLP
chr02,Bn7603,59804776,83842275,24037499,CNL
chr02,Bn7604,75489728,82581396,7091668,CNL
chr02,Bn7605,52167964,65443852,13275888,RLP
chr02,Bn7606,34174350,54492938,20318588,CNL
chr02,Bn7607,51478045,82962946,31484901,NBS
chr02,Bn7608,60197735,68632187,8434452,CN
chr02,Bn7609,36308428,94748515,58440087,TNL
chr02,Bn7610,37417727,65907945,28490218,NBS
chr02,Bn7611,81138918,99063295,17924377,RLK
chr02,Bn7612,28155537,81175819,53020282,CN
chr02,Bn7613,65288529,77205339,11916810,TN
chr02,Bn7614,24213444,53145119,28931675,RLP
chr02,Bn7615,48223333,76727945,28504612,CNL
chr02,Bn7616,48380530,83098896,34718366,RLK
chr02,Bn7617,91027374,98415688,7388314,TNL
chr02,Bn7618,59324019,74764873,15440854,CNL
chr02,Bn7619,94647675,95326314,678639,TN
chr02,Bn7620,53712485,67944477,14231992,TN
chr02,Bn7621,16021952,50654054,34632102,TNL
chr02,Bn7622,57489281,69949952,12460671,CNL
chr02,Bn7623,52320628,96643850,44323222,TN
chr02,Bn7624,56204139,76733018,20528879,TN
chr02,Bn7625,2135650,48419195,46283545,TN
chr02,Bn7626,74308714,82148356,7839642,TNL
chr02,Bn7627,19173398,41379413,22206015,TN
chr02,Bn7628,50293870,90937250,40643380,TNL
chr02,Bn7629,4238319,60963554,56725235,CNL
chr02,Bn7630,60424734,74851388,14426654,RLP
chr02,Bn7631,98031323,98674951,643628,NBS
chr02,Bn7632,12581617,98548464,85966847,NBS
chr02,Bn7633,39697512,46355526,6658014,CNL
chr02,Bn7634,31603384,82426448,50823064,RLP
chr02,Bn7635,25552635,76940290,51387655,CN
chr02,Bn7636,58317708,94914766,36597058,CN
chr02,Bn7637,72639637,82631420,9991783,CN
chr02,Bn7638,87525036,89283580,1758544,TNL
chr02,Bn7639,12812284,62004976,49192692,TN
chr02,Bn7640,28390336,87180176,58789840,CNL
chr02,Bn7641,1268262,82595200,81326938,CN
chr02,Bn7642,63861245,99115486,35254241,CNL
chr02,Bn7643,87005089,93532862,6527773,TNL
chr02,Bn7644,98846124,99734724,888600,CN
chr02,Bn7645,41191642,69068917,27877275,NBS
chr02,Bn7646,13726387,91917731,78191344,TNL
chr02,Bn7647,83161540,94120838,10959298,CN
chr02,Bn7648,93654177,96556247,2902070,RLK
chr02,Bn7649,9348249,39517564,30169315,RLK
chr02,Bn7650,15234162,18812428,3578266,CN
chr02,Bn7651,95689394,96700673,1011279,CNL
chr02,Bn7652,26275083,86247160,59972077,CNL
chr02,Bn7653,87812995,88084118,271123,TN
chr02,Bn7654,15720060,86692998,70972938,CN
chr02,Bn7655,38129164,92739965,54610801,RLP
chr02,Bn7656,81780331,95919097,14138766,CN
chr02,Bn7657,79804749,82918288,3113539,NBS
chr02,Bn7658,84066336,85886772,1820436,TN
chr02,Bn7659,40550383,42798478,2248095,RLK
chr02,Bn7660,13030377,58704008,45673631,CNL
chr02,Bn7661,10493424,62493480,52000056,RLK
chr02,Bn7662,76311214,97036147,20724933,CNL
chr02,Bn7663,26344956,27863192,1518236,TN
chr02,Bn7664,39482034,47227078,7745044,TN
chr02,Bn7665,96580279,97634397,1054118,CNL
chr02,Bn7666,13739087,86307325,72568238,RLP
chr02,Bn7667,24690990,53778570,29087580,NBS
chr02,Bn7668,88551928,93970800,5418872,CNL
chr02,Bn7669,8121768,16158171,8036403,CNL
chr02,Bn7670,17626058,41108525,23482467,NBS
chr02,Bn7671,94399292,99979747,5580455,TN
chr02,Bn7672,26705004,45074746,18369742,RLP
chr02,Bn7673,96980238,99286601,2306363,TNL
chr02,Bn7674,80897315,88480558,7583243,TN
chr02,Bn7675,75781009,75949673,168664,RLK
chr02,Bn7676,70693662,71810559,1116897,RLK
chr02,Bn7677,6097567,97553810,91456243,TNL
chr02,Bn7678,66437275,72670566,6233291,NBS
chr02,Bn7679,64611595,68460432,3848837,CNL
chr02,Bn7680,81946194,94843185,12896991,CN
chr02,Bn7681,56980492,95680707,38700215,RLK
chr02,Bn7682,68878873,76203287,7324414,TNL
chr02,Bn7683,6540703,93894458,87353755,RLP
chr02,Bn7684,59950226,95346135,35395909,TN
chr02,Bn7685,19878108,76298114,56420006,RLP
chr02,Bn7686,90686043,98960008,8273965,CNL
chr02,Bn7687,31153429,61671111,30517682,RLP
chr02,Bn7688,85122090,96463474,11341384,CNL
chr02,Bn7689,5234066,63837394,58603328,TNL
chr02,Bn7690,97155799,97432522,276723,CN
chr02,Bn7691,58004125,69349708,11345583,CN
chr02,Bn7692,54033249,77422848,23389599,NBS
chr02,Bn7693,59628527,68360535,8732008,TN
chr02,Bn7694,79379885,87069802,7689917,TN
chr02,Bn7695,11182459,93207900,82025441,CN
chr02,Bn7696,98762417,99687058,924641,NBS
chr02,Bn7697,72064435,98396947,26332512,RLP
chr02,Bn7698,20209222,70638514,50429292,CN
chr02,Bn7699,64041318,65536354,1495036,CNL
chr02,Bn7700,39139841,95773613,56633772,CNL
chr02,Bn7701,6964638,66269770,59305132,RLK
chr02,Bn7702,4690693,6146541,1455848,TNL
chr02,Bn7703,28191313,41777229,13585916,RLP
chr02,Bn7704,89266379,99660585,10394206,RLP
chr02,Bn7705,70380006,89416826,19036820,RLP
chr02,Bn7706,76739312,88539429,11800117,NBS
chr02,Bn7707,36235300,71009143,34773843,RLP
chr02,Bn7708,66728397,95111658,28383261,CNL
chr02,Bn7709,30289008,36781993,6492985,RLK
chr02,Bn7710,50766771,74685523,23918752,CN
chr02,Bn7711,50339003,65268528,14929525,NBS
chr02,Bn7712,98641739,98713925,72186,NBS
chr02,Bn7713,47533866,83013271,35479405,CNL
chr02,Bn7714,69955967,82840925,12884958,RLP
chr02,Bn7715,16497891,82989512,66491621,TNL
chr02,Bn7716,48708009,67466838,18758829,TNL
chr02,Bn7717,40111162,64171257,24060095,TNL
chr02,Bn7718,27475998,69212669,41736671,CN
chr02,Bn7719,46249989,63273676,17023687,RLK
chr02,Bn7720,27061334,48723199,21661865,TN
chr02,Bn7721,5544132,50816086,45271954,TNL
chr02,Bn7722,3358818,63999076,60640258,RLP
chr02,Bn7723,21902016,63267311,41365295,RLK
chr02,Bn7724,87632722,99839572,12206850,TNL
chr02,Bn7725,75544958,82259877,6714919,CNL
chr02,Bn7726,88161549,96085436,7923887,TN
chr02,Bn7727,30586584,94920039,64333455,RLP
chr02,Bn7728,81377777,92829742,11451965,CNL
chr02,Bn7729,4341081,35070418,30729337,RLP
chr02,Bn7730,11869465,60559119,48689654,TN
chr02,Bn7731,17932383,97463577,79531194,RLK
chr02,Bn7732,92253882,98212760,5958878,RLK
chr02,Bn7733,89775844,97109918,7334074,CN
chr02,Bn7734,95338529,96313958,975429,NBS
chr02,Bn7735,28680025,91291815,62611790,CNL
chr02,Bn7736,18422386,63243137,44820751,TNL
chr02,Bn7737,18571564,50840350,32268786,CNL
chr02,Bn7738,89017680,99283645,10265965,NBS
chr02,Bn7739,87013295,97190435,10177140,RLK
chr02,Bn7740,35506241,90841318,55335077,TNL
chr02,Bn7741,54901731,94000573,39098842,RLP
chr02,Bn7742,5089584,83917687,78828103,TN
chr02,Bn7743,64436410,66788191,2351781,CN
chr02,Bn7744,39423296,55818879,16395583,CNL
chr02,Bn7745,75692844,94228734,18535890,RLK
chr02,Bn7746,25049214,67279612,42230398,NBS
chr02,Bn7747,37534181,75494305,37960124,TNL
chr02,Bn7748,80306911,96086826,15779915,RLP
chr02,Bn7749,63103567,98815403,35711836,RLP
chr02,Bn7750,41363793,71103561,29739768,RLK
chr02,Bn7751,27006105,95641055,68634950,CN
chr02,Bn7752,30075497,71192321,41116824,TN
chr02,Bn7753,12792316,49683427,36891111,RLP
chr02,Bn7754,79072213,82332454,3260241,TN
chr02,Bn7755,56354045,84327255,27973210,TN
chr02,Bn7756,50449663,91484858,41035195,CNL
chr02,Bn7757,34321378,97336834,63015456,RLP
chr02,Bn7758,33247920,52048854,18800934,CNL
chr02,Bn7759,29791775,47729707,17937932,TNL
chr02,Bn7760,16203021,54553454,38350433,CNL
chr02,Bn7761,13480587,85110064,71629477,RLP
chr02,Bn7762,84584715,92044422,7459707,TN
chr02,Bn7763,60896064,69287430,8391366,TN
chr02,Bn7764,82548004,97138544,14590540,NBS
chr02,Bn7765,56085710,86711858,30626148,CN
chr02,Bn7766,51267885,84898916,33631031,TN
chr02,Bn7767,72509912,73555358,1045446,CNL
chr02,Bn7768,54826902,58732769,3905867,CNL
chr02,Bn7769,35330838,81024035,45693197,TNL
chr02,Bn7770,62783946,97610393,34826447,RLP
chr02,Bn7771,3284520,53906149,50621629,TN
chr02,Bn7772,55386711,78874648,23487937,TN
chr02,Bn7773,21545832,98858367,77312535,NBS
chr02,Bn7774,27382211,71380523,43998312,CNL
chr02,Bn7775,35954304,60578058,24623754,NBS
chr02,Bn7776,87975922,92743475,4767553,RLK
chr02,Bn7777,50315601,69302420,18986819,RLP
chr02,Bn7778,21690440,89055265,67364825,TNL
chr02,Bn7779,27548130,43008405,15460275,RLP
chr02,Bn7780,44680848,84156488,39475640,CNL
chr02,Bn7781,69627052,90788844,21161792,NBS
chr02,Bn7782,83462784,87981298,4518514,TNL
chr02,Bn7783,77764313,81352675,3588362,CNL
chr02,Bn7784,99454892,99897523,442631,CN
chr02,Bn7785,35305160,79678115,44372955,CN
chr02,Bn7786,85900087,87811922,1911835,TN
chr02,Bn7787,88576427,94625928,6049501,NBS
chr02,Bn7788,35671842,76789218,41117376,TN
chr02,Bn7789,47458211,69890911,22432700,CN
chr02,Bn7790,39718103,90916315,51198212,NBS
chr02,Bn7791,50949404,84551319,33601915,NBS
chr02,Bn7792,52020307,61925391,9905084,RLK
chr02,Bn7793,15141369,44774426,29633057,TN
chr02,Bn7794,82780590,86941247,4160657,CNL
chr02,Bn7795,41708049,99137139,57429090,RLK
chr02,Bn7796,6610357,70121985,63511628,RLP
chr02,Bn7797,59024648,88859946,29835298,RLK
chr02,Bn7798,24295671,34155888,9860217,CN
chr02,Bn7799,20324448,57827214,37502766,RLP
chr02,Bn7800,69357756,93835897,24478141,RLP
chr02,Bn7801,37909590,93554116,55644526,RLK
chr02,Bn7802,79603705,91730868,12127163,CNL
chr02,Bn7803,4628181,11046449,6418268,TNL
chr02,Bn7804,34896767,38935398,4038631,TN
chr02,Bn7805,42326417,43798592,1472175,RLP
chr02,Bn7806,91902869,97907661,6004792,CNL
chr02,Bn7807,88943403,99846604,10903201,TNL
chr02,Bn7808,60773038,82806601,22033563,NBS
chr02,Bn7809,46610810,96900691,50289881,NBS
chr02,Bn7810,64349323,99531430,35182107,CN
chr02,Bn7811,74263578,99651690,25388112,RLP
chr02,Bn7812,27052361,63046838,35994477,CN
chr02,Bn7813,82762006,89336213,6574207,TNL
chr02,Bn7814,9340595,31778527,22437932,TNL
chr02,Bn7815,22835830,35996527,13160697,CN
chr02,Bn7816,6876170,67481149,60604979,CN
chr02,Bn7817,65388018,99413391,34025373,CNL
chr02,Bn7818,52970791,83010938,30040147,TN
chr02,Bn7819,13028214,86344162,73315948,RLP
chr02,Bn7820,59666435,89237475,29571040,CNL
chr02,Bn7821,36045775,82510478,46464703,RLP
chr02,Bn7822,44972923,62308687,17335764,CN
chr02,Bn7823,78952632,94890201,15937569,RLP
chr02,Bn7824,34297533,70042759,35745226,CNL
chr02,Bn7825,8806044,51603315,42797271,NBS
chr02,Bn7826,20868964,89564414,68695450,CNL
chr02,Bn7827,81842925,99302338,17459413,CNL
chr02,Bn7828,19670998,78918220,59247222,NBS
chr02,Bn7829,36818461,70712571,33894110,RLK
chr02,Bn7830,51504563,96141991,44637428,NBS
chr02,Bn7831,72766191,75042542,2276351,CNL
chr02,Bn7832,4618218,52684701,48066483,CN
chr02,Bn7833,99344421,99836046,491625,TNL
chr02,Bn7834,15104556,21852892,6748336,TN
chr02,Bn7835,42784598,76934034,34149436,TN
chr02,Bn7836,13543727,20813869,7270142,NBS
chr02,Bn7837,63418970,65627220,2208250,CN
chr02,Bn7838,80389833,89130010,8740177,TN
chr02,Bn7839,27890310,28478355,588045,TNL
chr02,Bn7840,52238399,66827388,14588989,NBS
chr02,Bn7841,13216599,37150969,23934370,CNL
chr02,Bn7842,54624843,98548148,43923305,NBS
chr02,Bn7843,34497885,66414742,31916857,RLP
chr02,Bn7844,72282378,75502929,3220551,TNL
chr02,Bn7845,97361362,97816375,455013,RLK
chr02,Bn7846,80004044,80703085,699041,NBS
chr02,Bn7847,6080716,93716894,87636178,RLP
chr02,Bn7848,96301532,96532553,231021,TNL
chr02,Bn7849,83081255,83123804,42549,NBS
chr02,Bn7850,89750799,94322327,4571528,NBS
chr02,Bn7851,8137697,92349054,84211357,CNL
chr02,Bn7852,3850417,71829335,67978918,CNL
chr02,Bn7853,79534598,88592873,9058275,TN
chr02,Bn7854,55487936,99747819,44259883,TN
chr02,Bn7855,43494938,84637784,41142846,CN
chr02,Bn7856,68423824,89140091,20716267,NBS
chr02,Bn7857,14882316,89348615,74466299,CN
chr02,Bn7858,93767480,95726303,1958823,CNL
chr02,Bn7859,93944822,99891248,5946426,RLK
chr02,Bn7860,17199182,70633404,53434222,RLP
chr02,Bn7861,32319390,34677580,2358190,TNL
chr02,Bn7862,96628785,96992695,363910,TNL
chr02,Bn7863,71201448,81798423,10596975,RLK
chr02,Bn7864,84375669,93664099,9288430,CNL
chr02,Bn7865,94528900,94788815,259915,TN
chr02,Bn7866,79540817,91728574,12187757,RLP
chr02,Bn7867,14022114,49610605,35588491,CN
chr02,Bn7868,81441390,88328111,6886721,RLK
chr02,Bn7869,22043452,57755797,35712345,TNL
chr02,Bn7870,95613636,98561501,2947865,NBS
chr02,Bn7871,96271499,96685851,414352,RLK
chr02,Bn7872,76938729,86868923,9930194,CN
chr02,Bn7873,2720881,6139851,3418970,TNL
chr02,Bn7874,69334283,91885989,22551706,NBS
chr02,Bn7875,57807929,60633475,2825546,TNL
chr02,Bn7876,94444914,95809073,1364159,RLK
chr02,Bn7877,4267911,63692661,59424750,NBS
chr02,Bn7878,95408230,99242800,3834570,RLK
chr02,Bn7879,81014366,95975215,14960849,RLK
chr02,Bn7880,10494731,66789226,56294495,RLP
chr02,Bn7881,25606081,75828887,50222806,TNL
chr02,Bn7882,16991380,59168692,42177312,TN
chr02,Bn7883,27623907,57256311,29632404,TN
chr02,Bn7884,21996235,50105699,28109464,RLK
chr02,Bn7885,26748176,76701441,49953265,NBS
chr02,Bn7886,66845768,86096523,19250755,TNL
chr02,Bn7887,99616503,99627125,10622,CNL
chr02,Bn7888,80556156,96978641,16422485,RLP
chr02,Bn7889,6825265,67572542,60747277,RLP
chr02,Bn7890,78952721,91091553,12138832,RLK
chr02,Bn7891,45079462,73300516,28221054,RLK
chr02,Bn7892,74292386,99804803,25512417,TNL
chr02,Bn7893,65619672,75954600,10334928,TNL
chr02,Bn7894,28985122,55401922,26416800,CNL
chr02,Bn7895,93908585,95460394,1551809,CN
chr02,Bn7896,51988892,80264428,28275536,CN
chr02,Bn7897,75056885,98903569,23846684,RLP
chr02,Bn7898,36314226,44735696,8421470,CN
chr02,Bn7899,9965195,19204633,9239438,TN
chr02,Bn7900,60872193,62310867,1438674,RLK
chr02,Bn7901,66534685,66786274,251589,TN
chr02,Bn7902,58747712,71812835,13065123,CNL
chr02,Bn7903,97017075,98240405,1223330,TNL
chr02,Bn7904,50396149,90769644,40373495,RLP
chr02,Bn7905,49596850,90454959,40858109,CNL
chr02,Bn7906,96496883,96775846,278963,CNL
chr02,Bn7907,50960895,75322950,24362055,NBS
chr02,Bn7908,89663873,93090618,3426745,CN
chr02,Bn7909,90307789,91160019,852230,NBS
chr02,Bn7910,7797442,52333270,44535828,TN
chr02,Bn7911,28654491,68239271,39584780,NBS
chr02,Bn7912,41072943,99616233,58543290,TNL
chr02,Bn7913,56548563,91622810,35074247,TNL
chr02,Bn7914,6370842,7202963,832121,CN
chr02,Bn7915,68297016,87975824,19678808,RLP
chr02,Bn7916,16309864,42579854,26269990,NBS
chr02,Bn7917,32439128,68471598,36032470,CNL
chr02,Bn7918,12724722,61478244,48753522,TN
chr02,Bn7919,84398759,85603743,1204984,NBS
chr02,Bn7920,56702582,71728694,15026112,TN
chr02,Bn7921,36173295,84891640,48718345,RLP
chr02,Bn7922,96115243,97590874,1475631,TNL
chr02,Bn7923,14580475,49636528,35056053,RLK
chr02,Bn7924,89399865,99330456,9930591,NBS
chr02,Bn7925,65770734,68710081,2939347,NBS
chr02,Bn7926,11095848,92691055,81595207,CNL
chr02,Bn7927,5314411,59747382,54432971,CNL
chr02,Bn7928,88241528,92021789,3780261,TNL
chr02,Bn7929,58027916,73323520,15295604,CN
chr02,Bn7930,32356325,55625112,23268787,NBS
chr02,Bn7931,27435847,65409297,37973450,CNL
chr02,Bn7932,39935639,56243177,16307538,NBS
chr02,Bn7933,46888579,71760511,24871932,RLK
chr02,Bn7934,77961876,80475873,2513997,RLK
chr02,Bn7935,98685148,99178808,493660,RLP
chr02,Bn7936,34263490,58832591,24569101,NBS
chr02,Bn7937,52481744,92085690,39603946,NBS
chr02,Bn7938,2385841,72065549,69679708,RLK
chr02,Bn7939,71866861,72695404,828543,TN
chr02,Bn7940,33359990,46900972,13540982,CN
chr02,Bn7941,70867869,76980666,6112797,TNL
chr02,Bn7942,65143760,91406688,26262928,CNL
chr02,Bn7943,58654564,73431439,14776875,CNL
chr02,Bn7944,17624070,35802860,18178790,TN
chr02,Bn7945,39557463,54318590,14761127,RLP
chr02,Bn7946,27976119,58295387,30319268,TNL
chr02,Bn7947,38106872,46973510,8866638,TNL
chr02,Bn7948,44613709,55277860,10664151,TNL
chr02,Bn7949,58635800,92714302,34078502,TN
chr02,Bn7950,53566563,87758817,34192254,TNL
chr02,Bn7951,99650227,99985337,335110,CNL
chr02,Bn7952,80818625,88665347,7846722,NBS
chr02,Bn7953,92896214,94215205,1318991,RLK
chr02,Bn7954,73721283,90592245,16870962,TN
chr02,Bn7955,62724246,85569739,22845493,NBS
chr02,Bn7956,47828123,56712778,8884655,CN
chr02,Bn7957,85948151,99182059,13233908,NBS
chr02,Bn7958,86818264,99279538,12461274,RLK
chr02,Bn7959,44111265,70821104,26709839,NBS
chr02,Bn7960,9236485,59102810,49866325,RLK
chr02,Bn7961,93514633,96295271,2780638,TNL
chr02,Bn7962,89407537,92698631,3291094,CN
chr02,Bn7963,41015693,92565268,51549575,RLK
chr02,Bn7964,65578499,70890042,5311543,CN
chr02,Bn7965,76153020,87830821,11677801,TNL
chr02,Bn7966,45248946,46982810,1733864,RLK
chr02,Bn7967,15241874,15624544,382670,RLK
chr02,Bn7968,10814640,29017035,18202395,CNL
chr02,Bn7969,46539131,59024418,12485287,RLP
chr02,Bn7970,31589130,92374649,60785519,NBS
chr02,Bn7971,2355886,63691337,61335451,RLK
chr02,Bn7972,73176960,94079644,20902684,RLP
chr02,Bn7973,67260833,78044958,10784125,NBS
chr02,Bn7974,81717716,81880191,162475,TNL
chr02,Bn7975,88611945,94238918,5626973,NBS
chr02,Bn7976,60313263,98483704,38170441,CNL
chr02,Bn7977,82118259,86169456,4051197,CNL
chr02,Bn7978,78427778,83327099,4899321,NBS
chr02,Bn7979,82259666,93857605,11597939,TNL
chr02,Bn7980,78549611,92384501,13834890,NBS
chr02,Bn7981,63849326,92074399,28225073,CNL
chr02,Bn7982,47428450,81996568,34568118,TNL
chr02,Bn7983,19002442,76856945,57854503,RLP
chr02,Bn7984,24124664,37968858,13844194,TNL
chr02,Bn7985,38077013,72006176,33929163,CN
chr02,Bn7986,9341312,52599891,43258579,CN
chr02,Bn7987,90156330,95601466,5445136,CNL
chr02,Bn7988,17059272,81167962,64108690,RLP
chr02,Bn7989,58243802,88686893,30443091,CN
chr02,Bn7990,2552917,86959160,84406243,TN
chr02,Bn7991,33008572,85830453,52821881,RLK
chr02,Bn7992,71782971,83634686,11851715,CN
chr02,Bn7993,68499030,74970102,6471072,RLK
chr02,Bn7994,24599217,58381287,33782070,RLP
chr02,Bn7995,53208250,96639569,43431319,NBS
chr02,Bn7996,34081915,39875044,5793129,CNL
chr02,Bn7997,61688392,99255945,37567553,RLP
chr02,Bn7998,82810952,89388706,6577754,TN
chr02,Bn7999,9938690,75101556,65162866,TN
chr02,Bn8000,12183013,72960755,60777742,NBS
chr02,Bn8001,20915002,29682081,8767079,TN
chr02,Bn8002,86993015,98143391,11150376,NBS
chr02,Bn8003,73852271,81840488,7988217,TN
chr02,Bn8004,11743949,61952996,50209047,RLK
chr02,Bn8005,63552748,88852045,25299297,RLP
chr02,Bn8006,95728695,97808970,2080275,RLP
chr02,Bn8007,59703998,91416693,31712695,TN
chr02,Bn8008,39572922,69743097,30170175,CNL
chr02,Bn8009,90602899,99988327,9385428,NBS
chr02,Bn8010,61510877,65795019,4284142,TNL
chr02,Bn8011,8245777,42585323,34339546,RLP
chr02,Bn8012,34965661,73355103,38389442,CNL
chr02,Bn8013,20274188,36837544,16563356,RLK
chr02,Bn8014,63972288,91276472,27304184,NBS
chr02,Bn8015,51001106,98646300,47645194,RLK
chr02,Bn8016,77616258,82131157,4514899,RLK
chr02,Bn8017,49429900,72283941,22854041,TNL
chr02,Bn8018,25565770,95170527,69604757,CN
chr02,Bn8019,93117541,96693407,3575866,TN
chr02,Bn8020,34943921,49170825,14226904,RLK
chr02,Bn8021,68390693,95208563,26817870,CNL
chr02,Bn8022,51075917,64891489,13815572,TNL
chr02,Bn8023,46517991,90252306,43734315,TNL
chr02,Bn8024,2664072,5050451,2386379,NBS
chr02,Bn8025,21648372,59071511,37423139,CNL
chr02,Bn8026,62939591,96120378,33180787,TNL
chr02,Bn8027,72897465,90636154,17738689,CNL
chr02,Bn8028,25297851,39598809,14300958,NBS
chr02,Bn8029,21833448,78775731,56942283,TN
chr02,Bn8030,39191795,57834702,18642907,CN
chr02,Bn8031,31970434,95663533,63693099,TN
chr02,Bn8032,4776386,39896351,35119965,RLK
chr02,Bn8033,3981786,43438304,39456518,RLP
chr02,Bn8034,43861605,73827615,29966010,TN
chr02,Bn8035,29878471,38610560,8732089,RLK
chr02,Bn8036,48518590,91596068,43077478,TN
chr02,Bn8037,50758958,99199042,48440084,NBS
chr02,Bn8038,87441048,91330711,3889663,RLP
chr02,Bn8039,85447403,96879943,11432540,CNL
chr02,Bn8040,96631700,97053331,421631,TNL
chr02,Bn8041,52131502,80404654,28273152,TNL
chr02,Bn8042,61846645,88417232,26570587,CN
chr02,Bn8043,32343309,59310017,26966708,CNL
chr02,Bn8044,48612139,66779270,18167131,TNL
chr02,Bn8045,28577584,36448669,7871085,RLP
chr02,Bn8046,94000845,96838180,2837335,NBS
chr02,Bn8047,54751647,55171617,419970,NBS
chr02,Bn8048,64948429,80757131,15808702,CNL
chr02,Bn8049,70830564,94424257,23593693,TN
chr02,Bn8050,26120771,30574229,4453458,RLP
chr02,Bn8051,34695183,68862530,34167347,RLP
chr02,Bn8052,71164831,84584372,13419541,RLK
chr02,Bn8053,13269705,65928486,52658781,RLP
chr02,Bn8054,48600717,50830548,2229831,CNL
chr02,Bn8055,99729839,99979839,250000,NBS
chr02,Bn8056,33999926,66471917,32471991,RLP
chr02,Bn8057,41607996,63224598,21616602,CN
chr02,Bn8058,80082111,91973680,11891569,TNL
chr02,Bn8059,42089875,83349373,41259498,TNL
chr02,Bn8060,87222385,87699014,476629,CNL
chr02,Bn8061,96191790,97264023,1072233,CNL
chr02,Bn8062,17334994,43463293,26128299,CN
chr02,Bn8063,39422874,54004354,14581480,TN
chr02,Bn8064,96885830,99888226,3002396,RLK
chr02,Bn8065,91898976,96065582,4166606,CNL
chr02,Bn8066,86876611,92786414,5909803,TNL
chr02,Bn8067,76253416,94672152,18418736,NBS
chr02,Bn8068,54218665,92353884,38135219,TNL
chr02,Bn8069,4889076,68176468,63287392,RLP
chr02,Bn8070,67440898,95745883,28304985,NBS
chr02,Bn8071,43024867,63335722,20310855,RLP
chr02,Bn8072,73997002,91078176,17081174,NBS
chr02,Bn8073,99687083,99744874,57791,CNL
chr02,Bn8074,86946602,91865561,4918959,TN
chr02,Bn8075,32605098,59102118,26497020,CNL
chr02,Bn8076,33674071,54864569,21190498,RLK
chr02,Bn8077,53451835,95204002,41752167,RLP
chr02,Bn8078,63287673,83709143,20421470,TN
chr02,Bn8079,29792184,72841800,43049616,RLP
chr02,Bn8080,32694471,80923107,48228636,RLK
chr02,Bn8081,30646626,79671992,49025366,NBS
chr02,Bn8082,47448541,94036131,46587590,CNL
chr02,Bn8083,40195034,88516048,48321014,TN
chr02,Bn8084,80034777,88668102,8633325,CNL
chr02,Bn8085,56507745,80624015,24116270,CN
chr02,Bn8086,25497010,46077143,20580133,RLP
chr02,Bn8087,88348131,91807688,3459557,RLP
chr02,Bn8088,92229494,99802701,7573207,CNL
chr02,Bn8089,4993858,11810510,6816652,TN
chr02,Bn8090,20716373,68162906,47446533,CN
chr02,Bn8091,41469803,74521657,33051854,CN
chr02,Bn8092,47042312,93848983,46806671,NBS
chr02,Bn8093,72444757,79447955,7003198,RLP
chr02,Bn8094,29842611,64804211,34961600,RLK
chr02,Bn8095,22180638,24241427,2060789,TNL
chr02,Bn8096,61176815,97147425,35970610,NBS
chr02,Bn8097,24424806,94344707,69919901,RLK
chr02,Bn8098,73811227,92449901,18638674,RLP
chr02,Bn8099,9977636,98883516,88905880,RLK
chr02,Bn8100,35931624,40280345,4348721,RLP
chr02,Bn8101,54591685,93894064,39302379,RLP
chr02,Bn8102,63831324,71437279,7605955,RLP
chr02,Bn8103,31085145,39502196,8417051,TN
chr02,Bn8104,10105289,64991263,54885974,CN
chr02,Bn8105,92560288,96562632,4002344,NBS
chr02,Bn8106,53059960,58946480,5886520,RLP
chr02,Bn8107,85552063,87037529,1485466,NBS
chr02,Bn8108,75419827,93503357,18083530,RLP
chr02,Bn8109,29852607,46967907,17115300,TNL
chr02,Bn8110,15985357,43567992,27582635,TNL
chr02,Bn8111,54429846,90247615,35817769,NBS
chr02,Bn8112,3487883,82119278,78631395,TNL
chr02,Bn8113,85268769,87464466,2195697,TN
chr02,Bn8114,76767422,89003770,12236348,CN
chr02,Bn8115,39719356,83573458,43854102,CNL
chr02,Bn8116,24920421,49684644,24764223,RLP
chr02,Bn8117,1438626,70589846,69151220,RLP
chr02,Bn8118,48594925,88001147,39406222,CN
chr02,Bn8119,70800057,95109199,24309142,CNL
chr02,Bn8120,11603733,49276205,37672472,TNL
chr02,Bn8121,58542311,95314408,36772097,CN
chr02,Bn8122,36638703,39807049,3168346,CNL
chr02,Bn8123,78986558,92114851,13128293,TNL
chr02,Bn8124,76404005,87594166,11190161,TN
chr02,Bn8125,33424268,83617121,50192853,RLK
chr02,Bn8126,96671586,98300458,1628872,NBS
chr02,Bn8127,33365085,98724422,65359337,TN
chr02,Bn8128,48413761,50361645,1947884,TNL
chr02,Bn8129,35907334,75830144,39922810,RLK
chr02,Bn8130,13202603,90388665,77186062,TNL
chr02,Bn8131,58926345,90501275,31574930,TN
chr02,Bn8132,39559976,79141229,39581253,CNL
chr02,Bn8133,7104323,58013141,50908818,TNL
chr02,Bn8134,83294040,84821632,1527592,CN
chr02,Bn8135,19117157,46861938,27744781,RLK
chr02,Bn8136,10023478,77150130,67126652,NBS
chr02,Bn8137,3104870,43488569,40383699,RLK
chr02,Bn8138,94202898,99068746,4865848,CNL
chr02,Bn8139,36385684,37131562,745878,RLP
chr02,Bn8140,28047247,66928871,38881624,CN
chr02,Bn8141,93159127,95161036,2001909,NBS
chr02,Bn8142,1135062,21372133,20237071,TN
chr02,Bn8143,32374405,90335519,57961114,RLP
chr02,Bn8144,57291425,87670453,30379028,TN
chr02,Bn8145,45201864,48318148,3116284,CN
chr02,Bn8146,73107402,75649858,2542456,CNL
chr02,Bn8147,64664798,75355509,10690711,TN
chr02,Bn8148,70002901,91075142,21072241,TN
chr02,Bn8149,31271378,60665910,29394532,RLK
chr02,Bn8150,8336595,49658372,41321777,CN
chr02,Bn8151,92476163,92609615,133452,CNL
chr02,Bn8152,79820994,94921401,15100407,NBS
chr02,Bn8153,29429620,56931563,27501943,TN
chr02,Bn8154,43657456,86853336,43195880,NBS
chr02,Bn8155,56810814,88334164,31523350,RLP
chr02,Bn8156,71791399,98507503,26716104,CN
chr02,Bn8157,36777965,93243639,56465674,TN
chr02,Bn8158,12910821,79022671,66111850,RLP
chr02,Bn8159,75965338,99136053,23170715,NBS
chr02,Bn8160,19536722,72359341,52822619,TN
chr02,Bn8161,9694692,30288488,20593796,TN
chr02,Bn8162,69273372,85565807,16292435,RLK
chr02,Bn8163,90556014,92556354,2000340,RLK
chr02,Bn8164,7937318,52150321,44213003,RLP
chr02,Bn8165,96596898,99374711,2777813,NBS
chr02,Bn8166,57682606,78654647,20972041,TNL
chr02,Bn8167,20659985,80343593,59683608,RLK
chr02,Bn8168,18848318,72235081,53386763,RLP
chr02,Bn8169,39009356,57999341,18989985,RLK
chr02,Bn8170,47236362,65579945,18343583,TN
chr02,Bn8171,46497323,88397419,41900096,NBS
chr02,Bn8172,91118397,96962258,5843861,TN
chr02,Bn8173,62741619,94015957,31274338,TN
chr02,Bn8174,53468949,61745841,8276892,TNL
chr02,Bn8175,85518600,99834455,14315855,CNL
chr02,Bn8176,46616203,50460089,3843886,TNL
chr02,Bn8177,86866403,88180548,1314145,TNL
chr02,Bn8178,22978021,93661265,70683244,RLP
chr02,Bn8179,6885058,38040470,31155412,TN
chr02,Bn8180,90739814,95776010,5036196,CN
chr02,Bn8181,70045656,98498773,28453117,CNL
chr02,Bn8182,39781812,90320299,50538487,RLP
chr02,Bn8183,53228723,90814613,37585890,RLP
chr02,Bn8184,11789334,47739041,35949707,TNL
chr02,Bn8185,67214284,79422826,12208542,RLP
chr02,Bn8186,53824460,54188432,363972,TNL
chr02,Bn8187,26498701,95218083,68719382,TNL
chr02,Bn8188,44481192,81777642,37296450,CNL
chr02,Bn8189,70551443,79030777,8479334,NBS
chr02,Bn8190,56874760,60222575,3347815,TNL
chr02,Bn8191,52143572,53150643,1007071,RLP
chr02,Bn8192,33756280,35292387,1536107,TNL
chr02,Bn8193,78921750,84664451,5742701,CNL
chr02,Bn8194,36892669,88191697,51299028,NBS
chr02,Bn8195,60140439,88656282,28515843,CN
chr02,Bn8196,5790392,88866374,83075982,TNL
chr02,Bn8197,79341062,81983076,2642014,CNL
chr02,Bn8198,69219516,89408313,20188797,CN
chr02,Bn8199,5532517,50245128,44712611,CNL
chr02,Bn8200,6208904,44451451,38242547,CN
chr02,Bn8201,95411770,98637534,3225764,CNL
chr02,Bn8202,69881199,80482659,10601460,CN
chr02,Bn8203,97048525,99728072,2679547,CN
chr02,Bn8204,91565365,97343296,5777931,CN
chr02,Bn8205,56502444,86445801,29943357,TN
chr02,Bn8206,41146132,94698349,53552217,CN
chr02,Bn8207,31293766,75652827,44359061,TN
chr02,Bn8208,97611823,99252565,1640742,RLK
chr02,Bn8209,9961124,48821646,38860522,TNL
chr02,Bn8210,7859565,24070476,16210911,NBS
chr02,Bn8211,94524146,96556580,2032434,NBS
chr02,Bn8212,20806676,43473890,22667214,CNL
chr02,Bn8213,80345996,96023329,15677333,CN
chr02,Bn8214,30227703,48703091,18475388,TNL
chr02,Bn8215,12092343,65630256,53537913,CNL
chr02,Bn8216,30496321,87491513,56995192,CN
chr02,Bn8217,66027267,82342779,16315512,RLK
chr02,Bn8218,69000724,92182256,23181532,TNL
chr02,Bn8219,89949812,94309537,4359725,RLP
chr02,Bn8220,14010181,22112196,8102015,NBS
chr02,Bn8221,42015624,47117270,5101646,RLK
chr02,Bn8222,32406954,41806579,9399625,NBS
chr02,Bn8223,75325035,76849997,1524962,NBS
chr02,Bn8224,15487632,15756123,268491,RLP
chr02,Bn8225,65524538,86553223,21028685,TN
chr02,Bn8226,46234369,96668649,50434280,RLK
chr02,Bn8227,40084034,58458817,18374783,RLP
chr02,Bn8228,65451714,67472837,2021123,RLK
chr02,Bn8229,63480823,79853493,16372670,TN
chr02,Bn8230,80204019,90968858,10764839,RLK
chr02,Bn8231,31516952,32286906,769954,CNL
chr02,Bn8232,3740827,68084598,64343771,NBS
chr02,Bn8233,73989715,84963973,10974258,RLP
chr02,Bn8234,39178575,57005549,17826974,TNL
chr02,Bn8235,39299231,81424589,42125358,TN
chr02,Bn8236,10130449,79428774,69298325,CN
chr02,Bn8237,22186402,39699926,17513524,RLK
chr02,Bn8238,59058791,94302576,35243785,NBS
chr02,Bn8239,99890795,99949006,58211,RLP
chr02,Bn8240,79459083,79902652,443569,CN
chr02,Bn8241,78199598,86959330,8759732,CN
chr02,Bn8242,92106740,94204432,2097692,CNL
chr02,Bn8243,18801939,65215911,46413972,TNL
chr02,Bn8244,33864393,68315371,34450978,NBS
chr02,Bn8245,20776111,62292938,41516827,CNL
chr02,Bn8246,87826418,95061951,7235533,RLK
chr02,Bn8247,72854196,79394090,6539894,NBS
chr02,Bn8248,21361624,86382603,65020979,CNL
chr02,Bn8249,44346790,47534552,3187762,NBS
chr02,Bn8250,6289868,32242520,25952652,CNL
chr02,Bn8251,57864867,80640503,22775636,TN
chr02,Bn8252,56639742,65361041,8721299,NBS
chr02,Bn8253,42002134,85863484,43861350,CN
chr02,Bn8254,38380899,69153011,30772112,TN
chr02,Bn8255,70585468,82632845,12047377,RLP
chr02,Bn8256,19367839,50597304,31229465,CNL
chr02,Bn8257,36872732,47405969,10533237,CNL
chr02,Bn8258,68346248,75967521,7621273,CN
chr02,Bn8259,25059842,66215694,41155852,NBS
chr02,Bn8260,30085714,61929140,31843426,NBS
chr02,Bn8261,27732922,62292127,34559205,RLP
chr02,Bn8262,45934463,59572926,13638463,CN
chr02,Bn8263,89999757,98660897,8661140,RLK
chr02,Bn8264,2617622,66805501,64187879,CNL
chr02,Bn8265,65522664,71841348,6318684,CNL
chr02,Bn8266,84194137,96516862,12322725,NBS
chr02,Bn8267,80206802,87781169,7574367,RLP
chr02,Bn8268,15899949,73367297,57467348,CN
chr02,Bn8269,65866896,71995884,6128988,CNL
chr02,Bn8270,69612734,75940080,6327346,RLK
chr02,Bn8271,14797454,97687461,82890007,RLK
chr02,Bn8272,19071181,72826218,53755037,RLK
chr02,Bn8273,94034691,95310560,1275869,NBS
chr02,Bn8274,14606973,33361566,18754593,NBS
chr02,Bn8275,31031519,90364761,59333242,CN
chr02,Bn8276,91911160,95392153,3480993,RLK
chr02,Bn8277,44999817,92680978,47681161,NBS
chr02,Bn8278,19962663,44261092,24298429,RLK
chr02,Bn8279,43911285,77450485,33539200,NBS
chr02,Bn8280,11729596,43834991,32105395,TN
chr02,Bn8281,39956271,79110052,39153781,RLK
chr02,Bn8282,28317541,76022925,47705384,RLP
chr02,Bn8283,85059594,93718499,8658905,CN
chr02,Bn8284,3723390,21546505,17823115,RLK
chr02,Bn8285,18833477,33465000,14631523,RLP
chr02,Bn8286,49694668,54232955,4538287,TN
chr02,Bn8287,19623528,53835412,34211884,TNL
chr02,Bn8288,1424066,32330934,30906868,TNL
chr02,Bn8289,17939238,58589350,40650112,TNL
chr02,Bn8290,98374241,99350061,975820,NBS
chr02,Bn8291,57789040,59499530,1710490,CNL
chr02,Bn8292,44642831,96675792,52032961,RLK
chr02,Bn8293,10035468,86652844,76617376,CN
chr02,Bn8294,61062326,94385226,33322900,NBS
chr02,Bn8295,31069163,72087297,41018134,CN
chr02,Bn8296,57752423,73058134,15305711,NBS
chr02,Bn8297,94717829,94800166,82337,RLK
chr02,Bn8298,40335779,43559130,3223351,TN
chr02,Bn8299,31480478,44473718,12993240,TNL
chr02,Bn8300,39470870,88748291,49277421,CN
chr02,Bn8301,82488349,94226267,11737918,NBS
chr02,Bn8302,33256003,52561897,19305894,RLP
chr02,Bn8303,51690009,66248001,14557992,NBS
chr02,Bn8304,55582331,73219357,17637026,CNL
chr02,Bn8305,22907987,86626434,63718447,TN
chr02,Bn8306,68777218,93169120,24391902,TNL
chr02,Bn8307,35014397,68514669,33500272,RLK
chr02,Bn8308,59703708,60449592,745884,RLP
chr02,Bn8309,51304911,81659201,30354290,NBS
chr02,Bn8310,60472650,83393631,22920981,RLK
chr02,Bn8311,48674453,64750999,16076546,TN
chr02,Bn8312,59063492,70157191,11093699,RLP
chr02,Bn8313,78377319,92973783,14596464,CN
chr02,Bn8314,51705160,96480192,44775032,TNL
chr02,Bn8315,64182001,93673413,29491412,NBS
chr02,Bn8316,24521996,71591076,47069080,RLP
chr02,Bn8317,73649002,93823803,20174801,TN
chr02,Bn8318,58057265,74050758,15993493,RLP
chr02,Bn8319,79893918,85170916,5276998,NBS
chr02,Bn8320,7922657,18535092,10612435,RLK
chr02,Bn8321,20031904,79971381,59939477,CN
chr02,Bn8322,43716658,78931009,35214351,TN
chr02,Bn8323,93603085,97464546,3861461,RLP
chr02,Bn8324,56354697,60801682,4446985,RLP
chr02,Bn8325,69041884,92384365,23342481,TNL
chr02,Bn8326,91389029,94764032,3375003,RLK
chr02,Bn8327,21758087,55544615,33786528,TNL
chr02,Bn8328,18111593,99057977,80946384,NBS
chr02,Bn8329,51621131,88720189,37099058,TNL
chr02,Bn8330,20630777,43516436,22885659,TN
chr02,Bn8331,77855999,89105460,11249461,TN
chr02,Bn8332,42903570,67564033,24660463,TN
chr02,Bn8333,48599122,68221618,19622496,TN
chr02,Bn8334,18365170,48758662,30393492,RLP
chr02,Bn8335,70976002,83130152,12154150,CN
chr02,Bn8336,25397708,40778157,15380449,RLP
chr02,Bn8337,73446025,86029757,12583732,TN
chr02,Bn8338,21684796,65267021,43582225,CN
chr02,Bn8339,49729320,56012836,6283516,TNL
chr02,Bn8340,42598822,70922431,28323609,RLP
chr02,Bn8341,54540940,61411445,6870505,RLP
chr02,Bn8342,58970844,72283136,13312292,TNL
chr02,Bn8343,84116646,97546363,13429717,CN
chr02,Bn8344,4997473,53105814,48108341,RLK
chr02,Bn8345,14598443,53967527,39369084,TNL
chr02,Bn8346,33571724,93666935,60095211,NBS
chr02,Bn8347,79106609,82380105,3273496,TN
chr02,Bn8348,25921216,40481637,14560421,CN
chr02,Bn8349,87692575,92646758,4954183,RLK
chr02,Bn8350,83154727,89214869,6060142,TN
chr02,Bn8351,42732025,75957504,33225479,TNL
chr02,Bn8352,51643572,94600839,42957267,TN
chr02,Bn8353,19600274,57075234,37474960,RLP
chr02,Bn8354,22688815,72024025,49335210,CN
chr02,Bn8355,19058503,62200626,43142123,CNL
chr02,Bn8356,6204089,25998836,19794747,RLK
chr02,Bn8357,5836439,76625697,70789258,TNL
chr02,Bn8358,25998195,57961532,31963337,RLK
chr02,Bn8359,63379339,88991935,25612596,CNL
chr02,Bn8360,96994712,97487555,492843,TNL
chr02,Bn8361,48361788,51787584,3425796,RLP
chr02,Bn8362,80773407,99774953,19001546,CN
chr02,Bn8363,27298235,66107560,38809325,RLK
chr02,Bn8364,48267098,52028345,3761247,RLK
chr02,Bn8365,61169759,62309806,1140047,TN
chr02,Bn8366,47596052,90780287,43184235,CNL
chr02,Bn8367,52861710,67106099,14244389,TN
chr02,Bn8368,98372693,99856065,1483372,RLK
chr02,Bn8369,26921376,47306442,20385066,CN
chr02,Bn8370,50285175,53613104,3327929,TN
chr02,Bn8371,50745239,93614416,42869177,TNL
chr02,Bn8372,64466080,72393762,7927682,RLK
chr02,Bn8373,80112055,93708541,13596486,CNL
chr02,Bn8374,29354459,65266051,35911592,CNL
chr02,Bn8375,46659478,99429075,52769597,TN
chr02,Bn8376,6752751,40969432,34216681,NBS
chr02,Bn8377,2609684,57943259,55333575,CNL
chr02,Bn8378,92150562,95430929,3280367,NBS
chr02,Bn8379,11289347,86743464,75454117,RLK
chr02,Bn8380,95801606,95990244,188638,RLK
chr02,Bn8381,98536849,99599279,1062430,TN
chr02,Bn8382,40784554,66393715,25609161,CNL
chr02,Bn8383,60564207,95632192,35067985,NBS
chr02,Bn8384,67420910,93561199,26140289,TNL
chr02,Bn8385,14553719,36712062,22158343,CN
chr02,Bn8386,87728098,93468205,5740107,NBS
chr02,Bn8387,34876363,48313979,13437616,NBS
chr02,Bn8388,68261780,68770273,508493,CNL
chr02,Bn8389,14144691,35024209,20879518,CN
chr02,Bn8390,84851888,85555074,703186,TNL
chr02,Bn8391,83688241,93689413,10001172,TN
chr02,Bn8392,73307415,88177076,14869661,TNL
chr02,Bn8393,34723349,67939889,33216540,CN
chr02,Bn8394,51999273,99404061,47404788,CN
chr02,Bn8395,33712506,56709686,22997180,NBS
chr02,Bn8396,96162098,97029836,867738,TNL
chr02,Bn8397,46762973,82665740,35902767,RLK
chr02,Bn8398,96296279,98624777,2328498,TNL
chr02,Bn8399,53389402,92649794,39260392,CNL
chr02,Bn8400,62335355,78062414,15727059,RLP
chr02,Bn8401,56207560,90528482,34320922,CNL
chr02,Bn8402,42939934,79711723,36771789,NBS
chr02,Bn8403,34439470,72211859,37772389,CNL
chr02,Bn8404,44186059,55804913,11618854,RLK
chr02,Bn8405,95929726,99015929,3086203,CNL
chr02,Bn8406,75852960,83006377,7153417,RLP
chr02,Bn8407,40035361,87393513,47358152,NBS
chr02,Bn8408,55270568,93515850,38245282,NBS
chr02,Bn8409,40034067,47888656,7854589,RLP
chr02,Bn8410,44565499,57081758,12516259,TNL
chr02,Bn8411,29680891,65043530,35362639,NBS
chr02,Bn8412,45176012,48842780,3666768,RLP
chr02,Bn8413,6596000,21599631,15003631,RLP
chr02,Bn8414,99603992,99855359,251367,CN
chr02,Bn8415,44681881,46339887,1658006,TN
chr02,Bn8416,69473741,78409663,8935922,CNL
chr02,Bn8417,84006416,94956341,10949925,TN
chr02,Bn8418,29995821,91242741,61246920,TNL
chr02,Bn8419,35647781,96457282,60809501,CNL
chr02,Bn8420,28240399,87056141,58815742,NBS
chr02,Bn8421,18052482,75784601,57732119,NBS
chr02,Bn8422,43219308,55774323,12555015,RLK
chr02,Bn8423,96234178,99577397,3343219,CN
chr02,Bn8424,98838467,99366311,527844,TNL
chr02,Bn8425,70307416,77016531,6709115,TNL
chr02,Bn8426,11075597,13437039,2361442,TNL
chr02,Bn8427,75315880,96895427,21579547,CN
chr02,Bn8428,49642542,77494510,27851968,TN
chr02,Bn8429,57210884,87879626,30668742,CNL
chr02,Bn8430,41768820,63481826,21713006,TN
chr02,Bn8431,93709509,99570901,5861392,RLK
chr02,Bn8432,99435753,99685752,249999,NBS
chr02,Bn8433,73103898,94895412,21791514,TNL
chr02,Bn8434,17006806,60800546,43793740,TN
chr02,Bn8435,73653405,97728621,24075216,CN
chr02,Bn8436,93292861,97296208,4003347,CN
chr02,Bn8437,39253847,48315898,9062051,CNL
chr02,Bn8438,28427391,66056447,37629056,CN
chr02,Bn8439,30270562,74886722,44616160,CNL
chr02,Bn8440,17531989,66022339,48490350,RLK
chr02,Bn8441,45706760,53162749,7455989,NBS
chr02,Bn8442,89313556,93214829,3901273,CN
chr02,Bn8443,5467449,89115205,83647756,TN
chr02,Bn8444,27702006,57024675,29322669,CN
chr02,Bn8445,50427521,88354987,37927466,TNL
chr02,Bn8446,77863755,93680249,15816494,CNL
chr02,Bn8447,13186448,73182749,59996301,TNL
chr02,Bn8448,82302965,86163059,3860094,NBS
chr02,Bn8449,19771615,95987456,76215841,TNL
chr02,Bn8450,4609996,77335757,72725761,TNL
chr02,Bn8451,94234330,99918609,5684279,RLK
chr02,Bn8452,50589325,73719793,23130468,TNL
chr02,Bn8453,27230698,84897067,57666369,CNL
chr02,Bn8454,85852044,99652621,13800577,RLP
chr02,Bn8455,66153673,86074346,19920673,TNL
chr02,Bn8456,24355650,25215353,859703,TN
chr02,Bn8457,72174745,82744969,10570224,CNL
chr02,Bn8458,52988682,79876190,26887508,NBS
chr02,Bn8459,19503433,58059503,38556070,TN
chr02,Bn8460,76910388,90250148,13339760,RLK
chr02,Bn8461,50656833,84726595,34069762,TNL
chr02,Bn8462,50185339,75732767,25547428,TN
chr02,Bn8463,47280751,70381527,23100776,RLP
chr02,Bn8464,77183183,88911859,11728676,TNL
chr02,Bn8465,20162860,30785050,10622190,TN
chr02,Bn8466,39794861,61701255,21906394,CNL
chr02,Bn8467,92167849,97809440,5641591,CN
chr02,Bn8468,44732256,55085469,10353213,TN
chr02,Bn8469,77498035,80433746,2935711,NBS
chr02,Bn8470,87767390,98861606,11094216,RLK
chr02,Bn8471,27391465,65952309,38560844,CN
chr02,Bn8472,48443165,90157918,41714753,RLK
chr02,Bn8473,21045764,65850206,44804442,CNL
chr02,Bn8474,48332677,81796445,33463768,RLK
chr02,Bn8475,25926801,84787055,58860254,TN
chr02,Bn8476,81412898,91567868,10154970,TN
chr02,Bn8477,51608292,89852178,38243886,TNL
chr02,Bn8478,90334515,96009474,5674959,RLP
chr02,Bn8479,76198683,98758363,22559680,CNL
chr02,Bn8480,8127495,76870548,68743053,NBS
chr02,Bn8481,10215202,61876727,51661525,CN
chr02,Bn8482,99143109,99542271,399162,RLK
chr02,Bn8483,3672365,91365145,87692780,RLP
chr02,Bn8484,51732955,87733535,36000580,TN
chr02,Bn8485,71728633,99847687,28119054,CN
chr02,Bn8486,70374582,74309483,3934901,RLP
chr02,Bn8487,83236572,83947376,710804,NBS
chr02,Bn8488,15565536,54548875,38983339,CN
chr02,Bn8489,92334732,93418807,1084075,TN
chr02,Bn8490,58787929,97695467,38907538,CNL
chr02,Bn8491,33075081,98650744,65575663,CNL
chr02,Bn8492,58638127,77129167,18491040,TNL
chr02,Bn8493,83047609,89502793,6455184,CNL
chr02,Bn8494,42227718,78298883,36071165,CN
chr02,Bn8495,88221317,98577898,10356581,CNL
chr02,Bn8496,53327765,58133313,4805548,NBS
chr02,Bn8497,93141781,93341476,199695,NBS
chr02,Bn8498,82599624,85626430,3026806,TNL
chr02,Bn8499,82249414,99931573,17682159,TN
chr02,Bn8500,35447567,53613183,18165616,CN
chr02,Bn8501,72281133,88786606,16505473,CNL
chr02,Bn8502,23981594,86903842,62922248,RLP
chr02,Bn8503,35290180,58585595,23295415,CNL
chr02,Bn8504,51566772,62838753,11271981,RLK
chr02,Bn8505,57978609,89980367,32001758,CNL
chr02,Bn8506,95772404,98754646,2982242,CN
chr02,Bn8507,21881160,54391059,32509899,RLP
chr02,Bn8508,32679295,36442990,3763695,TNL
chr02,Bn8509,25616401,91606436,65990035,TN
chr02,Bn8510,87558187,91033748,3475561,RLP
chr02,Bn8511,44131200,66001930,21870730,CN
chr02,Bn8512,18172794,30776752,12603958,RLP
chr02,Bn8513,36556519,90315451,53758932,TNL
chr02,Bn8514,41297356,96523100,55225744,CN
chr02,Bn8515,24339748,57940763,33601015,CNL
chr02,Bn8516,84080603,88766505,4685902,TNL
chr02,Bn8517,35410826,76955767,41544941,RLP
chr02,Bn8518,61679434,84279767,22600333,CNL
chr02,Bn8519,72964784,73476125,511341,CN
chr02,Bn8520,40562766,78374415,37811649,TNL
chr02,Bn8521,10677911,25824789,15146878,RLK
chr02,Bn8522,92927308,96633269,3705961,NBS
chr02,Bn8523,58613275,68669275,10056000,CN
chr02,Bn8524,19313148,88600826,69287678,RLK
chr02,Bn8525,37940029,69017418,31077389,CNL
chr02,Bn8526,77164164,81250517,4086353,CNL
chr02,Bn8527,32908635,58287417,25378782,CNL
chr02,Bn8528,34862642,86241636,51378994,NBS
chr02,Bn8529,99303921,99828027,524106,NBS
chr02,Bn8530,12843431,63432214,50588783,RLK
chr02,Bn8531,66122121,74352506,8230385,TNL
chr02,Bn8532,80074841,81917747,1842906,TNL
chr02,Bn8533,19712504,60640123,40927619,CN
chr02,Bn8534,74520024,85758349,11238325,RLK
chr02,Bn8535,93432898,93921656,488758,NBS
chr02,Bn8536,37286867,44060845,6773978,CN
chr02,Bn8537,96497898,98156472,1658574,RLK
chr02,Bn8538,55566331,83556391,27990060,TN
chr02,Bn8539,49972975,55817060,5844085,RLP
chr02,Bn8540,11280532,40053125,28772593,CNL
chr02,Bn8541,74571921,88495442,13923521,TN
chr02,Bn8542,75017448,81352515,6335067,RLP
chr02,Bn8543,55293765,77009272,21715507,TN
chr02,Bn8544,29112406,92734305,63621899,RLP
chr02,Bn8545,92866978,98082887,5215909,CN
chr02,Bn8546,24482714,48376777,23894063,TNL
chr02,Bn8547,59652085,85382598,25730513,RLK
chr02,Bn8548,67204284,99989841,32785557,RLP
chr02,Bn8549,66261557,89523590,23262033,RLK
chr02,Bn8550,78592882,95543635,16950753,CNL
chr02,Bn8551,20282871,65323819,45040948,CN
chr02,Bn8552,13917506,20445601,6528095,TN
chr02,Bn8553,56171169,81433404,25262235,RLP
chr02,Bn8554,3086231,31475707,28389476,RLP
chr02,Bn8555,71619658,77323013,5703355,RLP
chr02,Bn8556,82629890,83113575,483685,TN
chr02,Bn8557,63792401,70176037,6383636,RLK
chr02,Bn8558,81318294,99025177,17706883,TN
chr02,Bn8559,45090835,63885033,18794198,CN
chr02,Bn8560,76372115,95739682,19367567,CNL
chr02,Bn8561,33788333,98052508,64264175,CNL
chr02,Bn8562,46557619,49647061,3089442,RLK
chr02,Bn8563,63924653,83784839,19860186,CN
chr02,Bn8564,88091428,88442790,351362,CN
chr02,Bn8565,62628738,64282641,1653903,RLP
chr02,Bn8566,87251089,92450209,5199120,TN
chr02,Bn8567,79133158,96057684,16924526,RLK
chr02,Bn8568,96848786,99667308,2818522,RLP
chr02,Bn8569,46381616,91598704,45217088,CN
chr02,Bn8570,56874890,97832228,40957338,RLP
chr02,Bn8571,20438909,57629835,37190926,CN
chr02,Bn8572,88726146,90750976,2024830,RLK
chr02,Bn8573,78244264,99397681,21153417,CN
chr02,Bn8574,80949318,96397343,15448025,TN
chr02,Bn8575,64349789,69950790,5601001,CN
chr02,Bn8576,85067984,94378672,9310688,CNL
chr02,Bn8577,75806785,88499233,12692448,RLK
chr02,Bn8578,86502573,95846096,9343523,CNL
chr02,Bn8579,79777089,82127368,2350279,RLP
chr02,Bn8580,32651430,42331517,9680087,CN
chr02,Bn8581,71456194,88665573,17209379,NBS
chr02,Bn8582,60551360,68367602,7816242,RLP
chr02,Bn8583,15782254,42841581,27059327,RLK
chr02,Bn8584,87760497,97666122,9905625,TN
chr02,Bn8585,20505419,60778530,40273111,TN
chr02,Bn8586,36412717,57592329,21179612,TNL
chr02,Bn8587,87983991,93530912,5546921,CNL
chr02,Bn8588,13824873,16713027,2888154,NBS
chr02,Bn8589,65070219,78389569,13319350,RLK
chr02,Bn8590,22835046,45820958,22985912,TNL
chr02,Bn8591,36182585,80500599,44318014,RLK
chr02,Bn8592,94858727,97574685,2715958,NBS
chr02,Bn8593,15939069,27144417,11205348,CNL
chr02,Bn8594,36606737,76515542,39908805,CN
chr02,Bn8595,23050058,90353588,67303530,TNL
chr02,Bn8596,21522097,78681876,57159779,RLP
chr02,Bn8597,93225110,96007923,2782813,CN
chr02,Bn8598,88865988,98138580,9272592,CNL
chr02,Bn8599,33423607,67660563,34236956,RLK
chr02,Bn8600,90343283,98925696,8582413,RLK
chr02,Bn8601,41587856,83958732,42370876,NBS
chr02,Bn8602,7079116,16947169,9868053,RLP
chr02,Bn8603,61346573,70477456,9130883,CNL
chr02,Bn8604,33985275,98322820,64337545,RLK
chr02,Bn8605,64021289,82515446,18494157,TN
chr02,Bn8606,20036495,44248466,24211971,NBS
chr02,Bn8607,53130345,82153959,29023614,RLP
chr02,Bn8608,4129808,86467232,82337424,RLP
chr02,Bn8609,67808864,73031136,5222272,TNL
chr02,Bn8610,2249739,90835596,88585857,RLK
chr02,Bn8611,86331603,89732739,3401136,RLP
chr02,Bn8612,9113634,10003571,889937,TN
chr02,Bn8613,66758365,68186004,1427639,TNL
chr02,Bn8614,25409109,36794794,11385685,RLK
chr02,Bn8615,83368978,91810878,8441900,CNL
chr02,Bn8616,57950206,70429711,12479505,TNL
chr02,Bn8617,95594438,95911957,317519,TN
chr02,Bn8618,87988174,91983461,3995287,RLK
chr02,Bn8619,57677620,69707415,12029795,RLK
chr02,Bn8620,62613235,72441150,9827915,TN
chr02,Bn8621,36512158,77154860,40642702,TNL
chr02,Bn8622,39424091,73501150,34077059,NBS
chr02,Bn8623,52204640,62045470,9840830,CNL
chr02,Bn8624,27914647,73116981,45202334,NBS
chr02,Bn8625,29593730,53479101,23885371,CN
chr02,Bn8626,57757494,63011001,5253507,TNL
chr02,Bn8627,82689683,94937678,12247995,NBS
chr02,Bn8628,46700723,72796060,26095337,CNL
chr02,Bn8629,80259354,90767735,10508381,RLP
chr02,Bn8630,30920105,31549509,629404,CN
chr02,Bn8631,14970651,56411506,41440855,TN
chr02,Bn8632,95774350,96739190,964840,TN
chr02,Bn8633,89482609,94407262,4924653,CN
chr02,Bn8634,78486583,82884628,4398045,RLK
chr02,Bn8635,6008661,49287343,43278682,TNL
chr02,Bn8636,22090714,27448780,5358066,NBS
chr02,Bn8637,26403262,93910761,67507499,CN
chr02,Bn8638,84755896,92970571,8214675,TN
chr02,Bn8639,49185024,90542109,41357085,RLK
chr02,Bn8640,34884085,75193588,40309503,TNL
chr02,Bn8641,2214913,55611685,53396772,RLK
chr02,Bn8642,36151746,77876770,41725024,CNL
chr02,Bn8643,78779387,91286509,12507122,RLK
chr02,Bn8644,82477773,98274837,15797064,NBS
chr02,Bn8645,7887870,39125725,31237855,NBS
chr02,Bn8646,8099975,86568476,78468501,RLP
chr02,Bn8647,1032047,73055969,72023922,RLP
chr02,Bn8648,25765555,41707566,15942011,RLP
chr02,Bn8649,48829255,55065025,6235770,CN
chr02,Bn8650,10276194,23030496,12754302,RLP
chr02,Bn8651,19424695,23380477,3955782,RLP
chr02,Bn8652,40983462,70379670,29396208,NBS
chr02,Bn8653,74240832,99680841,25440009,TNL
chr02,Bn8654,13204807,36169963,22965156,CNL
chr02,Bn8655,24517362,38185408,13668046,CNL
chr02,Bn8656,76874705,88209777,11335072,RLP
chr02,Bn8657,82219612,85483423,3263811,NBS
chr02,Bn8658,51139531,75324751,24185220,RLP
chr02,Bn8659,30852033,89582298,58730265,CN
chr02,Bn8660,34880734,71565169,36684435,TN
chr02,Bn8661,66731022,93675113,26944091,RLK
chr02,Bn8662,94375533,96899053,2523520,CN
chr02,Bn8663,45996634,61590298,15593664,TNL
chr02,Bn8664,97160236,99878416,2718180,TN
chr02,Bn8665,52532190,70875636,18343446,CN
chr02,Bn8666,42978067,84812254,41834187,TNL
chr02,Bn8667,78894713,94149071,15254358,NBS
chr02,Bn8668,33195296,65604641,32409345,RLK
chr02,Bn8669,26821567,26865606,44039,CN
chr02,Bn8670,79423985,86844526,7420541,CN
chr02,Bn8671,5016270,58519419,53503149,CN
chr02,Bn8672,66483964,85900880,19416916,TN
chr02,Bn8673,44134215,90764285,46630070,CNL
chr02,Bn8674,43868690,85385932,41517242,CN
chr02,Bn8675,58248574,90751268,32502694,NBS
chr02,Bn8676,95307007,97284134,1977127,CNL
chr02,Bn8677,30751238,83387804,52636566,CNL
chr02,Bn8678,95391695,99189750,3798055,TN
chr02,Bn8679,42234228,42595890,361662,RLK
chr02,Bn8680,83969646,92340646,8371000,NBS
chr02,Bn8681,28503183,79022692,50519509,TN
chr02,Bn8682,81698948,92640712,10941764,RLK
chr02,Bn8683,99857185,99946530,89345,NBS
chr02,Bn8684,40885409,59726950,18841541,TN
chr02,Bn8685,13780358,45366748,31586390,CN
chr02,Bn8686,34202614,66566222,32363608,CNL
chr02,Bn8687,19058098,48106117,29048019,NBS
chr02,Bn8688,8911969,68567402,59655433,RLP
chr02,Bn8689,47310122,55861562,8551440,CNL
chr02,Bn8690,25915906,47458506,21542600,RLP
chr02,Bn8691,60983572,92313454,31329882,CNL
chr02,Bn8692,44215229,64722119,20506890,TN
chr02,Bn8693,70191566,89836746,19645180,NBS
chr02,Bn8694,74728198,79818231,5090033,NBS
chr02,Bn8695,42041550,93956435,51914885,CNL
chr02,Bn8696,43299552,80521005,37221453,TN
chr02,Bn8697,24967403,83815416,58848013,CN
chr02,Bn8698,91012908,96395156,5382248,CN
chr02,Bn8699,54216043,57927142,3711099,TN
chr02,Bn8700,44722502,55396143,10673641,NBS
chr02,Bn8701,80860282,81216844,356562,NBS
chr02,Bn8702,73647155,78952730,5305575,RLK
chr02,Bn8703,20494774,93157653,72662879,CN
chr02,Bn8704,4899211,95001579,90102368,RLP
chr02,Bn8705,61794511,63024937,1230426,NBS
chr02,Bn8706,10416901,36840777,26423876,RLK
chr02,Bn8707,88186310,89249540,1063230,NBS
chr02,Bn8708,90514489,99150580,8636091,TN
chr02,Bn8709,58761994,81278915,22516921,RLP
chr02,Bn8710,51032591,91375531,40342940,NBS
chr02,Bn8711,63067790,76306295,13238505,TN
chr02,Bn8712,91216889,95632916,4416027,CNL
chr02,Bn8713,57030860,79256546,22225686,CNL
chr02,Bn8714,36416825,48609274,12192449,CN
chr02,Bn8715,7063796,64745933,57682137,RLP
chr02,Bn8716,58763974,91764821,33000847,RLK
chr02,Bn8717,79297023,88067758,8770735,TN
chr02,Bn8718,33045347,56292193,23246846,CN
chr02,Bn8719,7299600,64703857,57404257,NBS
chr02,Bn8720,98186507,98287804,101297,RLK
chr02,Bn8721,91616154,96585341,4969187,CNL
chr02,Bn8722,81267882,81594179,326297,CN
chr02,Bn8723,78573558,81731111,3157553,RLK
chr02,Bn8724,86208810,92448126,6239316,TN
chr02,Bn8725,57101360,85114240,28012880,CNL
chr02,Bn8726,92196677,97764579,5567902,CN
chr02,Bn8727,91249216,96569073,5319857,CNL
chr02,Bn8728,34446233,44498123,10051890,TNL
chr02,Bn8729,38955664,78337507,39381843,NBS
chr02,Bn8730,26760511,75834520,49074009,TNL
chr02,Bn8731,55595396,87994888,32399492,RLK
chr02,Bn8732,4000344,54069452,50069108,TNL
chr02,Bn8733,81580457,94170156,12589699,TN
chr02,Bn8734,5213362,61107716,55894354,CN
chr02,Bn8735,42890410,91343863,48453453,NBS
chr02,Bn8736,80413545,92103304,11689759,CNL
chr02,Bn8737,38851470,92718720,53867250,TNL
chr02,Bn8738,97937458,98525558,588100,CN
chr02,Bn8739,63999032,96473817,32474785,CN
chr02,Bn8740,52940856,55930035,2989179,CNL
chr02,Bn8741,54763441,56078177,1314736,CN
chr02,Bn8742,6212307,46869693,40657386,NBS
chr02,Bn8743,32115247,76678847,44563600,CNL
chr02,Bn8744,24033887,51882437,27848550,TNL
chr02,Bn8745,91735919,92733852,997933,RLK
chr02,Bn8746,61041180,86586204,25545024,RLK
chr02,Bn8747,82998164,85767156,2768992,CN
chr02,Bn8748,12309887,52613461,40303574,RLK
chr02,Bn8749,73121757,99273269,26151512,RLP
chr02,Bn8750,1453153,72692672,71239519,RLP
chr02,Bn8751,64323132,89270610,24947478,CNL
chr02,Bn8752,34332316,43277966,8945650,TN
chr02,Bn8753,10952033,72401638,61449605,CNL
chr02,Bn8754,45508335,78111832,32603497,CN
chr02,Bn8755,3130389,75330099,72199710,TN
chr02,Bn8756,53736575,69273430,15536855,RLP
chr02,Bn8757,10689934,60860227,50170293,TN
chr02,Bn8758,83672038,85174539,1502501,TN
chr02,Bn8759,15698309,48648802,32950493,CNL
chr02,Bn8760,78271159,81818208,3547049,CNL
chr02,Bn8761,50692618,93584809,42892191,TN
chr02,Bn8762,38497432,72404162,33906730,TN
chr02,Bn8763,66333471,89389161,23055690,TNL
chr02,Bn8764,82177679,84268404,2090725,RLP
chr02,Bn8765,99305720,99845773,540053,TNL
chr02,Bn8766,97385550,99898551,2513001,NBS
chr02,Bn8767,86209346,94238971,8029625,CNL
chr02,Bn8768,19335195,78987026,59651831,CN
chr02,Bn8769,15698873,69015748,53316875,RLK
chr02,Bn8770,54847507,63607900,8760393,TN
chr02,Bn8771,23856429,83004387,59147958,CNL
chr02,Bn8772,93228090,94502050,1273960,TN
chr02,Bn8773,63937442,97564254,33626812,TNL
chr02,Bn8774,13664972,66582586,52917614,TN
chr02,Bn8775,50352561,54154844,3802283,RLP
chr02,Bn8776,10105735,81349659,71243924,RLK
chr02,Bn8777,2826398,61304446,58478048,TN
chr02,Bn8778,37352001,66948543,29596542,TN
chr02,Bn8779,50037922,66092556,16054634,RLP
chr02,Bn8780,75202344,80689346,5487002,TNL
chr02,Bn8781,30999665,33802744,2803079,TNL
chr02,Bn8782,73723640,97749380,24025740,CNL
chr02,Bn8783,5406766,40585931,35179165,NBS
chr02,Bn8784,7986102,16769480,8783378,CN
chr02,Bn8785,36096664,49759031,13662367,CNL
chr02,Bn8786,36898685,52640337,15741652,TNL
chr02,Bn8787,72326694,88646362,16319668,RLP
chr02,Bn8788,85139873,98686298,13546425,CN
chr02,Bn8789,21645391,74380772,52735381,TN
chr02,Bn8790,88100277,97903522,9803245,CN
chr02,Bn8791,57509430,93608371,36098941,NBS
chr02,Bn8792,19757050,26659351,6902301,TNL
chr02,Bn8793,61170081,80058568,18888487,NBS
chr02,Bn8794,50171295,79900487,29729192,NBS
chr02,Bn8795,89895837,91354753,1458916,CN
chr02,Bn8796,70816046,86120019,15303973,NBS
chr02,Bn8797,91297099,98116715,6819616,TNL
chr02,Bn8798,12341961,97967903,85625942,RLP
chr02,Bn8799,93613708,99674148,6060440,TNL
chr02,Bn8800,8028900,12565488,4536588,RLK
chr02,Bn8801,12143532,77819079,65675547,RLP
chr02,Bn8802,3260287,24587579,21327292,NBS
chr02,Bn8803,25544777,35747531,10202754,CNL
chr02,Bn8804,98101038,99950027,1848989,RLP
chr02,Bn8805,30242351,37105587,6863236,RLP
chr02,Bn8806,78080156,88768285,10688129,NBS
chr02,Bn8807,62394350,94130509,31736159,CNL
chr02,Bn8808,79873780,90554601,10680821,NBS
chr02,Bn8809,68403109,85031033,16627924,CN
chr02,Bn8810,53625110,93475155,39850045,NBS
chr02,Bn8811,38173779,43930893,5757114,CN
chr02,Bn8812,64092397,76347764,12255367,CN
chr02,Bn8813,2614056,71716422,69102366,CN
chr02,Bn8814,17911766,25367885,7456119,CN
chr02,Bn8815,94389686,99907615,5517929,RLP
chr02,Bn8816,5909634,14177249,8267615,NBS
chr02,Bn8817,84206274,84655733,449459,RLK
chr02,Bn8818,18961292,97972587,79011295,RLK
chr02,Bn8819,23396063,39588436,16192373,NBS
chr02,Bn8820,48744504,99433681,50689177,TN
chr02,Bn8821,76178900,98407260,22228360,RLP
chr02,Bn8822,86597650,96483258,9885608,CNL
chr02,Bn8823,89579367,97963455,8384088,TN
chr02,Bn8824,65180902,71261459,6080557,RLP
chr02,Bn8825,92187403,92826968,639565,CNL
chr02,Bn8826,78773049,91587542,12814493,CNL
chr02,Bn8827,6252706,22755798,16503092,TN
chr02,Bn8828,40444035,61187428,20743393,NBS
chr02,Bn8829,72710377,77720620,5010243,TNL
chr02,Bn8830,62476729,79833678,17356949,TN
chr02,Bn8831,81500936,88724121,7223185,TN
chr02,Bn8832,59050256,63346853,4296597,CNL
chr02,Bn8833,61562466,88790459,27227993,CN
chr02,Bn8834,76947421,78520178,1572757,TNL
chr02,Bn8835,29152634,30002690,850056,TN
chr02,Bn8836,16098193,38032702,21934509,TN
chr02,Bn8837,21783254,44003122,22219868,TN
chr02,Bn8838,5765239,18440932,12675693,NBS
chr02,Bn8839,3722733,60873051,57150318,RLP
chr02,Bn8840,75870604,88758765,12888161,NBS
chr02,Bn8841,32778844,94107159,61328315,RLK
chr02,Bn8842,19618077,22856032,3237955,RLP
chr02,Bn8843,66093300,84928091,18834791,RLP
chr02,Bn8844,40626739,76305174,35678435,NBS
chr02,Bn8845,58081205,86613194,28531989,TNL
chr02,Bn8846,48347968,54981143,6633175,RLP
chr02,Bn8847,57399268,80645559,23246291,RLK
chr02,Bn8848,87166982,90863305,3696323,TN
chr02,Bn8849,88356324,94849371,6493047,RLK
chr02,Bn8850,1673810,51823365,50149555,CNL
chr02,Bn8851,25073419,83804088,58730669,NBS
chr02,Bn8852,4817682,19092393,14274711,CNL
chr02,Bn8853,22950809,98523303,75572494,CN
chr02,Bn8854,44824599,46132344,1307745,TN
chr02,Bn8855,20597430,61505836,40908406,RLK
chr02,Bn8856,37677909,97707274,60029365,RLK
chr02,Bn8857,44783773,75798873,31015100,TNL
chr02,Bn8858,99487694,99837976,350282,CNL
chr02,Bn8859,38964143,39928099,963956,TNL
chr02,Bn8860,54063358,82748818,28685460,TN
chr02,Bn8861,21996222,66804988,44808766,CNL
chr02,Bn8862,76941708,97106854,20165146,RLP
chr02,Bn8863,92854118,94965709,2111591,RLK
chr02,Bn8864,6624971,69920299,63295328,RLP
chr02,Bn8865,8008770,18292446,10283676,TNL
chr02,Bn8866,9116693,30526547,21409854,NBS
chr02,Bn8867,33859141,61925889,28066748,RLP
chr02,Bn8868,18265014,26742339,8477325,CNL
chr02,Bn8869,79248688,94812662,15563974,TNL
chr02,Bn8870,61594652,72083486,10488834,NBS
chr02,Bn8871,26398387,73562757,47164370,CN
chr02,Bn8872,36150340,84984283,48833943,NBS
chr02,Bn8873,62009682,67135778,5126096,TN
chr02,Bn8874,40889604,53685195,12795591,RLP
chr02,Bn8875,60355807,60893112,537305,NBS
chr02,Bn8876,3918837,4002112,83275,RLK
chr02,Bn8877,19689406,89115859,69426453,NBS
chr02,Bn8878,60010386,81612747,21602361,TN
chr02,Bn8879,57250892,96614662,39363770,RLK
chr02,Bn8880,42913298,59555272,16641974,CNL
chr02,Bn8881,21773230,76820855,55047625,RLP
chr02,Bn8882,25530692,63223456,37692764,RLK
chr02,Bn8883,90389632,97874012,7484380,CNL
chr02,Bn8884,41907902,91407281,49499379,NBS
chr02,Bn8885,35286044,68228033,32941989,RLP
chr02,Bn8886,40635654,94835319,54199665,CNL
chr02,Bn8887,42760436,84187462,41427026,CNL
chr02,Bn8888,11516836,91402360,79885524,RLK
chr02,Bn8889,18430297,24783416,6353119,CNL
chr02,Bn8890,47849168,97085294,49236126,NBS
chr02,Bn8891,76645003,93005595,16360592,RLP
chr02,Bn8892,88387497,98906127,10518630,TNL
chr02,Bn8893,86979167,99575581,12596414,NBS
chr02,Bn8894,26542003,67419831,40877828,CN
chr02,Bn8895,19762907,68534080,48771173,RLK
chr02,Bn8896,31141905,43196721,12054816,TNL
chr02,Bn8897,78158072,90217735,12059663,CNL
chr02,Bn8898,26358420,93527545,67169125,TN
chr02,Bn8899,12010036,92132422,80122386,RLP
chr02,Bn8900,22691216,45098414,22407198,NBS
chr02,Bn8901,24148978,70070307,45921329,RLP
chr02,Bn8902,34020833,61739273,27718440,TNL
chr02,Bn8903,63174548,96681723,33507175,TNL
chr02,Bn8904,59708898,85130466,25421568,CN
chr02,Bn8905,72171924,85775901,13603977,CN
chr02,Bn8906,17648155,41443166,23795011,TNL
chr02,Bn8907,80576072,92791146,12215074,TN
chr02,Bn8908,21003278,28468824,7465546,RLK
chr02,Bn8909,23518435,73618245,50099810,NBS
chr02,Bn8910,30029590,31999635,1970045,CN
chr02,Bn8911,92948527,95460348,2511821,RLP
chr02,Bn8912,91607269,98556353,6949084,CN
chr02,Bn8913,78915519,91264978,12349459,RLP
chr02,Bn8914,60871164,90295893,29424729,CN
chr02,Bn8915,97256376,97479287,222911,NBS
chr02,Bn8916,70640072,94550392,23910320,NBS
chr02,Bn8917,43772900,55875121,12102221,RLP
chr02,Bn8918,91687887,94287021,2599134,RLP
chr02,Bn8919,63994791,70191231,6196440,TN
chr02,Bn8920,2645368,35320073,32674705,CN
chr02,Bn8921,74403375,99076363,24672988,RLP
chr02,Bn8922,65324079,89579691,24255612,RLP
chr02,Bn8923,92321077,94045750,1724673,CNL
chr02,Bn8924,26464025,94058267,67594242,RLK
chr02,Bn8925,1624389,72525798,70901409,RLK
chr02,Bn8926,59205413,96220854,37015441,RLK
chr02,Bn8927,75331581,86207495,10875914,RLK
chr02,Bn8928,5155364,76038915,70883551,CN
chr02,Bn8929,82585166,82998460,413294,NBS
chr02,Bn8930,5885417,61791520,55906103,NBS
chr02,Bn8931,46505463,49549355,3043892,CN
chr02,Bn8932,54582249,57693369,3111120,TN
chr02,Bn8933,82686434,88251186,5564752,RLP
chr02,Bn8934,9138700,77196923,68058223,NBS
chr02,Bn8935,26273441,69967985,43694544,NBS
chr02,Bn8936,90927061,91851850,924789,CNL
chr02,Bn8937,25316584,67213097,41896513,TNL
chr02,Bn8938,93458121,98198460,4740339,RLP
chr02,Bn8939,28561027,41288553,12727526,TN
chr02,Bn8940,6623152,32537999,25914847,TNL
chr02,Bn8941,8080940,11288980,3208040,TN
chr02,Bn8942,61790102,94534861,32744759,TNL
chr02,Bn8943,12412045,62535338,50123293,RLK
chr02,Bn8944,14336361,92123058,77786697,CNL
chr02,Bn8945,54753482,71029297,16275815,TNL
chr02,Bn8946,44797140,77920535,33123395,RLK
chr02,Bn8947,76763295,86795804,10032509,TN
chr02,Bn8948,87743755,96528637,8784882,TN
chr02,Bn8949,18815597,39361322,20545725,TN
chr02,Bn8950,26368642,28097328,1728686,CNL
chr02,Bn8951,54750465,59361203,4610738,RLK
chr02,Bn8952,15392234,90072780,74680546,RLP
chr02,Bn8953,31339604,78108652,46769048,CNL
chr02,Bn8954,44317754,92153828,47836074,RLP
chr02,Bn8955,36782907,42010266,5227359,RLK
chr02,Bn8956,38045399,96856818,58811419,CNL
chr02,Bn8957,63314079,91341623,28027544,RLK
chr02,Bn8958,88587352,89359490,772138,TNL
chr02,Bn8959,16615486,23619272,7003786,RLK
chr02,Bn8960,31657414,99131759,67474345,RLP
chr02,Bn8961,22912014,49152217,26240203,RLP
chr02,Bn8962,95169655,97827961,2658306,TN
chr02,Bn8963,72545335,92009895,19464560,NBS
chr02,Bn8964,86235056,98091643,11856587,CNL
chr02,Bn8965,95883744,97081884,1198140,TN
chr02,Bn8966,84901478,95549079,10647601,RLK
chr02,Bn8967,15275420,56653739,41378319,NBS
chr02,Bn8968,87989800,91945209,3955409,NBS
chr02,Bn8969,53071581,91028827,37957246,NBS
chr02,Bn8970,62386350,74260532,11874182,TNL
chr02,Bn8971,76957827,89372703,12414876,NBS
chr02,Bn8972,12011808,21750648,9738840,CN
chr02,Bn8973,10328878,76606371,66277493,NBS
chr02,Bn8974,42158133,74093290,31935157,RLK
chr02,Bn8975,89916675,94902626,4985951,CNL
chr02,Bn8976,26895566,92675656,65780090,RLP
chr02,Bn8977,11553652,67697771,56144119,CN
chr02,Bn8978,82697076,90607652,7910576,TNL
chr02,Bn8979,41542133,53270011,11727878,RLP
chr02,Bn8980,97486960,98261631,774671,CN
chr02,Bn8981,67691338,72778797,5087459,CN
chr02,Bn8982,95146776,95980914,834138,CN
chr02,Bn8983,7280220,15455891,8175671,TN
chr02,Bn8984,32572095,46429616,13857521,RLK
chr02,Bn8985,54532950,64079425,9546475,CN
chr02,Bn8986,45316432,63641960,18325528,CNL
chr02,Bn8987,17754151,48696250,30942099,NBS
chr02,Bn8988,84861457,99845189,14983732,RLK
chr02,Bn8989,19164069,77279107,58115038,CN
chr02,Bn8990,60868134,67086084,6217950,NBS
chr02,Bn8991,44220617,58278243,14057626,RLP
chr02,Bn8992,37883312,67410659,29527347,TN
chr02,Bn8993,25946007,55125359,29179352,RLK
chr02,Bn8994,71519006,71663382,144376,CNL
chr02,Bn8995,1327939,88006403,86678464,CN
chr02,Bn8996,50861345,71492701,20631356,CN
chr02,Bn8997,18856890,70908340,52051450,RLP
chr02,Bn8998,18584932,81022407,62437475,CN
chr02,Bn8999,22448840,71639732,49190892,TN
chr02,Bn9000,85149090,88309074,3159984,CNL
chr02,Bn9001,16249654,40064764,23815110,RLP
chr02,Bn9002,2039823,42807748,40767925,CNL
chr02,Bn9003,85423962,85787644,363682,RLP
chr02,Bn9004,46937497,84038929,37101432,TN
chr02,Bn9005,41352819,71606319,30253500,RLK
chr02,Bn9006,62450099,98621117,36171018,TNL
chr02,Bn9007,77597526,98858222,21260696,NBS
chr02,Bn9008,15939477,63761889,47822412,CN
chr02,Bn9009,6035073,59262220,53227147,RLK
chr02,Bn9010,34183665,38932613,4748948,RLK
chr02,Bn9011,21157622,76846801,55689179,TN
chr02,Bn9012,72014483,80011192,7996709,CNL
chr02,Bn9013,71208948,72579022,1370074,NBS
chr02,Bn9014,82116508,91874642,9758134,TN
chr02,Bn9015,56287615,68907878,12620263,TN
chr02,Bn9016,17597634,60233884,42636250,CNL
chr02,Bn9017,77999766,82634420,4634654,RLP
chr02,Bn9018,9209164,69519124,60309960,RLP
chr02,Bn9019,71913483,73919760,2006277,RLP
chr02,Bn9020,28714828,44079025,15364197,NBS
chr02,Bn9021,95156450,96890539,1734089,TNL
chr02,Bn9022,73744949,84331931,10586982,TNL
chr02,Bn9023,18818492,87349070,68530578,NBS
chr02,Bn9024,47386581,54824159,7437578,CNL
chr02,Bn9025,52421635,54698548,2276913,RLK
chr02,Bn9026,15743517,97617334,81873817,CNL
chr02,Bn9027,8380266,57445227,49064961,NBS
chr02,Bn9028,53839960,91984055,38144095,CNL
chr02,Bn9029,69598872,76807883,7209011,TNL
chr02,Bn9030,32070556,42383965,10313409,TN
chr02,Bn9031,62011647,89589026,27577379,CNL
chr02,Bn9032,48338510,61612123,13273613,NBS
chr02,Bn9033,63654854,80757370,17102516,TNL
chr02,Bn9034,17877367,69432665,51555298,RLK
chr02,Bn9035,73165767,78575628,5409861,TNL
chr02,Bn9036,78008661,99140350,21131689,RLP
chr02,Bn9037,73060808,90058780,16997972,RLK
chr02,Bn9038,70855342,93116395,22261053,CNL
chr02,Bn9039,76502033,77200049,698016,RLP
chr02,Bn9040,2116321,32244061,30127740,CNL
chr02,Bn9041,25671234,57838121,32166887,NBS
chr02,Bn9042,64688636,99200914,34512278,RLK
chr02,Bn9043,41123565,76997334,35873769,TNL
chr02,Bn9044,42672261,56457851,13785590,RLK
chr02,Bn9045,74230972,98361965,24130993,TNL
chr02,Bn9046,8202935,54331737,46128802,RLK
chr02,Bn9047,19470377,57787433,38317056,TN
chr02,Bn9048,50341778,74681074,24339296,CN
chr02,Bn9049,92333852,97926613,5592761,CN
chr02,Bn9050,9180998,64690035,55509037,CNL
chr02,Bn9051,23066449,44330489,21264040,CNL
chr02,Bn9052,27700852,94003304,66302452,CN
chr02,Bn9053,60784849,83699586,22914737,TNL
chr02,Bn9054,12997214,21453765,8456551,TN
chr02,Bn9055,26669250,55395214,28725964,CN
chr02,Bn9056,77080522,93893177,16812655,RLK
chr02,Bn9057,40372405,82949864,42577459,CNL
chr02,Bn9058,94633876,94656994,23118,TNL
chr02,Bn9059,57390967,68743990,11353023,NBS
chr02,Bn9060,34884211,50515046,15630835,RLP
chr02,Bn9061,46383308,80147019,33763711,CN
chr02,Bn9062,91179583,92959689,1780106,TNL
chr02,Bn9063,53609667,55519412,1909745,CNL
chr02,Bn9064,49866408,67946775,18080367,CN
chr02,Bn9065,43312528,70195317,26882789,CN
chr02,Bn9066,61798485,77551682,15753197,NBS
chr02,Bn9067,73482838,87014746,13531908,TNL
chr02,Bn9068,73126661,83057891,9931230,RLK
chr02,Bn9069,3080751,33170391,30089640,RLK
chr02,Bn9070,14478006,88512642,74034636,NBS
chr02,Bn9071,67786936,76570025,8783089,RLK
chr02,Bn9072,51381258,63242152,11860894,CNL
chr02,Bn9073,34197544,51075174,16877630,CNL
chr02,Bn9074,91585903,91796052,210149,TN
chr02,Bn9075,77134239,93889958,16755719,RLK
chr02,Bn9076,32153245,54864400,22711155,RLP
chr02,Bn9077,30113565,83338909,53225344,RLK
chr02,Bn9078,71913398,73576953,1663555,TN
chr02,Bn9079,86938005,99928067,12990062,TNL
chr02,Bn9080,62761819,74930702,12168883,RLK
chr02,Bn9081,17312447,61444203,44131756,TNL
chr02,Bn9082,22669177,35218854,12549677,NBS
chr02,Bn9083,91903575,92721311,817736,TN
chr02,Bn9084,71329412,86855051,15525639,TN
chr02,Bn9085,37173217,57646249,20473032,NBS
chr02,Bn9086,98850468,99800800,950332,CNL
chr02,Bn9087,52079424,99702010,47622586,TNL
chr02,Bn9088,53886974,58931230,5044256,RLP
chr02,Bn9089,27755520,58385752,30630232,TN
chr02,Bn9090,78738489,94073404,15334915,TNL
chr02,Bn9091,38405386,51984166,13578780,CN
chr02,Bn9092,84483466,98589506,14106040,RLP
chr02,Bn9093,69750939,72172389,2421450,NBS
chr02,Bn9094,7645184,85580631,77935447,NBS
chr02,Bn9095,41488393,48723412,7235019,CNL
chr02,Bn9096,91721651,99999874,8278223,TN
chr02,Bn9097,84021094,95604871,11583777,RLP
chr02,Bn9098,74156227,77163709,3007482,RLK
chr02,Bn9099,90334415,93526791,3192376,CNL
chr02,Bn9100,77560710,82704066,5143356,CN
chr02,Bn9101,62692028,72521258,9829230,TN
chr02,Bn9102,60310144,94768022,34457878,CNL
chr02,Bn9103,55599061,98238660,42639599,TNL
chr02,Bn9104,58236121,58361103,124982,TNL
chr02,Bn9105,50747637,77051993,26304356,CN
chr02,Bn9106,70072616,82185443,12112827,CN
chr02,Bn9107,39624078,48713400,9089322,CN
chr02,Bn9108,55435746,72491860,17056114,CN
chr02,Bn9109,87533969,98810728,11276759,RLK
chr02,Bn9110,58476487,80542510,22066023,TN
chr02,Bn9111,59285702,61282620,1996918,CNL
chr02,Bn9112,80552537,98449538,17897001,NBS
chr02,Bn9113,11525176,37625817,26100641,CN
chr02,Bn9114,82096924,92014701,9917777,TN
chr02,Bn9115,66309552,76107282,9797730,TNL
chr02,Bn9116,35338273,72885544,37547271,TN
chr02,Bn9117,56976598,58270571,1293973,RLP
chr02,Bn9118,17503317,45618705,28115388,NBS
chr02,Bn9119,36093259,61875329,25782070,TN
chr02,Bn9120,47251854,71409004,24157150,RLK
chr02,Bn9121,14719706,29733566,15013860,RLK
chr02,Bn9122,80949527,96321776,15372249,CN
chr02,Bn9123,38800932,86765139,47964207,NBS
chr02,Bn9124,47425718,77096389,29670671,TNL
chr02,Bn9125,86405105,87616626,1211521,RLP
chr02,Bn9126,52196028,91402386,39206358,NBS
chr02,Bn9127,90590636,94285064,3694428,RLK
chr02,Bn9128,96193569,98829497,2635928,TNL
chr02,Bn9129,35765659,89638653,53872994,CNL
chr02,Bn9130,18221594,73709286,55487692,TNL
chr02,Bn9131,23429397,56561398,33132001,TN
chr02,Bn9132,83064131,96186844,13122713,NBS
chr02,Bn9133,10157264,15582155,5424891,TNL
chr02,Bn9134,6410593,83707706,77297113,CNL
chr02,Bn9135,34041051,62150319,28109268,RLK
chr02,Bn9136,11513862,37471188,25957326,TNL
chr02,Bn9137,72479500,84018597,11539097,CN
chr02,Bn9138,50112043,69879934,19767891,RLK
chr02,Bn9139,30173293,46389505,16216212,CN
chr02,Bn9140,65389429,92420569,27031140,RLK
chr02,Bn9141,55870997,65808053,9937056,CNL
chr02,Bn9142,23916728,82722153,58805425,TNL
chr02,Bn9143,32562056,91556979,58994923,RLK
chr02,Bn9144,82628806,84397983,1769177,TN
chr02,Bn9145,86623344,94730451,8107107,RLP
chr02,Bn9146,58457737,85591310,27133573,CN
chr02,Bn9147,40421324,87999850,47578526,CN
chr02,Bn9148,52492982,61259095,8766113,CN
chr02,Bn9149,82426418,96596264,14169846,RLK
chr02,Bn9150,81123333,96682697,15559364,TN
chr02,Bn9151,39259131,98197913,58938782,CN
chr02,Bn9152,50326657,84454849,34128192,NBS
chr02,Bn9153,36947203,64133644,27186441,TN
chr02,Bn9154,7202175,97692488,90490313,TN
chr02,Bn9155,58234984,96797307,38562323,TN
chr02,Bn9156,29933397,77481372,47547975,CNL
chr02,Bn9157,25631425,82350689,56719264,NBS
chr02,Bn9158,16356157,23564259,7208102,CN
chr02,Bn9159,87831529,97652435,9820906,NBS
chr02,Bn9160,76654315,83732732,7078417,RLK
chr02,Bn9161,36163438,42644510,6481072,TN
chr02,Bn9162,69826776,85027423,15200647,NBS
chr02,Bn9163,85399860,95695024,10295164,TNL
chr02,Bn9164,62870137,76810779,13940642,RLK
chr02,Bn9165,55980711,96769456,40788745,CNL
chr02,Bn9166,84695904,89011931,4316027,RLP
chr02,Bn9167,52828525,89530210,36701685,CNL
chr02,Bn9168,25703242,40141042,14437800,CNL
chr02,Bn9169,67424159,84533715,17109556,CNL
chr02,Bn9170,95761506,96508991,747485,TNL
chr02,Bn9171,85130060,99027344,13897284,RLP
chr02,Bn9172,47049549,47482001,432452,RLK
chr02,Bn9173,80319078,86244921,5925843,RLK
chr02,Bn9174,57134195,60900920,3766725,TN
chr02,Bn9175,52562318,62153106,9590788,CN
chr02,Bn9176,39491495,88493602,49002107,RLP
chr02,Bn9177,87455059,87504238,49179,RLK
chr02,Bn9178,19474559,52570204,33095645,RLK
chr02,Bn9179,2905032,56397545,53492513,TN
chr02,Bn9180,84502439,87345830,2843391,CN
chr02,Bn9181,41728050,98050251,56322201,CNL
chr02,Bn9182,59455273,79654003,20198730,CN
chr02,Bn9183,36694779,76425485,39730706,CNL
chr02,Bn9184,39289679,69719455,30429776,NBS
chr02,Bn9185,76997623,77855349,857726,CNL
chr02,Bn9186,7395674,32581992,25186318,RLK
chr02,Bn9187,83278177,87162130,3883953,CNL
chr02,Bn9188,51720547,67429485,15708938,TNL
chr02,Bn9189,55569852,74700884,19131032,CNL
chr02,Bn9190,44930880,96573219,51642339,CNL
chr02,Bn9191,58127160,88165590,30038430,RLK
chr02,Bn9192,84036534,87615662,3579128,RLP
chr02,Bn9193,72045996,76449432,4403436,NBS
chr02,Bn9194,86407884,88595410,2187526,CN
chr02,Bn9195,3020447,99843951,96823504,CN
chr02,Bn9196,53441747,84673529,31231782,TNL
chr02,Bn9197,90230219,94704608,4474389,TNL
chr02,Bn9198,60649785,65407061,4757276,RLK
chr02,Bn9199,26786543,38390503,11603960,CNL
chr02,Bn9200,44789495,97577923,52788428,CN
chr02,Bn9201,60933002,84700910,23767908,CNL
chr02,Bn9202,16222687,57742146,41519459,RLK
chr02,Bn9203,32249802,60303534,28053732,RLP
chr02,Bn9204,31964376,49630866,17666490,TNL
chr02,Bn9205,33837833,94534360,60696527,CNL
chr02,Bn9206,58733734,84203396,25469662,RLK
chr02,Bn9207,97932067,99938803,2006736,RLK
chr02,Bn9208,89758686,93626074,3867388,NBS
chr02,Bn9209,79932149,97382989,17450840,NBS
chr02,Bn9210,95261172,95694972,433800,NBS
chr02,Bn9211,51227083,53415046,2187963,TNL
chr02,Bn9212,74604170,97977707,23373537,RLP
chr02,Bn9213,92245437,93136710,891273,NBS
chr02,Bn9214,88329223,93115585,4786362,CN
chr02,Bn9215,40814632,50861178,10046546,TNL
chr02,Bn9216,86338350,92343339,6004989,TN
chr02,Bn9217,82998839,90992271,7993432,NBS
chr02,Bn9218,19171190,68709889,49538699,TN
chr02,Bn9219,43072801,93967304,50894503,TNL
chr02,Bn9220,68950488,83802361,14851873,NBS
chr02,Bn9221,89705684,96774055,7068371,CNL
chr02,Bn9222,53821484,66475437,12653953,NBS
chr02,Bn9223,96612228,98487495,1875267,CN
chr02,Bn9224,18246603,29549709,11303106,RLK
chr02,Bn9225,67730077,75065548,7335471,TN
chr02,Bn9226,54297435,96933771,42636336,RLP
chr02,Bn9227,64621516,94387556,29766040,CNL
chr02,Bn9228,7578901,8679260,1100359,TNL
chr02,Bn9229,85066667,95753171,10686504,CN
chr02,Bn9230,61800318,63180620,1380302,RLP
chr02,Bn9231,50971116,88529905,37558789,NBS
chr02,Bn9232,45880194,75373489,29493295,TN
chr02,Bn9233,88229119,93664894,5435775,RLK
chr02,Bn9234,30119332,32078863,1959531,CNL
chr02,Bn9235,38477424,61937891,23460467,RLP
chr02,Bn9236,64000138,65839504,1839366,NBS
chr02,Bn9237,53787874,63035484,9247610,NBS
chr02,Bn9238,93854447,98166874,4312427,CNL
chr02,Bn9239,10639155,27808088,17168933,CN
chr02,Bn9240,87726904,90696576,2969672,RLK
chr02,Bn9241,87597258,93560025,5962767,CNL
chr02,Bn9242,76127164,98717311,22590147,TN
chr02,Bn9243,53373959,60527810,7153851,CN
chr02,Bn9244,40894580,69543763,28649183,RLP
chr02,Bn9245,25764839,94670949,68906110,CN
chr02,Bn9246,29876023,45684324,15808301,CNL
chr02,Bn9247,60123553,87736984,27613431,CNL
chr02,Bn9248,48608341,49390089,781748,RLP
chr02,Bn9249,90319930,92907896,2587966,RLP
chr02,Bn9250,5771545,71473163,65701618,TNL
chr02,Bn9251,18568634,20118221,1549587,CN
chr02,Bn9252,21459035,87426211,65967176,TNL
chr02,Bn9253,5403785,95095497,89691712,TNL
chr02,Bn9254,65088143,74694651,9606508,RLP
chr02,Bn9255,1636520,59242706,57606186,RLK
chr02,Bn9256,29700118,98628012,68927894,NBS
chr02,Bn9257,12485789,85093465,72607676,CNL
chr02,Bn9258,64363029,75182410,10819381,CN
chr02,Bn9259,55842694,94529934,38687240,CNL
chr02,Bn9260,13221170,59379730,46158560,RLP
chr02,Bn9261,79188627,99998405,20809778,TN
chr02,Bn9262,82945933,89567557,6621624,TN
chr02,Bn9263,13574152,63862378,50288226,CN
chr02,Bn9264,56941932,81453007,24511075,TNL
chr02,Bn9265,49918205,82504254,32586049,NBS
chr02,Bn9266,11516146,95428357,83912211,TNL
chr02,Bn9267,55129974,87017568,31887594,RLK
chr02,Bn9268,31647143,62834814,31187671,TN
chr02,Bn9269,31647921,57900498,26252577,CNL
chr02,Bn9270,88792199,97629910,8837711,CN
chr02,Bn9271,89926401,94658539,4732138,RLP
chr02,Bn9272,52793489,80841711,28048222,CNL
chr02,Bn9273,1395496,13024057,11628561,TN
chr02,Bn9274,26361735,64884963,38523228,RLK
chr02,Bn9275,98213180,99175833,962653,TNL
chr02,Bn9276,68436853,96089940,27653087,CN
chr02,Bn9277,81103446,97467734,16364288,RLK
chr02,Bn9278,1165727,58068542,56902815,CNL
chr02,Bn9279,91285427,98947891,7662464,RLP
chr02,Bn9280,4669663,22245075,17575412,CN
chr02,Bn9281,43248169,55632653,12384484,CNL
chr02,Bn9282,66942130,85647646,18705516,TNL
chr02,Bn9283,21224556,37532939,16308383,NBS
chr02,Bn9284,21929092,47207213,25278121,RLP
chr02,Bn9285,98817145,99901022,1083877,CNL
chr02,Bn9286,2630755,92522883,89892128,TN
chr02,Bn9287,77851264,88620815,10769551,CNL
chr02,Bn9288,49739071,84580817,34841746,CN
chr02,Bn9289,55308111,73072914,17764803,CN
chr02,Bn9290,92734201,94202421,1468220,RLP
chr02,Bn9291,21113138,90980571,69867433,NBS
chr02,Bn9292,11210881,77867356,66656475,CNL
chr02,Bn9293,47470953,55801387,8330434,NBS
chr02,Bn9294,68913737,99805321,30891584,NBS
chr02,Bn9295,93501313,97758293,4256980,TNL
chr02,Bn9296,2101709,25802204,23700495,CN
chr02,Bn9297,93939787,99094645,5154858,RLP
chr02,Bn9298,22874143,97425846,74551703,CNL
chr02,Bn9299,16403704,79310390,62906686,CNL
chr02,Bn9300,27065626,79715823,52650197,RLP
chr02,Bn9301,24201601,86622092,62420491,RLP
chr02,Bn9302,80659095,88707832,8048737,CN
chr02,Bn9303,41916185,45042240,3126055,TNL
chr02,Bn9304,49608278,83645077,34036799,CNL
chr02,Bn9305,49729991,86708053,36978062,TNL
chr02,Bn9306,15515509,35130972,19615463,NBS
chr02,Bn9307,79104686,91821599,12716913,RLK
chr02,Bn9308,76611859,88543861,11932002,RLK
chr02,Bn9309,30925783,64226383,33300600,CNL
chr02,Bn9310,56764343,97083527,40319184,NBS
chr02,Bn9311,34097320,52085792,17988472,CN
chr02,Bn9312,39020255,61433637,22413382,RLP
chr02,Bn9313,35767461,58030930,22263469,RLK
chr02,Bn9314,2624400,20900693,18276293,TNL
chr02,Bn9315,57651845,98612219,40960374,TN
chr02,Bn9316,10736616,99216525,88479909,TNL
chr02,Bn9317,3250756,48645337,45394581,NBS
chr02,Bn9318,52345001,61989876,9644875,CNL
chr02,Bn9319,14198063,32900064,18702001,NBS
chr02,Bn9320,7005214,42306386,35301172,TN
chr02,Bn9321,43295969,75858845,32562876,TNL
chr02,Bn9322,46120645,91973243,45852598,RLK
chr02,Bn9323,63426584,74136560,10709976,CN
chr02,Bn9324,70608237,83290135,12681898,CNL
chr02,Bn9325,4202028,10831128,6629100,CN
chr02,Bn9326,87914089,95205769,7291680,CNL
chr02,Bn9327,58909233,83908364,24999131,NBS
chr02,Bn9328,43477827,99597362,56119535,RLP
chr02,Bn9329,20221309,58317102,38095793,NBS
chr02,Bn9330,47521946,67250930,19728984,NBS
chr02,Bn9331,4795569,94222694,89427125,RLP
chr02,Bn9332,1155949,5009062,3853113,TN
chr02,Bn9333,81822171,94819211,12997040,TN
chr02,Bn9334,98396606,99256319,859713,RLK
chr02,Bn9335,44944692,57680531,12735839,TN
chr02,Bn9336,78831367,88380676,9549309,TNL
chr02,Bn9337,69867476,97117977,27250501,TN
chr02,Bn9338,12535034,71568854,59033820,NBS
chr02,Bn9339,65041775,74259906,9218131,RLK
chr02,Bn9340,39669841,57203065,17533224,TNL
chr02,Bn9341,40402380,68062183,27659803,RLP
chr02,Bn9342,76030220,95921341,19891121,CNL
chr02,Bn9343,14191720,51806099,37614379,CN
chr02,Bn9344,92847654,95589992,2742338,CNL
chr02,Bn9345,81977572,94159961,12182389,NBS
chr02,Bn9346,51508954,62910266,11401312,TNL
chr02,Bn9347,32858846,59278743,26419897,TN
chr02,Bn9348,52944778,65578742,12633964,RLK
chr02,Bn9349,34717232,64942652,30225420,CNL
chr02,Bn9350,51740011,97519445,45779434,CN
chr02,Bn9351,20730549,75723164,54992615,TNL
chr02,Bn9352,59059930,88133655,29073725,RLP
chr02,Bn9353,99542376,99749774,207398,CN
chr02,Bn9354,94882194,97027410,2145216,CN
chr02,Bn9355,5225476,42908073,37682597,RLK
chr02,Bn9356,41657399,99225170,57567771,CNL
chr02,Bn9357,46523689,65358023,18834334,RLP
chr02,Bn9358,26957555,40528982,13571427,CNL
chr02,Bn9359,37066153,65249129,28182976,RLK
chr02,Bn9360,61245327,70828174,9582847,NBS
chr02,Bn9361,18285630,76275995,57990365,RLP
chr02,Bn9362,84192746,91255252,7062506,TNL
chr02,Bn9363,51137796,64090866,12953070,RLK
chr02,Bn9364,86979472,98477327,11497855,CN
chr02,Bn9365,3248423,86219297,82970874,NBS
chr02,Bn9366,24185721,98531294,74345573,TN
chr02,Bn9367,21010426,96371071,75360645,NBS
chr02,Bn9368,54090156,92607403,38517247,NBS
chr02,Bn9369,84175388,84643159,467771,TNL
chr02,Bn9370,38660824,80517560,41856736,RLP
chr02,Bn9371,71004070,86326741,15322671,CNL
chr02,Bn9372,79938339,88280510,8342171,CNL
chr02,Bn9373,10063671,47032253,36968582,RLK
chr02,Bn9374,27272090,77786113,50514023,RLK
chr02,Bn9375,57249164,98841284,41592120,CN
chr02,Bn9376,80603967,96994564,16390597,NBS
chr02,Bn9377,89652675,91270892,1618217,CN
chr02,Bn9378,48904334,54642755,5738421,NBS
chr02,Bn9379,21710354,30057805,8347451,TNL
chr02,Bn9380,89510209,95519508,6009299,CN
chr02,Bn9381,69398138,94265798,24867660,TN
chr02,Bn9382,65114482,99807180,34692698,CN
chr02,Bn9383,68877914,99503048,30625134,RLK
chr02,Bn9384,52030273,53977667,1947394,CN
chr02,Bn9385,20206860,47052256,26845396,CN
chr02,Bn9386,80859685,93801698,12942013,CN
chr02,Bn9387,2765565,43292591,40527026,RLK
chr02,Bn9388,1932416,85205855,83273439,RLP
chr02,Bn9389,66393906,76624214,10230308,NBS
chr02,Bn9390,59724382,75271601,15547219,TNL
chr02,Bn9391,81076693,89339240,8262547,RLP
chr02,Bn9392,1344130,55042527,53698397,TNL
chr02,Bn9393,9812184,37583307,27771123,CNL
chr02,Bn9394,90909384,99961729,9052345,RLP
chr02,Bn9395,74681919,77493174,2811255,NBS
chr02,Bn9396,52053626,77234350,25180724,NBS
chr02,Bn9397,84121410,84529402,407992,RLP
chr02,Bn9398,81369029,99975746,18606717,TN
chr02,Bn9399,83713880,94179477,10465597,TNL
chr02,Bn9400,4740668,52763194,48022526,TNL
chr02,Bn9401,52528320,97411858,44883538,TNL
chr02,Bn9402,93738523,96548009,2809486,TN
chr02,Bn9403,23321396,41327902,18006506,NBS
chr02,Bn9404,74983150,96026533,21043383,NBS
chr02,Bn9405,75409556,92833964,17424408,RLP
chr02,Bn9406,36930055,40748447,3818392,CNL
chr02,Bn9407,73377880,81100300,7722420,CN
chr02,Bn9408,28972060,35487434,6515374,RLK
chr02,Bn9409,96217269,96316908,99639,RLK
chr02,Bn9410,12471663,71870393,59398730,TN
chr02,Bn9411,56342797,96168334,39825537,RLK
chr02,Bn9412,69284091,92070245,22786154,TNL
chr02,Bn9413,1644037,67850195,66206158,TN
chr02,Bn9414,54876168,65965325,11089157,CNL
chr02,Bn9415,33160998,41733349,8572351,TN
chr02,Bn9416,94103947,99158128,5054181,RLP
chr02,Bn9417,30276629,39625726,9349097,TN
chr02,Bn9418,36719560,43945069,7225509,RLP
chr02,Bn9419,5359431,38448602,33089171,RLK
chr02,Bn9420,70430862,79483325,9052463,TNL
chr02,Bn9421,87647517,93393182,5745665,RLK
chr02,Bn9422,14790548,38536087,23745539,CNL
chr02,Bn9423,12863394,27252209,14388815,CN
chr02,Bn9424,97035218,99389930,2354712,NBS
chr02,Bn9425,71695823,91843504,20147681,RLP
chr02,Bn9426,53117618,69114039,15996421,RLP
chr02,Bn9427,41643577,72407376,30763799,NBS
chr02,Bn9428,65113554,97650835,32537281,TNL
chr02,Bn9429,87628435,96907479,9279044,TNL
chr02,Bn9430,26248128,70484933,44236805,CNL
chr02,Bn9431,40575865,47831146,7255281,TN
chr02,Bn9432,55848010,83687889,27839879,TN
chr02,Bn9433,66393596,67910011,1516415,TN
chr02,Bn9434,90968830,98260480,7291650,TN
chr02,Bn9435,74686703,99263450,24576747,NBS
chr02,Bn9436,50997980,76711227,25713247,TN
chr02,Bn9437,32552324,65590840,33038516,NBS
chr02,Bn9438,41796880,44699071,2902191,CN
chr02,Bn9439,86032398,87955495,1923097,CN
chr02,Bn9440,48281180,93059696,44778516,NBS
chr02,Bn9441,21417941,71708272,50290331,RLP
chr02,Bn9442,89955303,94382379,4427076,CN
chr02,Bn9443,46179565,59883718,13704153,TN
chr02,Bn9444,75530814,93293674,17762860,TNL
chr02,Bn9445,12896498,55181267,42284769,NBS
chr02,Bn9446,87669112,89428681,1759569,CN
chr02,Bn9447,3950348,79893734,75943386,RLK
chr02,Bn9448,31387688,73843604,42455916,CN
chr02,Bn9449,3021612,85355091,82333479,CN
chr02,Bn9450,26119821,49735661,23615840,RLK
chr02,Bn9451,28086038,75939788,47853750,RLP
chr02,Bn9452,84469107,88198106,3728999,CN
chr02,Bn9453,38896476,75915243,37018767,CN
chr02,Bn9454,62887853,85276241,22388388,CNL
chr02,Bn9455,44382691,64180064,19797373,TNL
chr02,Bn9456,33690390,57217365,23526975,RLP
chr02,Bn9457,85365629,90173842,4808213,CN
chr02,Bn9458,49169741,71794366,22624625,CNL
chr02,Bn9459,97968973,99668458,1699485,RLP
chr02,Bn9460,85636355,86590167,953812,TNL
chr02,Bn9461,64356226,88197646,23841420,NBS
chr02,Bn9462,52314347,78187512,25873165,TN
chr02,Bn9463,67750012,98078693,30328681,TN
chr02,Bn9464,13474027,56312617,42838590,TN
chr02,Bn9465,88021477,93327333,5305856,RLP
chr02,Bn9466,16154687,60087180,43932493,CN
chr02,Bn9467,33841368,73498960,39657592,RLP
chr02,Bn9468,6988478,90589030,83600552,CN
chr02,Bn9469,52685206,77124973,24439767,RLK
chr02,Bn9470,97706167,98999050,1292883,CN
chr02,Bn9471,44108819,56640107,12531288,CNL
chr02,Bn9472,93938022,96824846,2886824,RLP
chr02,Bn9473,26289208,90901391,64612183,NBS
chr02,Bn9474,71461108,91549891,20088783,CN
chr02,Bn9475,93520800,99721836,6201036,TN
chr02,Bn9476,10480421,92019575,81539154,TN
chr02,Bn9477,87372589,96865013,9492424,TNL
chr02,Bn9478,15791141,52894744,37103603,TN
chr02,Bn9479,87714311,89295104,1580793,NBS
chr02,Bn9480,86217278,86229563,12285,CNL
chr02,Bn9481,56764669,99516259,42751590,TNL
chr02,Bn9482,19973732,32106590,12132858,TN
chr02,Bn9483,30883798,98801860,67918062,CNL
chr02,Bn9484,66884902,98740338,31855436,CNL
chr02,Bn9485,37944205,77243098,39298893,TNL
chr02,Bn9486,28220991,61944425,33723434,RLP
chr02,Bn9487,37329461,84105611,46776150,TN
chr02,Bn9488,63518042,81727655,18209613,RLP
chr02,Bn9489,13545422,29846305,16300883,CN
chr02,Bn9490,63375303,82146256,18770953,NBS
chr02,Bn9491,53406504,77883279,24476775,TNL
chr02,Bn9492,34645251,62451682,27806431,RLK
chr02,Bn9493,60457323,77706181,17248858,CN
chr02,Bn9494,23226590,33692033,10465443,CN
chr02,Bn9495,15461684,24243799,8782115,CNL
chr02,Bn9496,83286906,83636195,349289,TN
chr02,Bn9497,79232844,97774154,18541310,CN
chr02,Bn9498,10722844,12340118,1617274,CNL
chr02,Bn9499,8457180,78573394,70116214,TN
chr02,Bn9500,18413794,51697538,33283744,RLK
chr02,Bn9501,19968354,56907230,36938876,TNL
chr02,Bn9502,51489632,98982018,47492386,CNL
chr02,Bn9503,4842310,50313097,45470787,RLP
chr02,Bn9504,64213944,70989619,6775675,NBS
chr02,Bn9505,57715419,70999894,13284475,RLP
chr02,Bn9506,40549088,43704210,3155122,TN
chr02,Bn9507,12785926,40529502,27743576,TNL
chr02,Bn9508,95162002,95937955,775953,CNL
chr02,Bn9509,47538730,50871009,3332279,TN
chr02,Bn9510,53694606,93279462,39584856,CN
chr02,Bn9511,53003927,82398715,29394788,TNL
chr02,Bn9512,86344093,94060762,7716669,TN
chr02,Bn9513,43211686,99323158,56111472,CN
chr02,Bn9514,85892036,98698240,12806204,TNL
chr02,Bn9515,46697541,76713891,30016350,CN
chr02,Bn9516,5223416,91857311,86633895,NBS
chr02,Bn9517,39172800,95076439,55903639,CNL
chr02,Bn9518,60300912,69266034,8965122,TNL
chr02,Bn9519,39093946,59603806,20509860,CN
chr02,Bn9520,57752965,84161280,26408315,TNL
chr02,Bn9521,71988073,77888645,5900572,TNL
chr02,Bn9522,6545063,15335727,8790664,CNL
chr02,Bn9523,24037551,34051495,10013944,NBS
chr02,Bn9524,19208280,78414842,59206562,TN
chr02,Bn9525,99095225,99506489,411264,CNL
chr02,Bn9526,56094102,87991218,31897116,TN
chr02,Bn9527,75232404,91690310,16457906,CNL
chr02,Bn9528,14982794,66312226,51329432,NBS
chr02,Bn9529,42103189,45692308,3589119,CNL
chr02,Bn9530,55131813,69991794,14859981,TN
chr02,Bn9531,73262286,78840702,5578416,CN
chr02,Bn9532,84820757,87879410,3058653,TNL
chr02,Bn9533,18012548,53840180,35827632,NBS
chr02,Bn9534,75671605,86374522,10702917,TNL
chr02,Bn9535,30787931,46397775,15609844,TN
chr02,Bn9536,21323571,26106264,4782693,CN
chr02,Bn9537,84589739,88530748,3941009,CNL
chr02,Bn9538,7914197,19585572,11671375,TN
chr02,Bn9539,15519808,39592615,24072807,TNL
chr02,Bn9540,2837697,38130852,35293155,RLP
chr02,Bn9541,84863702,98280629,13416927,CN
chr02,Bn9542,13481399,48392870,34911471,RLP
chr02,Bn9543,30769974,35586833,4816859,RLK
chr02,Bn9544,77371108,96660583,19289475,RLK
chr02,Bn9545,63241729,74775854,11534125,NBS
chr02,Bn9546,57465474,71570183,14104709,CN
chr02,Bn9547,80862880,86956933,6094053,RLP
chr02,Bn9548,69278212,75295677,6017465,CNL
chr02,Bn9549,90724692,93577505,2852813,RLK
chr02,Bn9550,95585938,95620563,34625,CN
chr02,Bn9551,72881524,90160685,17279161,TN
chr02,Bn9552,51581240,75642461,24061221,NBS
chr02,Bn9553,96563297,98532178,1968881,RLK
chr02,Bn9554,29692868,77776906,48084038,RLP
chr02,Bn9555,62618973,82909898,20290925,NBS
chr02,Bn9556,62296058,80592507,18296449,TN
chr02,Bn9557,68711701,85987093,17275392,RLP
chr02,Bn9558,31976375,53358606,21382231,NBS
chr02,Bn9559,16552070,34206658,17654588,TN
chr02,Bn9560,34417796,36442915,2025119,TNL
chr02,Bn9561,40090548,71329463,31238915,RLK
chr02,Bn9562,81344602,97181775,15837173,NBS
chr02,Bn9563,42440856,74129286,31688430,RLP
chr02,Bn9564,26240438,59835324,33594886,NBS
chr02,Bn9565,43101885,43642540,540655,TNL
chr02,Bn9566,26926581,51849742,24923161,NBS
chr02,Bn9567,41114843,69095981,27981138,TN
chr02,Bn9568,78455159,96662084,18206925,TNL
chr02,Bn9569,48094797,79378211,31283414,TN
chr02,Bn9570,26456415,35268143,8811728,RLP
chr02,Bn9571,87868733,93593638,5724905,CNL
chr02,Bn9572,77051574,77228171,176597,TNL
chr02,Bn9573,66132605,80124892,13992287,CN
chr02,Bn9574,70322000,83550488,13228488,RLK
chr02,Bn9575,77422779,91319033,13896254,RLK
chr02,Bn9576,8218265,66462023,58243758,RLK
chr02,Bn9577,37774549,45424242,7649693,TN
chr02,Bn9578,43787971,66969266,23181295,TN
chr02,Bn9579,34825622,58006494,23180872,TNL
chr02,Bn9580,65867311,66493108,625797,NBS
chr02,Bn9581,96195197,98315726,2120529,NBS
chr02,Bn9582,91075740,98356038,7280298,RLK
chr02,Bn9583,95385520,99234228,3848708,TNL
chr02,Bn9584,6906820,76089910,69183090,CN
chr02,Bn9585,68863489,87456152,18592663,NBS
chr02,Bn9586,51180455,94659894,43479439,CN
chr02,Bn9587,79239410,81956070,2716660,CN
chr02,Bn9588,70831655,90987570,20155915,NBS
chr02,Bn9589,43823146,57162421,13339275,TN
chr02,Bn9590,61010888,87478178,26467290,RLP
chr02,Bn9591,95458601,99129779,3671178,CNL
chr02,Bn9592,20197568,68144589,47947021,CN
chr02,Bn9593,20421721,30666698,10244977,CNL
chr02,Bn9594,75353502,95048693,19695191,CN
chr02,Bn9595,37193096,64287929,27094833,CNL
chr02,Bn9596,79256794,92299228,13042434,NBS
chr02,Bn9597,19635786,90744577,71108791,TNL
chr02,Bn9598,24256943,48152188,23895245,RLK
chr02,Bn9599,1776633,5056922,3280289,RLK
chr02,Bn9600,93337881,97249221,3911340,TNL
chr02,Bn9601,62141758,76495275,14353517,CN
chr02,Bn9602,41944647,59532296,17587649,RLP
chr02,Bn9603,88910674,97475589,8564915,TNL
chr02,Bn9604,14917810,26058842,11141032,NBS
chr02,Bn9605,83842288,99166860,15324572,CN
chr02,Bn9606,30577112,92956018,62378906,RLK
chr02,Bn9607,5727933,67995192,62267259,CN
chr02,Bn9608,21425692,36733140,15307448,TNL
chr02,Bn9609,40435386,94431335,53995949,NBS
chr02,Bn9610,3312685,78126862,74814177,NBS
chr02,Bn9611,41801813,86219747,44417934,TNL
chr02,Bn9612,97659585,98586165,926580,NBS
chr02,Bn9613,8780506,23604009,14823503,TNL
chr02,Bn9614,94927359,96917308,1989949,CN
chr02,Bn9615,10300203,84672357,74372154,CNL
chr02,Bn9616,50961240,93513848,42552608,TN
chr02,Bn9617,67041200,75526979,8485779,NBS
chr02,Bn9618,13899867,23854440,9954573,NBS
chr02,Bn9619,21032105,37914424,16882319,NBS
chr02,Bn9620,15984022,23425002,7440980,TN
chr02,Bn9621,27039442,39154593,12115151,TNL
chr02,Bn9622,4991762,37419903,32428141,RLP
chr02,Bn9623,96225652,97013004,787352,NBS
chr02,Bn9624,72742635,89597355,16854720,CNL
chr02,Bn9625,87732371,96420866,8688495,TNL
chr02,Bn9626,1804982,72035705,70230723,RLP
chr02,Bn9627,59718174,84853342,25135168,TNL
chr02,Bn9628,70631250,79541060,8909810,RLK
chr02,Bn9629,82121508,87689243,5567735,CN
chr02,Bn9630,30364292,99604364,69240072,NBS
chr02,Bn9631,87658320,97801396,10143076,RLK
chr02,Bn9632,9782981,62273495,52490514,NBS
chr02,Bn9633,98654102,99169902,515800,RLP
chr02,Bn9634,11426064,91453413,80027349,TN
chr02,Bn9635,38349109,60098430,21749321,RLP
chr02,Bn9636,98012288,99148157,1135869,TNL
chr02,Bn9637,50344821,95614709,45269888,RLK
chr02,Bn9638,95291466,96885157,1593691,TNL
chr02,Bn9639,8098156,87188816,79090660,RLP
chr02,Bn9640,97387894,99351838,1963944,CNL
chr02,Bn9641,17526531,99859500,82332969,CN
chr02,Bn9642,85994007,86282758,288751,NBS
chr02,Bn9643,72516172,75196426,2680254,RLP
chr02,Bn9644,29813982,62273570,32459588,CNL
chr02,Bn9645,66195299,79828440,13633141,RLP
chr02,Bn9646,2753282,53064874,50311592,CNL
chr02,Bn9647,45922271,64987739,19065468,TNL
chr02,Bn9648,60327367,74723899,14396532,NBS
chr02,Bn9649,5857306,65689614,59832308,RLK
chr02,Bn9650,99212387,99446377,233990,CN
chr02,Bn9651,43936171,74284926,30348755,NBS
chr02,Bn9652,27336177,35397186,8061009,CN
chr02,Bn9653,7363936,99115462,91751526,RLK
chr02,Bn9654,24308283,45249237,20940954,RLP
chr02,Bn9655,10215605,13948989,3733384,NBS
chr02,Bn9656,25081533,88349624,63268091,RLP
chr02,Bn9657,39440412,79279580,39839168,TNL
chr02,Bn9658,90528803,94670139,4141336,CNL
chr02,Bn9659,12520908,60975259,48454351,TNL
chr02,Bn9660,96140173,98644786,2504613,TN
chr02,Bn9661,2454327,11184647,8730320,NBS
chr02,Bn9662,41129543,75706079,34576536,CN
chr02,Bn9663,93286931,99289096,6002165,CNL
chr02,Bn9664,21708375,74128136,52419761,CN
chr02,Bn9665,84058655,85463072,1404417,CN
chr02,Bn9666,65869344,88955588,23086244,CN
chr02,Bn9667,91534832,94341559,2806727,NBS
chr02,Bn9668,78479415,79582949,1103534,CN
chr02,Bn9669,94197642,95463631,1265989,RLK
chr02,Bn9670,32859603,55665423,22805820,CNL
chr02,Bn9671,59165883,82681916,23516033,RLK
chr02,Bn9672,80039542,94850992,14811450,CN
chr02,Bn9673,96565415,97691904,1126489,TN
chr02,Bn9674,5178394,55669075,50490681,CNL
chr02,Bn9675,15980861,91410155,75429294,RLP
chr02,Bn9676,66504460,79862858,13358398,CNL
chr02,Bn9677,9444065,44698498,35254433,RLP
chr02,Bn9678,75896083,89246925,13350842,TN
chr02,Bn9679,52732971,82348084,29615113,TNL
chr02,Bn9680,20225113,33548407,13323294,TNL
chr02,Bn9681,48543876,74073667,25529791,NBS
chr02,Bn9682,61214667,89542331,28327664,CN
chr02,Bn9683,33678053,95028500,61350447,TN
chr02,Bn9684,47348543,82616008,35267465,RLP
chr02,Bn9685,78606971,82809591,4202620,RLP
chr02,Bn9686,12671863,59584948,46913085,TNL
chr02,Bn9687,92863062,94923955,2060893,TN
chr02,Bn9688,80381394,89782421,9401027,TN
chr02,Bn9689,52937099,66840697,13903598,TN
chr02,Bn9690,40650366,84420102,43769736,TN
chr02,Bn9691,34179529,52517084,18337555,CNL
chr02,Bn9692,28552344,94091957,65539613,NBS
chr02,Bn9693,33457057,79351480,45894423,TNL
chr02,Bn9694,84412456,88488755,4076299,NBS
chr02,Bn9695,88895678,99430282,10534604,TNL
chr02,Bn9696,34454446,42280755,7826309,RLP
chr02,Bn9697,55355453,99491216,44135763,RLK
chr02,Bn9698,80027196,83668094,3640898,TN
chr02,Bn9699,64439555,87703383,23263828,NBS
chr02,Bn9700,59963372,91479136,31515764,TN
chr02,Bn9701,55090869,99186337,44095468,TNL
chr02,Bn9702,94886451,98621008,3734557,NBS
chr02,Bn9703,35325321,40102025,4776704,RLK
chr02,Bn9704,21225627,70221325,48995698,CNL
chr02,Bn9705,89816859,97651962,7835103,CNL
chr02,Bn9706,3207117,51425881,48218764,RLP
chr02,Bn9707,94604460,95274493,670033,NBS
chr02,Bn9708,89523973,93626372,4102399,NBS
chr02,Bn9709,87605618,92243925,4638307,TN
chr02,Bn9710,5455703,28455539,22999836,TNL
chr02,Bn9711,34917242,54950125,20032883,RLP
chr02,Bn9712,78441235,98385526,19944291,CNL
chr02,Bn9713,58150406,69227130,11076724,CNL
chr02,Bn9714,76011000,85612965,9601965,TN
chr02,Bn9715,84539470,88908525,4369055,CN
chr02,Bn9716,70389208,94959865,24570657,RLP
chr02,Bn9717,40365189,64573940,24208751,NBS
chr02,Bn9718,7180747,99252699,92071952,RLK
chr02,Bn9719,46208181,55641940,9433759,TNL
chr02,Bn9720,13285260,83273912,69988652,RLK
chr02,Bn9721,80810677,94257854,13447177,TNL
chr02,Bn9722,81217990,98638170,17420180,TN
chr02,Bn9723,19634001,49171132,29537131,NBS
chr02,Bn9724,68570144,81356177,12786033,RLK
chr02,Bn9725,49488821,84819059,35330238,CN
chr02,Bn9726,78142585,88700515,10557930,CN
chr02,Bn9727,37034499,47681737,10647238,RLP
chr02,Bn9728,95915791,96853083,937292,CNL
chr02,Bn9729,65100558,96120297,31019739,NBS
chr02,Bn9730,97614420,98529692,915272,CN
chr02,Bn9731,3653446,19459076,15805630,RLK
chr02,Bn9732,85191350,99659795,14468445,RLP
chr02,Bn9733,36662975,92667653,56004678,TN
chr02,Bn9734,59595532,87240232,27644700,TNL
chr02,Bn9735,64996218,92980232,27984014,NBS
chr02,Bn9736,51248586,86520180,35271594,NBS
chr02,Bn9737,36001511,79667746,43666235,NBS
chr02,Bn9738,88250681,96117775,7867094,CN
chr02,Bn9739,46035695,81608589,35572894,RLK
chr02,Bn9740,70612078,99530208,28918130,TN
chr02,Bn9741,67627825,88720007,21092182,CN
chr02,Bn9742,78310551,82947739,4637188,RLK
chr02,Bn9743,48989403,53399146,4409743,NBS
chr02,Bn9744,99688064,99877149,189085,CN
chr02,Bn9745,21058308,76600046,55541738,RLK
chr02,Bn9746,86969764,99390103,12420339,TNL
chr02,Bn9747,74715479,85592573,10877094,CN
chr02,Bn9748,38280553,40218133,1937580,RLP
chr02,Bn9749,45270364,86906142,41635778,NBS
chr02,Bn9750,37055190,49076152,12020962,RLK
chr02,Bn9751,16524919,46606221,30081302,RLP
chr02,Bn9752,68699989,73311882,4611893,CNL
chr02,Bn9753,24573432,34316944,9743512,RLK
chr02,Bn9754,45685978,46759544,1073566,NBS
chr02,Bn9755,13471012,92396816,78925804,TN
chr02,Bn9756,84655808,92377208,7721400,CNL
chr02,Bn9757,62320328,77013093,14692765,NBS
chr02,Bn9758,20475228,59705411,39230183,TN
chr02,Bn9759,21190029,23859058,2669029,TN
chr02,Bn9760,55009550,66754678,11745128,CNL
chr02,Bn9761,7496325,58303549,50807224,TN
chr02,Bn9762,74033020,91914731,17881711,RLK
chr02,Bn9763,78826071,91429385,12603314,TN
chr02,Bn9764,63355264,89446046,26090782,CNL
chr02,Bn9765,81230651,84396294,3165643,CN
chr02,Bn9766,35496090,69079253,33583163,RLK
chr02,Bn9767,90106885,94043483,3936598,NBS
chr02,Bn9768,48587127,53140202,4553075,TNL
chr02,Bn9769,92904538,98676465,5771927,NBS
chr02,Bn9770,85330965,95392699,10061734,TNL
chr02,Bn9771,36876895,67171290,30294395,TN
chr02,Bn9772,85943485,97922789,11979304,RLP
chr02,Bn9773,27321867,97244857,69922990,CNL
chr02,Bn9774,84606238,99237421,14631183,RLP
chr02,Bn9775,75355191,88493025,13137834,RLK
chr02,Bn9776,33745289,56894214,23148925,CN
chr02,Bn9777,37469929,42452666,4982737,RLK
chr02,Bn9778,28005403,91305836,63300433,CN
chr02,Bn9779,40881861,42093535,1211674,RLK
chr02,Bn9780,29892073,83843862,53951789,TN
chr02,Bn9781,17768923,48057203,30288280,CN
chr02,Bn9782,49260950,71399179,22138229,RLK
chr02,Bn9783,21682999,48602291,26919292,RLK
chr02,Bn9784,69394892,80792168,11397276,RLP
chr02,Bn9785,26184863,55194409,29009546,RLK
chr02,Bn9786,12020275,61662651,49642376,RLP
chr02,Bn9787,64392170,91293143,26900973,RLP
chr02,Bn9788,26090445,80483707,54393262,TN
chr02,Bn9789,84271350,96614031,12342681,RLP
chr02,Bn9790,87381435,93765655,6384220,CNL
chr02,Bn9791,87617875,96382141,8764266,CNL
chr02,Bn9792,49495691,79310269,29814578,RLK
chr02,Bn9793,80617260,93730557,13113297,NBS
chr02,Bn9794,19727240,94413906,74686666,NBS
chr02,Bn9795,38723966,59302194,20578228,NBS
chr02,Bn9796,8993739,77693291,68699552,CNL
chr02,Bn9797,12459985,24791837,12331852,RLP
chr02,Bn9798,79508282,98112164,18603882,CNL
chr02,Bn9799,36513563,70743435,34229872,TN
chr02,Bn9800,1724419,12869767,11145348,RLK
chr02,Bn9801,24970474,75467053,50496579,RLP
chr02,Bn9802,71688336,89497006,17808670,TN
chr02,Bn9803,34843626,98467282,63623656,CN
chr02,Bn9804,66636602,94491190,27854588,CN
chr02,Bn9805,97710191,97710323,132,CN
chr02,Bn9806,95958291,96643082,684791,TN
chr02,Bn9807,65531190,84753759,19222569,TNL
chr02,Bn9808,33428549,38512797,5084248,TN
chr02,Bn9809,27111827,52602897,25491070,CNL
chr02,Bn9810,69922500,96629040,26706540,RLK
chr02,Bn9811,95048913,96211981,1163068,RLK
chr02,Bn9812,38505633,62121122,23615489,TN
chr02,Bn9813,82665314,92061370,9396056,CN
chr02,Bn9814,45686244,63028334,17342090,CNL
chr02,Bn9815,4673884,40493601,35819717,RLP
chr02,Bn9816,26873154,56563520,29690366,NBS
chr02,Bn9817,63822714,95763200,31940486,TNL
chr02,Bn9818,44643669,98721047,54077378,RLP
chr02,Bn9819,30786490,90448631,59662141,RLP
chr02,Bn9820,15082486,51864154,36781668,TNL
chr02,Bn9821,42635858,67155380,24519522,CN
chr02,Bn9822,66484653,84980068,18495415,CNL
chr02,Bn9823,45460002,70824809,25364807,NBS
chr02,Bn9824,79019089,86172711,7153622,TN
chr02,Bn9825,50469263,83296538,32827275,CNL
chr02,Bn9826,83641697,89111617,5469920,TN
chr02,Bn9827,98442515,98573480,130965,TNL
chr02,Bn9828,91038616,93735640,2697024,CNL
chr02,Bn9829,82955642,90433074,7477432,NBS
chr02,Bn9830,51506053,64227912,12721859,TNL
chr02,Bn9831,77584549,95023863,17439314,NBS
chr02,Bn9832,96796282,97902618,1106336,RLP
chr02,Bn9833,88349555,98320447,9970892,TN
chr02,Bn9834,64737807,79270023,14532216,TN
chr02,Bn9835,94728295,95245834,517539,TNL
chr02,Bn9836,26277873,79546161,53268288,CNL
chr02,Bn9837,94033293,98394645,4361352,CNL
chr02,Bn9838,87454219,98257306,10803087,CNL
chr02,Bn9839,90473905,91824066,1350161,RLK
chr02,Bn9840,45105045,74959823,29854778,TN
chr02,Bn9841,77712357,92253799,14541442,NBS
chr02,Bn9842,28724488,55273504,26549016,NBS
chr02,Bn9843,64882203,74889898,10007695,CN
chr02,Bn9844,4024933,70697237,66672304,RLP
chr02,Bn9845,58152844,94941863,36789019,NBS
chr02,Bn9846,87123043,88350004,1226961,NBS
chr02,Bn9847,82788772,89632158,6843386,TNL
chr02,Bn9848,90501754,98454724,7952970,RLK
chr02,Bn9849,20430614,26537398,6106784,TNL
chr02,Bn9850,66706263,81243819,14537556,TN
chr02,Bn9851,49381380,91804024,42422644,RLK
chr02,Bn9852,27435148,55108532,27673384,RLP
chr02,Bn9853,32738853,55681760,22942907,NBS
chr02,Bn9854,89535901,91708433,2172532,TNL
chr02,Bn9855,38511927,47204171,8692244,NBS
chr02,Bn9856,31215503,67083244,35867741,CNL
chr02,Bn9857,58480721,69438722,10958001,TNL
chr02,Bn9858,38810280,91874829,53064549,CN
chr02,Bn9859,28894493,64394900,35500407,CN
chr02,Bn9860,23325339,33499831,10174492,TNL
chr02,Bn9861,54506220,62713648,8207428,CN
chr02,Bn9862,93448178,94160467,712289,NBS
chr02,Bn9863,28404441,41074472,12670031,CNL
chr02,Bn9864,60984394,68421087,7436693,TNL
chr02,Bn9865,67751041,85032959,17281918,CN
chr02,Bn9866,87576398,91636321,4059923,RLP
chr02,Bn9867,39705406,91206701,51501295,TNL
chr02,Bn9868,82341746,99951209,17609463,CN
chr02,Bn9869,27566864,44268383,16701519,TN
chr02,Bn9870,94017058,98382634,4365576,RLK
chr02,Bn9871,94543184,98877444,4334260,TNL
chr02,Bn9872,42325881,98884301,56558420,RLK
chr02,Bn9873,3989011,9305909,5316898,TN
chr02,Bn9874,88531829,95250033,6718204,TN
chr02,Bn9875,36347159,76093538,39746379,RLK
chr02,Bn9876,5187454,90785760,85598306,RLK
chr02,Bn9877,34362305,44793595,10431290,CN
chr02,Bn9878,22633467,48213019,25579552,NBS
chr02,Bn9879,21403043,23459960,2056917,CNL
chr02,Bn9880,78926407,82016262,3089855,RLP
chr02,Bn9881,46880312,94457496,47577184,CNL
chr02,Bn9882,3178613,5749715,2571102,TN
chr02,Bn9883,32025355,42524447,10499092,TN
chr02,Bn9884,6569834,59487432,52917598,NBS
chr02,Bn9885,5499892,82232100,76732208,NBS
chr02,Bn9886,26203160,54424757,28221597,RLP
chr02,Bn9887,8663273,25126247,16462974,CN
chr02,Bn9888,70863877,81010270,10146393,CN
chr02,Bn9889,95843494,98514184,2670690,CN
chr02,Bn9890,59596065,84541326,24945261,CNL
chr02,Bn9891,6978931,61238651,54259720,NBS
chr02,Bn9892,48669117,78904767,30235650,TNL
chr02,Bn9893,32459103,96302010,63842907,RLP
chr02,Bn9894,60288467,81968385,21679918,TNL
chr02,Bn9895,19340271,69684003,50343732,CNL
chr02,Bn9896,67827955,94826438,26998483,TNL
chr02,Bn9897,74302779,91490046,17187267,TN
chr02,Bn9898,2034003,28232869,26198866,CN
chr02,Bn9899,63620609,85261416,21640807,TN
chr02,Bn9900,62496646,92754760,30258114,TNL
chr02,Bn9901,86337966,97952468,11614502,TNL
chr02,Bn9902,70525550,77488206,6962656,NBS
chr02,Bn9903,68555939,93895264,25339325,CN
chr02,Bn9904,88976591,99332161,10355570,RLK
chr02,Bn9905,16185740,42482848,26297108,CN
chr02,Bn9906,19976646,36094228,16117582,TN
chr02,Bn9907,43767386,50868073,7100687,NBS
chr02,Bn9908,4474252,44985802,40511550,RLK
chr02,Bn9909,27439785,95101114,67661329,CNL
chr02,Bn9910,19339616,91468452,72128836,TNL
chr02,Bn9911,42686951,43227459,540508,CNL
chr02,Bn9912,51815414,82928442,31113028,TNL
chr02,Bn9913,1975923,29991817,28015894,CN
chr02,Bn9914,53489055,54787805,1298750,TN
chr02,Bn9915,9151172,85366293,76215121,RLK
chr02,Bn9916,51361151,52189260,828109,CNL
chr02,Bn9917,2816882,51783466,48966584,RLK
chr02,Bn9918,7497568,47225492,39727924,CNL
chr02,Bn9919,97510462,97653379,142917,CNL
chr02,Bn9920,1180454,29713084,28532630,CNL
chr02,Bn9921,12075798,97762905,85687107,TN
chr02,Bn9922,74177827,99064620,24886793,NBS
chr02,Bn9923,58220219,81895153,23674934,TNL
chr02,Bn9924,69037974,89973049,20935075,RLP
chr02,Bn9925,65642107,72115320,6473213,RLP
chr02,Bn9926,84641808,86003533,1361725,TNL
chr02,Bn9927,8024342,10907964,2883622,NBS
chr02,Bn9928,35771951,56609431,20837480,RLP
chr02,Bn9929,28855753,64157301,35301548,CNL
chr02,Bn9930,22924361,24387842,1463481,CNL
chr02,Bn9931,50617387,67994424,17377037,RLP
chr02,Bn9932,69230873,89752740,20521867,NBS
chr02,Bn9933,21584898,39577660,17992762,CNL
chr02,Bn9934,97993466,99213771,1220305,CN
chr02,Bn9935,71916304,98013715,26097411,CNL
chr02,Bn9936,87184029,97153765,9969736,TN
chr02,Bn9937,17130643,23347954,6217311,RLP
chr02,Bn9938,26352836,26634099,281263,TN
chr02,Bn9939,11046063,91909272,80863209,CN
chr02,Bn9940,30317316,39997732,9680416,TNL
chr02,Bn9941,14145899,69488658,55342759,CNL
chr02,Bn9942,80514459,88245063,7730604,CNL
chr02,Bn9943,83295408,84911534,1616126,RLP
chr02,Bn9944,22511965,43319579,20807614,RLP
chr02,Bn9945,25365559,74107448,48741889,RLK
chr02,Bn9946,2184641,54724421,52539780,RLP
chr02,Bn9947,71538421,95086846,23548425,CNL
chr02,Bn9948,96860482,96997932,137450,TNL
chr02,Bn9949,10336225,48553543,38217318,CN
chr02,Bn9950,77807243,95410104,17602861,NBS
chr02,Bn9951,22180724,84581344,62400620,TNL
chr02,Bn9952,93970054,98038308,4068254,TNL
chr02,Bn9953,55598190,87377352,31779162,TN
chr02,Bn9954,64699148,69971277,5272129,RLK
chr02,Bn9955,10681169,89106866,78425697,CNL
chr02,Bn9956,23000505,52373724,29373219,NBS
chr02,Bn9957,36737491,62468839,25731348,NBS
chr02,Bn9958,80800582,82465419,1664837,NBS
chr02,Bn9959,90717970,91596017,878047,NBS
chr02,Bn9960,65160409,92041124,26880715,RLP
chr02,Bn9961,85370458,88230142,2859684,RLK
chr02,Bn9962,40783868,81888659,41104791,TNL
chr02,Bn9963,64555185,96064102,31508917,CNL
chr02,Bn9964,62951498,72023968,9072470,TN
chr02,Bn9965,31288327,72846192,41557865,CN
chr02,Bn9966,59021929,78725780,19703851,NBS
chr02,Bn9967,98410649,99125675,715026,TN
chr02,Bn9968,10910938,15401071,4490133,NBS
chr02,Bn9969,27396627,51793159,24396532,RLK
chr02,Bn9970,91018386,98580452,7562066,TNL
chr02,Bn9971,25370400,26025856,655456,RLK
chr02,Bn9972,49116469,62553745,13437276,TN
chr02,Bn9973,61187539,64321054,3133515,TNL
chr02,Bn9974,93499569,99239543,5739974,CN
chr02,Bn9975,89496052,90669628,1173576,TNL
chr02,Bn9976,56516844,79620760,23103916,CNL
chr02,Bn9977,72646778,74013478,1366700,NBS
chr02,Bn9978,49256491,85702759,36446268,CNL
chr02,Bn9979,76426674,92792998,16366324,CN
chr02,Bn9980,56908577,64630553,7721976,TN
chr02,Bn9981,94866693,99807112,4940419,RLK
chr02,Bn9982,68318624,92900094,24581470,TN
chr02,Bn9983,20769879,82252151,61482272,TN
chr02,Bn9984,83023387,88783829,5760442,NBS
chr02,Bn9985,25592464,78215075,52622611,TN
chr02,Bn9986,24482172,92581722,68099550,NBS
chr02,Bn9987,35262269,79522099,44259830,TNL
chr02,Bn9988,58803663,99678765,40875102,TN
chr02,Bn9989,75209334,99947811,24738477,TNL
chr02,Bn9990,81462656,82646669,1184013,CN
chr02,Bn9991,74681453,78834760,4153307,NBS
chr02,Bn9992,18110891,62349594,44238703,RLK
chr02,Bn9993,25117985,80668601,55550616,TN
chr02,Bn9994,29653359,89075482,59422123,CNL
chr02,Bn9995,36140066,67924586,31784520,RLP
chr02,Bn9996,72865321,95004188,22138867,CN
chr02,Bn9997,6884858,40167575,33282717,TNL
chr02,Bn9998,12861080,46812244,33951164,TN
chr02,Bn9999,66441520,71455980,5014460,CN
chr02,Bn10000,32749921,79634824,46884903,CN
chr02,Bn10001,58111843,77048388,18936545,CNL
chr02,Bn10002,56222329,71169387,14947058,TNL
chr02,Bn10003,90375139,96432692,6057553,RLP
chr02,Bn10004,94396552,97442725,3046173,CNL
chr02,Bn10005,11413110,46242215,34829105,RLP
chr02,Bn10006,5440362,46148782,40708420,CN
chr02,Bn10007,94858789,95464711,605922,TNL
chr02,Bn10008,2916130,74938638,72022508,TNL
chr02,Bn10009,3901881,47708741,43806860,RLK
chr02,Bn10010,52929647,84118500,31188853,NBS
chr02,Bn10011,4116981,74689075,70572094,CNL
chr02,Bn10012,45266036,94966455,49700419,CNL
chr02,Bn10013,83451226,94061838,10610612,RLK
chr02,Bn10014,68891411,96691890,27800479,CN
chr02,Bn10015,63481425,79759204,16277779,NBS
chr02,Bn10016,40200204,79820866,39620662,RLP
chr02,Bn10017,82211584,83209841,998257,CN
chr02,Bn10018,79565542,83291517,3725975,RLK
chr02,Bn10019,14227684,15078881,851197,TN
chr02,Bn10020,12589488,62812958,50223470,RLK
chr02,Bn10021,18378694,95746544,77367850,CNL
chr02,Bn10022,21771766,82854553,61082787,RLK
chr02,Bn10023,50212822,98736118,48523296,RLP
chr02,Bn10024,49463574,55160516,5696942,CN
chr02,Bn10025,62213496,94518106,32304610,RLP
chr02,Bn10026,70865048,74976170,4111122,TN
chr02,Bn10027,78453405,80403484,1950079,NBS
chr02,Bn10028,31198046,50287436,19089390,CNL
chr02,Bn10029,85415205,92138757,6723552,TNL
chr02,Bn10030,16342137,84004672,67662535,CN
chr02,Bn10031,4562648,52101696,47539048,CNL
chr02,Bn10032,85411956,98811855,13399899,NBS
chr02,Bn10033,36964453,46947768,9983315,RLK
chr02,Bn10034,38363180,51585971,13222791,TNL
chr02,Bn10035,97293864,98978378,1684514,CN
chr02,Bn10036,21200994,85373108,64172114,CN
chr02,Bn10037,22904205,24217945,1313740,RLK
chr02,Bn10038,88175682,89826802,1651120,RLK
chr02,Bn10039,43849596,78533427,34683831,NBS
chr02,Bn10040,61956310,77453646,15497336,TNL
chr02,Bn10041,26049261,72556935,46507674,TN
chr02,Bn10042,8403414,16146422,7743008,TNL
chr02,Bn10043,68710464,76502579,7792115,CNL
chr02,Bn10044,66383316,68595091,2211775,CNL
chr02,Bn10045,35034748,75378864,40344116,CNL
chr02,Bn10046,8058902,10587264,2528362,TN
chr02,Bn10047,70652313,94152707,23500394,CNL
chr02,Bn10048,27530302,33121274,5590972,CNL
chr02,Bn10049,62510811,78073570,15562759,TN
chr02,Bn10050,61746848,85966282,24219434,CN
chr02,Bn10051,13949826,52319694,38369868,CN
chr02,Bn10052,41311847,51652796,10340949,TN
chr02,Bn10053,26120892,83828643,57707751,RLK
chr02,Bn10054,11652129,89391457,77739328,CN
chr02,Bn10055,19419837,73970429,54550592,TN
chr02,Bn10056,14474176,67261271,52787095,CN
chr02,Bn10057,55832886,63520101,7687215,RLK
chr02,Bn10058,24807421,35028173,10220752,RLK
chr02,Bn10059,73624274,94103387,20479113,TNL
chr02,Bn10060,47742855,56298481,8555626,TN
chr02,Bn10061,14544062,60706255,46162193,CNL
chr02,Bn10062,38465283,77954108,39488825,RLP
chr02,Bn10063,63801645,87546096,23744451,TN
chr02,Bn10064,80782344,84589736,3807392,RLK
chr02,Bn10065,38779597,58997175,20217578,RLK
chr02,Bn10066,4495833,56225391,51729558,CNL
chr02,Bn10067,66232014,93259301,27027287,RLK
chr02,Bn10068,3108169,82047967,78939798,TNL
chr02,Bn10069,43789350,55417361,11628011,CN
chr02,Bn10070,83168169,84969874,1801705,TN
chr02,Bn10071,71108359,97348852,26240493,CN
chr02,Bn10072,19226530,57393748,38167218,TN
chr02,Bn10073,5063108,42942932,37879824,NBS
chr02,Bn10074,3270164,38958241,35688077,RLK
chr02,Bn10075,26547045,49469115,22922070,TN
chr02,Bn10076,45094406,83512165,38417759,TN
chr02,Bn10077,81031112,85880211,4849099,TN
chr02,Bn10078,63020659,76178804,13158145,TN
chr02,Bn10079,92366284,93937624,1571340,NBS
chr02,Bn10080,9412547,29420146,20007599,RLP
chr02,Bn10081,61127993,98649394,37521401,TNL
chr02,Bn10082,68046716,79243474,11196758,NBS
chr02,Bn10083,38158601,63836863,25678262,TNL
chr02,Bn10084,3935130,59243566,55308436,CN
chr02,Bn10085,20742563,27637759,6895196,NBS
chr02,Bn10086,48832087,90269536,41437449,TN
chr02,Bn10087,3670157,10342964,6672807,CN
chr02,Bn10088,20808448,43319113,22510665,CNL
chr02,Bn10089,4617189,33535289,28918100,RLP
chr02,Bn10090,78515390,90425996,11910606,CNL
chr02,Bn10091,31169724,42042517,10872793,RLK
chr02,Bn10092,92519281,92679466,160185,TN
chr02,Bn10093,43198893,43320019,121126,TN
chr02,Bn10094,55096454,64340638,9244184,TNL
chr02,Bn10095,46453371,49685418,3232047,NBS
chr02,Bn10096,13806840,97923667,84116827,TNL
chr02,Bn10097,76637075,82319785,5682710,RLK
chr02,Bn10098,67964267,91721573,23757306,TN
chr02,Bn10099,57734415,68713458,10979043,RLP
chr02,Bn10100,83868018,97450328,13582310,TNL
chr02,Bn10101,47741692,67828418,20086726,CN
chr02,Bn10102,15889255,79041520,63152265,CN
chr02,Bn10103,92067124,98774689,6707565,RLK
chr02,Bn10104,29883306,57477060,27593754,RLK
chr02,Bn10105,83937655,98504736,14567081,NBS
chr02,Bn10106,8141958,9557088,1415130,CNL
chr02,Bn10107,49677726,90952507,41274781,RLK
chr02,Bn10108,86859993,96835586,9975593,RLP
chr02,Bn10109,41402718,46120065,4717347,CNL
chr02,Bn10110,68540102,70880157,2340055,CNL
chr02,Bn10111,26125473,36837064,10711591,CN
chr02,Bn10112,48731868,97305430,48573562,TNL
chr02,Bn10113,39540166,42270248,2730082,TNL
chr02,Bn10114,61552367,69243043,7690676,TN
chr02,Bn10115,59808173,80330896,20522723,CNL
chr02,Bn10116,28170719,49932934,21762215,NBS
chr02,Bn10117,84951973,86703116,1751143,CNL
chr02,Bn10118,55094207,88557426,33463219,TNL
chr02,Bn10119,52420726,88419214,35998488,CN
chr02,Bn10120,38855553,84861614,46006061,RLP
chr02,Bn10121,4779997,33010412,28230415,TN
chr02,Bn10122,33800181,87417553,53617372,NBS
chr02,Bn10123,41049404,67501632,26452228,NBS
chr02,Bn10124,5807587,33186105,27378518,CNL
chr02,Bn10125,84287696,85827045,1539349,NBS
chr02,Bn10126,96776353,99548053,2771700,RLP
chr02,Bn10127,92598069,97936643,5338574,CNL
chr02,Bn10128,54745464,98561283,43815819,CNL
chr02,Bn10129,43297233,83091378,39794145,RLK
chr02,Bn10130,83135104,95638928,12503824,RLK
chr02,Bn10131,29979959,35062210,5082251,TN
chr02,Bn10132,33782315,77874450,44092135,NBS
chr02,Bn10133,89223396,96897752,7674356,TNL
chr02,Bn10134,6367573,67280712,60913139,CN
chr02,Bn10135,63059905,68252430,5192525,TNL
chr02,Bn10136,25282675,89540487,64257812,TN
chr02,Bn10137,67588135,72100940,4512805,NBS
chr02,Bn10138,5264182,74062713,68798531,RLK
chr02,Bn10139,19787488,55721862,35934374,RLP
chr02,Bn10140,53189956,99485639,46295683,CN
chr02,Bn10141,46319836,95661415,49341579,CNL
chr02,Bn10142,83101389,97415458,14314069,CNL
chr02,Bn10143,37280914,59675266,22394352,NBS
chr02,Bn10144,45576837,75542115,29965278,TN
chr02,Bn10145,33570635,58006174,24435539,CNL
chr02,Bn10146,99021895,99783106,761211,RLP
chr02,Bn10147,59336691,60268280,931589,TNL
chr02,Bn10148,3948013,19356260,15408247,CNL
chr02,Bn10149,28740181,49854643,21114462,CNL
chr02,Bn10150,36425809,60406020,23980211,TN
chr02,Bn10151,44571034,67715991,23144957,RLK
chr02,Bn10152,65983155,98558293,32575138,TNL
chr02,Bn10153,18941441,95738499,76797058,TNL
chr02,Bn10154,93405883,99052783,5646900,RLP
chr02,Bn10155,36200256,48368381,12168125,CN
chr02,Bn10156,15985798,26181114,10195316,TN
chr02,Bn10157,35086871,37425624,2338753,RLP
chr02,Bn10158,60141001,80793495,20652494,NBS
chr02,Bn10159,29822562,79451739,49629177,TN
chr02,Bn10160,10721533,32039277,21317744,TN
chr02,Bn10161,74259095,84420882,10161787,NBS
chr02,Bn10162,77355902,99027565,21671663,CNL
chr02,Bn10163,92003610,97028192,5024582,CNL
chr02,Bn10164,31984977,55012824,23027847,CN
chr02,Bn10165,28603441,31809707,3206266,NBS
chr02,Bn10166,61247320,61842556,595236,RLP
chr02,Bn10167,81505892,81914440,408548,RLK
chr02,Bn10168,98380219,99526633,1146414,CNL
chr02,Bn10169,68547780,79490467,10942687,TNL
chr02,Bn10170,55322873,89076016,33753143,TNL
chr02,Bn10171,62769734,73079804,10310070,RLP
chr02,Bn10172,36158229,62859729,26701500,TNL
chr02,Bn10173,17279458,76960154,59680696,TN
chr02,Bn10174,46368903,77120978,30752075,TNL
chr02,Bn10175,98244446,98283431,38985,RLK
chr02,Bn10176,29298526,64957743,35659217,CN
chr02,Bn10177,92596547,99719427,7122880,CN
chr02,Bn10178,25892561,74381555,48488994,NBS
chr02,Bn10179,62577756,68688007,6110251,TNL
chr02,Bn10180,1232964,62865518,61632554,TNL
chr02,Bn10181,67581317,79895464,12314147,CN
chr02,Bn10182,14154618,21658349,7503731,RLK
chr02,Bn10183,42507439,69852129,27344690,CN
chr02,Bn10184,57656754,95494820,37838066,RLK
chr02,Bn10185,34080919,37606214,3525295,RLP
chr02,Bn10186,2586771,87376004,84789233,TN
chr02,Bn10187,1237866,65139091,63901225,RLK
chr02,Bn10188,12893253,14916664,2023411,CNL
chr02,Bn10189,73758495,85054750,11296255,TN
chr02,Bn10190,24192283,48680956,24488673,RLK
chr02,Bn10191,6930224,68518807,61588583,NBS
chr02,Bn10192,44786467,46155368,1368901,TN
chr02,Bn10193,38902784,97365587,58462803,RLK
chr02,Bn10194,35998627,78083866,42085239,RLP
chr02,Bn10195,82385539,96969699,14584160,CNL
chr02,Bn10196,66916400,92465311,25548911,TNL
chr02,Bn10197,11170174,32631212,21461038,CN
chr02,Bn10198,10632992,85581320,74948328,RLK
chr02,Bn10199,73320897,81202178,7881281,RLK
chr02,Bn10200,31323587,48800248,17476661,TN
chr02,Bn10201,97777065,99336037,1558972,CNL
chr02,Bn10202,68352145,70352585,2000440,CN
chr02,Bn10203,66908473,71859147,4950674,RLK
chr02,Bn10204,41771111,43242250,1471139,CN
chr02,Bn10205,31544503,97325697,65781194,TNL
chr02,Bn10206,27491031,34951161,7460130,CN
chr02,Bn10207,18557782,89756424,71198642,RLK
chr02,Bn10208,22757198,95496827,72739629,RLP
chr02,Bn10209,86678639,89344859,2666220,NBS
chr02,Bn10210,37094008,74346156,37252148,CNL
chr02,Bn10211,58252660,84080510,25827850,RLP
chr02,Bn10212,93034201,95418777,2384576,NBS
chr02,Bn10213,91889735,95470899,3581164,RLP
chr02,Bn10214,16699186,46289840,29590654,TN
chr02,Bn10215,29670251,71359193,41688942,TN
chr02,Bn10216,52347834,83644761,31296927,TN
chr02,Bn10217,48268470,94996359,46727889,TNL
chr02,Bn10218,27313043,77910800,50597757,TNL
chr02,Bn10219,98044601,99491227,1446626,RLK
chr02,Bn10220,15719086,97684193,81965107,NBS
chr02,Bn10221,68636266,76691198,8054932,RLK
chr02,Bn10222,84787300,95781006,10993706,CNL
chr02,Bn10223,45701827,49419326,3717499,TN
chr02,Bn10224,32337618,76009075,43671457,CN
chr02,Bn10225,25890656,71004324,45113668,TN
chr02,Bn10226,34799261,81984723,47185462,RLK
chr02,Bn10227,64343818,79953880,15610062,TNL
chr02,Bn10228,71172863,81922467,10749604,TNL
chr02,Bn10229,79131278,80457789,1326511,CNL
chr02,Bn10230,80366982,98021867,17654885,RLP
chr02,Bn10231,95023496,99090115,4066619,NBS
chr02,Bn10232,22522942,43425651,20902709,TN
chr02,Bn10233,76976802,87653723,10676921,CNL
chr02,Bn10234,75698456,83649987,7951531,CN
chr02,Bn10235,16066509,86434234,70367725,CN
chr02,Bn10236,52324169,64768958,12444789,RLK
chr02,Bn10237,44657443,90577306,45919863,CN
chr02,Bn10238,98550672,98942683,392011,CN
chr02,Bn10239,61995597,97097814,35102217,TN
chr02,Bn10240,87972077,93229968,5257891,CN
chr02,Bn10241,70552525,77607877,7055352,TNL
chr02,Bn10242,71670995,95066906,23395911,RLK
chr02,Bn10243,28421618,44267145,15845527,CN
chr02,Bn10244,30187760,50300514,20112754,RLK
chr02,Bn10245,71205182,73048281,1843099,RLP
chr02,Bn10246,88191265,88651520,460255,NBS
chr02,Bn10247,85003820,92459533,7455713,RLP
chr02,Bn10248,24978873,37891492,12912619,NBS
chr02,Bn10249,48407904,94192088,45784184,RLK
chr02,Bn10250,68757191,99604192,30847001,RLP
chr02,Bn10251,13054420,56932863,43878443,NBS
chr02,Bn10252,51584079,76022450,24438371,RLK
chr02,Bn10253,10755208,42634393,31879185,RLP
chr02,Bn10254,90683972,94420913,3736941,CN
chr02,Bn10255,34055623,84322925,50267302,RLP
chr02,Bn10256,35006796,60898020,25891224,RLK
chr02,Bn10257,24888069,42749840,17861771,TNL
chr02,Bn10258,44863550,50330832,5467282,NBS
chr02,Bn10259,61692850,89581346,27888496,RLP
chr02,Bn10260,46879409,70325890,23446481,RLK
chr02,Bn10261,5053949,80024536,74970587,CN
chr02,Bn10262,73983207,95074614,21091407,NBS
chr02,Bn10263,97928895,99335172,1406277,RLP
chr02,Bn10264,38196171,86601200,48405029,CNL
chr02,Bn10265,7832388,51911820,44079432,NBS
chr02,Bn10266,98845456,99607495,762039,TN
chr02,Bn10267,37125781,84051311,46925530,NBS
chr02,Bn10268,12835734,64492236,51656502,NBS
chr02,Bn10269,76196469,89595829,13399360,TN
chr02,Bn10270,48542239,59821152,11278913,CNL
chr02,Bn10271,75364666,99870330,24505664,RLK
chr02,Bn10272,68785810,72656498,3870688,TN
chr02,Bn10273,26239328,35365555,9126227,RLK
chr02,Bn10274,51169983,97708907,46538924,TN
chr02,Bn10275,10100342,58658430,48558088,RLP
chr02,Bn10276,92570680,97929801,5359121,CNL
chr02,Bn10277,22144132,76632477,54488345,TN
chr02,Bn10278,77807693,84332708,6525015,NBS
chr02,Bn10279,78665873,92286113,13620240,NBS
chr02,Bn10280,20549509,35259132,14709623,RLP
chr02,Bn10281,20956674,50467918,29511244,TN
chr02,Bn10282,53364654,68412522,15047868,RLK
chr02,Bn10283,45611325,94952734,49341409,RLK
chr02,Bn10284,87183179,98243544,11060365,RLP
chr02,Bn10285,66852678,67939209,1086531,CNL
chr02,Bn10286,13309499,46525584,33216085,TN
chr02,Bn10287,27971851,59115357,31143506,NBS
chr02,Bn10288,49148033,63873373,14725340,NBS
chr02,Bn10289,26822913,62628385,35805472,CN
chr02,Bn10290,63426520,81993585,18567065,NBS
chr02,Bn10291,2774735,79822885,77048150,TN
chr02,Bn10292,98850336,99006956,156620,RLP
chr02,Bn10293,67082968,94325435,27242467,TN
chr02,Bn10294,49011938,50151697,1139759,RLK
chr02,Bn10295,5254228,60277837,55023609,TNL
chr02,Bn10296,33552651,79638207,46085556,NBS
chr02,Bn10297,77229681,83620071,6390390,CN
chr02,Bn10298,62417633,76646919,14229286,RLK
chr02,Bn10299,17923523,96626631,78703108,RLP
chr02,Bn10300,79472954,92814881,13341927,TNL
chr02,Bn10301,68955513,98937995,29982482,CN
chr02,Bn10302,81879296,91021139,9141843,TN
chr02,Bn10303,30852767,78203025,47350258,RLK
chr02,Bn10304,2269268,11789490,9520222,CNL
chr02,Bn10305,17343601,34308207,16964606,RLK
chr02,Bn10306,70783084,84563298,13780214,TN
chr02,Bn10307,12838845,38173071,25334226,NBS
chr02,Bn10308,1128736,76074510,74945774,RLK
chr02,Bn10309,13553207,76500100,62946893,RLP
chr02,Bn10310,27388940,56815571,29426631,NBS
chr02,Bn10311,35265461,52190754,16925293,RLK
chr02,Bn10312,6427887,63837486,57409599,NBS
chr02,Bn10313,69120489,96848501,27728012,TNL
chr02,Bn10314,49148564,51248450,2099886,CN
chr02,Bn10315,61378301,92201597,30823296,NBS
chr02,Bn10316,84523654,95320016,10796362,CNL
chr02,Bn10317,39292221,93380443,54088222,RLK
chr02,Bn10318,35490359,64309019,28818660,RLP
chr02,Bn10319,49984915,55974264,5989349,NBS
chr02,Bn10320,95046888,98373244,3326356,CNL
chr02,Bn10321,95175372,97410350,2234978,CN
chr02,Bn10322,7477020,85319202,77842182,TNL
chr02,Bn10323,36543067,47468451,10925384,TNL
chr02,Bn10324,15764569,83833567,68068998,TN
chr02,Bn10325,78287534,98996030,20708496,RLP
chr02,Bn10326,35887554,72291692,36404138,NBS
chr02,Bn10327,1967351,99494720,97527369,RLK
chr02,Bn10328,16891987,99637792,82745805,TN
chr02,Bn10329,61616723,62325355,708632,CNL
chr02,Bn10330,34073278,40868150,6794872,CN
chr02,Bn10331,51687037,87914669,36227632,TN
chr02,Bn10332,20589828,77270902,56681074,CNL
chr02,Bn10333,91582535,93658226,2075691,RLP
chr02,Bn10334,63907211,80240073,16332862,CNL
chr02,Bn10335,33592260,77193155,43600895,CN
chr02,Bn10336,12250945,99378760,87127815,TNL
chr02,Bn10337,49843776,60029564,10185788,TN
chr02,Bn10338,78611881,86623955,8012074,NBS
chr02,Bn10339,45647668,61082673,15435005,CN
chr02,Bn10340,58832710,87184570,28351860,NBS
chr02,Bn10341,24906767,76801268,51894501,TNL
chr02,Bn10342,84867930,93093217,8225287,NBS
chr02,Bn10343,42164103,45817526,3653423,RLP
chr02,Bn10344,11776804,79542745,67765941,TN
chr02,Bn10345,66965216,79468071,12502855,TN
chr02,Bn10346,9982627,82229716,72247089,RLP
chr02,Bn10347,91539910,97408470,5868560,RLK
chr02,Bn10348,87261286,93819795,6558509,RLP
chr02,Bn10349,71412705,96179296,24766591,CNL
chr02,Bn10350,32521414,93036567,60515153,CN
chr02,Bn10351,67738599,88185966,20447367,TNL
chr02,Bn10352,17489755,84903613,67413858,CNL
chr02,Bn10353,92799732,94814858,2015126,TNL
chr02,Bn10354,93624931,99043057,5418126,NBS
chr02,Bn10355,46694838,97630414,50935576,NBS
chr02,Bn10356,87332120,87881773,549653,TN
chr02,Bn10357,81855843,93464108,11608265,CNL
chr02,Bn10358,9068024,49769971,40701947,RLP
chr02,Bn10359,74442865,84135932,9693067,TN
chr02,Bn10360,72141976,81567651,9425675,CNL
chr02,Bn10361,95099762,96654298,1554536,TN
chr02,Bn10362,31381945,90185261,58803316,TN
chr02,Bn10363,8840250,15998284,7158034,TN
chr02,Bn10364,29858113,38548166,8690053,NBS
chr02,Bn10365,69729951,80156882,10426931,RLK
chr02,Bn10366,53101328,56225542,3124214,RLK
chr02,Bn10367,68163627,72472635,4309008,CN
chr02,Bn10368,68566076,79432458,10866382,RLK
chr02,Bn10369,13378239,69259212,55880973,CN
chr02,Bn10370,51930517,81463685,29533168,TN
chr02,Bn10371,21921789,88520262,66598473,TNL
chr02,Bn10372,19700297,19823135,122838,CNL
chr02,Bn10373,56987060,64369270,7382210,TNL
chr02,Bn10374,45256195,80619058,35362863,NBS
chr02,Bn10375,59049934,65206490,6156556,CN
chr02,Bn10376,76193593,76335684,142091,CNL
chr02,Bn10377,81868781,84281340,2412559,TN
chr02,Bn10378,47682751,51550781,3868030,CNL
chr02,Bn10379,51759633,69863234,18103601,CN
chr02,Bn10380,46289661,75449179,29159518,CN
chr02,Bn10381,61854861,94648865,32794004,NBS
chr02,Bn10382,83188819,83923264,734445,TNL
chr02,Bn10383,99535306,99537748,2442,CN
chr02,Bn10384,40936784,49821130,8884346,RLP
chr02,Bn10385,55924504,92773577,36849073,TNL
chr02,Bn10386,85803752,88412259,2608507,NBS
chr02,Bn10387,30828047,93675773,62847726,CN
chr02,Bn10388,19292248,77109967,57817719,RLK
chr02,Bn10389,18174027,79475767,61301740,TN
chr02,Bn10390,37119509,97063758,59944249,NBS
chr02,Bn10391,64392170,70350006,5957836,RLK
chr02,Bn10392,71758652,94051058,22292406,CN
chr02,Bn10393,13551616,76673458,63121842,RLP
chr02,Bn10394,69725012,79820688,10095676,NBS
chr02,Bn10395,16080360,37100790,21020430,NBS
chr02,Bn10396,59988874,95266009,35277135,NBS
chr02,Bn10397,38349455,44072531,5723076,CNL
chr02,Bn10398,98769069,99745159,976090,TN
chr02,Bn10399,19883440,64550126,44666686,TNL
chr02,Bn10400,95103773,97645122,2541349,RLP
chr02,Bn10401,30420497,33443504,3023007,CN
chr02,Bn10402,14329625,81347799,67018174,CNL
chr02,Bn10403,93211611,93744737,533126,TNL
chr02,Bn10404,29144221,80523398,51379177,CNL
chr02,Bn10405,81532346,81914375,382029,RLK
chr02,Bn10406,96319948,98969079,2649131,CN
chr02,Bn10407,36881581,84542908,47661327,CNL
chr02,Bn10408,50854260,80901672,30047412,RLK
chr02,Bn10409,48855356,66631966,17776610,RLK
chr02,Bn10410,33532359,51708473,18176114,TN
chr02,Bn10411,3628985,39476191,35847206,RLP
chr02,Bn10412,66160149,91330866,25170717,RLK
chr02,Bn10413,98175833,98513645,337812,TN
chr02,Bn10414,21914073,52535858,30621785,NBS
chr02,Bn10415,5769333,76023100,70253767,CNL
chr02,Bn10416,20001022,20956937,955915,TNL
chr02,Bn10417,6226852,8372168,2145316,NBS
chr02,Bn10418,89757094,92889975,3132881,NBS
chr02,Bn10419,93747871,95589896,1842025,NBS
chr02,Bn10420,29114391,46773495,17659104,NBS
chr02,Bn10421,77897938,99718620,21820682,TNL
chr02,Bn10422,39219655,57314144,18094489,NBS
chr02,Bn10423,63000262,77145720,14145458,NBS
chr02,Bn10424,9261971,96349871,87087900,RLP
chr02,Bn10425,56031496,99909555,43878059,CNL
chr02,Bn10426,96831708,97015705,183997,TNL
chr02,Bn10427,63925487,76029446,12103959,TN
chr02,Bn10428,53434929,74867710,21432781,RLK
chr02,Bn10429,58568976,77604762,19035786,TN
chr02,Bn10430,92196609,99891430,7694821,CN
chr02,Bn10431,31718907,35369115,3650208,TN
chr02,Bn10432,86312619,88532412,2219793,NBS
chr02,Bn10433,76392570,85534374,9141804,CNL
chr02,Bn10434,68654373,83308333,14653960,TNL
chr02,Bn10435,17580953,42651393,25070440,RLK
chr02,Bn10436,85311527,92080235,6768708,CNL
chr02,Bn10437,73207638,99328958,26121320,CN
chr02,Bn10438,69106331,93454230,24347899,RLK
chr02,Bn10439,76439008,88963443,12524435,NBS
chr02,Bn10440,73335214,80487973,7152759,NBS
chr02,Bn10441,27364317,39362343,11998026,TNL
chr02,Bn10442,93593274,96036267,2442993,TN
chr02,Bn10443,61431307,64024518,2593211,CN
chr02,Bn10444,92421494,94185570,1764076,CNL
chr02,Bn10445,85800593,95102920,9302327,CNL
chr02,Bn10446,92012463,93141725,1129262,CN
chr02,Bn10447,61426357,66492649,5066292,CN
chr02,Bn10448,26304406,38122374,11817968,TNL
chr02,Bn10449,5514789,14203524,8688735,NBS
chr02,Bn10450,51878160,98640667,46762507,RLP
chr02,Bn10451,44832822,65488890,20656068,RLP
chr02,Bn10452,12830387,32798338,19967951,RLP
chr02,Bn10453,82347632,95611094,13263462,RLK
chr02,Bn10454,30454276,86048067,55593791,CNL
chr02,Bn10455,60036196,64393021,4356825,RLP
chr02,Bn10456,98067739,99191621,1123882,CNL
chr02,Bn10457,85098162,87446790,2348628,CN
chr02,Bn10458,46819621,88710211,41890590,CNL
chr02,Bn10459,33197823,63654689,30456866,TN
chr02,Bn10460,39997138,74200156,34203018,NBS
chr02,Bn10461,62842492,64966029,2123537,TN
chr02,Bn10462,39243615,80553696,41310081,TN
chr02,Bn10463,91998195,92672052,673857,TN
chr02,Bn10464,41023347,65001946,23978599,CNL
chr02,Bn10465,97394611,98965051,1570440,CN
chr02,Bn10466,78953822,80228246,1274424,NBS
chr02,Bn10467,76546292,85577155,9030863,RLP
chr02,Bn10468,26023140,40477329,14454189,TNL
chr02,Bn10469,84243040,89633910,5390870,TNL
chr02,Bn10470,60123874,91541745,31417871,RLP
chr02,Bn10471,31109311,55805104,24695793,CNL
chr02,Bn10472,1283434,71468539,70185105,CN
chr02,Bn10473,9099485,32523053,23423568,RLK
chr02,Bn10474,1577555,50021894,48444339,RLP
chr02,Bn10475,16057530,44101759,28044229,TNL
chr02,Bn10476,86315810,86932382,616572,RLK
chr02,Bn10477,30875694,58273969,27398275,TN
chr02,Bn10478,6713662,75018008,68304346,CN
chr02,Bn10479,28468334,77770853,49302519,RLK
chr02,Bn10480,38889066,58073728,19184662,NBS
chr02,Bn10481,65196845,94118298,28921453,TNL
chr02,Bn10482,3195323,40620172,37424849,CN
chr02,Bn10483,52597537,97528960,44931423,TN
chr02,Bn10484,32927519,89551336,56623817,RLK
chr02,Bn10485,6514394,27873075,21358681,RLK
chr02,Bn10486,7062767,21478815,14416048,TNL
chr02,Bn10487,89109410,94569957,5460547,NBS
chr02,Bn10488,43263673,84798953,41535280,RLP
chr02,Bn10489,4558911,47219747,42660836,TNL
chr02,Bn10490,43293041,91222650,47929609,RLK
chr02,Bn10491,50659648,64593246,13933598,RLP
chr02,Bn10492,7117551,80403773,73286222,CNL
chr02,Bn10493,74329861,82254753,7924892,TNL
chr02,Bn10494,36774667,94154968,57380301,NBS
chr02,Bn10495,42341324,62872064,20530740,TN
chr02,Bn10496,55577780,71781810,16204030,NBS
chr02,Bn10497,23928896,78781007,54852111,NBS
chr02,Bn10498,10695145,69858698,59163553,TNL
chr02,Bn10499,81271721,81621685,349964,TNL
chr02,Bn10500,91274763,94257408,2982645,RLP
chr02,Bn10501,43387279,59194117,15806838,NBS
chr02,Bn10502,64499746,80270091,15770345,CNL
chr02,Bn10503,90794747,91666942,872195,RLK
chr02,Bn10504,71118958,89454241,18335283,CN
chr02,Bn10505,26910317,76371911,49461594,CN
chr02,Bn10506,3256929,34952512,31695583,CNL
chr02,Bn10507,37492466,79078231,41585765,NBS
chr02,Bn10508,60867633,79927403,19059770,TNL
chr02,Bn10509,37847879,80327247,42479368,CNL
chr02,Bn10510,29835865,58676071,28840206,TNL
chr02,Bn10511,68159077,76231396,8072319,RLK
chr02,Bn10512,6132838,95522445,89389607,CN
chr02,Bn10513,42683100,70624506,27941406,NBS
chr02,Bn10514,31563111,78174850,46611739,TN
chr02,Bn10515,27761083,66965075,39203992,NBS
chr02,Bn10516,48877232,69164460,20287228,CN
chr02,Bn10517,98937601,99846493,908892,CNL
chr02,Bn10518,10042257,42254853,32212596,TN
chr02,Bn10519,40058286,40278582,220296,TNL
chr02,Bn10520,2304901,63975347,61670446,CN
chr02,Bn10521,61275988,63947934,2671946,RLP
chr02,Bn10522,40107463,91483104,51375641,NBS
chr02,Bn10523,18628116,20417673,1789557,CNL
chr02,Bn10524,25896984,88376578,62479594,CNL
chr02,Bn10525,15798314,23268055,7469741,CNL
chr02,Bn10526,67288827,73770526,6481699,CNL
chr02,Bn10527,47039551,69870391,22830840,TNL
chr02,Bn10528,33042172,91676887,58634715,TN
chr02,Bn10529,13068678,78430443,65361765,RLK
chr02,Bn10530,50834451,67275797,16441346,RLP
chr02,Bn10531,42763982,59673097,16909115,TNL
chr02,Bn10532,48479073,66377727,17898654,TNL
chr02,Bn10533,86337823,96990187,10652364,NBS
chr02,Bn10534,69907616,84425274,14517658,CN
chr02,Bn10535,83481183,96778645,13297462,NBS
chr02,Bn10536,44179940,66379715,22199775,NBS
chr02,Bn10537,85331601,99056134,13724533,CNL
chr02,Bn10538,52255557,88471470,36215913,CNL
chr02,Bn10539,10488893,53942588,43453695,TN
chr02,Bn10540,95625697,96479587,853890,NBS
chr02,Bn10541,8043589,50118479,42074890,TNL
chr02,Bn10542,58986749,77210205,18223456,TNL
chr02,Bn10543,8145994,33433826,25287832,CNL
chr02,Bn10544,78448750,86671887,8223137,NBS
chr02,Bn10545,2630831,83076635,80445804,RLK
chr02,Bn10546,95964326,98053533,2089207,TNL
chr02,Bn10547,53507175,57131416,3624241,TN
chr02,Bn10548,53078568,98732426,45653858,TNL
chr02,Bn10549,4099973,69164614,65064641,NBS
chr02,Bn10550,47108663,68099726,20991063,RLP
chr02,Bn10551,18571350,49736015,31164665,CN
chr02,Bn10552,10206789,49434110,39227321,CN
chr02,Bn10553,53348121,74530762,21182641,RLK
chr02,Bn10554,76331831,89115202,12783371,CN
chr02,Bn10555,4043863,32615112,28571249,RLP
chr02,Bn10556,3157297,47792779,44635482,RLK
chr02,Bn10557,87901884,95383646,7481762,RLK
chr02,Bn10558,12597435,43586644,30989209,RLK
chr02,Bn10559,55858252,74412762,18554510,CNL
chr02,Bn10560,10462747,47489213,37026466,TNL
chr02,Bn10561,97342037,98741301,1399264,NBS
chr02,Bn10562,53224987,97151360,43926373,TN
chr02,Bn10563,14431024,77070541,62639517,CN
chr02,Bn10564,36237998,60978989,24740991,NBS
chr02,Bn10565,51384168,71235551,19851383,RLP
chr02,Bn10566,2659312,78676127,76016815,CNL
chr02,Bn10567,32034992,35394677,3359685,CN
chr02,Bn10568,87436707,89343451,1906744,TN
chr02,Bn10569,77965080,90609901,12644821,NBS
chr02,Bn10570,13147843,71275429,58127586,RLP
chr02,Bn10571,38727816,80281915,41554099,CNL
chr02,Bn10572,4287460,80768212,76480752,CN
chr02,Bn10573,22252823,73123224,50870401,NBS
chr02,Bn10574,48789338,84585092,35795754,RLP
chr02,Bn10575,36009054,82852262,46843208,CNL
chr02,Bn10576,52980344,92285864,39305520,NBS
chr02,Bn10577,67860577,81173513,13312936,CN
chr02,Bn10578,5938602,25765625,19827023,RLP
chr02,Bn10579,3328499,77378851,74050352,CNL
chr02,Bn10580,9818126,96437111,86618985,CN
chr02,Bn10581,48264463,51126520,2862057,CN
chr02,Bn10582,8481485,85142228,76660743,RLK
chr02,Bn10583,87773102,89802175,2029073,TN
chr02,Bn10584,81457849,93404214,11946365,NBS
chr02,Bn10585,91906933,93883428,1976495,TN
chr02,Bn10586,36686319,95328018,58641699,NBS
chr02,Bn10587,40419895,42439492,2019597,TN
chr02,Bn10588,32946362,58535449,25589087,RLP
chr02,Bn10589,78483746,97043792,18560046,TNL
chr02,Bn10590,87222779,90453149,3230370,RLP
chr02,Bn10591,75533937,91612476,16078539,TNL
chr02,Bn10592,22415603,23753806,1338203,TN
chr02,Bn10593,37559050,81058468,43499418,RLK
chr02,Bn10594,37072725,91223817,54151092,NBS
chr02,Bn10595,56853553,75130832,18277279,CN
chr02,Bn10596,12429946,81006074,68576128,NBS
chr02,Bn10597,10700099,51913440,41213341,RLK
chr02,Bn10598,45712749,86929354,41216605,CNL
chr02,Bn10599,73485358,77026738,3541380,RLK
chr02,Bn10600,32561126,60448430,27887304,TN
chr02,Bn10601,65529283,75867779,10338496,CNL
chr02,Bn10602,10830207,83755809,72925602,TNL
chr02,Bn10603,70747687,86804495,16056808,TNL
chr02,Bn10604,21971964,41126645,19154681,CNL
chr02,Bn10605,99344000,99411994,67994,NBS
chr02,Bn10606,82826071,83967245,1141174,RLP
chr02,Bn10607,59734618,72874469,13139851,CNL
chr02,Bn10608,82319655,91042234,8722579,RLP
chr02,Bn10609,15096325,66078201,50981876,CN
chr02,Bn10610,46779268,73371436,26592168,RLP
chr02,Bn10611,61752484,99951975,38199491,CNL
chr02,Bn10612,12077088,79155385,67078297,TNL
chr02,Bn10613,17438137,21781798,4343661,RLP
chr02,Bn10614,99065415,99485359,419944,TNL
chr02,Bn10615,29837815,95204906,65367091,CN
chr02,Bn10616,10300042,50444269,40144227,TN
chr02,Bn10617,55693467,79350076,23656609,NBS
chr02,Bn10618,75960345,98677705,22717360,CN
chr02,Bn10619,82413664,82434112,20448,RLK
chr02,Bn10620,38037061,67102191,29065130,NBS
chr02,Bn10621,53264314,55441605,2177291,TN
chr02,Bn10622,12449134,29865937,17416803,TN
chr02,Bn10623,17913612,59899211,41985599,RLK
chr02,Bn10624,88499117,97996781,9497664,NBS
chr02,Bn10625,45703655,66826376,21122721,RLK
chr02,Bn10626,47488025,87984864,40496839,TN
chr02,Bn10627,4666981,12065720,7398739,RLK
chr02,Bn10628,2204166,62734317,60530151,RLK
chr02,Bn10629,63584529,94719870,31135341,RLP
chr02,Bn10630,73754929,97556547,23801618,RLP
chr02,Bn10631,90150425,97473432,7323007,TN
chr02,Bn10632,15140220,80661632,65521412,RLP
chr02,Bn10633,8678517,98527249,89848732,NBS
chr02,Bn10634,87793877,97121747,9327870,NBS
chr02,Bn10635,64932947,72649493,7716546,NBS
chr02,Bn10636,81246183,94949101,13702918,CN
chr02,Bn10637,9606638,53800084,44193446,TNL
chr02,Bn10638,53957197,75254763,21297566,CN
chr02,Bn10639,63628109,81258169,17630060,RLP
chr02,Bn10640,57858955,81931527,24072572,CN
chr02,Bn10641,38724581,60286056,21561475,NBS
chr02,Bn10642,43469163,81399607,37930444,CN
chr02,Bn10643,62223073,83188866,20965793,CNL
chr02,Bn10644,38950948,98196846,59245898,RLP
chr02,Bn10645,91738458,94980889,3242431,NBS
chr02,Bn10646,11694507,77332261,65637754,TNL
chr02,Bn10647,13606264,62141127,48534863,RLK
chr02,Bn10648,18712450,85066301,66353851,CN
chr02,Bn10649,53816478,66460485,12644007,RLK
chr02,Bn10650,80789981,87400136,6610155,CN
chr02,Bn10651,46925182,55319526,8394344,NBS
chr02,Bn10652,29356760,42221024,12864264,CNL
chr02,Bn10653,64968829,87784156,22815327,TNL
chr02,Bn10654,2159572,84645417,82485845,TNL
chr02,Bn10655,2145642,55914996,53769354,NBS
chr02,Bn10656,69191706,93804395,24612689,TNL
chr02,Bn10657,59418260,92287784,32869524,RLP
chr02,Bn10658,96942589,99584000,2641411,CN
chr02,Bn10659,23322591,47565196,24242605,CNL
chr02,Bn10660,94469568,95250813,781245,CNL
chr02,Bn10661,29118652,98046495,68927843,NBS
chr02,Bn10662,68744236,70255826,1511590,TNL
chr02,Bn10663,99353239,99639013,285774,CN
chr02,Bn10664,8884253,34304052,25419799,CNL
chr02,Bn10665,84543559,85546816,1003257,RLK
chr02,Bn10666,80639959,87005370,6365411,TNL
chr02,Bn10667,74783584,94039010,19255426,TN
chr02,Bn10668,41564770,72008604,30443834,CNL
chr02,Bn10669,28585398,90827561,62242163,TNL
chr02,Bn10670,74439543,88272348,13832805,CNL
chr02,Bn10671,53557463,83698122,30140659,CN
chr02,Bn10672,9546207,74229184,64682977,NBS
chr02,Bn10673,30275140,57801658,27526518,CNL
chr02,Bn10674,43254138,88356125,45101987,TNL
chr02,Bn10675,2146027,26122679,23976652,RLP
chr02,Bn10676,81170139,82347577,1177438,TNL
chr02,Bn10677,98524475,99060158,535683,RLK
chr02,Bn10678,30814632,65410264,34595632,NBS
chr02,Bn10679,31612090,71083937,39471847,RLP
chr02,Bn10680,42628349,53505382,10877033,TNL
chr02,Bn10681,17636717,73729798,56093081,TNL
chr02,Bn10682,1237917,4004465,2766548,RLP
chr02,Bn10683,86333172,94296659,7963487,TNL
chr02,Bn10684,19898776,65783092,45884316,RLK
chr02,Bn10685,92340119,98393469,6053350,CN
chr02,Bn10686,55175604,80345325,25169721,TN
chr02,Bn10687,3565109,93695384,90130275,CN
chr02,Bn10688,53099452,95496412,42396960,TN
chr02,Bn10689,14970746,99076085,84105339,CN
chr02,Bn10690,96922768,97526113,603345,TNL
chr02,Bn10691,65223815,84582933,19359118,TNL
chr02,Bn10692,6774070,72594148,65820078,RLK
chr02,Bn10693,8825841,47713953,38888112,CNL
chr02,Bn10694,31611382,82625070,51013688,NBS
chr02,Bn10695,85578939,95500069,9921130,TNL
chr02,Bn10696,56569232,81506264,24937032,TNL
chr02,Bn10697,83458912,96126439,12667527,RLK
chr02,Bn10698,97858463,98629815,771352,RLK
chr02,Bn10699,24483636,26678194,2194558,TN
chr02,Bn10700,9995835,84181422,74185587,CNL
chr02,Bn10701,83141254,89793571,6652317,NBS
chr02,Bn10702,63399320,93157394,29758074,RLP
chr02,Bn10703,56079537,97095850,41016313,RLP
chr02,Bn10704,94998724,99821693,4822969,CNL
chr02,Bn10705,80154431,98664147,18509716,NBS
chr02,Bn10706,33634812,78185955,44551143,NBS
chr02,Bn10707,10053026,47490876,37437850,NBS
chr02,Bn10708,97917822,99590592,1672770,NBS
chr02,Bn10709,60028174,94336058,34307884,RLP
chr02,Bn10710,40953632,48572394,7618762,RLP
chr02,Bn10711,80726003,80768093,42090,CN
chr02,Bn10712,56853449,85326850,28473401,RLK
chr02,Bn10713,57658760,81267924,23609164,TNL
chr02,Bn10714,21901065,54933227,33032162,RLP
chr02,Bn10715,98464878,98868781,403903,CN
chr02,Bn10716,51864192,68656285,16792093,RLP
chr02,Bn10717,22609669,78180823,55571154,RLK
chr02,Bn10718,66482020,66942943,460923,RLK
chr02,Bn10719,3345844,51388594,48042750,CNL
chr02,Bn10720,44605234,66502180,21896946,RLK
chr02,Bn10721,62054818,71419509,9364691,RLP
chr02,Bn10722,26988097,86165560,59177463,TN
chr02,Bn10723,84544027,91385128,6841101,RLP
chr02,Bn10724,87930601,91223718,3293117,NBS
chr02,Bn10725,37273902,69589991,32316089,RLP
chr02,Bn10726,49556624,87322298,37765674,RLP
chr02,Bn10727,67556656,84309350,16752694,TN
chr02,Bn10728,90574955,96293690,5718735,TNL
chr02,Bn10729,75151031,82455154,7304123,CN
chr02,Bn10730,65481950,89234904,23752954,TNL
chr02,Bn10731,96839827,98195321,1355494,RLP
chr02,Bn10732,19461466,51271320,31809854,CNL
chr02,Bn10733,33057125,40725440,7668315,RLP
chr02,Bn10734,84738007,97169380,12431373,CN
chr02,Bn10735,7736727,67290064,59553337,TN
chr02,Bn10736,52450875,54318994,1868119,TN
chr02,Bn10737,62765393,98219690,35454297,TN
chr02,Bn10738,1125048,20667260,19542212,TNL
chr02,Bn10739,52446018,62704937,10258919,TN
chr02,Bn10740,39277895,66683476,27405581,CN
chr02,Bn10741,83886968,88117813,4230845,CN
chr02,Bn10742,95665153,96337751,672598,RLK
chr02,Bn10743,16444349,23777565,7333216,NBS
chr02,Bn10744,50291328,62915477,12624149,RLK
chr02,Bn10745,9037891,45371663,36333772,TNL
chr02,Bn10746,8196359,54564479,46368120,CN
chr02,Bn10747,45774728,91149719,45374991,CN
chr02,Bn10748,86258896,94001116,7742220,CNL
chr02,Bn10749,46965402,51753434,4788032,CNL
chr02,Bn10750,95030662,98975568,3944906,RLP
chr02,Bn10751,53762863,68104534,14341671,RLP
chr02,Bn10752,10193594,74970854,64777260,RLK
chr02,Bn10753,26072383,53452324,27379941,RLP
chr02,Bn10754,81686207,87372627,5686420,CNL
chr02,Bn10755,31467108,58973257,27506149,TNL
chr02,Bn10756,71852441,85575909,13723468,RLP
chr02,Bn10757,81136196,91983338,10847142,CN
chr02,Bn10758,46169552,65084043,18914491,CN
chr02,Bn10759,57420553,82129973,24709420,RLK
chr02,Bn10760,29999139,58656506,28657367,CNL
chr02,Bn10761,51201679,62156826,10955147,TN
chr02,Bn10762,15274648,63973625,48698977,TN
chr02,Bn10763,85470152,91875167,6405015,RLK
chr02,Bn10764,47018566,56656989,9638423,CN
chr02,Bn10765,11219039,94611272,83392233,NBS
chr02,Bn10766,77579999,94122377,16542378,RLK
chr02,Bn10767,82814982,92796695,9981713,CNL
chr02,Bn10768,59513106,90374437,30861331,TN
chr02,Bn10769,3679694,16395939,12716245,NBS
chr02,Bn10770,15713898,72714045,57000147,CNL
chr02,Bn10771,60513390,94408431,33895041,CN
chr02,Bn10772,76788458,79119651,2331193,RLK
chr02,Bn10773,82541591,91118399,8576808,CNL
chr02,Bn10774,25658597,66152728,40494131,CNL
chr02,Bn10775,23211842,41775305,18563463,TN
chr02,Bn10776,52140906,70892584,18751678,TNL
chr02,Bn10777,30653727,91993857,61340130,TN
chr02,Bn10778,2779308,95630968,92851660,RLP
chr02,Bn10779,7299494,35879193,28579699,RLK
chr02,Bn10780,6919790,75325126,68405336,CN
chr02,Bn10781,52786975,74684568,21897593,TN
chr02,Bn10782,97567054,97678036,110982,CNL
chr02,Bn10783,44953392,86256804,41303412,TN
chr02,Bn10784,80288401,98067602,17779201,NBS
chr02,Bn10785,28044521,80194262,52149741,TN
chr02,Bn10786,42137554,54874217,12736663,RLK
chr02,Bn10787,57818056,89233855,31415799,CN
chr02,Bn10788,7979506,92039834,84060328,TNL
chr02,Bn10789,44442327,75200454,30758127,TNL
chr02,Bn10790,67064441,82827783,15763342,RLK
chr02,Bn10791,3480706,26555824,23075118,RLP
chr02,Bn10792,14729289,15290856,561567,CNL
chr02,Bn10793,39425602,73607762,34182160,RLP
chr02,Bn10794,97297927,99339967,2042040,RLP
chr02,Bn10795,6366220,72999072,66632852,NBS
chr02,Bn10796,98865247,99962031,1096784,TNL
chr02,Bn10797,32023579,94672851,62649272,TN
chr02,Bn10798,12773003,31356882,18583879,TNL
chr02,Bn10799,16602910,35908250,19305340,RLP
chr02,Bn10800,75235157,86998788,11763631,RLK
chr02,Bn10801,74434507,99362822,24928315,RLK
chr02,Bn10802,22596971,66907838,44310867,CN
chr02,Bn10803,6726653,95884926,89158273,TNL
chr02,Bn10804,26952903,30041031,3088128,CNL
chr02,Bn10805,1182802,43150583,41967781,TNL
chr02,Bn10806,21835733,83092129,61256396,RLP
chr02,Bn10807,18482543,53631452,35148909,CN
chr02,Bn10808,2733755,17413435,14679680,NBS
chr02,Bn10809,66555849,74532559,7976710,RLK
chr02,Bn10810,80966843,92681830,11714987,TNL
chr02,Bn10811,49520533,62663104,13142571,TNL
chr02,Bn10812,20742024,31241242,10499218,TN
chr02,Bn10813,17649829,69300942,51651113,RLP
chr02,Bn10814,51845473,88430481,36585008,CNL
chr02,Bn10815,44187645,79426501,35238856,CN
chr02,Bn10816,77867317,93167465,15300148,TNL
chr02,Bn10817,67656377,74567348,6910971,RLK
chr02,Bn10818,62995431,85202935,22207504,RLP
chr02,Bn10819,13575043,66540756,52965713,CN
chr02,Bn10820,51019781,63577872,12558091,TNL
chr02,Bn10821,88561282,98014312,9453030,CN
chr02,Bn10822,47111401,62572513,15461112,TNL
chr02,Bn10823,33646240,39849517,6203277,CN
chr02,Bn10824,11203435,97404393,86200958,CNL
chr02,Bn10825,86001054,92082028,6080974,NBS
chr02,Bn10826,34808542,87733300,52924758,RLK
chr02,Bn10827,27208569,63496590,36288021,RLP
chr02,Bn10828,42564035,72185523,29621488,RLP
chr02,Bn10829,47556203,99598730,52042527,NBS
chr02,Bn10830,64926578,69002445,4075867,RLP
chr02,Bn10831,84461525,91971324,7509799,TNL
chr02,Bn10832,1664848,50130716,48465868,NBS
chr02,Bn10833,82764714,94918120,12153406,TN
chr02,Bn10834,2433940,78943239,76509299,RLP
chr02,Bn10835,44097396,62344908,18247512,CNL
chr02,Bn10836,57512835,58597972,1085137,TNL
chr02,Bn10837,96247480,98727523,2480043,CN
chr02,Bn10838,82971954,84856305,1884351,TN
chr02,Bn10839,15335392,28786570,13451178,TNL
chr02,Bn10840,31937470,51034237,19096767,CNL
chr02,Bn10841,30066158,41593344,11527186,RLK
chr02,Bn10842,1253044,72012198,70759154,RLK
chr02,Bn10843,41911671,52935515,11023844,CNL
chr02,Bn10844,10041674,10859534,817860,RLK
chr02,Bn10845,46376246,83904901,37528655,TNL
chr02,Bn10846,74151759,96774696,22622937,TN
chr02,Bn10847,81367739,98688575,17320836,CN
chr02,Bn10848,79449749,88402985,8953236,RLK
chr02,Bn10849,94343195,95026409,683214,TNL
chr02,Bn10850,59673559,69145098,9471539,CNL
chr02,Bn10851,91394036,96229580,4835544,TNL
chr02,Bn10852,35433268,53523196,18089928,TNL
chr02,Bn10853,90491211,93092638,2601427,CN
chr02,Bn10854,47405531,82874266,35468735,RLP
chr02,Bn10855,2383447,98372731,95989284,CN
chr02,Bn10856,8188585,25991986,17803401,TN
chr02,Bn10857,96986535,97912312,925777,TNL
chr02,Bn10858,37555666,49703250,12147584,CN
chr02,Bn10859,77089248,79354440,2265192,RLP
chr02,Bn10860,53884887,55160451,1275564,CNL
chr02,Bn10861,72236554,86000565,13764011,NBS
chr02,Bn10862,46414904,89662313,43247409,RLK
chr02,Bn10863,79594317,99066707,19472390,TNL
chr02,Bn10864,24375625,31010894,6635269,RLK
chr02,Bn10865,61703359,79378190,17674831,TNL
chr02,Bn10866,75400445,95159090,19758645,TNL
chr02,Bn10867,67691751,99058851,31367100,CN
chr02,Bn10868,50927367,88177286,37249919,NBS
chr02,Bn10869,93583018,96187289,2604271,TNL
chr02,Bn10870,17074191,48536898,31462707,RLP
chr02,Bn10871,34790020,51672460,16882440,CNL
chr02,Bn10872,76094060,85471625,9377565,RLP
chr02,Bn10873,33482384,94072797,60590413,TN
chr02,Bn10874,93535419,95300196,1764777,TNL
chr02,Bn10875,38629918,71157663,32527745,CNL
chr02,Bn10876,7685913,23828295,16142382,CNL
chr02,Bn10877,17931577,49588891,31657314,TN
chr02,Bn10878,17201534,60734584,43533050,CN
chr02,Bn10879,57978975,78785430,20806455,RLP
chr02,Bn10880,98366535,99107047,740512,CNL
chr02,Bn10881,89479930,90090638,610708,RLP
chr02,Bn10882,81559184,98334614,16775430,RLK
chr02,Bn10883,17384564,46173721,28789157,RLP
chr02,Bn10884,39906255,82015348,42109093,RLP
chr02,Bn10885,22849149,59796811,36947662,RLK
chr02,Bn10886,95386505,97627777,2241272,NBS
chr02,Bn10887,55714615,92340082,36625467,CN
chr02,Bn10888,81021013,94829094,13808081,TNL
chr02,Bn10889,97433886,97801820,367934,CNL
chr02,Bn10890,37454128,75535171,38081043,TN
chr02,Bn10891,93791341,99780797,5989456,TN
chr02,Bn10892,50184097,77837868,27653771,CNL
chr02,Bn10893,43550418,45598566,2048148,TNL
chr02,Bn10894,15103696,50894107,35790411,CN
chr02,Bn10895,20774056,22832921,2058865,RLK
chr02,Bn10896,56104252,97894333,41790081,CNL
chr02,Bn10897,47891987,86226540,38334553,TNL
chr02,Bn10898,83161470,91861866,8700396,CNL
chr02,Bn10899,28517107,98005686,69488579,TNL
chr02,Bn10900,4449227,7065059,2615832,TN
chr02,Bn10901,18990712,72322618,53331906,CN
chr02,Bn10902,99321258,99389014,67756,RLK
chr02,Bn10903,5104104,92512019,87407915,CN
chr02,Bn10904,20265302,26914039,6648737,RLP
chr02,Bn10905,72997479,90843825,17846346,RLP
chr02,Bn10906,53933644,95265707,41332063,RLP
chr02,Bn10907,39169455,87390883,48221428,CN
chr02,Bn10908,19648133,85485270,65837137,CNL
chr02,Bn10909,91055290,91759359,704069,TNL
chr02,Bn10910,61956942,80081322,18124380,TNL
chr02,Bn10911,73125861,78332216,5206355,TNL
chr02,Bn10912,80690418,83637353,2946935,RLK
chr02,Bn10913,75023029,79853019,4829990,RLK
chr02,Bn10914,74972460,75439304,466844,TN
chr02,Bn10915,89700964,95043299,5342335,NBS
chr02,Bn10916,3336643,24309217,20972574,CNL
chr02,Bn10917,57347028,87648604,30301576,TN
chr02,Bn10918,20621022,23765966,3144944,TN
chr02,Bn10919,17765406,85784015,68018609,RLK
chr02,Bn10920,96383576,98979275,2595699,TNL
chr02,Bn10921,98959940,99269972,310032,TN
chr02,Bn10922,46040719,91826171,45785452,RLP
chr02,Bn10923,71801328,78512230,6710902,RLP
chr02,Bn10924,70163016,71126794,963778,NBS
chr02,Bn10925,69860425,84875654,15015229,CN
chr02,Bn10926,9556692,35865730,26309038,CN
chr02,Bn10927,48017924,64355410,16337486,RLK
chr02,Bn10928,4416608,8268298,3851690,TN
chr02,Bn10929,39469708,87500055,48030347,CNL
chr02,Bn10930,8256756,71952464,63695708,TNL
chr02,Bn10931,67885687,78117103,10231416,NBS
chr02,Bn10932,14534789,41828351,27293562,RLP
chr02,Bn10933,49777632,55808384,6030752,CN
chr02,Bn10934,41900896,59335458,17434562,CNL
chr02,Bn10935,7848037,73294847,65446810,RLP
chr02,Bn10936,36038334,82440702,46402368,RLP
chr02,Bn10937,89730787,89801503,70716,RLK
chr02,Bn10938,17988870,93432640,75443770,CN
chr02,Bn10939,97773923,98855523,1081600,NBS
chr02,Bn10940,51388733,61791958,10403225,CN
chr02,Bn10941,88918893,98593629,9674736,NBS
chr02,Bn10942,53987887,86259741,32271854,CNL
chr02,Bn10943,48723691,61675153,12951462,CNL
chr02,Bn10944,97937553,97948582,11029,CNL
chr02,Bn10945,90050443,98258023,8207580,TN
chr02,Bn10946,49918166,71514169,21596003,NBS
chr02,Bn10947,42623804,66118985,23495181,TN
chr02,Bn10948,85907057,92241618,6334561,CN
chr02,Bn10949,39512969,84270795,44757826,CN
chr02,Bn10950,34275470,54418849,20143379,TNL
chr02,Bn10951,69211002,91238350,22027348,NBS
chr02,Bn10952,1507136,39401808,37894672,TN
chr02,Bn10953,54070303,63490707,9420404,NBS
chr02,Bn10954,52110027,64223511,12113484,TNL
chr02,Bn10955,92123267,95333841,3210574,RLK
chr02,Bn10956,55510317,98364495,42854178,TN
chr02,Bn10957,13015534,98531748,85516214,TN
chr02,Bn10958,54075756,87559560,33483804,TN
chr02,Bn10959,79832744,90566044,10733300,CNL
chr02,Bn10960,83328312,92188322,8860010,CN
chr02,Bn10961,51684641,66767754,15083113,TNL
chr02,Bn10962,75857061,99980972,24123911,TN
chr02,Bn10963,81489759,98295027,16805268,RLP
chr02,Bn10964,58727548,64813142,6085594,RLP
chr02,Bn10965,30672038,63206568,32534530,NBS
chr02,Bn10966,17308167,55956111,38647944,CNL
chr02,Bn10967,50388812,85539845,35151033,CN
chr02,Bn10968,11166074,77354523,66188449,RLP
chr02,Bn10969,47279109,69395806,22116697,CN
chr02,Bn10970,63169854,85591334,22421480,TNL
chr02,Bn10971,70152894,75870313,5717419,CNL
chr02,Bn10972,11903076,48907876,37004800,CN
chr02,Bn10973,2650816,98454645,95803829,CNL
chr02,Bn10974,69562712,81138922,11576210,CN
chr02,Bn10975,97039264,97839347,800083,TN
chr02,Bn10976,50159616,62212226,12052610,RLP
chr02,Bn10977,77010063,83244026,6233963,CNL
chr02,Bn10978,72638526,94522469,21883943,CN
chr02,Bn10979,11576727,66567187,54990460,NBS
chr02,Bn10980,61080246,62002662,922416,NBS
chr02,Bn10981,58959593,98510169,39550576,RLP
chr02,Bn10982,59368709,98965248,39596539,RLK
chr02,Bn10983,45603867,68215706,22611839,TNL
chr02,Bn10984,2332020,71181469,68849449,TN
chr02,Bn10985,11086294,46136492,35050198,TN
chr02,Bn10986,85339373,97295069,11955696,NBS
chr02,Bn10987,72044228,81614885,9570657,RLP
chr02,Bn10988,25752319,81655185,55902866,TN
chr02,Bn10989,53644755,85134606,31489851,TNL
chr02,Bn10990,75646695,86874633,11227938,CN
chr02,Bn10991,42674753,77137969,34463216,TNL
chr02,Bn10992,79649006,83714776,4065770,NBS
chr02,Bn10993,2449178,36725529,34276351,CNL
chr02,Bn10994,48806360,83897089,35090729,CNL
chr02,Bn10995,56967359,87317940,30350581,RLK
chr02,Bn10996,23546282,52314157,28767875,CN
chr02,Bn10997,75361900,92860535,17498635,RLK
chr02,Bn10998,39587765,57661497,18073732,TNL
chr02,Bn10999,18307276,21212147,2904871,RLK
chr02,Bn11000,14758358,86950872,72192514,TNL
chr02,Bn11001,78935306,84566871,5631565,RLK
chr02,Bn11002,2668753,67699729,65030976,RLP
chr02,Bn11003,78376296,90824302,12448006,RLP
chr02,Bn11004,44080559,76668429,32587870,RLK
chr02,Bn11005,61881779,82705075,20823296,RLP
chr02,Bn11006,69525834,84120340,14594506,NBS
chr02,Bn11007,18704049,90680398,71976349,RLK
chr02,Bn11008,38770059,90380909,51610850,RLK
chr02,Bn11009,37753571,52022259,14268688,RLK
chr02,Bn11010,90638347,91408920,770573,RLK
chr02,Bn11011,6221074,44025077,37804003,RLP
chr02,Bn11012,61824536,79624806,17800270,CN
chr02,Bn11013,5828268,25880701,20052433,TNL
chr02,Bn11014,94224300,97401891,3177591,TN
chr02,Bn11015,43850355,61769722,17919367,CNL
chr02,Bn11016,68604106,76010960,7406854,TN
chr02,Bn11017,72065588,80326046,8260458,CNL
chr02,Bn11018,25143241,51721871,26578630,RLK
chr02,Bn11019,64714527,92521524,27806997,RLK
chr02,Bn11020,66575129,89394256,22819127,RLP
chr02,Bn11021,36664581,62471404,25806823,TNL
chr02,Bn11022,14002769,51844556,37841787,TNL
chr02,Bn11023,56168158,60615080,4446922,CN
chr02,Bn11024,79185190,87155947,7970757,CNL
chr02,Bn11025,72549123,87481140,14932017,NBS
chr02,Bn11026,88636076,97652794,9016718,TN
chr02,Bn11027,23295259,73422792,50127533,TN
chr02,Bn11028,63185482,69386407,6200925,NBS
chr02,Bn11029,67207354,75175833,7968479,TN
chr02,Bn11030,73902896,75908852,2005956,TNL
chr02,Bn11031,37942865,40376133,2433268,NBS
chr02,Bn11032,17239826,49554188,32314362,CN
chr02,Bn11033,21834089,48236627,26402538,RLK
chr02,Bn11034,67435757,84381286,16945529,TNL
chr02,Bn11035,97563368,99013803,1450435,CNL
chr02,Bn11036,33144556,61066455,27921899,CN
chr02,Bn11037,2853963,95250042,92396079,TN
chr02,Bn11038,47382079,75183484,27801405,RLP
chr02,Bn11039,35215762,55397648,20181886,CN
chr02,Bn11040,11271666,33713310,22441644,TN
chr02,Bn11041,96232291,98165708,1933417,NBS
chr02,Bn11042,57878179,88488088,30609909,CNL
chr02,Bn11043,59455443,79987927,20532484,TNL
chr02,Bn11044,11872647,87369593,75496946,TN
chr02,Bn11045,34466147,57317026,22850879,RLK
chr02,Bn11046,26390792,53980155,27589363,NBS
chr02,Bn11047,11757063,87714076,75957013,RLK
chr02,Bn11048,42322557,44723947,2401390,CNL
chr02,Bn11049,33606265,67281363,33675098,RLP
chr02,Bn11050,8769197,39623164,30853967,RLP
chr02,Bn11051,71498846,96459347,24960501,RLK
chr02,Bn11052,93458031,98276526,4818495,RLK
chr02,Bn11053,86180309,98376169,12195860,RLK
chr02,Bn11054,62686386,81519033,18832647,CN
chr02,Bn11055,48713711,90010190,41296479,TN
chr02,Bn11056,16801312,35757600,18956288,TN
chr02,Bn11057,2005122,88050366,86045244,RLP
chr02,Bn11058,44735217,91951697,47216480,CNL
chr02,Bn11059,11942581,30575038,18632457,NBS
chr02,Bn11060,41558457,50263038,8704581,CN
chr02,Bn11061,85213221,98096790,12883569,NBS
chr02,Bn11062,98667326,98864332,197006,RLK
chr02,Bn11063,40809764,86424786,45615022,TNL
chr02,Bn11064,63727668,90478191,26750523,RLK
chr02,Bn11065,48558661,72514817,23956156,NBS
chr02,Bn11066,96688969,98608959,1919990,TNL
chr02,Bn11067,8073317,10528150,2454833,NBS
chr02,Bn11068,85733132,86649147,916015,RLP
chr02,Bn11069,34459536,64138693,29679157,CN
chr02,Bn11070,13434852,41660719,28225867,TNL
chr02,Bn11071,3115044,75816670,72701626,TN
chr02,Bn11072,99062163,99686165,624002,TNL
chr02,Bn11073,80771367,88034465,7263098,TN
chr02,Bn11074,43318693,57183923,13865230,CN
chr02,Bn11075,98779533,99396811,617278,CN
chr02,Bn11076,36148965,97337962,61188997,NBS
chr02,Bn11077,97499543,99713540,2213997,TNL
chr02,Bn11078,49797387,75257507,25460120,CN
chr02,Bn11079,58661196,73336864,14675668,CN
chr02,Bn11080,8814478,78564907,69750429,RLK
chr02,Bn11081,27773405,48833664,21060259,RLK
chr02,Bn11082,80329686,84661316,4331630,TNL
chr02,Bn11083,22310661,33302847,10992186,CNL
chr02,Bn11084,29926972,32471443,2544471,RLP
chr02,Bn11085,26695584,88418298,61722714,TNL
chr02,Bn11086,95642575,97061121,1418546,CNL
chr02,Bn11087,75498898,79315793,3816895,CN
chr02,Bn11088,77008222,99087454,22079232,RLK
chr02,Bn11089,47990553,72829190,24838637,CN
chr02,Bn11090,25911519,29807781,3896262,TNL
chr02,Bn11091,53764894,64925773,11160879,TNL
chr02,Bn11092,24337895,47841312,23503417,CNL
chr02,Bn11093,83008432,91903401,8894969,TN
chr02,Bn11094,38952385,85959477,47007092,CN
chr02,Bn11095,9560757,85091011,75530254,TNL
chr02,Bn11096,78198747,93984994,15786247,TN
chr02,Bn11097,73144439,98110518,24966079,RLK
chr02,Bn11098,14766478,29480269,14713791,CNL
chr02,Bn11099,14480174,93664314,79184140,RLK
chr02,Bn11100,24626549,35664003,11037454,TNL
chr02,Bn11101,62415610,96230353,33814743,CN
chr02,Bn11102,45355457,68977111,23621654,CN
chr02,Bn11103,67713166,92992641,25279475,TN
chr02,Bn11104,14488567,94914051,80425484,RLP
chr02,Bn11105,2320676,49254048,46933372,TN
chr02,Bn11106,89012913,96466526,7453613,NBS
chr02,Bn11107,39762905,97450979,57688074,RLP
chr02,Bn11108,47976826,85261635,37284809,RLP
chr02,Bn11109,61493368,94511048,33017680,RLP
chr02,Bn11110,60681726,70018993,9337267,CNL
chr02,Bn11111,31661796,83356378,51694582,NBS
chr02,Bn11112,97682117,99994446,2312329,NBS
chr02,Bn11113,83816634,94402687,10586053,CNL
chr02,Bn11114,47297836,73167791,25869955,RLP
chr02,Bn11115,39194789,67008472,27813683,TNL
chr02,Bn11116,2259070,83266566,81007496,TN
chr02,Bn11117,84025096,87827269,3802173,TNL
chr02,Bn11118,47572930,50867594,3294664,RLK
chr02,Bn11119,58780372,93002038,34221666,TN
chr02,Bn11120,11684611,82149719,70465108,TNL
chr02,Bn11121,78301226,96090403,17789177,NBS
chr02,Bn11122,58527974,92944859,34416885,CN
chr02,Bn11123,35044717,61135587,26090870,TN
chr02,Bn11124,21443624,39976739,18533115,RLP
chr02,Bn11125,70025178,86513707,16488529,CNL
chr02,Bn11126,95253000,96767656,1514656,TN
chr02,Bn11127,80741414,90455121,9713707,CNL
chr02,Bn11128,95702863,99995346,4292483,TN
chr02,Bn11129,11345342,49961861,38616519,CN
chr02,Bn11130,18745662,53276849,34531187,RLK
chr02,Bn11131,34720250,59795004,25074754,CN
chr02,Bn11132,55944801,96417125,40472324,RLP
chr02,Bn11133,52666719,99177500,46510781,NBS
chr02,Bn11134,39499384,69373876,29874492,TNL
chr02,Bn11135,57777233,84778750,27001517,TN
chr02,Bn11136,65591846,82774472,17182626,CNL
chr02,Bn11137,51210636,78507884,27297248,RLK
chr02,Bn11138,45083596,45478298,394702,CNL
chr02,Bn11139,66824552,95930501,29105949,NBS
chr02,Bn11140,95016784,99812342,4795558,RLP
chr02,Bn11141,52365662,87866965,35501303,RLK
chr02,Bn11142,43376700,88568249,45191549,TNL
chr02,Bn11143,33786747,36300864,2514117,NBS
chr02,Bn11144,61363318,80085946,18722628,CNL
chr02,Bn11145,48528360,54359018,5830658,TNL
chr02,Bn11146,99066319,99587851,521532,CNL
chr02,Bn11147,6199045,84487845,78288800,CNL
chr02,Bn11148,60843893,73734537,12890644,CN
chr02,Bn11149,32856255,45551272,12695017,TN
chr02,Bn11150,58243582,87373981,29130399,NBS
chr02,Bn11151,48367497,62810287,14442790,CN
chr02,Bn11152,17832346,46144015,28311669,TNL
chr02,Bn11153,45746511,63897510,18150999,TN
chr02,Bn11154,35519074,58673430,23154356,RLK
chr02,Bn11155,10006734,97122560,87115826,RLK
chr02,Bn11156,15381220,34028737,18647517,NBS
chr02,Bn11157,85214150,99438356,14224206,RLK
chr02,Bn11158,17792592,83337274,65544682,CN
chr02,Bn11159,11749367,27844851,16095484,TN
chr02,Bn11160,75017550,96191077,21173527,TN
chr02,Bn11161,39837633,59256293,19418660,TN
chr02,Bn11162,72199704,91486406,19286702,RLP
chr02,Bn11163,84873083,99904108,15031025,RLP
chr02,Bn11164,87422871,94009109,6586238,TN
chr02,Bn11165,16545577,55712089,39166512,TNL
chr02,Bn11166,28934084,34466692,5532608,TN
chr02,Bn11167,84641453,92670726,8029273,TNL
chr02,Bn11168,66227273,76451529,10224256,RLK
chr02,Bn11169,58208192,92070324,33862132,CN
chr02,Bn11170,82940417,84568878,1628461,TN
chr02,Bn11171,49174140,95454782,46280642,TNL
chr02,Bn11172,82856922,96697122,13840200,NBS
chr02,Bn11173,78671174,96048144,17376970,TNL
chr02,Bn11174,85605846,88256938,2651092,TN
chr02,Bn11175,95209969,98363393,3153424,CNL
chr02,Bn11176,25292459,90978294,65685835,RLP
chr02,Bn11177,25169866,62762396,37592530,TN
chr02,Bn11178,48281968,90699849,42417881,TNL
chr02,Bn11179,58012590,76011786,17999196,CNL
chr02,Bn11180,31006250,34844279,3838029,NBS
chr02,Bn11181,40135740,56181815,16046075,TN
chr02,Bn11182,75013500,77540307,2526807,NBS
chr02,Bn11183,56605267,83191341,26586074,TNL
chr02,Bn11184,22419540,35008764,12589224,CNL
chr02,Bn11185,58176798,58220686,43888,TNL
chr02,Bn11186,86088954,86877168,788214,TNL
chr02,Bn11187,79044970,99970197,20925227,RLP
chr02,Bn11188,70343129,77089322,6746193,TNL
chr02,Bn11189,45445594,71814183,26368589,CNL
chr02,Bn11190,74074198,87150397,13076199,RLK
chr02,Bn11191,25970071,55555636,29585565,NBS
chr02,Bn11192,81267562,86041543,4773981,CN
chr02,Bn11193,84243753,85612531,1368778,CNL
chr02,Bn11194,2659588,76259967,73600379,TN
chr02,Bn11195,70246773,92331598,22084825,CNL
chr02,Bn11196,82205041,84281178,2076137,RLK
chr02,Bn11197,64110236,77031696,12921460,TN
chr02,Bn11198,72201977,92195314,19993337,RLP
chr02,Bn11199,10278464,51159199,40880735,RLP
chr02,Bn11200,63813524,76012404,12198880,RLP
chr02,Bn11201,13467420,96363360,82895940,CNL
chr02,Bn11202,84003048,85777336,1774288,NBS
chr02,Bn11203,54807370,91650555,36843185,NBS
chr02,Bn11204,58177351,96464624,38287273,CN
chr02,Bn11205,66455188,87447385,20992197,TN
chr02,Bn11206,83828578,94731437,10902859,RLK
chr02,Bn11207,73312300,79318077,6005777,TNL
chr02,Bn11208,80646708,86978358,6331650,RLP
chr02,Bn11209,24167503,29068678,4901175,CN
chr02,Bn11210,71356923,87008988,15652065,TN
chr02,Bn11211,82433654,90740281,8306627,CNL
chr02,Bn11212,21406933,90143104,68736171,CNL
chr02,Bn11213,73227655,93023342,19795687,TNL
chr02,Bn11214,63650684,80572179,16921495,CN
chr02,Bn11215,54053843,84453648,30399805,NBS
chr02,Bn11216,75057072,94376427,19319355,RLP
chr02,Bn11217,68577344,85361015,16783671,RLP
chr02,Bn11218,32021402,37290179,5268777,CNL
chr02,Bn11219,12769448,53767840,40998392,CNL
chr02,Bn11220,74451866,77273037,2821171,CN
chr02,Bn11221,56115466,68362072,12246606,RLP
chr02,Bn11222,73870991,97063270,23192279,RLP
chr02,Bn11223,32829013,97885009,65055996,RLP
chr02,Bn11224,74595956,92861627,18265671,CNL
chr02,Bn11225,4042050,86071415,82029365,RLK
chr02,Bn11226,27342954,92035649,64692695,RLP
chr02,Bn11227,75289629,86250813,10961184,NBS
chr02,Bn11228,99582172,99674469,92297,RLP
chr02,Bn11229,12244421,61883547,49639126,TNL
chr02,Bn11230,95832804,97065841,1233037,NBS
chr02,Bn11231,32400599,56452670,24052071,TNL
chr02,Bn11232,29128043,58374497,29246454,CN
chr02,Bn11233,27552851,95377046,67824195,RLP
chr02,Bn11234,32204819,97834274,65629455,RLP
chr02,Bn11235,42871298,92595447,49724149,NBS
chr02,Bn11236,45960751,60024444,14063693,RLK
chr02,Bn11237,93587320,97384984,3797664,TNL
chr02,Bn11238,2642219,15484114,12841895,NBS
chr02,Bn11239,40540000,57730109,17190109,CN
chr02,Bn11240,13875939,71044166,57168227,RLK
chr02,Bn11241,73728921,77542532,3813611,NBS
chr02,Bn11242,42119826,84143342,42023516,TN
chr02,Bn11243,80138891,83083800,2944909,RLK
chr02,Bn11244,36816221,89986260,53170039,CNL
chr02,Bn11245,84341621,89793244,5451623,CNL
chr02,Bn11246,19084392,57514665,38430273,NBS
chr02,Bn11247,96759991,98375791,1615800,NBS
chr02,Bn11248,74761735,76129757,1368022,RLP
chr02,Bn11249,94192559,99588472,5395913,NBS
chr02,Bn11250,45259445,61290353,16030908,CN
chr02,Bn11251,30991399,60991111,29999712,CN
chr02,Bn11252,45697642,86841646,41144004,NBS
chr02,Bn11253,98166450,99908657,1742207,RLK
chr02,Bn11254,32560051,52428115,19868064,CNL
chr02,Bn11255,5879298,76069622,70190324,TNL
chr02,Bn11256,35254272,45871862,10617590,CN
chr02,Bn11257,8669868,85805608,77135740,RLK
chr02,Bn11258,98510055,98768431,258376,RLP
chr02,Bn11259,99746358,99815737,69379,RLK
chr02,Bn11260,45809331,71416151,25606820,CNL
chr02,Bn11261,50222532,70793092,20570560,RLP
chr02,Bn11262,92562000,93061009,499009,CN
chr02,Bn11263,28365572,94643758,66278186,TNL
chr02,Bn11264,36148620,61664350,25515730,TN
chr02,Bn11265,60008574,97793451,37784877,RLP
chr02,Bn11266,80090626,98028002,17937376,TNL
chr02,Bn11267,94338196,99118680,4780484,CNL
chr02,Bn11268,85840652,93826101,7985449,CNL
chr02,Bn11269,56349221,74869596,18520375,TNL
chr02,Bn11270,36367106,51904657,15537551,RLP
chr02,Bn11271,34611519,35648985,1037466,RLK
chr02,Bn11272,9862208,45126236,35264028,RLP
chr02,Bn11273,60874550,61779178,904628,CNL
chr02,Bn11274,90366364,96175336,5808972,RLK
chr02,Bn11275,33401655,87577177,54175522,RLK
chr02,Bn11276,21053963,47161739,26107776,TN
chr02,Bn11277,33615552,79401680,45786128,TNL
chr02,Bn11278,13835028,16303687,2468659,RLK
chr02,Bn11279,72482595,73205599,723004,TNL
chr02,Bn11280,55814016,59728239,3914223,CNL
chr02,Bn11281,18334532,22968119,4633587,CN
chr02,Bn11282,91149198,96731753,5582555,RLP
chr02,Bn11283,73462305,97647884,24185579,CN
chr02,Bn11284,24273130,59525623,35252493,CN
chr02,Bn11285,59764610,68364014,8599404,CN
chr02,Bn11286,45047218,94339116,49291898,TN
chr02,Bn11287,14698797,26803209,12104412,TN
chr02,Bn11288,89998913,96047641,6048728,RLK
chr02,Bn11289,11644488,27329540,15685052,RLK
chr02,Bn11290,54733039,84782394,30049355,NBS
chr02,Bn11291,72697324,90219643,17522319,TNL
chr02,Bn11292,47841877,83764630,35922753,NBS
chr02,Bn11293,54401723,75375519,20973796,TN
chr02,Bn11294,99124312,99455299,330987,TN
chr02,Bn11295,98831127,99367237,536110,RLP
chr02,Bn11296,78919107,90451705,11532598,NBS
chr02,Bn11297,21745072,66626114,44881042,RLP
chr02,Bn11298,76379347,98799345,22419998,RLP
chr02,Bn11299,45391566,83915824,38524258,NBS
chr02,Bn11300,91843690,92586664,742974,CNL
chr02,Bn11301,38265042,93771509,55506467,TNL
chr02,Bn11302,40333904,66873158,26539254,RLP
chr02,Bn11303,9256786,75623369,66366583,CN
chr02,Bn11304,9338645,56307499,46968854,NBS
chr02,Bn11305,9707229,17190559,7483330,TNL
chr02,Bn11306,68310948,93836461,25525513,CNL
chr02,Bn11307,86110980,86587152,476172,NBS
chr02,Bn11308,84744855,96680273,11935418,RLP
chr02,Bn11309,61131316,89276560,28145244,RLK
chr02,Bn11310,89335857,91167199,1831342,TN
chr02,Bn11311,45441252,57661817,12220565,CNL
chr02,Bn11312,94600086,97228653,2628567,TNL
chr02,Bn11313,77698413,77873168,174755,NBS
chr02,Bn11314,68642339,90257998,21615659,RLK
chr02,Bn11315,87488464,89587922,2099458,RLK
chr02,Bn11316,48377628,91261544,42883916,CN
chr02,Bn11317,57130172,73312331,16182159,TN
chr02,Bn11318,27104322,70261272,43156950,TN
chr02,Bn11319,35506853,98429127,62922274,NBS
chr02,Bn11320,26334575,62617127,36282552,RLK
chr02,Bn11321,45387467,57824266,12436799,CNL
chr02,Bn11322,49661456,56433217,6771761,RLP
chr02,Bn11323,10708509,50400869,39692360,CNL
chr02,Bn11324,58631088,93739438,35108350,CN
chr02,Bn11325,1062625,64929060,63866435,TN
chr02,Bn11326,98159177,99110995,951818,RLP
chr02,Bn11327,2061506,5693653,3632147,TNL
chr02,Bn11328,25824799,64118954,38294155,NBS
chr02,Bn11329,82845056,98430630,15585574,CN
chr02,Bn11330,12204934,71721347,59516413,TNL
chr02,Bn11331,37905757,40160351,2254594,TNL
chr02,Bn11332,77707688,94980232,17272544,CN
chr02,Bn11333,61072094,75077774,14005680,CNL
chr02,Bn11334,79337492,97419815,18082323,TNL
chr02,Bn11335,30069932,58954925,28884993,CN
chr02,Bn11336,76217979,88423463,12205484,TN
chr02,Bn11337,15886339,71788104,55901765,CN
chr02,Bn11338,11523146,60847590,49324444,TNL
chr02,Bn11339,63426415,97595554,34169139,CNL
chr02,Bn11340,31363444,71258841,39895397,CN
chr02,Bn11341,22025870,86800685,64774815,RLP
chr02,Bn11342,16698497,77774956,61076459,CN
chr02,Bn11343,30597310,60012964,29415654,TN
chr02,Bn11344,85452413,92252115,6799702,NBS
chr02,Bn11345,57996528,59633229,1636701,CN
chr02,Bn11346,62428533,96411144,33982611,RLK
chr02,Bn11347,87139623,96156757,9017134,TNL
chr02,Bn11348,99570231,99656266,86035,RLK
chr02,Bn11349,1390491,28496479,27105988,RLK
chr02,Bn11350,44159776,72226723,28066947,TN
chr02,Bn11351,60456602,66462092,6005490,RLK
chr02,Bn11352,51904237,98059040,46154803,CN
chr02,Bn11353,90059916,97149907,7089991,NBS
chr02,Bn11354,47030701,54061594,7030893,TNL
chr02,Bn11355,72954747,93215534,20260787,RLK
chr02,Bn11356,9056962,72347665,63290703,CNL
chr02,Bn11357,68661641,84215925,15554284,TN
chr02,Bn11358,81551964,95186992,13635028,TN
chr02,Bn11359,44440233,55260592,10820359,TNL
chr02,Bn11360,12913335,43615060,30701725,RLK
chr02,Bn11361,28635130,49839052,21203922,NBS
chr02,Bn11362,5311331,45184516,39873185,NBS
chr02,Bn11363,5476584,46894881,41418297,CN
chr02,Bn11364,47553624,64668313,17114689,TN
chr02,Bn11365,36181532,39033615,2852083,RLP
chr02,Bn11366,86903417,91963585,5060168,CN
chr02,Bn11367,25489788,86027490,60537702,TN
chr02,Bn11368,65968965,88774693,22805728,CN
chr02,Bn11369,66622959,89629555,23006596,TNL
chr02,Bn11370,13306413,74309099,61002686,RLP
chr02,Bn11371,42513994,84185213,41671219,NBS
chr02,Bn11372,92380164,98885116,6504952,TNL
chr02,Bn11373,1232488,77764077,76531589,RLP
chr02,Bn11374,93208092,98513332,5305240,RLP
chr02,Bn11375,69304497,97244678,27940181,TNL
chr02,Bn11376,31836649,70200819,38364170,CN
chr02,Bn11377,37316093,58772331,21456238,TN
chr02,Bn11378,29196119,59493063,30296944,RLK
chr02,Bn11379,36700969,89912073,53211104,RLK
chr02,Bn11380,88645931,90892808,2246877,NBS
chr02,Bn11381,71887895,99409760,27521865,CNL
chr02,Bn11382,7176231,54196643,47020412,CN
chr02,Bn11383,67658397,72846288,5187891,NBS
chr02,Bn11384,87596055,90833710,3237655,TN
chr02,Bn11385,61933916,83022560,21088644,CNL
chr02,Bn11386,64208386,67539569,3331183,NBS
chr02,Bn11387,80805893,97086101,16280208,NBS
chr02,Bn11388,99437039,99563031,125992,TNL
chr02,Bn11389,67575234,86771325,19196091,TNL
chr02,Bn11390,39279209,48508614,9229405,RLP
chr02,Bn11391,70124404,85161658,15037254,CNL
chr02,Bn11392,91166582,98982840,7816258,TNL
chr02,Bn11393,89749918,99712020,9962102,CN
chr02,Bn11394,26236168,81683935,55447767,CN
chr02,Bn11395,9698852,93860283,84161431,CNL
chr02,Bn11396,19835120,82570686,62735566,TN
chr02,Bn11397,10687978,89948835,79260857,CNL
chr02,Bn11398,32160948,70322004,38161056,CNL
chr02,Bn11399,52366962,98400107,46033145,RLK
chr02,Bn11400,80011125,99962198,19951073,RLP
chr02,Bn11401,13297718,52792809,39495091,CNL
chr02,Bn11402,56860174,97790028,40929854,TN
chr02,Bn11403,78717452,93760060,15042608,RLP
chr02,Bn11404,49775472,83739188,33963716,TN
chr02,Bn11405,32596765,47808725,15211960,TNL
chr02,Bn11406,79048715,86472208,7423493,TN
chr02,Bn11407,29498727,50662968,21164241,CNL
chr02,Bn11408,79646758,84837927,5191169,TNL
chr02,Bn11409,47888750,61260737,13371987,CN
chr02,Bn11410,88977913,99241230,10263317,NBS
chr02,Bn11411,13947294,86820787,72873493,RLK
chr02,Bn11412,44120089,69357050,25236961,CN
chr02,Bn11413,5576544,35339311,29762767,NBS
chr02,Bn11414,41918132,85926804,44008672,NBS
chr02,Bn11415,59483590,71153278,11669688,NBS
chr02,Bn11416,82373579,93295257,10921678,RLP
chr02,Bn11417,17509986,27343562,9833576,TNL
chr02,Bn11418,31318872,60287906,28969034,CNL
chr02,Bn11419,11349196,51205524,39856328,RLK
chr02,Bn11420,70284366,93074428,22790062,TN
chr02,Bn11421,32947027,91262264,58315237,CN
chr02,Bn11422,80767398,98188156,17420758,CNL
chr02,Bn11423,25464687,70566170,45101483,CNL
chr02,Bn11424,80400814,83028686,2627872,CNL
chr02,Bn11425,96409288,99295769,2886481,CN
chr02,Bn11426,35415133,41136896,5721763,TN
chr02,Bn11427,25210278,89998747,64788469,RLP
chr02,Bn11428,54596341,62086861,7490520,NBS
chr02,Bn11429,41680455,60219821,18539366,TNL
chr02,Bn11430,39121538,65525953,26404415,RLK
chr02,Bn11431,87714271,87935471,221200,CNL
chr02,Bn11432,38517301,88115991,49598690,TN
chr02,Bn11433,67422848,76348624,8925776,RLK
chr02,Bn11434,39621999,95925583,56303584,CNL
chr02,Bn11435,70879688,73880074,3000386,TNL
chr02,Bn11436,57700546,89931046,32230500,CN
chr02,Bn11437,81195637,91757621,10561984,CN
chr02,Bn11438,8268682,83881868,75613186,RLP
chr02,Bn11439,35603594,35860428,256834,RLK
chr02,Bn11440,58490805,91642637,33151832,CN
chr02,Bn11441,85675543,94729161,9053618,NBS
chr02,Bn11442,60238066,79434170,19196104,TNL
chr02,Bn11443,84782491,98828972,14046481,CNL
chr02,Bn11444,77020229,97740143,20719914,RLP
chr02,Bn11445,24130071,95088631,70958560,TNL
chr02,Bn11446,18463509,32161597,13698088,CN
chr02,Bn11447,24110125,92495109,68384984,RLK
chr02,Bn11448,95144743,99484387,4339644,RLP
chr02,Bn11449,76047015,90479581,14432566,TNL
chr02,Bn11450,9781757,48208231,38426474,CNL
chr02,Bn11451,68758494,87410582,18652088,TN
chr02,Bn11452,47877667,91873146,43995479,RLK
chr02,Bn11453,73436642,83144300,9707658,CN
chr02,Bn11454,88166072,89342684,1176612,RLP
chr02,Bn11455,67328676,79597021,12268345,TNL
chr02,Bn11456,84592249,92353531,7761282,RLP
chr02,Bn11457,94777742,99845278,5067536,CNL
chr02,Bn11458,29179586,39240193,10060607,TNL
chr02,Bn11459,85312884,94684556,9371672,CNL
chr02,Bn11460,7031531,76873570,69842039,RLP
chr02,Bn11461,83513502,96029104,12515602,CN
chr02,Bn11462,58000432,75164719,17164287,TN
chr02,Bn11463,61642915,97326322,35683407,NBS
chr02,Bn11464,65070605,93170400,28099795,TN
chr02,Bn11465,26050568,86360223,60309655,TN
chr02,Bn11466,93841253,95166296,1325043,RLK
chr02,Bn11467,5682888,93769015,88086127,TNL
chr02,Bn11468,20359768,82861490,62501722,RLK
chr02,Bn11469,48861560,88746991,39885431,RLP
chr02,Bn11470,77244117,80083125,2839008,TNL
chr02,Bn11471,77712960,95803178,18090218,NBS
chr02,Bn11472,28098484,72851974,44753490,RLP
chr02,Bn11473,56670007,64629934,7959927,TN
chr02,Bn11474,42859933,82504423,39644490,NBS
chr02,Bn11475,30051339,95655668,65604329,RLK
chr02,Bn11476,45254601,62159031,16904430,RLK
chr02,Bn11477,29314826,69706367,40391541,CNL
chr02,Bn11478,10686192,72842696,62156504,RLK
chr02,Bn11479,67716030,77095881,9379851,CN
chr02,Bn11480,19376426,56276349,36899923,TN
chr02,Bn11481,18380448,69131942,50751494,TNL
chr02,Bn11482,81908713,94665484,12756771,CN
chr02,Bn11483,8192572,55435194,47242622,CN
chr02,Bn11484,50211601,56687395,6475794,RLP
chr02,Bn11485,11798570,93297778,81499208,CNL
chr02,Bn11486,15948485,90246708,74298223,CNL
chr02,Bn11487,35294117,40089977,4795860,NBS
chr02,Bn11488,30810034,57737827,26927793,RLK
chr02,Bn11489,74424118,79675431,5251313,NBS
chr02,Bn11490,96811953,98950011,2138058,RLK
chr02,Bn11491,34921664,35529245,607581,CNL
chr02,Bn11492,54483431,58999751,4516320,CNL
chr02,Bn11493,69097743,72120109,3022366,RLP
chr02,Bn11494,17901703,35676658,17774955,RLP
chr02,Bn11495,22967025,83571257,60604232,RLP
chr02,Bn11496,49531836,63969038,14437202,TN
chr02,Bn11497,93290027,98195148,4905121,TN
chr02,Bn11498,1800310,78472695,76672385,RLK
chr02,Bn11499,45190310,60832840,15642530,NBS
chr02,Bn11500,28005000,74041009,46036009,TNL
chr02,Bn11501,62510387,66583143,4072756,TN
chr02,Bn11502,80160981,89590413,9429432,TN
chr02,Bn11503,34482368,40280029,5797661,RLK
chr02,Bn11504,93240636,96560421,3319785,RLK
chr02,Bn11505,91025220,96625958,5600738,NBS
chr02,Bn11506,77753012,88175416,10422404,TNL
chr02,Bn11507,42303235,48595779,6292544,RLP
chr02,Bn11508,39257686,71716898,32459212,TN
chr02,Bn11509,98489334,98527888,38554,CN
chr02,Bn11510,85357411,96714703,11357292,CNL
chr02,Bn11511,94904752,97156894,2252142,RLK
chr02,Bn11512,55036231,66050523,11014292,TNL
chr02,Bn11513,45521041,94087671,48566630,NBS
chr02,Bn11514,40404858,74356461,33951603,RLP
chr02,Bn11515,92569526,96833296,4263770,NBS
chr02,Bn11516,51957689,97373441,45415752,RLK
chr02,Bn11517,9436531,71654270,62217739,NBS
chr02,Bn11518,48845108,89732935,40887827,CN
chr02,Bn11519,2334538,97149849,94815311,CNL
chr02,Bn11520,69781422,96985010,27203588,RLP
chr02,Bn11521,61235899,86135461,24899562,CN
chr02,Bn11522,4613055,93591497,88978442,TNL
chr02,Bn11523,72212745,76406785,4194040,CNL
chr02,Bn11524,98200782,98956963,756181,RLK
chr02,Bn11525,34275356,64799404,30524048,CNL
chr02,Bn11526,34300919,39009285,4708366,NBS
chr02,Bn11527,18294614,72780186,54485572,TN
chr02,Bn11528,10162826,17055730,6892904,RLK
chr02,Bn11529,80998844,92012388,11013544,TN
chr02,Bn11530,47896028,75097872,27201844,NBS
chr02,Bn11531,29115892,95841806,66725914,RLK
chr02,Bn11532,38249474,71919168,33669694,NBS
chr02,Bn11533,71050363,87952303,16901940,RLP
chr02,Bn11534,82320638,91841981,9521343,CNL
chr02,Bn11535,99659919,99740342,80423,RLK
chr02,Bn11536,15277259,69762010,54484751,TNL
chr02,Bn11537,39144618,54768962,15624344,RLP
chr02,Bn11538,93999278,98693313,4694035,RLK
chr02,Bn11539,20774411,92501514,71727103,RLK
chr02,Bn11540,58671813,60088297,1416484,TNL
chr02,Bn11541,11427332,38296399,26869067,RLK
chr02,Bn11542,83692383,91190394,7498011,RLP
chr02,Bn11543,60043674,97224641,37180967,NBS
chr02,Bn11544,61865623,70335709,8470086,CNL
chr02,Bn11545,38244846,46024419,7779573,CNL
chr02,Bn11546,51107020,71644740,20537720,RLK
chr02,Bn11547,12861653,59100721,46239068,TN
chr02,Bn11548,56621690,96302446,39680756,TN
chr02,Bn11549,21922386,89763998,67841612,CNL
chr02,Bn11550,75068783,83516183,8447400,TNL
chr02,Bn11551,19207073,98358058,79150985,RLP
chr02,Bn11552,54891451,64615359,9723908,NBS
chr02,Bn11553,24606290,70204075,45597785,TNL
chr02,Bn11554,31389511,54746653,23357142,CN
chr02,Bn11555,44990163,94220878,49230715,CN
chr02,Bn11556,60843521,82289831,21446310,RLP
chr02,Bn11557,94369658,97570425,3200767,CN
chr02,Bn11558,73412205,86665005,13252800,TNL
chr02,Bn11559,13244687,85510931,72266244,CN
chr02,Bn11560,41933846,64683877,22750031,NBS
chr02,Bn11561,7343800,52738490,45394690,TNL
chr02,Bn11562,86696061,94817838,8121777,TNL
chr02,Bn11563,34879276,52738360,17859084,TNL
chr02,Bn11564,79831801,99818382,19986581,TN
chr02,Bn11565,31419207,82022428,50603221,NBS
chr02,Bn11566,86899628,89582765,2683137,RLP
chr02,Bn11567,83423937,94031011,10607074,CN
chr02,Bn11568,3561958,67943980,64382022,CNL
chr02,Bn11569,60251072,99467089,39216017,TN
chr02,Bn11570,37874958,98520315,60645357,RLP
chr02,Bn11571,85318496,88373110,3054614,TN
chr02,Bn11572,69513068,70044659,531591,CN
chr02,Bn11573,58113432,94765869,36652437,NBS
chr02,Bn11574,21204432,66719731,45515299,CN
chr02,Bn11575,78082623,88535161,10452538,TNL
chr02,Bn11576,34956868,38789682,3832814,CN
chr02,Bn11577,18836210,85970386,67134176,RLP
chr02,Bn11578,14287181,50367538,36080357,RLP
chr02,Bn11579,92860505,97277567,4417062,CN
chr02,Bn11580,39486329,44769247,5282918,RLP
chr02,Bn11581,38863822,78477943,39614121,NBS
chr02,Bn11582,83207067,96879859,13672792,NBS
chr02,Bn11583,60839498,71705913,10866415,NBS
chr02,Bn11584,76636262,84951932,8315670,TNL
chr02,Bn11585,51801649,78185296,26383647,RLP
chr02,Bn11586,46045139,99649124,53603985,CNL
chr02,Bn11587,52043018,65079207,13036189,CNL
chr02,Bn11588,97279061,98655565,1376504,TN
chr02,Bn11589,83431242,94573164,11141922,CN
chr02,Bn11590,39457605,70564189,31106584,RLP
chr02,Bn11591,41371919,53196377,11824458,CN
chr02,Bn11592,70903817,77656451,6752634,RLK
chr02,Bn11593,41739249,91981124,50241875,CNL
chr02,Bn11594,4915405,78592020,73676615,CN
chr02,Bn11595,74232311,82448631,8216320,NBS
chr02,Bn11596,65472350,87281622,21809272,TN
chr02,Bn11597,45372343,79048896,33676553,NBS
chr02,Bn11598,92180973,96052470,3871497,CNL
chr02,Bn11599,7059981,68333781,61273800,RLP
chr02,Bn11600,58317290,69683369,11366079,CNL
chr02,Bn11601,57757737,99742569,41984832,CNL
chr02,Bn11602,35649007,46672187,11023180,RLP
chr02,Bn11603,23859067,68384821,44525754,TNL
chr02,Bn11604,66630303,84238761,17608458,CNL
chr02,Bn11605,73340411,96816925,23476514,CNL
chr02,Bn11606,26096942,38915134,12818192,TNL
chr02,Bn11607,61553173,99242343,37689170,NBS
chr02,Bn11608,25066818,78425229,53358411,CNL
chr02,Bn11609,40263378,81255685,40992307,TNL
chr02,Bn11610,42296850,95424809,53127959,RLP
chr02,Bn11611,51441125,63992602,12551477,TN
chr02,Bn11612,58616295,69157683,10541388,TN
chr02,Bn11613,62257374,70410706,8153332,NBS
chr02,Bn11614,93663725,97518911,3855186,TNL
chr02,Bn11615,78671810,80006833,1335023,RLK
chr02,Bn11616,86703594,97501208,10797614,NBS
chr02,Bn11617,99577056,99717500,140444,TN
chr02,Bn11618,20818797,62966011,42147214,CN
chr02,Bn11619,19344946,84630295,65285349,NBS
chr02,Bn11620,69227857,77931707,8703850,RLP
chr02,Bn11621,25486327,46693193,21206866,TNL
chr02,Bn11622,13093826,75088794,61994968,CN
chr02,Bn11623,63372851,72190473,8817622,TNL
chr02,Bn11624,63871114,98234107,34362993,NBS
chr02,Bn11625,71211252,71463156,251904,CNL
chr02,Bn11626,68207348,76881828,8674480,RLK
chr02,Bn11627,15080004,65206839,50126835,NBS
chr02,Bn11628,34821908,90663061,55841153,CN
chr02,Bn11629,11820152,53269157,41449005,NBS
chr02,Bn11630,47288637,67739148,20450511,TN
chr02,Bn11631,8880570,25833283,16952713,RLP
chr02,Bn11632,45222960,97623929,52400969,RLP
chr02,Bn11633,74316417,94243795,19927378,RLK
chr02,Bn11634,11880334,93656791,81776457,RLK
chr02,Bn11635,24166738,64358225,40191487,CN
chr02,Bn11636,53114019,67975619,14861600,TNL
chr02,Bn11637,49287250,66408739,17121489,TNL
chr02,Bn11638,46271619,72799252,26527633,TN
chr02,Bn11639,33643870,85034633,51390763,TN
chr02,Bn11640,58071604,70800866,12729262,RLP
chr02,Bn11641,91297416,99834787,8537371,TN
chr02,Bn11642,44838828,55884193,11045365,NBS
chr02,Bn11643,7667406,93694738,86027332,CN
chr02,Bn11644,55268867,80699701,25430834,RLK
chr02,Bn11645,98244689,99675609,1430920,CNL
chr02,Bn11646,49711817,94289873,44578056,CN
chr02,Bn11647,96138299,97783453,1645154,RLK
chr02,Bn11648,66387589,68773973,2386384,TN
chr02,Bn11649,4062895,94398139,90335244,NBS
chr02,Bn11650,45072707,45219097,146390,NBS
chr02,Bn11651,61214219,93918571,32704352,NBS
chr02,Bn11652,25588028,82252490,56664462,CN
chr02,Bn11653,78279725,80039805,1760080,RLP
chr02,Bn11654,94546634,98326062,3779428,NBS
chr02,Bn11655,23563447,75159554,51596107,RLP
chr02,Bn11656,53984300,55928687,1944387,CNL
chr02,Bn11657,11560171,25167840,13607669,CN
chr02,Bn11658,38559808,46847446,8287638,RLK
chr02,Bn11659,59973579,98110531,38136952,TN
chr02,Bn11660,81189262,88645592,7456330,CNL
chr02,Bn11661,53075195,81252674,28177479,TN
chr02,Bn11662,75671324,80086314,4414990,CNL
chr02,Bn11663,66347276,77797393,11450117,NBS
chr02,Bn11664,36310780,51613760,15302980,RLK
chr02,Bn11665,8633126,27072763,18439637,RLK
chr02,Bn11666,61005843,74410771,13404928,CN
chr02,Bn11667,38106926,95051794,56944868,NBS
chr02,Bn11668,50517633,96268149,45750516,TN
chr02,Bn11669,78790788,79924572,1133784,RLK
chr02,Bn11670,62934127,77077264,14143137,RLP
chr02,Bn11671,58491930,95195380,36703450,TNL
chr02,Bn11672,10186815,66174599,55987784,RLK
chr02,Bn11673,25641611,76144296,50502685,CNL
chr02,Bn11674,58433472,98793685,40360213,TN
chr02,Bn11675,99822653,99946309,123656,TNL
chr02,Bn11676,49810287,73284715,23474428,RLP
chr02,Bn11677,69582272,93297078,23714806,CN
chr02,Bn11678,87945139,98430294,10485155,TN
chr02,Bn11679,42092734,47283655,5190921,NBS
chr02,Bn11680,67510153,98562030,31051877,CNL
chr02,Bn11681,78135052,98697811,20562759,CNL
chr02,Bn11682,75965033,83788015,7822982,RLP
chr02,Bn11683,99844293,99851251,6958,CNL
chr02,Bn11684,10949539,49256611,38307072,TNL
chr02,Bn11685,11363333,63752613,52389280,RLP
chr02,Bn11686,66497435,84242431,17744996,NBS
chr02,Bn11687,67473917,73105376,5631459,CNL
chr02,Bn11688,93854712,99136970,5282258,NBS
chr02,Bn11689,89519363,95833504,6314141,TNL
chr02,Bn11690,15132533,46732030,31599497,RLK
chr02,Bn11691,32875308,39639065,6763757,NBS
chr02,Bn11692,11649410,37206703,25557293,TN
chr02,Bn11693,31725142,35299874,3574732,TN
chr02,Bn11694,53846396,92441506,38595110,CNL
chr02,Bn11695,62213827,79386306,17172479,TNL
chr02,Bn11696,76162093,87261219,11099126,TN
chr02,Bn11697,14520020,99895242,85375222,CN
chr02,Bn11698,96897210,97631706,734496,TNL
chr02,Bn11699,62456866,70573902,8117036,RLK
chr02,Bn11700,48468980,71832230,23363250,RLK
chr02,Bn11701,54611811,94553732,39941921,CN
chr02,Bn11702,19850669,88648306,68797637,RLP
chr02,Bn11703,82621288,97697299,15076011,NBS
chr02,Bn11704,93091276,97391061,4299785,TN
chr02,Bn11705,63188144,70741490,7553346,NBS
chr02,Bn11706,81375377,89235178,7859801,RLP
chr02,Bn11707,24119694,72588107,48468413,NBS
chr02,Bn11708,12935750,87639451,74703701,CNL
chr02,Bn11709,14291487,44391062,30099575,CNL
chr02,Bn11710,60716598,61455001,738403,TN
chr02,Bn11711,6306839,9143687,2836848,NBS
chr02,Bn11712,24261003,58176139,33915136,RLK
chr02,Bn11713,36784467,57550400,20765933,NBS
chr02,Bn11714,38780524,76987876,38207352,RLK
chr02,Bn11715,12667151,91957355,79290204,CNL
chr02,Bn11716,18689617,89059780,70370163,TNL
chr02,Bn11717,91420394,92043407,623013,RLK
chr02,Bn11718,38156126,52311842,14155716,RLK
chr02,Bn11719,81106292,81322986,216694,TN
chr02,Bn11720,43788477,87222425,43433948,TN
chr02,Bn11721,82152035,85778667,3626632,RLK
chr02,Bn11722,63371045,94621707,31250662,TNL
chr02,Bn11723,51713380,86114801,34401421,TNL
chr02,Bn11724,25522584,31980526,6457942,RLP
chr02,Bn11725,77887891,88835725,10947834,TN
chr02,Bn11726,79511877,81298765,1786888,TN
chr02,Bn11727,20393204,47944315,27551111,RLP
chr02,Bn11728,37314838,86629392,49314554,NBS
chr02,Bn11729,80211032,89016798,8805766,RLP
chr02,Bn11730,35739772,78687436,42947664,RLK
chr02,Bn11731,6634572,29027402,22392830,RLP
chr02,Bn11732,72374901,80917624,8542723,CN
chr02,Bn11733,59482002,65907623,6425621,CN
chr02,Bn11734,87435927,94139554,6703627,RLK
chr02,Bn11735,22655459,51267287,28611828,TN
chr02,Bn11736,67962381,76734585,8772204,CN
chr02,Bn11737,91426829,98976777,7549948,NBS
chr02,Bn11738,20951271,29880903,8929632,CNL
chr02,Bn11739,84467585,91659372,7191787,RLP
chr02,Bn11740,34151308,36830700,2679392,CNL
chr02,Bn11741,52200719,86975802,34775083,RLP
chr02,Bn11742,14049093,47904932,33855839,RLP
chr02,Bn11743,94152966,99624095,5471129,CNL
chr02,Bn11744,78432398,85024617,6592219,TN
chr02,Bn11745,16699308,31321769,14622461,RLP
chr02,Bn11746,40529718,55032617,14502899,TN
chr02,Bn11747,39747213,41533652,1786439,CN
chr02,Bn11748,61517772,92673224,31155452,TN
chr02,Bn11749,74851861,98260186,23408325,CNL
chr02,Bn11750,64506048,78974573,14468525,RLK
chr02,Bn11751,36438170,81679628,45241458,RLP
chr02,Bn11752,56240621,96800452,40559831,CNL
chr02,Bn11753,41720583,79886948,38166365,CN
chr02,Bn11754,40189598,83300861,43111263,NBS
chr02,Bn11755,25120979,70536535,45415556,RLK
chr02,Bn11756,69165456,95104503,25939047,TNL
chr02,Bn11757,26454223,45608798,19154575,TN
chr02,Bn11758,29091207,29742256,651049,TN
chr02,Bn11759,33703762,87892045,54188283,NBS
chr02,Bn11760,64885914,91102907,26216993,RLK
chr02,Bn11761,61634197,75856472,14222275,CNL
chr02,Bn11762,14620873,45723526,31102653,RLK
chr02,Bn11763,84693953,87680182,2986229,TNL
chr02,Bn11764,32236412,90789242,58552830,CNL
chr02,Bn11765,88807556,91134611,2327055,CNL
chr02,Bn11766,88861950,89841617,979667,TN
chr02,Bn11767,15584016,30911259,15327243,NBS
chr02,Bn11768,42281602,96324959,54043357,RLP
chr02,Bn11769,63331405,65727985,2396580,CN
chr02,Bn11770,14912623,80720792,65808169,RLP
chr02,Bn11771,2267620,70527886,68260266,RLP
chr02,Bn11772,52628135,58146966,5518831,CN
chr02,Bn11773,79902809,94369987,14467178,CNL
chr02,Bn11774,10751391,22980828,12229437,TN
chr02,Bn11775,49907942,73267290,23359348,CNL
chr02,Bn11776,69697431,71154189,1456758,RLK
chr02,Bn11777,14772828,48175763,33402935,NBS
chr02,Bn11778,23261573,59179812,35918239,RLK
chr02,Bn11779,21047931,30663895,9615964,RLK
chr02,Bn11780,87462985,95195992,7733007,RLK
chr02,Bn11781,63322360,98842716,35520356,RLP
chr02,Bn11782,8376849,56127727,47750878,TN
chr02,Bn11783,57368325,99210251,41841926,CN
chr02,Bn11784,43584341,80124695,36540354,RLP
chr02,Bn11785,60449732,99279792,38830060,CN
chr02,Bn11786,84685776,89439004,4753228,CN
chr02,Bn11787,52513776,90037765,37523989,RLK
chr02,Bn11788,37468776,89467018,51998242,TNL
chr02,Bn11789,4011302,83066220,79054918,TNL
chr02,Bn11790,13115646,27345519,14229873,NBS
chr02,Bn11791,80524555,82092820,1568265,RLP
chr02,Bn11792,16652254,37991898,21339644,NBS
chr02,Bn11793,80315670,90933151,10617481,RLP
chr02,Bn11794,76363710,82471711,6108001,TN
chr02,Bn11795,8102637,99305365,91202728,TNL
chr02,Bn11796,20515335,44196450,23681115,NBS
chr02,Bn11797,94956728,99533164,4576436,CN
chr02,Bn11798,46903003,83543885,36640882,CNL
chr02,Bn11799,91309546,94156594,2847048,TNL
chr02,Bn11800,80043112,82829421,2786309,TNL
chr02,Bn11801,75097561,99715896,24618335,TNL
chr02,Bn11802,84364700,89601193,5236493,NBS
chr02,Bn11803,24463907,39543310,15079403,RLK
chr02,Bn11804,67695262,80258272,12563010,TN
chr02,Bn11805,82482031,92868522,10386491,CN
chr02,Bn11806,68295553,72534617,4239064,RLK
chr02,Bn11807,20233836,94871684,74637848,CN
chr02,Bn11808,6862380,88096010,81233630,RLP
chr02,Bn11809,20885767,28449734,7563967,RLP
chr02,Bn11810,37319294,41041690,3722396,CNL
chr02,Bn11811,79121554,97933698,18812144,TNL
chr02,Bn11812,43983601,48825154,4841553,RLK
chr02,Bn11813,36416730,58324355,21907625,CNL
chr02,Bn11814,87784398,95248097,7463699,CN
chr02,Bn11815,25181563,39077789,13896226,CN
chr02,Bn11816,57099582,80820843,23721261,TN
chr02,Bn11817,96365835,97499462,1133627,TN
chr02,Bn11818,35982290,96966733,60984443,RLK
chr02,Bn11819,64926075,98299371,33373296,TNL
chr02,Bn11820,48835380,83080635,34245255,NBS
chr02,Bn11821,38448032,51885451,13437419,NBS
chr02,Bn11822,11825663,54790449,42964786,TNL
chr02,Bn11823,84459698,87237693,2777995,NBS
chr02,Bn11824,84390850,94857938,10467088,CN
chr02,Bn11825,64307796,91388780,27080984,RLK
chr02,Bn11826,40380246,57045892,16665646,TN
chr02,Bn11827,51379348,73692820,22313472,TN
chr02,Bn11828,43506607,59625521,16118914,NBS
chr02,Bn11829,92127516,94456582,2329066,TN
chr02,Bn11830,70885312,80409472,9524160,TN
chr02,Bn11831,47842921,96043401,48200480,CNL
chr02,Bn11832,18940722,57755796,38815074,NBS
chr02,Bn11833,9168633,47385144,38216511,CN
chr02,Bn11834,62815473,73152344,10336871,TNL
chr02,Bn11835,69833923,85979241,16145318,RLP
chr02,Bn11836,22366397,30560794,8194397,CN
chr02,Bn11837,19600973,85999924,66398951,CN
chr02,Bn11838,18641155,72118048,53476893,CNL
chr02,Bn11839,32240774,67478665,35237891,CNL
chr02,Bn11840,84821801,92536192,7714391,TNL
chr02,Bn11841,99905660,99937919,32259,TNL
chr02,Bn11842,58105694,70849988,12744294,RLK
chr02,Bn11843,98047224,98450142,402918,CN
chr02,Bn11844,42516493,96118886,53602393,RLP
chr02,Bn11845,5806868,41306575,35499707,RLP
chr02,Bn11846,79721947,92243827,12521880,CN
chr02,Bn11847,46709032,82370514,35661482,RLK
chr02,Bn11848,65377401,85697316,20319915,CN
chr02,Bn11849,81243741,87174868,5931127,RLP
chr02,Bn11850,11045328,19235417,8190089,TNL
chr02,Bn11851,39063806,55462146,16398340,TN
chr02,Bn11852,62771189,73247592,10476403,RLK
chr02,Bn11853,11361136,30631031,19269895,TN
chr02,Bn11854,91098073,93671018,2572945,NBS
chr02,Bn11855,64728030,83655381,18927351,TNL
chr02,Bn11856,36928130,54162968,17234838,TNL
chr02,Bn11857,18861179,38605942,19744763,TN
chr02,Bn11858,8627793,30045712,21417919,TNL
chr02,Bn11859,4410893,39694130,35283237,RLP
chr02,Bn11860,79095462,99081088,19985626,RLK
chr02,Bn11861,63147215,74424514,11277299,TN
chr02,Bn11862,45377904,47531765,2153861,TNL
chr02,Bn11863,28395597,67611248,39215651,TN
chr02,Bn11864,56290373,63362559,7072186,NBS
chr02,Bn11865,49542306,67743950,18201644,RLK
chr02,Bn11866,40496899,80457096,39960197,RLK
chr02,Bn11867,32214055,43065891,10851836,NBS
chr02,Bn11868,2351622,10088347,7736725,TNL
chr02,Bn11869,96144052,99381487,3237435,TNL
chr02,Bn11870,47561816,86148658,38586842,TN
chr02,Bn11871,8224913,60294846,52069933,RLK
chr02,Bn11872,94712765,97542548,2829783,RLP
chr02,Bn11873,60030180,65041667,5011487,CNL
chr02,Bn11874,76022291,81978708,5956417,TNL
chr02,Bn11875,4874004,52287822,47413818,CNL
chr02,Bn11876,50518300,72862038,22343738,TN
chr02,Bn11877,96073935,99887469,3813534,CNL
chr02,Bn11878,33041998,58108077,25066079,CN
chr02,Bn11879,24485397,91630756,67145359,CN
chr02,Bn11880,28926838,70890855,41964017,TNL
chr02,Bn11881,79753935,88649068,8895133,RLK
chr02,Bn11882,78452610,99148222,20695612,RLP
chr02,Bn11883,93490804,94741370,1250566,TNL
chr02,Bn11884,77603465,88160975,10557510,NBS
chr02,Bn11885,68228031,96066139,27838108,CNL
chr02,Bn11886,53313258,57435023,4121765,CNL
chr02,Bn11887,87401505,92623149,5221644,CNL
chr02,Bn11888,14908284,68673732,53765448,TNL
chr02,Bn11889,49643984,82984679,33340695,TNL
chr02,Bn11890,27610512,28889691,1279179,NBS
chr02,Bn11891,43935407,89566732,45631325,TNL
chr02,Bn11892,41316978,49302231,7985253,TN
chr02,Bn11893,70341319,89694390,19353071,CN
chr02,Bn11894,22719515,74780835,52061320,NBS
chr02,Bn11895,14277260,72273754,57996494,RLK
chr02,Bn11896,4880469,21179003,16298534,RLK
chr02,Bn11897,58433069,63888716,5455647,RLK
chr02,Bn11898,99057750,99686311,628561,CN
chr02,Bn11899,27163901,27816726,652825,NBS
chr02,Bn11900,11575087,92986414,81411327,RLP
chr02,Bn11901,33328152,38629203,5301051,CNL
chr02,Bn11902,23509989,33548581,10038592,TN
chr02,Bn11903,68990062,79069766,10079704,RLK
chr02,Bn11904,50430985,72698125,22267140,TN
chr02,Bn11905,6549870,93721122,87171252,CN
chr02,Bn11906,60368873,82229122,21860249,CNL
chr02,Bn11907,84801808,97609264,12807456,RLP
chr02,Bn11908,55815324,76519035,20703711,CN
chr02,Bn11909,85190409,87443709,2253300,TNL
chr02,Bn11910,59302738,72749629,13446891,TN
chr02,Bn11911,7150835,40359159,33208324,CNL
chr02,Bn11912,33063534,61182224,28118690,RLP
chr02,Bn11913,56394490,90962361,34567871,TNL
chr02,Bn11914,24093410,88737791,64644381,CNL
chr02,Bn11915,55508912,72445506,16936594,CNL
chr02,Bn11916,42713474,59436964,16723490,TNL
chr02,Bn11917,95989785,98572372,2582587,TN
chr02,Bn11918,3961433,76354260,72392827,NBS
chr02,Bn11919,70562321,77792100,7229779,TN
chr02,Bn11920,33011422,42393907,9382485,CNL
chr02,Bn11921,40952638,55104875,14152237,RLP
chr02,Bn11922,62982301,99259985,36277684,NBS
chr02,Bn11923,54140840,80305586,26164746,TNL
chr02,Bn11924,70508549,98902149,28393600,TN
chr02,Bn11925,13543607,58295992,44752385,RLP
chr02,Bn11926,56036498,63198060,7161562,TN
chr02,Bn11927,29662671,84473821,54811150,CN
chr02,Bn11928,49425931,96149096,46723165,CN
chr02,Bn11929,5755124,66747922,60992798,RLK
chr02,Bn11930,28867323,43234495,14367172,RLP
chr02,Bn11931,75139497,82503433,7363936,RLP
chr02,Bn11932,19033371,68725961,49692590,TN
chr02,Bn11933,86313437,94607820,8294383,NBS
chr02,Bn11934,54740030,62347675,7607645,RLK
chr02,Bn11935,84153694,91762774,7609080,RLP
chr02,Bn11936,96296691,98212713,1916022,RLP
chr02,Bn11937,30967180,50631791,19664611,TNL
chr02,Bn11938,13896805,43998540,30101735,RLP
chr02,Bn11939,66763857,70985577,4221720,CNL
chr02,Bn11940,58884249,96969180,38084931,CN
chr02,Bn11941,97292587,98391392,1098805,CN
chr02,Bn11942,57723159,77581324,19858165,RLK
chr02,Bn11943,90858819,95201454,4342635,NBS
chr02,Bn11944,60636622,90711409,30074787,TNL
chr02,Bn11945,79026001,83501210,4475209,RLP
chr02,Bn11946,59106445,72942512,13836067,RLP
chr02,Bn11947,11953304,65212040,53258736,TN
chr02,Bn11948,79572095,96038832,16466737,NBS
chr02,Bn11949,51850032,97111675,45261643,RLK
chr02,Bn11950,33339446,36069898,2730452,CN
chr02,Bn11951,87960263,97581009,9620746,CNL
chr02,Bn11952,76901339,96488152,19586813,TN
chr02,Bn11953,59957311,85272694,25315383,RLK
chr02,Bn11954,77389548,95024187,17634639,CN
chr02,Bn11955,53016114,60467461,7451347,TNL
chr02,Bn11956,40315524,94950540,54635016,NBS
chr02,Bn11957,79106333,84991233,5884900,NBS
chr02,Bn11958,45428836,56838538,11409702,CNL
chr02,Bn11959,17017664,31399555,14381891,CNL
chr02,Bn11960,90948026,93917403,2969377,TNL
chr02,Bn11961,75944393,78545216,2600823,TNL
chr02,Bn11962,53930880,55277610,1346730,TN
chr02,Bn11963,85039889,89669470,4629581,TNL
chr02,Bn11964,48056755,51879041,3822286,CN
chr02,Bn11965,60462210,95967101,35504891,TNL
chr02,Bn11966,17918077,73786721,55868644,CN
chr02,Bn11967,25995403,96514373,70518970,CN
chr02,Bn11968,9205277,18950370,9745093,RLK
chr02,Bn11969,30083623,31479585,1395962,TNL
chr02,Bn11970,56451479,86766124,30314645,RLK
chr02,Bn11971,39715975,84154066,44438091,TNL
chr02,Bn11972,26665122,47816875,21151753,RLP
chr02,Bn11973,82933909,98926055,15992146,TN
chr02,Bn11974,31753405,78900776,47147371,TNL
chr02,Bn11975,32064954,72839308,40774354,CNL
chr02,Bn11976,54817149,84455380,29638231,NBS
chr02,Bn11977,53961615,57310281,3348666,NBS
chr02,Bn11978,14420630,78401455,63980825,CNL
chr02,Bn11979,67473457,95056008,27582551,TN
chr02,Bn11980,92769774,97337441,4567667,CN
chr02,Bn11981,17256071,52211283,34955212,RLK
chr02,Bn11982,39934638,94186331,54251693,NBS
chr02,Bn11983,76691286,81969132,5277846,TNL
chr02,Bn11984,92019679,97520099,5500420,CN
chr02,Bn11985,18450860,58688796,40237936,RLP
chr02,Bn11986,35904162,92065045,56160883,RLP
chr02,Bn11987,77317385,78829251,1511866,NBS
chr02,Bn11988,69096728,90870497,21773769,CN
chr02,Bn11989,42936929,94654433,51717504,CNL
chr02,Bn11990,29948639,95780398,65831759,NBS
chr02,Bn11991,76162656,95595574,19432918,CN
chr02,Bn11992,31712416,41558761,9846345,CN
chr02,Bn11993,14621426,84906914,70285488,RLK
chr02,Bn11994,50867911,60966523,10098612,NBS
chr02,Bn11995,57521397,63297714,5776317,RLK
chr02,Bn11996,28860339,35536817,6676478,RLP
chr02,Bn11997,11885862,19788661,7902799,NBS
chr02,Bn11998,69248292,94728889,25480597,CN
chr02,Bn11999,14699929,62375740,47675811,TNL
chr02,Bn12000,33406702,37200539,3793837,RLP
chr02,Bn12001,77165965,87472065,10306100,CNL
chr02,Bn12002,64154065,79751817,15597752,TN
chr02,Bn12003,92936229,97258470,4322241,TNL
chr02,Bn12004,85575833,86754323,1178490,RLK
chr02,Bn12005,1050999,24629034,23578035,CNL
chr02,Bn12006,9304235,73653702,64349467,NBS
chr02,Bn12007,72675438,90768392,18092954,NBS
chr02,Bn12008,93127580,98047527,4919947,TNL
chr02,Bn12009,86342222,98249572,11907350,NBS
chr02,Bn12010,32205360,38936534,6731174,TN
chr02,Bn12011,3864250,75462641,71598391,TNL
chr02,Bn12012,99471494,99860427,388933,CN
chr03,Bn12013,46683541,65661513,18977972,RLK
chr03,Bn12014,77890596,87283622,9393026,TNL
chr03,Bn12015,73408685,98682870,25274185,RLK
chr03,Bn12016,25350663,90398578,65047915,TNL
chr03,Bn12017,57949819,61274752,3324933,CN
chr03,Bn12018,10571361,80260475,69689114,CN
chr03,Bn12019,48617938,76162760,27544822,RLK
chr03,Bn12020,59802753,87200110,27397357,CNL
chr03,Bn12021,10087635,81852689,71765054,CNL
chr03,Bn12022,93348078,95671538,2323460,RLP
chr03,Bn12023,28981744,52771654,23789910,RLK
chr03,Bn12024,2215504,90143386,87927882,RLK
chr03,Bn12025,82132487,93714864,11582377,CN
chr03,Bn12026,1449253,55339965,53890712,NBS
chr03,Bn12027,75614721,92847749,17233028,RLP
chr03,Bn12028,85236851,93022693,7785842,RLP
chr03,Bn12029,57126669,61176248,4049579,TNL
chr03,Bn12030,13741709,80623337,66881628,RLP
chr03,Bn12031,16525254,86268587,69743333,NBS
chr03,Bn12032,72748983,80825793,8076810,RLP
chr03,Bn12033,65301743,72801488,7499745,NBS
chr03,Bn12034,32505075,73738712,41233637,CNL
chr03,Bn12035,39464581,79785791,40321210,RLK
chr03,Bn12036,91881290,95044892,3163602,CN
chr03,Bn12037,20890733,87867982,66977249,TN
chr03,Bn12038,57392919,85124742,27731823,TNL
chr03,Bn12039,17667262,59473266,41806004,CN
chr03,Bn12040,52971164,91976879,39005715,CNL
chr03,Bn12041,42502033,70396622,27894589,RLP
chr03,Bn12042,81795734,93160548,11364814,RLP
chr03,Bn12043,54927109,59371509,4444400,CN
chr03,Bn12044,71447332,73852907,2405575,RLP
chr03,Bn12045,5628561,38085397,32456836,RLK
chr03,Bn12046,79737080,98075703,18338623,TN
chr03,Bn12047,8637723,78145113,69507390,RLK
chr03,Bn12048,84379573,88510607,4131034,RLP
chr03,Bn12049,5123298,85118692,79995394,TN
chr03,Bn12050,80312381,88243545,7931164,NBS
chr03,Bn12051,60653680,63488584,2834904,CNL
chr03,Bn12052,90192653,94777326,4584673,TNL
chr03,Bn12053,44337940,89535107,45197167,CN
chr03,Bn12054,30510128,51677052,21166924,RLP
chr03,Bn12055,73038104,74236252,1198148,CN
chr03,Bn12056,31576463,60969271,29392808,CN
chr03,Bn12057,67856085,86320581,18464496,RLP
chr03,Bn12058,8790697,51491589,42700892,RLP
chr03,Bn12059,75307792,77628510,2320718,NBS
chr03,Bn12060,64865332,74024142,9158810,TN
chr03,Bn12061,67382569,89738067,22355498,TN
chr03,Bn12062,28855907,87166905,58310998,RLP
chr03,Bn12063,70485855,97214054,26728199,RLP
chr03,Bn12064,56090357,63428554,7338197,NBS
chr03,Bn12065,48560631,58709492,10148861,CN
chr03,Bn12066,48650031,69296162,20646131,CNL
chr03,Bn12067,2571799,97556793,94984994,CN
chr03,Bn12068,75601121,89484161,13883040,TNL
chr03,Bn12069,63529021,84598901,21069880,NBS
chr03,Bn12070,98255136,98392742,137606,NBS
chr03,Bn12071,35963629,75379825,39416196,RLP
chr03,Bn12072,52244894,67391895,15147001,RLP
chr03,Bn12073,81905717,96677236,14771519,TNL
chr03,Bn12074,79473245,93050041,13576796,NBS
chr03,Bn12075,17725790,72276171,54550381,TNL
chr03,Bn12076,78586818,82692283,4105465,CN
chr03,Bn12077,10264670,55233466,44968796,CNL
chr03,Bn12078,65509104,93027446,27518342,NBS
chr03,Bn12079,57113231,60996874,3883643,TN
chr03,Bn12080,44900198,74898704,29998506,RLP
chr03,Bn12081,66878974,80249251,13370277,RLK
chr03,Bn12082,61658871,96796186,35137315,RLK
chr03,Bn12083,23477826,84612594,61134768,RLP
chr03,Bn12084,14813087,41429330,26616243,TNL
chr03,Bn12085,3806288,42018345,38212057,NBS
chr03,Bn12086,35050006,77383725,42333719,CN
chr03,Bn12087,82738237,86942014,4203777,CNL
chr03,Bn12088,39733360,88710621,48977261,NBS
chr03,Bn12089,78493111,85948843,7455732,CN
chr03,Bn12090,39963967,92626581,52662614,RLK
chr03,Bn12091,45686424,61058478,15372054,CNL
chr03,Bn12092,98179435,99888047,1708612,CN
chr03,Bn12093,39761813,98143518,58381705,RLK
chr03,Bn12094,60698055,72216033,11517978,RLK
chr03,Bn12095,96579147,99431181,2852034,RLK
chr03,Bn12096,44786783,71311393,26524610,NBS
chr03,Bn12097,83092866,85762616,2669750,RLK
chr03,Bn12098,20701685,38120838,17419153,NBS
chr03,Bn12099,1843265,12963337,11120072,RLP
chr03,Bn12100,91103088,93898935,2795847,RLK
chr03,Bn12101,44924414,58233142,13308728,RLK
chr03,Bn12102,48596575,78869083,30272508,RLK
chr03,Bn12103,50236620,78838046,28601426,TNL
chr03,Bn12104,53961749,76432937,22471188,CNL
chr03,Bn12105,26381667,64502852,38121185,TN
chr03,Bn12106,25161804,72061419,46899615,CN
chr03,Bn12107,70660617,76738605,6077988,CN
chr03,Bn12108,27826881,84970862,57143981,NBS
chr03,Bn12109,81819369,95359225,13539856,TNL
chr03,Bn12110,71125274,88080423,16955149,TN
chr03,Bn12111,93325816,98438135,5112319,NBS
chr03,Bn12112,82338136,84546335,2208199,NBS
chr03,Bn12113,46180370,59673817,13493447,NBS
chr03,Bn12114,72709706,98045900,25336194,TNL
chr03,Bn12115,52530591,86680909,34150318,NBS
chr03,Bn12116,50553852,63918880,13365028,NBS
chr03,Bn12117,63151324,68934119,5782795,CNL
chr03,Bn12118,50039803,69805863,19766060,RLP
chr03,Bn12119,41368146,45425984,4057838,TNL
chr03,Bn12120,70478879,75579881,5101002,CNL
chr03,Bn12121,75305983,79142661,3836678,RLK
chr03,Bn12122,38389368,67844275,29454907,TNL
chr03,Bn12123,88205906,89287057,1081151,TN
chr03,Bn12124,68361149,92472524,24111375,NBS
chr03,Bn12125,64439601,95368777,30929176,RLK
chr03,Bn12126,28543488,43979594,15436106,NBS
chr03,Bn12127,88169497,92430016,4260519,RLP
chr03,Bn12128,18520546,70626428,52105882,TNL
chr03,Bn12129,64183292,77888324,13705032,NBS
chr03,Bn12130,7455089,21162299,13707210,RLK
chr03,Bn12131,57595682,70279638,12683956,TNL
chr03,Bn12132,49611230,91973882,42362652,TNL
chr03,Bn12133,1554942,84043395,82488453,NBS
chr03,Bn12134,23323418,71823229,48499811,CN
chr03,Bn12135,49380391,68812196,19431805,TN
chr03,Bn12136,54299953,78910677,24610724,NBS
chr03,Bn12137,94364243,94926442,562199,CNL
chr03,Bn12138,36132062,84970448,48838386,NBS
chr03,Bn12139,23339386,85056532,61717146,CNL
chr03,Bn12140,27627177,87559605,59932428,CN
chr03,Bn12141,36587664,78675685,42088021,CN
chr03,Bn12142,51231677,64403328,13171651,NBS
chr03,Bn12143,65167318,86060549,20893231,CN
chr03,Bn12144,32856766,67894438,35037672,TN
chr03,Bn12145,33185885,39775934,6590049,TNL
chr03,Bn12146,43364605,67714255,24349650,TNL
chr03,Bn12147,73092607,96947921,23855314,CNL
chr03,Bn12148,27217979,61203406,33985427,CN
chr03,Bn12149,27806462,30617991,2811529,TN
chr03,Bn12150,89508610,95402835,5894225,CN
chr03,Bn12151,38511471,41008174,2496703,CNL
chr03,Bn12152,80092536,98821702,18729166,CNL
chr03,Bn12153,22995137,85085894,62090757,TNL
chr03,Bn12154,37741209,88414664,50673455,CNL
chr03,Bn12155,49410436,58452101,9041665,CN
chr03,Bn12156,76934361,97148799,20214438,TNL
chr03,Bn12157,65279906,79059372,13779466,RLP
chr03,Bn12158,8509180,20364429,11855249,NBS
chr03,Bn12159,47620996,83024686,35403690,RLP
chr03,Bn12160,37919784,46204801,8285017,RLP
chr03,Bn12161,30750833,71875480,41124647,TNL
chr03,Bn12162,54177207,90937909,36760702,CNL
chr03,Bn12163,44579494,46293229,1713735,TNL
chr03,Bn12164,27132574,54747312,27614738,RLP
chr03,Bn12165,67199469,82396652,15197183,TN
chr03,Bn12166,18046892,55846261,37799369,NBS
chr03,Bn12167,81561125,94388103,12826978,TNL
chr03,Bn12168,6089556,22023174,15933618,NBS
chr03,Bn12169,97086033,97777253,691220,RLP
chr03,Bn12170,53837948,79982370,26144422,RLP
chr03,Bn12171,81229794,99669119,18439325,CN
chr03,Bn12172,31043249,76788369,45745120,RLP
chr03,Bn12173,83636454,85865717,2229263,CNL
chr03,Bn12174,49327649,68961551,19633902,CNL
chr03,Bn12175,53738745,84292295,30553550,NBS
chr03,Bn12176,68686542,71426793,2740251,RLP
chr03,Bn12177,88250889,93240442,4989553,TN
chr03,Bn12178,97671880,99101843,1429963,TNL
chr03,Bn12179,72563753,96136797,23573044,TN
chr03,Bn12180,47841076,95226145,47385069,CNL
chr03,Bn12181,31240607,60716292,29475685,CN
chr03,Bn12182,86566911,90544917,3978006,NBS
chr03,Bn12183,52478353,90244484,37766131,RLP
chr03,Bn12184,21847030,94262052,72415022,CNL
chr03,Bn12185,91529727,97134655,5604928,RLP
chr03,Bn12186,51584177,97909721,46325544,RLK
chr03,Bn12187,8961164,81984469,73023305,TN
chr03,Bn12188,7499894,47399500,39899606,CN
chr03,Bn12189,53118234,89464936,36346702,NBS
chr03,Bn12190,38927526,72535271,33607745,CN
chr03,Bn12191,86810233,94033531,7223298,CNL
chr03,Bn12192,34121398,85429058,51307660,TNL
chr03,Bn12193,21174294,27343837,6169543,RLP
chr03,Bn12194,17567758,68166115,50598357,NBS
chr03,Bn12195,53825810,81297370,27471560,NBS
chr03,Bn12196,59007428,74362114,15354686,CN
chr03,Bn12197,51163988,99599790,48435802,CNL
chr03,Bn12198,96136781,96319637,182856,NBS
chr03,Bn12199,9281063,33923347,24642284,CNL
chr03,Bn12200,33012114,74164816,41152702,TN
chr03,Bn12201,58826714,74115660,15288946,TNL
chr03,Bn12202,8370242,45035819,36665577,TNL
chr03,Bn12203,4210746,60602278,56391532,NBS
chr03,Bn12204,50400023,98933542,48533519,TN
chr03,Bn12205,75025039,94601431,19576392,CNL
chr03,Bn12206,27479651,71284840,43805189,RLK
chr03,Bn12207,3837985,80063327,76225342,RLP
chr03,Bn12208,7051957,65432961,58381004,NBS
chr03,Bn12209,75183138,76135804,952666,CN
chr03,Bn12210,68928817,85231622,16302805,NBS
chr03,Bn12211,27071059,61928563,34857504,TN
chr03,Bn12212,15466064,29055370,13589306,RLK
chr03,Bn12213,55996715,79132886,23136171,CNL
chr03,Bn12214,33964354,87687997,53723643,RLK
chr03,Bn12215,5319650,84209054,78889404,CN
chr03,Bn12216,83433403,91527529,8094126,TNL
chr03,Bn12217,55533217,69591019,14057802,CN
chr03,Bn12218,54256519,63329332,9072813,RLK
chr03,Bn12219,97326789,99454083,2127294,CNL
chr03,Bn12220,24355459,56670433,32314974,TN
chr03,Bn12221,96569820,96589279,19459,TN
chr03,Bn12222,14305784,40771619,26465835,TN
chr03,Bn12223,70290223,75801754,5511531,CNL
chr03,Bn12224,84970055,99021824,14051769,RLP
chr03,Bn12225,13343315,27245592,13902277,CN
chr03,Bn12226,36272633,43739517,7466884,RLP
chr03,Bn12227,99312404,99881622,569218,TNL
chr03,Bn12228,35548779,40721616,5172837,TN
chr03,Bn12229,88260550,92623640,4363090,RLP
chr03,Bn12230,45444976,68535822,23090846,CNL
chr03,Bn12231,66750683,98406034,31655351,CN
chr03,Bn12232,49581643,90942723,41361080,CNL
chr03,Bn12233,89392123,96107007,6714884,RLP
chr03,Bn12234,99460664,99927394,466730,TNL
chr03,Bn12235,7150206,62855524,55705318,CNL
chr03,Bn12236,59452625,69229332,9776707,NBS
chr03,Bn12237,63987558,91297149,27309591,CN
chr03,Bn12238,14398471,24243767,9845296,TN
chr03,Bn12239,80713669,85499034,4785365,TNL
chr03,Bn12240,97067302,99069616,2002314,RLK
chr03,Bn12241,15340581,68591241,53250660,TNL
chr03,Bn12242,56415281,92609721,36194440,TN
chr03,Bn12243,51456708,59105233,7648525,CNL
chr03,Bn12244,6963767,95641047,88677280,CNL
chr03,Bn12245,82695771,82794061,98290,RLK
chr03,Bn12246,63513535,86743365,23229830,CN
chr03,Bn12247,90586252,96734678,6148426,TNL
chr03,Bn12248,66352913,86878672,20525759,CN
chr03,Bn12249,4016164,12263681,8247517,CN
chr03,Bn12250,89029400,96652271,7622871,TNL
chr03,Bn12251,98639279,99961367,1322088,CN
chr03,Bn12252,76450303,98553800,22103497,NBS
chr03,Bn12253,3867365,54663060,50795695,CNL
chr03,Bn12254,48328228,60811170,12482942,RLK
chr03,Bn12255,52240279,77865468,25625189,CNL
chr03,Bn12256,97468591,98477710,1009119,NBS
chr03,Bn12257,32611631,65836846,33225215,TNL
chr03,Bn12258,71021933,85855897,14833964,RLK
chr03,Bn12259,71242060,92766060,21524000,TNL
chr03,Bn12260,53180038,83842800,30662762,CN
chr03,Bn12261,94584740,98611077,4026337,NBS
chr03,Bn12262,6104387,80793382,74688995,RLK
chr03,Bn12263,58877801,89706981,30829180,RLK
chr03,Bn12264,90736215,99243144,8506929,TN
chr03,Bn12265,31442535,40921429,9478894,RLP
chr03,Bn12266,18536768,32707995,14171227,TN
chr03,Bn12267,24123429,93771377,69647948,TN
chr03,Bn12268,43855081,83352973,39497892,RLK
chr03,Bn12269,90539897,93978173,3438276,TNL
chr03,Bn12270,44365736,66119327,21753591,TNL
chr03,Bn12271,99755532,99975025,219493,CNL
chr03,Bn12272,21916732,94266935,72350203,TN
chr03,Bn12273,45294568,55287230,9992662,CNL
chr03,Bn12274,17686477,35344142,17657665,CN
chr03,Bn12275,25238625,33340450,8101825,CNL
chr03,Bn12276,46293180,68392329,22099149,TNL
chr03,Bn12277,8925593,40054456,31128863,NBS
chr03,Bn12278,33773290,50888477,17115187,TN
chr03,Bn12279,53009400,81002322,27992922,RLP
chr03,Bn12280,22027994,58750026,36722032,CN
chr03,Bn12281,65763385,96692024,30928639,CN
chr03,Bn12282,96539483,99953891,3414408,RLK
chr03,Bn12283,85664505,88168835,2504330,RLK
chr03,Bn12284,2328350,77468340,75139990,RLK
chr03,Bn12285,31966431,35675615,3709184,NBS
chr03,Bn12286,36700117,95385440,58685323,TNL
chr03,Bn12287,73141022,84888657,11747635,RLK
chr03,Bn12288,27419361,66215744,38796383,RLP
chr03,Bn12289,71100142,88213312,17113170,CN
chr03,Bn12290,34437620,68912066,34474446,RLK
chr03,Bn12291,70547332,99216112,28668780,TN
chr03,Bn12292,98915203,99301963,386760,CN
chr03,Bn12293,40160845,74870772,34709927,CNL
chr03,Bn12294,23178197,74588327,51410130,TN
chr03,Bn12295,48141129,66897214,18756085,NBS
chr03,Bn12296,18541383,54876370,36334987,RLK
chr03,Bn12297,75392132,95762821,20370689,RLP
chr03,Bn12298,28627565,71119157,42491592,CN
chr03,Bn12299,57007758,84305316,27297558,RLP
chr03,Bn12300,79808150,90857664,11049514,NBS
chr03,Bn12301,86842500,87668885,826385,TN
chr03,Bn12302,80087886,93130749,13042863,RLK
chr03,Bn12303,1250118,11791151,10541033,RLP
chr03,Bn12304,76665139,85633754,8968615,NBS
chr03,Bn12305,16355589,39631526,23275937,CN
chr03,Bn12306,16728756,39357611,22628855,RLK
chr03,Bn12307,70780001,74122819,3342818,TN
chr03,Bn12308,67427826,85233956,17806130,RLK
chr03,Bn12309,25976201,76175037,50198836,RLP
chr03,Bn12310,77859317,81513973,3654656,CNL
chr03,Bn12311,69627748,80093747,10465999,NBS
chr03,Bn12312,44628169,49994947,5366778,RLK
chr03,Bn12313,11174801,79737285,68562484,CN
chr03,Bn12314,64167324,84026727,19859403,TNL
chr03,Bn12315,84445644,98305449,13859805,TNL
chr03,Bn12316,78128198,93967198,15839000,TNL
chr03,Bn12317,36140813,97122313,60981500,RLK
chr03,Bn12318,21811961,88375088,66563127,CN
chr03,Bn12319,71423710,99386180,27962470,RLK
chr03,Bn12320,75665174,96590201,20925027,CNL
chr03,Bn12321,45894208,83743485,37849277,TN
chr03,Bn12322,55073338,90634329,35560991,CN
chr03,Bn12323,29094702,59739070,30644368,CNL
chr03,Bn12324,8111121,95942776,87831655,TNL
chr03,Bn12325,51172320,52753205,1580885,NBS
chr03,Bn12326,18233443,65395470,47162027,RLP
chr03,Bn12327,16054817,50374675,34319858,RLP
chr03,Bn12328,1746730,62045558,60298828,RLP
chr03,Bn12329,42291757,68733276,26441519,CNL
chr03,Bn12330,52660714,62669650,10008936,RLP
chr03,Bn12331,94032421,98189584,4157163,TNL
chr03,Bn12332,84834113,95837302,11003189,TNL
chr03,Bn12333,59099301,63809241,4709940,RLP
chr03,Bn12334,54561043,55188146,627103,RLP
chr03,Bn12335,51033906,95401557,44367651,TN
chr03,Bn12336,35123004,86998806,51875802,NBS
chr03,Bn12337,47804685,54125640,6320955,RLK
chr03,Bn12338,5116570,29815648,24699078,TN
chr03,Bn12339,24953568,88469452,63515884,NBS
chr03,Bn12340,44037959,71332203,27294244,CN
chr03,Bn12341,44942446,70100184,25157738,TNL
chr03,Bn12342,37321406,42958749,5637343,CNL
chr03,Bn12343,4774095,69407589,64633494,CN
chr03,Bn12344,20092593,53574253,33481660,CNL
chr03,Bn12345,60611530,67865002,7253472,TN
chr03,Bn12346,17532437,98604790,81072353,RLP
chr03,Bn12347,45931085,98535187,52604102,RLP
chr03,Bn12348,76962703,77507207,544504,CNL
chr03,Bn12349,47882875,72453129,24570254,CN
chr03,Bn12350,22361160,82435376,60074216,RLP
chr03,Bn12351,22499671,56885640,34385969,RLK
chr03,Bn12352,19382318,59920817,40538499,TNL
chr03,Bn12353,72635759,95631670,22995911,NBS
chr03,Bn12354,53122308,82702238,29579930,RLK
chr03,Bn12355,66761314,79425476,12664162,CN
chr03,Bn12356,84348749,84362666,13917,TNL
chr03,Bn12357,53881389,57555719,3674330,TN
chr03,Bn12358,53292546,71953035,18660489,CN
chr03,Bn12359,35082554,66335083,31252529,CNL
chr03,Bn12360,98699684,99012785,313101,TNL
chr03,Bn12361,30016899,52513145,22496246,TN
chr03,Bn12362,2995429,79919988,76924559,RLK
chr03,Bn12363,37039470,97064454,60024984,RLP
chr03,Bn12364,1714541,84322975,82608434,RLK
chr03,Bn12365,80978212,82162324,1184112,CN
chr03,Bn12366,51770482,64458612,12688130,NBS
chr03,Bn12367,15813289,87151783,71338494,CNL
chr03,Bn12368,49330790,61444553,12113763,RLP
chr03,Bn12369,16843792,72034898,55191106,NBS
chr03,Bn12370,64912185,83169737,18257552,NBS
chr03,Bn12371,26886063,86854057,59967994,NBS
chr03,Bn12372,62145672,80429668,18283996,CN
chr03,Bn12373,80777761,86992147,6214386,RLP
chr03,Bn12374,75513186,99455285,23942099,TN
chr03,Bn12375,79130100,87268459,8138359,RLK
chr03,Bn12376,80031138,99879074,19847936,CNL
chr03,Bn12377,14574549,55934268,41359719,CN
chr03,Bn12378,86768544,89011462,2242918,TN
chr03,Bn12379,27406423,42698118,15291695,TN
chr03,Bn12380,18488667,93749355,75260688,RLK
chr03,Bn12381,72604972,80171176,7566204,TN
chr03,Bn12382,24171890,45800119,21628229,NBS
chr03,Bn12383,53528929,85301975,31773046,TN
chr03,Bn12384,59024996,75381457,16356461,CNL
chr03,Bn12385,20895060,49151023,28255963,CNL
chr03,Bn12386,16886259,56657689,39771430,TN
chr03,Bn12387,7247387,43129597,35882210,TNL
chr03,Bn12388,75160638,95538377,20377739,NBS
chr03,Bn12389,6842239,37223021,30380782,CN
chr03,Bn12390,26646090,48419127,21773037,TNL
chr03,Bn12391,27873488,41881896,14008408,RLP
chr03,Bn12392,58336365,69676434,11340069,CNL
chr03,Bn12393,4223529,66170944,61947415,TN
chr03,Bn12394,65027209,98899500,33872291,TN
chr03,Bn12395,58976717,99881484,40904767,CNL
chr03,Bn12396,17686401,24668852,6982451,TNL
chr03,Bn12397,94935725,99350652,4414927,RLP
chr03,Bn12398,79935474,85334074,5398600,RLP
chr03,Bn12399,52405181,99588534,47183353,TN
chr03,Bn12400,39076421,85588689,46512268,NBS
chr03,Bn12401,15682055,69736836,54054781,TN
chr03,Bn12402,12787527,84754382,71966855,TNL
chr03,Bn12403,72847811,74804490,1956679,RLK
chr03,Bn12404,23016447,44980766,21964319,TN
chr03,Bn12405,71494760,85010114,13515354,RLK
chr03,Bn12406,89340703,92594566,3253863,TNL
chr03,Bn12407,91062440,96470712,5408272,RLK
chr03,Bn12408,35815267,47087760,11272493,RLP
chr03,Bn12409,36550388,50032282,13481894,CNL
chr03,Bn12410,91696826,95575170,3878344,TN
chr03,Bn12411,52877314,93320112,40442798,TNL
chr03,Bn12412,40689566,62635315,21945749,TN
chr03,Bn12413,74277153,74794458,517305,TNL
chr03,Bn12414,79468999,87594051,8125052,CNL
chr03,Bn12415,40814753,50191920,9377167,RLP
chr03,Bn12416,44875382,69751901,24876519,RLP
chr03,Bn12417,92691872,98307149,5615277,NBS
chr03,Bn12418,12540210,97960453,85420243,CNL
chr03,Bn12419,46124060,63910287,17786227,TN
chr03,Bn12420,44589054,98260301,53671247,NBS
chr03,Bn12421,42057619,43096172,1038553,TNL
chr03,Bn12422,64590031,76834345,12244314,NBS
chr03,Bn12423,72363531,96178037,23814506,CNL
chr03,Bn12424,66739831,89080507,22340676,CN
chr03,Bn12425,65316463,87184514,21868051,CNL
chr03,Bn12426,52450791,85569039,33118248,TN
chr03,Bn12427,81405748,84371324,2965576,TNL
chr03,Bn12428,57609515,95678430,38068915,RLP
chr03,Bn12429,40290852,42619192,2328340,RLK
chr03,Bn12430,94295791,95552949,1257158,CNL
chr03,Bn12431,89061417,96307246,7245829,RLP
chr03,Bn12432,51108239,73160157,22051918,CNL
chr03,Bn12433,47549464,76525632,28976168,CN
chr03,Bn12434,4397866,32760166,28362300,TN
chr03,Bn12435,56306205,93343952,37037747,NBS
chr03,Bn12436,7517397,52329987,44812590,TN
chr03,Bn12437,63213737,90995832,27782095,RLP
chr03,Bn12438,14952509,53599992,38647483,RLK
chr03,Bn12439,90257620,98137453,7879833,CNL
chr03,Bn12440,21520025,23768441,2248416,RLP
chr03,Bn12441,84649434,97773359,13123925,NBS
chr03,Bn12442,26937241,33566091,6628850,NBS
chr03,Bn12443,6173218,34286440,28113222,TNL
chr03,Bn12444,23264924,80172258,56907334,RLP
chr03,Bn12445,41255287,97410312,56155025,CNL
chr03,Bn12446,24576298,39593832,15017534,RLP
chr03,Bn12447,78114080,89213810,11099730,RLP
chr03,Bn12448,39533540,41926828,2393288,RLK
chr03,Bn12449,71612629,80259951,8647322,CNL
chr03,Bn12450,3051482,40439534,37388052,RLP
chr03,Bn12451,99886257,99887314,1057,NBS
chr03,Bn12452,31451526,88611812,57160286,CNL
chr03,Bn12453,15459501,63983949,48524448,TNL
chr03,Bn12454,91921215,97784982,5863767,RLK
chr03,Bn12455,83634719,93350501,9715782,RLP
chr03,Bn12456,71750685,93785845,22035160,NBS
chr03,Bn12457,68328964,80326824,11997860,CN
chr03,Bn12458,1991330,58490864,56499534,RLP
chr03,Bn12459,16921212,48765770,31844558,NBS
chr03,Bn12460,22683894,90341798,67657904,RLK
chr03,Bn12461,85851289,97707634,11856345,RLP
chr03,Bn12462,47718866,92555730,44836864,TN
chr03,Bn12463,70567351,78792101,8224750,RLP
chr03,Bn12464,97347912,97670316,322404,RLK
chr03,Bn12465,28887350,94553401,65666051,NBS
chr03,Bn12466,42997591,76022931,33025340,CNL
chr03,Bn12467,63051883,68283878,5231995,RLK
chr03,Bn12468,83358573,86080910,2722337,RLP
chr03,Bn12469,51233611,90303845,39070234,CNL
chr03,Bn12470,40882895,88501029,47618134,TNL
chr03,Bn12471,79326288,96445816,17119528,TNL
chr03,Bn12472,89219878,94246232,5026354,RLP
chr03,Bn12473,38480962,76828835,38347873,RLK
chr03,Bn12474,99828153,99908166,80013,TNL
chr03,Bn12475,70397192,83237282,12840090,RLP
chr03,Bn12476,46940212,96112914,49172702,RLP
chr03,Bn12477,18741646,97497839,78756193,NBS
chr03,Bn12478,9152823,10670812,1517989,CNL
chr03,Bn12479,8126243,74698392,66572149,CNL
chr03,Bn12480,19893106,90579578,70686472,TN
chr03,Bn12481,51128498,80778402,29649904,RLP
chr03,Bn12482,43429252,51085867,7656615,CN
chr03,Bn12483,44000158,69143985,25143827,CNL
chr03,Bn12484,6681521,14216001,7534480,CN
chr03,Bn12485,83696157,99054608,15358451,TNL
chr03,Bn12486,1321063,86196718,84875655,CN
chr03,Bn12487,92129099,93298729,1169630,TN
chr03,Bn12488,72277043,92707363,20430320,NBS
chr03,Bn12489,35861379,54323273,18461894,CN
chr03,Bn12490,19495711,36334552,16838841,TNL
chr03,Bn12491,96402459,98024960,1622501,CN
chr03,Bn12492,2851129,30394441,27543312,CN
chr03,Bn12493,21199447,89159348,67959901,CN
chr03,Bn12494,47001507,53387810,6386303,CN
chr03,Bn12495,70444547,71803599,1359052,RLP
chr03,Bn12496,7019972,16300115,9280143,CN
chr03,Bn12497,72032621,93774000,21741379,CNL
chr03,Bn12498,26975130,71526809,44551679,NBS
chr03,Bn12499,15551985,86173240,70621255,NBS
chr03,Bn12500,96650532,99950524,3299992,NBS
chr03,Bn12501,11327068,61493506,50166438,CN
chr03,Bn12502,51057825,99114772,48056947,TNL
chr03,Bn12503,54152753,89312197,35159444,TN
chr03,Bn12504,89979819,94432104,4452285,RLP
chr03,Bn12505,25941849,65305779,39363930,NBS
chr03,Bn12506,36411515,95211089,58799574,TN
chr03,Bn12507,39934014,76272915,36338901,CN
chr03,Bn12508,65021520,71157672,6136152,TN
chr03,Bn12509,75622654,78678903,3056249,RLK
chr03,Bn12510,79964554,99153099,19188545,RLP
chr03,Bn12511,64981558,71647541,6665983,RLK
chr03,Bn12512,41150465,63486743,22336278,RLK
chr03,Bn12513,11587291,25155634,13568343,TN
chr03,Bn12514,3227602,11578532,8350930,TNL
chr03,Bn12515,39786176,68989165,29202989,TNL
chr03,Bn12516,31990552,73241881,41251329,CNL
chr03,Bn12517,16206485,83262838,67056353,CN
chr03,Bn12518,28904658,94818338,65913680,RLP
chr03,Bn12519,79525336,80519988,994652,RLK
chr03,Bn12520,26408054,40269998,13861944,TN
chr03,Bn12521,64602311,85128175,20525864,CNL
chr03,Bn12522,69425200,86874594,17449394,RLP
chr03,Bn12523,55545554,60493970,4948416,TN
chr03,Bn12524,43614075,46979246,3365171,RLP
chr03,Bn12525,32298274,49922042,17623768,TN
chr03,Bn12526,44295835,95786457,51490622,TNL
chr03,Bn12527,44695327,82097849,37402522,RLK
chr03,Bn12528,65754905,76681708,10926803,RLP
chr03,Bn12529,54798770,58731404,3932634,CNL
chr03,Bn12530,78477013,93841498,15364485,RLK
chr03,Bn12531,95816658,96496480,679822,RLP
chr03,Bn12532,36433096,51428668,14995572,RLK
chr03,Bn12533,77826769,91323550,13496781,TNL
chr03,Bn12534,73666918,94727514,21060596,CN
chr03,Bn12535,10835510,34600478,23764968,TN
chr03,Bn12536,16534101,81218944,64684843,TNL
chr03,Bn12537,87315520,94693525,7378005,RLK
chr03,Bn12538,99697863,99931327,233464,CN
chr03,Bn12539,45034228,90294410,45260182,RLK
chr03,Bn12540,42232959,52734461,10501502,NBS
chr03,Bn12541,51773850,82445074,30671224,CNL
chr03,Bn12542,12448474,18513505,6065031,NBS
chr03,Bn12543,76658061,78392143,1734082,RLK
chr03,Bn12544,3455941,58123476,54667535,CNL
chr03,Bn12545,97510588,98229572,718984,CNL
chr03,Bn12546,46682640,89144136,42461496,RLK
chr03,Bn12547,55805195,88312909,32507714,NBS
chr03,Bn12548,89476249,99881873,10405624,CN
chr03,Bn12549,47555960,93196094,45640134,TN
chr03,Bn12550,98271780,98932802,661022,TNL
chr03,Bn12551,4352948,81398264,77045316,RLP
chr03,Bn12552,41113478,78786238,37672760,TNL
chr03,Bn12553,67559650,83610185,16050535,CNL
chr03,Bn12554,4648495,6980323,2331828,CN
chr03,Bn12555,74333823,79276894,4943071,RLP
chr03,Bn12556,56857545,71604810,14747265,RLK
chr03,Bn12557,54864467,70878324,16013857,NBS
chr03,Bn12558,12648760,52578184,39929424,CN
chr03,Bn12559,26697080,60180077,33482997,CNL
chr03,Bn12560,43605388,67769448,24164060,CNL
chr03,Bn12561,29532987,93002556,63469569,TN
chr03,Bn12562,43743749,81381699,37637950,TNL
chr03,Bn12563,32920733,69123918,36203185,RLK
chr03,Bn12564,58985700,89236156,30250456,RLK
chr03,Bn12565,84342468,89225621,4883153,RLK
chr03,Bn12566,57760814,79050964,21290150,RLK
chr03,Bn12567,27653935,47399901,19745966,TNL
chr03,Bn12568,40877724,71361099,30483375,TNL
chr03,Bn12569,25728378,93935138,68206760,TNL
chr03,Bn12570,24893310,38226433,13333123,CNL
chr03,Bn12571,92453408,97709880,5256472,CN
chr03,Bn12572,90453396,92100403,1647007,NBS
chr03,Bn12573,65492530,70619799,5127269,NBS
chr03,Bn12574,69777212,83879280,14102068,RLK
chr03,Bn12575,76714302,90682131,13967829,NBS
chr03,Bn12576,41934854,69988857,28054003,NBS
chr03,Bn12577,11351657,44463986,33112329,NBS
chr03,Bn12578,92558597,97862168,5303571,CNL
chr03,Bn12579,5605172,86210819,80605647,TNL
chr03,Bn12580,2402392,43066930,40664538,CN
chr03,Bn12581,43585570,54509110,10923540,TN
chr03,Bn12582,32785265,82287626,49502361,RLK
chr03,Bn12583,63805080,80421252,16616172,RLP
chr03,Bn12584,14794157,60786616,45992459,TNL
chr03,Bn12585,8032912,22168301,14135389,RLK
chr03,Bn12586,79034663,80338993,1304330,TN
chr03,Bn12587,67561569,94032452,26470883,RLP
chr03,Bn12588,55606472,97919830,42313358,RLK
chr03,Bn12589,41668683,78129248,36460565,TN
chr03,Bn12590,25787573,41429537,15641964,CNL
chr03,Bn12591,55675640,81374453,25698813,TN
chr03,Bn12592,72442793,84181777,11738984,NBS
chr03,Bn12593,34109403,37160662,3051259,RLP
chr03,Bn12594,83029574,88810749,5781175,CN
chr03,Bn12595,51898740,99458504,47559764,TNL
chr03,Bn12596,25945827,36918080,10972253,TN
chr03,Bn12597,65219778,96704560,31484782,NBS
chr03,Bn12598,50879512,60009014,9129502,TNL
chr03,Bn12599,83142344,92077253,8934909,CN
chr03,Bn12600,84830569,88387314,3556745,NBS
chr03,Bn12601,93655017,97075871,3420854,CN
chr03,Bn12602,11796980,62369348,50572368,RLK
chr03,Bn12603,79838092,90376394,10538302,CNL
chr03,Bn12604,92128385,96287706,4159321,NBS
chr03,Bn12605,37799239,65962913,28163674,RLP
chr03,Bn12606,1249631,39973076,38723445,RLK
chr03,Bn12607,97027310,98066917,1039607,RLP
chr03,Bn12608,27546708,59341994,31795286,CNL
chr03,Bn12609,95239514,98394897,3155383,RLP
chr03,Bn12610,33695677,47504182,13808505,CN
chr03,Bn12611,18777092,30485736,11708644,RLP
chr03,Bn12612,37850602,66852897,29002295,TN
chr03,Bn12613,62512874,64436403,1923529,CN
chr03,Bn12614,50355031,93825236,43470205,TNL
chr03,Bn12615,63931760,89974514,26042754,RLP
chr03,Bn12616,40952963,70964917,30011954,NBS
chr03,Bn12617,89663628,96770974,7107346,RLK
chr03,Bn12618,50179677,63391001,13211324,CNL
chr03,Bn12619,22637228,36447480,13810252,CN
chr03,Bn12620,17158354,43542340,26383986,CNL
chr03,Bn12621,51267830,81128475,29860645,CNL
chr03,Bn12622,56158750,92167047,36008297,CNL
chr03,Bn12623,32327999,95914015,63586016,TN
chr03,Bn12624,12210407,35047627,22837220,TN
chr03,Bn12625,60730933,97078626,36347693,CN
chr03,Bn12626,80834950,96482521,15647571,TN
chr03,Bn12627,80905942,88145143,7239201,CN
chr03,Bn12628,46714603,61382068,14667465,RLP
chr03,Bn12629,33129162,85090443,51961281,RLP
chr03,Bn12630,53826070,60096511,6270441,TN
chr03,Bn12631,7546986,89927016,82380030,CN
chr03,Bn12632,30319245,68634736,38315491,TN
chr03,Bn12633,89257492,97257714,8000222,NBS
chr03,Bn12634,5516791,89967708,84450917,CNL
chr03,Bn12635,64225169,98360286,34135117,RLK
chr03,Bn12636,44912083,72189916,27277833,RLK
chr03,Bn12637,93722976,96096533,2373557,RLP
chr03,Bn12638,76672601,78396201,1723600,TN
chr03,Bn12639,15754739,20151849,4397110,CNL
chr03,Bn12640,76766414,94541245,17774831,RLK
chr03,Bn12641,69092645,97800852,28708207,TN
chr03,Bn12642,56976259,76168175,19191916,CN
chr03,Bn12643,68504242,81186192,12681950,RLK
chr03,Bn12644,6466646,85563914,79097268,TNL
chr03,Bn12645,79481194,89081331,9600137,CNL
chr03,Bn12646,44955859,58537586,13581727,CNL
chr03,Bn12647,2222317,95687549,93465232,CN
chr03,Bn12648,89495499,97552736,8057237,RLP
chr03,Bn12649,49252457,58951911,9699454,RLP
chr03,Bn12650,60266767,66004915,5738148,CNL
chr03,Bn12651,19123296,61450173,42326877,CN
chr03,Bn12652,27136590,88226517,61089927,NBS
chr03,Bn12653,67556350,85527585,17971235,TN
chr03,Bn12654,91390625,93610972,2220347,RLP
chr03,Bn12655,36189366,43849074,7659708,TNL
chr03,Bn12656,89650891,95281679,5630788,CNL
chr03,Bn12657,52085810,60645466,8559656,CN
chr03,Bn12658,18088951,79538888,61449937,NBS
chr03,Bn12659,29302456,29719788,417332,RLK
chr03,Bn12660,24132970,73266566,49133596,RLP
chr03,Bn12661,86004380,96886669,10882289,TN
chr03,Bn12662,18405529,45057912,26652383,TNL
chr03,Bn12663,31516873,46452588,14935715,RLK
chr03,Bn12664,65081170,82832343,17751173,NBS
chr03,Bn12665,46631445,99870786,53239341,RLK
chr03,Bn12666,86197943,91097497,4899554,CN
chr03,Bn12667,88471347,88945487,474140,TNL
chr03,Bn12668,16959819,73463365,56503546,RLP
chr03,Bn12669,77893732,97998843,20105111,RLP
chr03,Bn12670,91048125,91087832,39707,RLP
chr03,Bn12671,28784764,94042396,65257632,RLP
chr03,Bn12672,82814628,87058528,4243900,NBS
chr03,Bn12673,77729070,97661219,19932149,RLP
chr03,Bn12674,46872113,56464546,9592433,CN
chr03,Bn12675,82191338,95994231,13802893,RLP
chr03,Bn12676,68551573,71416309,2864736,RLP
chr03,Bn12677,10857502,86844120,75986618,TNL
chr03,Bn12678,5478748,12006402,6527654,TN
chr03,Bn12679,43249971,73908088,30658117,CNL
chr03,Bn12680,7265134,15768169,8503035,RLP
chr03,Bn12681,78054609,79386797,1332188,RLK
chr03,Bn12682,51742092,63845608,12103516,CNL
chr03,Bn12683,37686871,52852753,15165882,CNL
chr03,Bn12684,4828011,19198736,14370725,CN
chr03,Bn12685,83308493,91094210,7785717,CNL
chr03,Bn12686,20133408,64293562,44160154,CN
chr03,Bn12687,68687534,97431070,28743536,CNL
chr03,Bn12688,16303963,61028728,44724765,CN
chr03,Bn12689,89963794,95032398,5068604,TN
chr03,Bn12690,2661637,36966512,34304875,TN
chr03,Bn12691,76071017,85619342,9548325,RLP
chr03,Bn12692,89755835,90480275,724440,TN
chr03,Bn12693,82578943,85806521,3227578,NBS
chr03,Bn12694,45226240,51176640,5950400,TN
chr03,Bn12695,63160358,82798773,19638415,NBS
chr03,Bn12696,59405597,65269655,5864058,CNL
chr03,Bn12697,8787039,43292139,34505100,RLP
chr03,Bn12698,4362822,64540509,60177687,CN
chr03,Bn12699,24776813,42665248,17888435,TNL
chr03,Bn12700,89644115,99262858,9618743,CN
chr03,Bn12701,48880541,96806920,47926379,RLK
chr03,Bn12702,46009425,95668391,49658966,RLP
chr03,Bn12703,44337806,82187110,37849304,TN
chr03,Bn12704,60085165,80388977,20303812,CN
chr03,Bn12705,52484729,80890648,28405919,CN
chr03,Bn12706,55414954,94015132,38600178,TN
chr03,Bn12707,95713240,97288786,1575546,CN
chr03,Bn12708,49715418,64055108,14339690,CN
chr03,Bn12709,29777096,46947200,17170104,RLK
chr03,Bn12710,37643215,71919773,34276558,CN
chr03,Bn12711,74971797,89772054,14800257,CN
chr03,Bn12712,2150838,46436333,44285495,TN
chr03,Bn12713,70479077,77999786,7520709,RLP
chr03,Bn12714,59773459,95073661,35300202,CN
chr03,Bn12715,95688840,97748282,2059442,RLP
chr03,Bn12716,19367873,70263257,50895384,NBS
chr03,Bn12717,63030727,65563303,2532576,RLP
chr03,Bn12718,59312871,68197191,8884320,CNL
chr03,Bn12719,27002512,42708536,15706024,TNL
chr03,Bn12720,34199437,57406928,23207491,NBS
chr03,Bn12721,41982181,77285768,35303587,NBS
chr03,Bn12722,37263456,79804079,42540623,RLK
chr03,Bn12723,60714830,79733549,19018719,RLP
chr03,Bn12724,54555321,74096548,19541227,RLP
chr03,Bn12725,50594848,88233237,37638389,NBS
chr03,Bn12726,9597369,80428130,70830761,NBS
chr03,Bn12727,45177404,82264126,37086722,TNL
chr03,Bn12728,43477971,59915575,16437604,CNL
chr03,Bn12729,88899671,99327399,10427728,TNL
chr03,Bn12730,27890136,60557486,32667350,TN
chr03,Bn12731,50899539,58168568,7269029,CN
chr03,Bn12732,11408118,70805642,59397524,CN
chr03,Bn12733,67455109,92760676,25305567,NBS
chr03,Bn12734,13775355,95386343,81610988,TNL
chr03,Bn12735,78139882,95250613,17110731,RLP
chr03,Bn12736,83539389,90792629,7253240,TNL
chr03,Bn12737,99066002,99147602,81600,RLP
chr03,Bn12738,15784835,99192633,83407798,TNL
chr03,Bn12739,50368289,64147648,13779359,NBS
chr03,Bn12740,58017583,65518702,7501119,RLK
chr03,Bn12741,53945513,94162341,40216828,CN
chr03,Bn12742,91646025,98242560,6596535,RLP
chr03,Bn12743,40046258,40378128,331870,CNL
chr03,Bn12744,49785508,83660102,33874594,CNL
chr03,Bn12745,41982199,92530931,50548732,CNL
chr03,Bn12746,11146530,25606147,14459617,CN
chr03,Bn12747,62076491,91552122,29475631,CN
chr03,Bn12748,59301772,89299927,29998155,CNL
chr03,Bn12749,1933980,2330411,396431,CN
chr03,Bn12750,21472029,64870529,43398500,RLP
chr03,Bn12751,14379304,78496071,64116767,CN
chr03,Bn12752,51098572,66063905,14965333,TNL
chr03,Bn12753,59869548,87396691,27527143,RLK
chr03,Bn12754,28164004,37777077,9613073,RLP
chr03,Bn12755,21767683,43617785,21850102,NBS
chr03,Bn12756,98468652,99176247,707595,RLK
chr03,Bn12757,67757592,89852583,22094991,RLK
chr03,Bn12758,28019985,49473949,21453964,TN
chr03,Bn12759,62087620,64976990,2889370,RLP
chr03,Bn12760,96260621,99581227,3320606,RLK
chr03,Bn12761,49939221,56303128,6363907,RLP
chr03,Bn12762,39941340,80251378,40310038,TNL
chr03,Bn12763,71316032,89744508,18428476,TNL
chr03,Bn12764,18539365,91157048,72617683,CNL
chr03,Bn12765,63607243,91404908,27797665,TN
chr03,Bn12766,78033513,93845670,15812157,NBS
chr03,Bn12767,38466603,81323627,42857024,CN
chr03,Bn12768,52289426,93962040,41672614,TNL
chr03,Bn12769,77598253,93387572,15789319,TN
chr03,Bn12770,26751066,44998051,18246985,RLP
chr03,Bn12771,22412922,61527380,39114458,CN
chr03,Bn12772,95345902,96411707,1065805,RLP
chr03,Bn12773,49552722,62412738,12860016,RLK
chr03,Bn12774,98418970,99756292,1337322,NBS
chr03,Bn12775,23724405,71471812,47747407,CN
chr03,Bn12776,26126473,80149841,54023368,TN
chr03,Bn12777,44595823,71360878,26765055,TN
chr03,Bn12778,61815208,67413359,5598151,TN
chr03,Bn12779,64325316,98665021,34339705,CNL
chr03,Bn12780,68686945,84156021,15469076,RLP
chr03,Bn12781,94014609,94341439,326830,TNL
chr03,Bn12782,56396845,71016416,14619571,CN
chr03,Bn12783,73987423,90002015,16014592,CNL
chr03,Bn12784,19451249,58172212,38720963,RLP
chr03,Bn12785,97739926,99312669,1572743,TN
chr03,Bn12786,55608468,79794596,24186128,NBS
chr03,Bn12787,15571450,46627774,31056324,TNL
chr03,Bn12788,55379233,96883515,41504282,CNL
chr03,Bn12789,37110613,85983871,48873258,TN
chr03,Bn12790,77130641,90684815,13554174,CN
chr03,Bn12791,30275273,81034784,50759511,TNL
chr03,Bn12792,65308903,88920785,23611882,TN
chr03,Bn12793,3500089,30862280,27362191,TN
chr03,Bn12794,31632064,99131991,67499927,NBS
chr03,Bn12795,89753525,89912953,159428,CNL
chr03,Bn12796,24439504,69141037,44701533,TNL
chr03,Bn12797,27412308,78507238,51094930,NBS
chr03,Bn12798,61554043,85898126,24344083,TN
chr03,Bn12799,37447936,99931669,62483733,NBS
chr03,Bn12800,11173674,74258851,63085177,CN
chr03,Bn12801,48072925,66606244,18533319,TN
chr03,Bn12802,93163431,98417105,5253674,RLP
chr03,Bn12803,5075187,60435398,55360211,NBS
chr03,Bn12804,31135876,46355336,15219460,NBS
chr03,Bn12805,37391821,52882687,15490866,TN
chr03,Bn12806,31286500,48122529,16836029,TNL
chr03,Bn12807,64006780,73143779,9136999,RLP
chr03,Bn12808,41402841,61117555,19714714,TNL
chr03,Bn12809,90772540,90853874,81334,TNL
chr03,Bn12810,58861013,87469047,28608034,RLP
chr03,Bn12811,83512193,93737532,10225339,CNL
chr03,Bn12812,1366459,6732601,5366142,CNL
chr03,Bn12813,10674549,77884231,67209682,TN
chr03,Bn12814,92122723,95205294,3082571,RLK
chr03,Bn12815,39742390,97153971,57411581,TN
chr03,Bn12816,68193772,74676812,6483040,CN
chr03,Bn12817,44509464,71285962,26776498,RLP
chr03,Bn12818,21150734,54835544,33684810,RLP
chr03,Bn12819,55488306,74364012,18875706,CNL
chr03,Bn12820,79858664,99301900,19443236,NBS
chr03,Bn12821,82121129,93949675,11828546,NBS
chr03,Bn12822,21879780,62145636,40265856,CN
chr03,Bn12823,80167896,88210172,8042276,CN
chr03,Bn12824,24072849,31045546,6972697,TN
chr03,Bn12825,43360035,73033475,29673440,RLK
chr03,Bn12826,66028985,67388600,1359615,NBS
chr03,Bn12827,12308171,17128840,4820669,RLK
chr03,Bn12828,66203867,80997238,14793371,TNL
chr03,Bn12829,85035030,90677553,5642523,TNL
chr03,Bn12830,56906127,87974467,31068340,TN
chr03,Bn12831,94631440,96880273,2248833,RLP
chr03,Bn12832,14544497,81695861,67151364,CNL
chr03,Bn12833,36340552,53561824,17221272,CN
chr03,Bn12834,1530072,74098608,72568536,CN
chr03,Bn12835,47492562,96249314,48756752,CN
chr03,Bn12836,32330225,63822062,31491837,CN
chr03,Bn12837,63719797,77800740,14080943,CNL
chr03,Bn12838,62510131,63183069,672938,RLP
chr03,Bn12839,97299632,98939831,1640199,TNL
chr03,Bn12840,54791960,71133275,16341315,NBS
chr03,Bn12841,44314709,91251423,46936714,NBS
chr03,Bn12842,92404567,93603129,1198562,CN
chr03,Bn12843,1267842,71722843,70455001,CN
chr03,Bn12844,69310401,71631416,2321015,CN
chr03,Bn12845,80919192,90037671,9118479,TNL
chr03,Bn12846,19145493,95636499,76491006,NBS
chr03,Bn12847,49512173,93074947,43562774,RLP
chr03,Bn12848,67087553,91622225,24534672,NBS
chr03,Bn12849,34207683,77337297,43129614,NBS
chr03,Bn12850,56738929,93794141,37055212,CNL
chr03,Bn12851,66491173,80103563,13612390,NBS
chr03,Bn12852,66703431,83437463,16734032,RLK
chr03,Bn12853,10035992,34270587,24234595,NBS
chr03,Bn12854,16946112,90126515,73180403,RLP
chr03,Bn12855,11489667,38901489,27411822,RLP
chr03,Bn12856,12633067,84461499,71828432,NBS
chr03,Bn12857,95973734,99872549,3898815,TN
chr03,Bn12858,68154139,98887449,30733310,CNL
chr03,Bn12859,93528149,94995347,1467198,TNL
chr03,Bn12860,50335060,68304232,17969172,CNL
chr03,Bn12861,87646368,93660467,6014099,TNL
chr03,Bn12862,25570827,55552300,29981473,RLK
chr03,Bn12863,43005739,86160275,43154536,TN
chr03,Bn12864,79293842,95245069,15951227,NBS
chr03,Bn12865,74788002,91446792,16658790,TN
chr03,Bn12866,34469530,91648431,57178901,NBS
chr03,Bn12867,15308064,41655296,26347232,RLP
chr03,Bn12868,52029418,60492048,8462630,RLK
chr03,Bn12869,17886848,85998182,68111334,CN
chr03,Bn12870,75253811,96811270,21557459,TNL
chr03,Bn12871,61295313,68724917,7429604,TN
chr03,Bn12872,45120069,65374556,20254487,NBS
chr03,Bn12873,72931443,80134520,7203077,TN
chr03,Bn12874,37124539,72494766,35370227,RLP
chr03,Bn12875,24811568,66173174,41361606,NBS
chr03,Bn12876,45300557,60488760,15188203,RLP
chr03,Bn12877,83762156,92513587,8751431,CNL
chr03,Bn12878,80034945,86404543,6369598,RLP
chr03,Bn12879,16884218,75939643,59055425,NBS
chr03,Bn12880,42714266,62414226,19699960,NBS
chr03,Bn12881,71049603,82173097,11123494,RLK
chr03,Bn12882,52241693,73534340,21292647,RLP
chr03,Bn12883,6516266,38962016,32445750,TNL
chr03,Bn12884,35463171,82468999,47005828,TNL
chr03,Bn12885,72198437,85552531,13354094,RLP
chr03,Bn12886,27081267,59874683,32793416,CN
chr03,Bn12887,85617469,99176627,13559158,NBS
chr03,Bn12888,79553693,84366601,4812908,TN
chr03,Bn12889,53920191,96536536,42616345,RLK
chr03,Bn12890,42649262,82956501,40307239,TN
chr03,Bn12891,44283896,64065534,19781638,RLK
chr03,Bn12892,27437135,59633424,32196289,CNL
chr03,Bn12893,53664063,94623929,40959866,CNL
chr03,Bn12894,62070152,85543122,23472970,CNL
chr03,Bn12895,13739597,30995194,17255597,RLP
chr03,Bn12896,74093900,82136332,8042432,TNL
chr03,Bn12897,47562862,51187811,3624949,RLK
chr03,Bn12898,75391986,99627655,24235669,TN
chr03,Bn12899,8549763,85626263,77076500,NBS
chr03,Bn12900,99953829,99982164,28335,CNL
chr03,Bn12901,21070618,88468414,67397796,TN
chr03,Bn12902,50897628,93044476,42146848,RLP
chr03,Bn12903,59047497,81639779,22592282,RLP
chr03,Bn12904,80581568,96839720,16258152,NBS
chr03,Bn12905,40836128,57986898,17150770,CN
chr03,Bn12906,81693925,95427718,13733793,CNL
chr03,Bn12907,3253273,99407459,96154186,RLP
chr03,Bn12908,67199456,81098610,13899154,CNL
chr03,Bn12909,11309011,20676930,9367919,RLK
chr03,Bn12910,38899314,87243816,48344502,TNL
chr03,Bn12911,60892112,67071494,6179382,TNL
chr03,Bn12912,29538477,33389721,3851244,TNL
chr03,Bn12913,57013060,76497399,19484339,RLK
chr03,Bn12914,54246795,70306659,16059864,TN
chr03,Bn12915,24056646,48971924,24915278,CNL
chr03,Bn12916,65044113,91255878,26211765,CN
chr03,Bn12917,48767121,72224153,23457032,CNL
chr03,Bn12918,61682948,96881906,35198958,TN
chr03,Bn12919,35233953,49258638,14024685,RLP
chr03,Bn12920,97771247,99151398,1380151,CN
chr03,Bn12921,2839462,35824986,32985524,TNL
chr03,Bn12922,68841605,99277654,30436049,NBS
chr03,Bn12923,28900122,29200852,300730,RLP
chr03,Bn12924,13257139,84517649,71260510,TNL
chr03,Bn12925,59626724,64155977,4529253,TNL
chr03,Bn12926,74366620,93838217,19471597,TNL
chr03,Bn12927,31457761,42877127,11419366,TNL
chr03,Bn12928,44880143,80974862,36094719,CNL
chr03,Bn12929,76470132,99919805,23449673,CNL
chr03,Bn12930,63953327,99111560,35158233,RLK
chr03,Bn12931,77009207,86384853,9375646,RLK
chr03,Bn12932,91553972,93206104,1652132,RLP
chr03,Bn12933,53961950,78147644,24185694,RLP
chr03,Bn12934,70544514,73923911,3379397,NBS
chr03,Bn12935,6815812,19279577,12463765,TNL
chr03,Bn12936,16600472,58060619,41460147,NBS
chr03,Bn12937,61275777,91433508,30157731,CNL
chr03,Bn12938,34717493,81227913,46510420,CNL
chr03,Bn12939,92153784,97380156,5226372,CNL
chr03,Bn12940,57813779,99002775,41188996,NBS
chr03,Bn12941,44229988,97149721,52919733,CNL
chr03,Bn12942,31855519,39144752,7289233,CNL
chr03,Bn12943,3369576,79850694,76481118,NBS
chr03,Bn12944,67504925,75453337,7948412,TNL
chr03,Bn12945,12749543,44840726,32091183,TNL
chr03,Bn12946,10373124,37926122,27552998,TNL
chr03,Bn12947,25004139,52571528,27567389,RLK
chr03,Bn12948,45263692,85865133,40601441,CNL
chr03,Bn12949,1549171,50336654,48787483,RLK
chr03,Bn12950,16613941,57923635,41309694,TNL
chr03,Bn12951,50005018,62266871,12261853,NBS
chr03,Bn12952,65448801,71454604,6005803,TN
chr03,Bn12953,73496693,74628391,1131698,RLK
chr03,Bn12954,91851949,92477774,625825,CN
chr03,Bn12955,97882154,98059884,177730,CNL
chr03,Bn12956,72618688,92177317,19558629,TN
chr03,Bn12957,79662518,98532740,18870222,RLK
chr03,Bn12958,1117118,79350348,78233230,TN
chr03,Bn12959,32682138,83058136,50375998,TNL
chr03,Bn12960,78888770,99576830,20688060,RLP
chr03,Bn12961,22469076,64232612,41763536,CNL
chr03,Bn12962,47700099,57616191,9916092,NBS
chr03,Bn12963,37845336,55397047,17551711,NBS
chr03,Bn12964,12413620,35920296,23506676,NBS
chr03,Bn12965,35588182,52650738,17062556,RLP
chr03,Bn12966,33446773,84416908,50970135,NBS
chr03,Bn12967,90829455,91975714,1146259,NBS
chr03,Bn12968,92032719,94484995,2452276,CNL
chr03,Bn12969,75705052,88905761,13200709,NBS
chr03,Bn12970,1431891,42413927,40982036,CNL
chr03,Bn12971,45063271,79235789,34172518,TNL
chr03,Bn12972,1720668,58848077,57127409,TNL
chr03,Bn12973,92276366,98487268,6210902,RLP
chr03,Bn12974,15551188,21255581,5704393,CNL
chr03,Bn12975,50249843,70257155,20007312,NBS
chr03,Bn12976,64191759,72476673,8284914,TN
chr03,Bn12977,27076277,37534456,10458179,CN
chr03,Bn12978,73740570,85106116,11365546,CNL
chr03,Bn12979,47188207,90727612,43539405,CN
chr03,Bn12980,52571861,95236495,42664634,CN
chr03,Bn12981,54637275,92797217,38159942,RLK
chr03,Bn12982,28615067,75814714,47199647,RLP
chr03,Bn12983,83673422,96239878,12566456,RLK
chr03,Bn12984,67747475,80867134,13119659,CN
chr03,Bn12985,30924306,89900934,58976628,RLP
chr03,Bn12986,1923055,23540847,21617792,RLK
chr03,Bn12987,43250921,77275711,34024790,CNL
chr03,Bn12988,62270771,88098683,25827912,CN
chr03,Bn12989,23021905,83739858,60717953,RLP
chr03,Bn12990,16630634,34282108,17651474,TNL
chr03,Bn12991,96065470,99485484,3420014,TNL
chr03,Bn12992,25350644,68416781,43066137,RLP
chr03,Bn12993,71212465,97917753,26705288,CNL
chr03,Bn12994,43667501,98458445,54790944,RLP
chr03,Bn12995,83672489,99876437,16203948,CNL
chr03,Bn12996,84903207,99391999,14488792,NBS
chr03,Bn12997,46039072,71604509,25565437,CNL
chr03,Bn12998,70074030,71713226,1639196,TN
chr03,Bn12999,60633284,95927048,35293764,TN
chr03,Bn13000,61706235,78809736,17103501,RLK
chr03,Bn13001,39604170,58816265,19212095,CN
chr03,Bn13002,45547723,90493853,44946130,CNL
chr03,Bn13003,69924383,86937656,17013273,TNL
chr03,Bn13004,84898116,85013383,115267,TNL
chr03,Bn13005,88958496,92293651,3335155,CN
chr03,Bn13006,59146527,90795543,31649016,NBS
chr03,Bn13007,34114862,80931217,46816355,RLP
chr03,Bn13008,35323900,44964256,9640356,RLK
chr03,Bn13009,57573769,64292017,6718248,CNL
chr03,Bn13010,42032024,51895546,9863522,TN
chr03,Bn13011,92295214,92930148,634934,CN
chr03,Bn13012,12318875,24207046,11888171,TN
chr03,Bn13013,55243242,98712337,43469095,CNL
chr03,Bn13014,66087313,79366111,13278798,NBS
chr03,Bn13015,8953812,9448096,494284,NBS
chr03,Bn13016,33446363,91034197,57587834,RLP
chr03,Bn13017,83888532,94476234,10587702,RLK
chr03,Bn13018,46091635,83381021,37289386,CNL
chr03,Bn13019,17305807,92886471,75580664,RLK
chr03,Bn13020,14660924,90511351,75850427,RLP
chr03,Bn13021,21264325,82105251,60840926,RLK
chr03,Bn13022,58008339,80972756,22964417,TN
chr03,Bn13023,80419972,95524587,15104615,RLK
chr03,Bn13024,22388183,51788451,29400268,RLK
chr03,Bn13025,47056626,85480779,38424153,CNL
chr03,Bn13026,83442570,98586177,15143607,RLP
chr03,Bn13027,36307817,70940021,34632204,RLK
chr03,Bn13028,79103253,85533458,6430205,CNL
chr03,Bn13029,56571296,84481723,27910427,RLP
chr03,Bn13030,39691615,85620520,45928905,TNL
chr03,Bn13031,36104046,43408245,7304199,CNL
chr03,Bn13032,93543175,96771850,3228675,TN
chr03,Bn13033,82510631,88486893,5976262,CNL
chr03,Bn13034,99811591,99936074,124483,CN
chr03,Bn13035,88390379,99695025,11304646,RLK
chr03,Bn13036,54220026,61357695,7137669,TNL
chr03,Bn13037,15626008,20338638,4712630,CNL
chr03,Bn13038,65808381,72914728,7106347,TNL
chr03,Bn13039,11280805,69411114,58130309,TN
chr03,Bn13040,83033835,83845076,811241,CN
chr03,Bn13041,82499780,99359904,16860124,TN
chr03,Bn13042,34894706,45093576,10198870,RLK
chr03,Bn13043,12167865,63014930,50847065,TN
chr03,Bn13044,9110985,78578419,69467434,CN
chr03,Bn13045,30355193,64715531,34360338,CNL
chr03,Bn13046,89683218,99143752,9460534,TN
chr03,Bn13047,94608769,97418275,2809506,RLP
chr03,Bn13048,59687294,67607785,7920491,NBS
chr03,Bn13049,84142887,92892392,8749505,RLP
chr03,Bn13050,22493889,53117535,30623646,RLP
chr03,Bn13051,25649684,43898441,18248757,RLP
chr03,Bn13052,55824498,64196996,8372498,RLP
chr03,Bn13053,19049790,62445018,43395228,TNL
chr03,Bn13054,48702237,69903185,21200948,TNL
chr03,Bn13055,21888596,40442774,18554178,CNL
chr03,Bn13056,82312040,84421998,2109958,NBS
chr03,Bn13057,90943054,97541354,6598300,NBS
chr03,Bn13058,64963934,78965308,14001374,TN
chr03,Bn13059,10501781,47279171,36777390,CNL
chr03,Bn13060,96566929,98534067,1967138,TN
chr03,Bn13061,71501481,83070944,11569463,RLP
chr03,Bn13062,80011033,94876167,14865134,RLP
chr03,Bn13063,74823310,77954682,3131372,RLP
chr03,Bn13064,29033608,77645902,48612294,CNL
chr03,Bn13065,33026615,67607292,34580677,TN
chr03,Bn13066,92515593,96828251,4312658,CN
chr03,Bn13067,25664286,44171906,18507620,TNL
chr03,Bn13068,61598618,73426690,11828072,CN
chr03,Bn13069,35303106,73668325,38365219,CNL
chr03,Bn13070,24046612,57014520,32967908,TN
chr03,Bn13071,96714011,97599820,885809,TNL
chr03,Bn13072,69487716,95964944,26477228,TN
chr03,Bn13073,2585877,38616870,36030993,TN
chr03,Bn13074,30026126,70964995,40938869,RLP
chr03,Bn13075,9474277,68666107,59191830,RLP
chr03,Bn13076,16370681,40129536,23758855,RLP
chr03,Bn13077,89294330,91949386,2655056,CNL
chr03,Bn13078,29701475,67889419,38187944,RLK
chr03,Bn13079,27070923,27216615,145692,CNL
chr03,Bn13080,97051084,97162062,110978,CN
chr03,Bn13081,24380562,74224901,49844339,NBS
chr03,Bn13082,72335214,83618270,11283056,CNL
chr03,Bn13083,40737554,65093903,24356349,TNL
chr03,Bn13084,82824709,87345711,4521002,NBS
chr03,Bn13085,72031736,84999118,12967382,TN
chr03,Bn13086,50074619,78477592,28402973,CNL
chr03,Bn13087,75043712,90555959,15512247,RLK
chr03,Bn13088,49103817,78110631,29006814,NBS
chr03,Bn13089,99020200,99575861,555661,TN
chr03,Bn13090,73000974,76598369,3597395,NBS
chr03,Bn13091,41245492,55500843,14255351,CN
chr03,Bn13092,45901324,91422992,45521668,NBS
chr03,Bn13093,46814513,59408347,12593834,RLK
chr03,Bn13094,5158106,15918221,10760115,RLP
chr03,Bn13095,65820893,79221243,13400350,RLK
chr03,Bn13096,72805675,75047952,2242277,TN
chr03,Bn13097,48038686,74175916,26137230,CN
chr03,Bn13098,32205302,57310836,25105534,CNL
chr03,Bn13099,40579662,77283802,36704140,RLP
chr03,Bn13100,99016624,99027171,10547,CNL
chr03,Bn13101,94791154,96283416,1492262,CNL
chr03,Bn13102,15841652,43662561,27820909,TN
chr03,Bn13103,99299720,99763725,464005,RLK
chr03,Bn13104,69076026,99123693,30047667,CN
chr03,Bn13105,94980108,95524387,544279,RLK
chr03,Bn13106,71120415,77288674,6168259,CNL
chr03,Bn13107,25135622,52281437,27145815,TNL
chr03,Bn13108,53279804,91654039,38374235,TNL
chr03,Bn13109,92384597,95559527,3174930,NBS
chr03,Bn13110,75594258,83060708,7466450,CNL
chr03,Bn13111,92846045,99298386,6452341,CN
chr03,Bn13112,18298942,80872860,62573918,CN
chr03,Bn13113,43081704,85019106,41937402,RLK
chr03,Bn13114,40617172,91817125,51199953,CN
chr03,Bn13115,47306795,72477871,25171076,CN
chr03,Bn13116,33065520,49022944,15957424,TN
chr03,Bn13117,81715257,92064580,10349323,RLP
chr03,Bn13118,14540249,47878286,33338037,TNL
chr03,Bn13119,53203799,74448416,21244617,CNL
chr03,Bn13120,55738194,58656849,2918655,CN
chr03,Bn13121,96172402,97183712,1011310,CN
chr03,Bn13122,63384986,95924672,32539686,TNL
chr03,Bn13123,79045651,99421750,20376099,RLP
chr03,Bn13124,67270260,78956146,11685886,TNL
chr03,Bn13125,18350397,61094150,42743753,TN
chr03,Bn13126,87622181,90257233,2635052,TN
chr03,Bn13127,63734423,99944272,36209849,NBS
chr03,Bn13128,86998511,88569142,1570631,NBS
chr03,Bn13129,94077061,98186113,4109052,TNL
chr03,Bn13130,55362855,64243346,8880491,NBS
chr03,Bn13131,97822970,99308080,1485110,NBS
chr03,Bn13132,71746226,74670636,2924410,TNL
chr03,Bn13133,59669514,76999992,17330478,RLP
chr03,Bn13134,20324350,26039921,5715571,NBS
chr03,Bn13135,68869109,96614033,27744924,NBS
chr03,Bn13136,55410080,83461759,28051679,CNL
chr03,Bn13137,59276594,62732394,3455800,RLK
chr03,Bn13138,23180581,57350344,34169763,TN
chr03,Bn13139,16120927,36683936,20563009,TNL
chr03,Bn13140,3585945,38631515,35045570,CNL
chr03,Bn13141,30875885,83069216,52193331,TNL
chr03,Bn13142,62967478,81121274,18153796,TN
chr03,Bn13143,30556837,86374136,55817299,TNL
chr03,Bn13144,81750161,98333206,16583045,CN
chr03,Bn13145,48465329,49508030,1042701,RLP
chr03,Bn13146,89214179,94769965,5555786,NBS
chr03,Bn13147,48446357,54446135,5999778,RLP
chr03,Bn13148,87887291,89298898,1411607,CNL
chr03,Bn13149,69698642,70389778,691136,NBS
chr03,Bn13150,12415113,53220434,40805321,TN
chr03,Bn13151,23792917,28569118,4776201,RLK
chr03,Bn13152,71619015,99094494,27475479,CNL
chr03,Bn13153,48053049,90050253,41997204,NBS
chr03,Bn13154,9631669,45545727,35914058,TN
chr03,Bn13155,39963630,93538008,53574378,CNL
chr03,Bn13156,7659686,86675213,79015527,TNL
chr03,Bn13157,71205490,98873194,27667704,RLK
chr03,Bn13158,44941893,85673462,40731569,CNL
chr03,Bn13159,29385211,47408833,18023622,CN
chr03,Bn13160,83913902,96260015,12346113,TNL
chr03,Bn13161,18748422,86484548,67736126,CNL
chr03,Bn13162,48669567,51526783,2857216,NBS
chr03,Bn13163,50771621,93386338,42614717,RLK
chr03,Bn13164,50578813,51918774,1339961,TN
chr03,Bn13165,39468038,52353174,12885136,TNL
chr03,Bn13166,25080249,68513388,43433139,CN
chr03,Bn13167,36861585,90180303,53318718,RLK
chr03,Bn13168,36774648,42037472,5262824,NBS
chr03,Bn13169,8616694,54871954,46255260,RLP
chr03,Bn13170,57920056,89301589,31381533,RLP
chr03,Bn13171,54360882,54834926,474044,CN
chr03,Bn13172,11217741,31472363,20254622,RLK
chr03,Bn13173,49404884,96896092,47491208,RLP
chr03,Bn13174,42141353,61920843,19779490,RLP
chr03,Bn13175,16251123,93410527,77159404,TN
chr03,Bn13176,73663842,93179976,19516134,CN
chr03,Bn13177,54809941,79331139,24521198,CNL
chr03,Bn13178,10992644,32454282,21461638,CN
chr03,Bn13179,24024152,79207703,55183551,CN
chr03,Bn13180,74385876,91605545,17219669,NBS
chr03,Bn13181,20780895,55943108,35162213,NBS
chr03,Bn13182,56497295,96572397,40075102,TNL
chr03,Bn13183,80557284,89067731,8510447,TN
chr03,Bn13184,89223280,91465970,2242690,CNL
chr03,Bn13185,62160979,87930872,25769893,CN
chr03,Bn13186,88213689,94986146,6772457,CNL
chr03,Bn13187,71517308,97311384,25794076,RLP
chr03,Bn13188,22734312,43614597,20880285,NBS
chr03,Bn13189,83195286,89980532,6785246,TNL
chr03,Bn13190,83239527,98988244,15748717,TN
chr03,Bn13191,89943146,93982157,4039011,CN
chr03,Bn13192,78793584,96454418,17660834,CN
chr03,Bn13193,10798094,87202828,76404734,CN
chr03,Bn13194,58848694,78656850,19808156,TN
chr03,Bn13195,21431458,72686699,51255241,NBS
chr03,Bn13196,26485116,80679030,54193914,TN
chr03,Bn13197,25409703,50924773,25515070,CN
chr03,Bn13198,34482515,40899872,6417357,RLK
chr03,Bn13199,13260282,23081275,9820993,TNL
chr03,Bn13200,32357492,62873996,30516504,TN
chr03,Bn13201,54619365,59186425,4567060,TN
chr03,Bn13202,95752674,97606075,1853401,RLK
chr03,Bn13203,16242524,72772194,56529670,RLP
chr03,Bn13204,62172076,66150288,3978212,TN
chr03,Bn13205,73924632,89998449,16073817,TNL
chr03,Bn13206,73440227,89806963,16366736,CN
chr03,Bn13207,28136033,31873748,3737715,TN
chr03,Bn13208,34541910,76532413,41990503,CNL
chr03,Bn13209,25812786,80483866,54671080,RLK
chr03,Bn13210,86312526,94415509,8102983,NBS
chr03,Bn13211,77943979,78763763,819784,TNL
chr03,Bn13212,90091036,98144498,8053462,TNL
chr03,Bn13213,33673488,53023099,19349611,CNL
chr03,Bn13214,23245364,89635724,66390360,RLP
chr03,Bn13215,77254380,81987216,4732836,NBS
chr03,Bn13216,51459303,51671975,212672,NBS
chr03,Bn13217,23352876,59594759,36241883,CN
chr03,Bn13218,73526278,91888635,18362357,NBS
chr03,Bn13219,50797315,62848337,12051022,RLP
chr03,Bn13220,16959706,74280366,57320660,CN
chr03,Bn13221,83138424,85540320,2401896,RLK
chr03,Bn13222,21095171,58227195,37132024,TN
chr03,Bn13223,59308687,62763067,3454380,RLP
chr03,Bn13224,24730104,57285019,32554915,TNL
chr03,Bn13225,2737056,90800780,88063724,NBS
chr03,Bn13226,29799595,73626556,43826961,NBS
chr03,Bn13227,24488756,38969220,14480464,RLK
chr03,Bn13228,8783111,44538620,35755509,NBS
chr03,Bn13229,92476538,97005125,4528587,CNL
chr03,Bn13230,50916436,97945883,47029447,TNL
chr03,Bn13231,41809071,93812585,52003514,RLP
chr03,Bn13232,1612638,17602443,15989805,CN
chr03,Bn13233,34804190,99503681,64699491,NBS
chr03,Bn13234,41157265,66204175,25046910,RLK
chr03,Bn13235,28178257,60981000,32802743,TNL
chr03,Bn13236,82819207,91295113,8475906,CN
chr03,Bn13237,77517350,98913458,21396108,TNL
chr03,Bn13238,45153845,69233685,24079840,NBS
chr03,Bn13239,93988896,95911375,1922479,RLP
chr03,Bn13240,76410256,78956162,2545906,CNL
chr03,Bn13241,63632770,89881411,26248641,NBS
chr03,Bn13242,58195445,88507904,30312459,TN
chr03,Bn13243,48932168,61601233,12669065,RLK
chr03,Bn13244,62927834,87952893,25025059,RLK
chr03,Bn13245,41600556,68034026,26433470,TNL
chr03,Bn13246,90757183,92242486,1485303,TNL
chr03,Bn13247,42926351,68465403,25539052,RLK
chr03,Bn13248,95452400,99313962,3861562,TNL
chr03,Bn13249,18710307,87977559,69267252,CN
chr03,Bn13250,12697300,96904202,84206902,RLK
chr03,Bn13251,10197692,46020251,35822559,RLP
chr03,Bn13252,32271888,38589215,6317327,CNL
chr03,Bn13253,27507497,43164378,15656881,CN
chr03,Bn13254,47819398,99680383,51860985,CNL
chr03,Bn13255,22040491,86379632,64339141,RLP
chr03,Bn13256,16398700,20103722,3705022,TN
chr03,Bn13257,40021683,75151359,35129676,CN
chr03,Bn13258,82812836,91262877,8450041,NBS
chr03,Bn13259,23847584,30708289,6860705,CN
chr03,Bn13260,18554115,79784461,61230346,CNL
chr03,Bn13261,19235635,33211069,13975434,NBS
chr03,Bn13262,70227387,81391523,11164136,TN
chr03,Bn13263,3400547,31227051,27826504,TNL
chr03,Bn13264,42080783,95434942,53354159,CNL
chr03,Bn13265,13188656,56937303,43748647,TN
chr03,Bn13266,35369354,75397725,40028371,RLK
chr03,Bn13267,53295300,70345947,17050647,TNL
chr03,Bn13268,7250827,13028587,5777760,RLP
chr03,Bn13269,64547733,85840635,21292902,CN
chr03,Bn13270,44812856,52473293,7660437,RLK
chr03,Bn13271,29491811,48580865,19089054,CN
chr03,Bn13272,1095054,56706340,55611286,NBS
chr03,Bn13273,40166633,48874090,8707457,RLP
chr03,Bn13274,88050702,97678514,9627812,NBS
chr03,Bn13275,42755021,59474973,16719952,NBS
chr03,Bn13276,78276620,90584641,12308021,RLP
chr03,Bn13277,4009191,37116025,33106834,TN
chr03,Bn13278,77301857,85002412,7700555,RLP
chr03,Bn13279,48548216,70387737,21839521,CNL
chr03,Bn13280,62212352,68059921,5847569,CNL
chr03,Bn13281,61702486,93774806,32072320,CNL
chr03,Bn13282,69325815,76869956,7544141,NBS
chr03,Bn13283,77478550,94673840,17195290,CNL
chr03,Bn13284,22569470,85561132,62991662,CN
chr03,Bn13285,64107506,77754395,13646889,RLK
chr03,Bn13286,55628369,65676165,10047796,NBS
chr03,Bn13287,16388404,80507455,64119051,RLK
chr03,Bn13288,13289800,48357777,35067977,CNL
chr03,Bn13289,10030433,13021371,2990938,TN
chr03,Bn13290,22090178,72546481,50456303,TN
chr03,Bn13291,61051436,70856590,9805154,TN
chr03,Bn13292,34880941,85884799,51003858,TNL
chr03,Bn13293,68716761,88291451,19574690,CNL
chr03,Bn13294,1760816,74971647,73210831,CN
chr03,Bn13295,81600533,98134208,16533675,NBS
chr03,Bn13296,3653643,51211095,47557452,CN
chr03,Bn13297,24383858,93883805,69499947,RLK
chr03,Bn13298,62815273,93226419,30411146,RLP
chr03,Bn13299,11685904,14513715,2827811,NBS
chr03,Bn13300,51774758,65527611,13752853,TNL
chr03,Bn13301,90200163,90431812,231649,RLK
chr03,Bn13302,4322156,88261954,83939798,TNL
chr03,Bn13303,63292435,87401719,24109284,TNL
chr03,Bn13304,27889682,70653908,42764226,RLP
chr03,Bn13305,94586011,99114324,4528313,CNL
chr03,Bn13306,31813231,42356830,10543599,RLK
chr03,Bn13307,69388788,84183615,14794827,NBS
chr03,Bn13308,91978071,93247710,1269639,TNL
chr03,Bn13309,50847472,95008890,44161418,RLP
chr03,Bn13310,18762641,33408286,14645645,RLK
chr03,Bn13311,24454754,95223850,70769096,RLK
chr03,Bn13312,93282587,93501761,219174,CNL
chr03,Bn13313,89429601,90412429,982828,NBS
chr03,Bn13314,62943195,76666002,13722807,TNL
chr03,Bn13315,60602897,90451033,29848136,RLP
chr03,Bn13316,3080891,50490250,47409359,RLK
chr03,Bn13317,65897361,73915135,8017774,RLP
chr03,Bn13318,14060028,73365035,59305007,NBS
chr03,Bn13319,13431752,21155879,7724127,RLP
chr03,Bn13320,62638819,77732747,15093928,RLP
chr03,Bn13321,57284453,90613569,33329116,TNL
chr03,Bn13322,75879287,97353337,21474050,CN
chr03,Bn13323,38306331,67087097,28780766,NBS
chr03,Bn13324,58739546,60407966,1668420,CN
chr03,Bn13325,74706161,78499447,3793286,NBS
chr03,Bn13326,46425399,92257750,45832351,NBS
chr03,Bn13327,96019955,98299474,2279519,NBS
chr03,Bn13328,30683333,37081480,6398147,RLK
chr03,Bn13329,9957772,80217704,70259932,NBS
chr03,Bn13330,62957549,64703365,1745816,CN
chr03,Bn13331,76857070,83342107,6485037,CNL
chr03,Bn13332,33509114,52369936,18860822,RLK
chr03,Bn13333,63133245,76447940,13314695,CNL
chr03,Bn13334,49016734,66568140,17551406,NBS
chr03,Bn13335,54622892,62393490,7770598,RLP
chr03,Bn13336,90051666,91626938,1575272,CN
chr03,Bn13337,8795698,33920443,25124745,CNL
chr03,Bn13338,17812117,40702865,22890748,RLP
chr03,Bn13339,85151335,97602656,12451321,TNL
chr03,Bn13340,29673576,57693218,28019642,CN
chr03,Bn13341,5354079,46326527,40972448,TN
chr03,Bn13342,8865363,60926948,52061585,TNL
chr03,Bn13343,81061226,96671854,15610628,TNL
chr03,Bn13344,31611569,44120893,12509324,RLP
chr03,Bn13345,52457673,53016022,558349,CNL
chr03,Bn13346,55178513,71034264,15855751,RLK
chr03,Bn13347,32555302,75423440,42868138,CNL
chr03,Bn13348,20319834,47783508,27463674,NBS
chr03,Bn13349,4737016,36367044,31630028,TNL
chr03,Bn13350,72771193,86004481,13233288,CNL
chr03,Bn13351,47149666,99286119,52136453,TN
chr03,Bn13352,88867164,95072918,6205754,NBS
chr03,Bn13353,4644606,35629604,30984998,RLP
chr03,Bn13354,30939151,91586912,60647761,RLK
chr03,Bn13355,84088089,94098439,10010350,TN
chr03,Bn13356,87067444,93296263,6228819,NBS
chr03,Bn13357,91474764,95595559,4120795,TN
chr03,Bn13358,35019367,79779257,44759890,TN
chr03,Bn13359,96046233,96847664,801431,TN
chr03,Bn13360,23827168,56682879,32855711,RLP
chr03,Bn13361,16615467,85401819,68786352,CNL
chr03,Bn13362,49308834,67005721,17696887,NBS
chr03,Bn13363,48927764,59111626,10183862,TNL
chr03,Bn13364,91225165,99557385,8332220,CN
chr03,Bn13365,81782254,85325667,3543413,CNL
chr03,Bn13366,12258236,55622366,43364130,RLK
chr03,Bn13367,67923805,98810340,30886535,RLK
chr03,Bn13368,89309348,91790277,2480929,CNL
chr03,Bn13369,47697619,77493838,29796219,TNL
chr03,Bn13370,91844254,95855760,4011506,TNL
chr03,Bn13371,60306256,78751601,18445345,RLK
chr03,Bn13372,82938542,92892698,9954156,CN
chr03,Bn13373,48359307,75025360,26666053,RLK
chr03,Bn13374,40266410,81055866,40789456,TN
chr03,Bn13375,1127082,98835309,97708227,RLP
chr03,Bn13376,63694969,90281403,26586434,TNL
chr03,Bn13377,86062359,89060843,2998484,CN
chr03,Bn13378,20496397,33460555,12964158,TN
chr03,Bn13379,99012797,99629677,616880,RLP
chr03,Bn13380,67188579,96725100,29536521,RLP
chr03,Bn13381,12911400,27292846,14381446,RLP
chr03,Bn13382,21153501,34951860,13798359,CN
chr03,Bn13383,77347775,91846396,14498621,CN
chr03,Bn13384,7797887,94117307,86319420,CNL
chr03,Bn13385,57184587,95400196,38215609,TNL
chr03,Bn13386,44749079,54719984,9970905,TNL
chr03,Bn13387,69911059,84436795,14525736,CNL
chr03,Bn13388,51255491,95508272,44252781,RLP
chr03,Bn13389,22788330,97793712,75005382,CN
chr03,Bn13390,11604270,23052866,11448596,RLK
chr03,Bn13391,45315869,51019599,5703730,NBS
chr03,Bn13392,9517383,94292764,84775381,TN
chr03,Bn13393,30488045,38547476,8059431,CNL
chr03,Bn13394,61347734,62794950,1447216,RLP
chr03,Bn13395,43933582,93558025,49624443,TNL
chr03,Bn13396,66361090,87169400,20808310,TNL
chr03,Bn13397,72892777,76542112,3649335,NBS
chr03,Bn13398,69643457,79902756,10259299,CNL
chr03,Bn13399,49316265,71126683,21810418,CNL
chr03,Bn13400,80238624,99462057,19223433,CNL
chr03,Bn13401,76480860,91660601,15179741,TNL
chr03,Bn13402,24904882,37033176,12128294,TN
chr03,Bn13403,10753151,64110470,53357319,CNL
chr03,Bn13404,55749947,64519094,8769147,NBS
chr03,Bn13405,27569033,28949909,1380876,NBS
chr03,Bn13406,25922682,51337497,25414815,TNL
chr03,Bn13407,5215044,29916163,24701119,CNL
chr03,Bn13408,21372129,61656953,40284824,RLP
chr03,Bn13409,92886753,98189313,5302560,CN
chr03,Bn13410,61249402,98492168,37242766,TN
chr03,Bn13411,8964977,23670412,14705435,NBS
chr03,Bn13412,61315096,79647648,18332552,TNL
chr03,Bn13413,8422562,17921865,9499303,TN
chr03,Bn13414,79188650,91074714,11886064,RLP
chr03,Bn13415,27809339,76204963,48395624,RLP
chr03,Bn13416,30665199,41701571,11036372,CN
chr03,Bn13417,21126500,49208861,28082361,RLK
chr03,Bn13418,80117853,81738126,1620273,TNL
chr03,Bn13419,76054178,83505517,7451339,NBS
chr03,Bn13420,52169133,61671369,9502236,CN
chr03,Bn13421,85384607,92822142,7437535,RLK
chr03,Bn13422,44078866,78322688,34243822,NBS
chr03,Bn13423,16290518,38133344,21842826,CNL
chr03,Bn13424,69218164,84472600,15254436,CN
chr03,Bn13425,18129875,47953363,29823488,RLK
chr03,Bn13426,52028490,89510741,37482251,RLK
chr03,Bn13427,59321861,60183890,862029,NBS
chr03,Bn13428,76909241,84281453,7372212,TNL
chr03,Bn13429,14022807,97838813,83816006,RLP
chr03,Bn13430,55983476,72032137,16048661,NBS
chr03,Bn13431,33666310,70840402,37174092,NBS
chr03,Bn13432,20257059,77678028,57420969,CNL
chr03,Bn13433,28634604,73944565,45309961,CNL
chr03,Bn13434,14565732,87027545,72461813,RLP
chr03,Bn13435,16013150,59711463,43698313,CNL
chr03,Bn13436,39408942,74158630,34749688,RLK
chr03,Bn13437,24100130,94166787,70066657,CN
chr03,Bn13438,7695605,25791716,18096111,RLK
chr03,Bn13439,52698910,97537623,44838713,TN
chr03,Bn13440,35903614,92355943,56452329,CN
chr03,Bn13441,58834195,83953864,25119669,TN
chr03,Bn13442,49535507,66869882,17334375,TN
chr03,Bn13443,83819957,86626012,2806055,TN
chr03,Bn13444,6578818,57506629,50927811,RLP
chr03,Bn13445,50706914,76221003,25514089,RLK
chr03,Bn13446,95350806,98455360,3104554,NBS
chr03,Bn13447,81434329,94388692,12954363,RLP
chr03,Bn13448,70968175,80578111,9609936,RLP
chr03,Bn13449,44524679,65653689,21129010,NBS
chr03,Bn13450,31142907,37820985,6678078,TNL
chr03,Bn13451,92688971,96907096,4218125,CNL
chr03,Bn13452,5775402,70972078,65196676,CN
chr03,Bn13453,84086905,90291349,6204444,RLK
chr03,Bn13454,31896110,36419690,4523580,TN
chr03,Bn13455,36090547,40321561,4231014,RLP
chr03,Bn13456,66166155,98155423,31989268,CN
chr03,Bn13457,32848851,56989046,24140195,TNL
chr03,Bn13458,2175729,67175382,64999653,TN
chr03,Bn13459,55264079,85664999,30400920,CNL
chr03,Bn13460,91795250,97757379,5962129,RLP
chr03,Bn13461,77162030,92186681,15024651,NBS
chr03,Bn13462,94662405,99234906,4572501,CNL
chr03,Bn13463,28991420,53702241,24710821,NBS
chr03,Bn13464,60040629,70698032,10657403,CN
chr03,Bn13465,92199968,95977497,3777529,TN
chr03,Bn13466,48074032,87403198,39329166,NBS
chr03,Bn13467,98368126,99762724,1394598,RLP
chr03,Bn13468,75840466,90624541,14784075,RLK
chr03,Bn13469,94636715,95148889,512174,TN
chr03,Bn13470,45960618,71744530,25783912,RLP
chr03,Bn13471,2864808,18401124,15536316,CN
chr03,Bn13472,73675344,87605681,13930337,NBS
chr03,Bn13473,83534550,95684652,12150102,CNL
chr03,Bn13474,94622255,99933193,5310938,NBS
chr03,Bn13475,56473067,92606588,36133521,TNL
chr03,Bn13476,30675850,90823445,60147595,TN
chr03,Bn13477,25737003,73988287,48251284,NBS
chr03,Bn13478,22282299,24167279,1884980,RLP
chr03,Bn13479,42342243,50683862,8341619,TN
chr03,Bn13480,46310368,96196109,49885741,CNL
chr03,Bn13481,33454091,87860621,54406530,TN
chr03,Bn13482,91544493,94592411,3047918,CN
chr03,Bn13483,56355718,57029637,673919,TN
chr03,Bn13484,60045214,83182430,23137216,TN
chr03,Bn13485,85097858,93719002,8621144,TN
chr03,Bn13486,38968823,65048245,26079422,RLK
chr03,Bn13487,32109345,72111195,40001850,RLP
chr03,Bn13488,83264806,87982979,4718173,TN
chr03,Bn13489,71814954,83784552,11969598,RLK
chr03,Bn13490,63709323,80883757,17174434,TNL
chr03,Bn13491,90867056,95292510,4425454,CN
chr03,Bn13492,32128120,52845966,20717846,NBS
chr03,Bn13493,24788707,58964204,34175497,TNL
chr03,Bn13494,41033790,87201504,46167714,RLP
chr03,Bn13495,57616069,68412581,10796512,TNL
chr03,Bn13496,3330893,55619544,52288651,CN
chr03,Bn13497,82979499,90939546,7960047,CN
chr03,Bn13498,57563101,70507766,12944665,RLK
chr03,Bn13499,87605159,96270813,8665654,CNL
chr03,Bn13500,62369483,71217764,8848281,CN
chr03,Bn13501,28591947,94595354,66003407,CNL
chr03,Bn13502,31261156,68534454,37273298,RLK
chr03,Bn13503,41146877,71889539,30742662,NBS
chr03,Bn13504,23421957,56564550,33142593,NBS
chr03,Bn13505,17590620,96799180,79208560,TNL
chr03,Bn13506,60686621,65991537,5304916,RLP
chr03,Bn13507,2949243,97711833,94762590,CN
chr03,Bn13508,98544949,98607981,63032,TNL
chr03,Bn13509,77100399,77139078,38679,RLK
chr03,Bn13510,44516477,72059253,27542776,RLK
chr03,Bn13511,33648337,87977351,54329014,CNL
chr03,Bn13512,41088233,85389018,44300785,TN
chr03,Bn13513,48298539,49812871,1514332,RLP
chr03,Bn13514,44091990,61461683,17369693,TN
chr03,Bn13515,34555617,39754398,5198781,TN
chr03,Bn13516,50540587,90037927,39497340,TNL
chr03,Bn13517,98623386,98630191,6805,TNL
chr03,Bn13518,65904759,84574931,18670172,RLP
chr03,Bn13519,92374842,92579005,204163,RLK
chr03,Bn13520,65483693,65963566,479873,CN
chr03,Bn13521,36242229,73427416,37185187,NBS
chr03,Bn13522,44798245,93639573,48841328,RLK
chr03,Bn13523,89360022,94015695,4655673,NBS
chr03,Bn13524,14203607,54544763,40341156,RLP
chr03,Bn13525,13153152,16839861,3686709,CN
chr03,Bn13526,78198328,99122336,20924008,CNL
chr03,Bn13527,69037908,81275984,12238076,NBS
chr03,Bn13528,4995251,15738436,10743185,NBS
chr03,Bn13529,51306410,52382263,1075853,TNL
chr03,Bn13530,65384179,71251509,5867330,TNL
chr03,Bn13531,54710233,59945256,5235023,CN
chr03,Bn13532,63060757,63652984,592227,RLK
chr03,Bn13533,48895351,77081815,28186464,TN
chr03,Bn13534,31568672,64121291,32552619,CNL
chr03,Bn13535,91246169,98859143,7612974,TNL
chr03,Bn13536,7373445,31504910,24131465,CNL
chr03,Bn13537,53906019,59303691,5397672,TNL
chr03,Bn13538,85832353,98130102,12297749,CNL
chr03,Bn13539,52211224,70004353,17793129,RLK
chr03,Bn13540,6283399,33059111,26775712,NBS
chr03,Bn13541,39105576,59038340,19932764,TNL
chr03,Bn13542,22375318,75164185,52788867,TN
chr03,Bn13543,37143439,63812687,26669248,RLK
chr03,Bn13544,20717960,88097866,67379906,NBS
chr03,Bn13545,27906608,37993734,10087126,TN
chr03,Bn13546,21840880,28943915,7103035,CNL
chr03,Bn13547,4169542,76579323,72409781,TNL
chr03,Bn13548,13334276,15231527,1897251,CN
chr03,Bn13549,66139385,70292075,4152690,RLP
chr03,Bn13550,70601057,91115148,20514091,RLP
chr03,Bn13551,85793148,92711365,6918217,RLK
chr03,Bn13552,60568531,76971433,16402902,CN
chr03,Bn13553,67787125,87330510,19543385,RLP
chr03,Bn13554,2076589,71462740,69386151,TN
chr03,Bn13555,19655697,73104530,53448833,RLP
chr03,Bn13556,6545807,84018121,77472314,RLK
chr03,Bn13557,36139556,91566328,55426772,RLP
chr03,Bn13558,28169441,53903324,25733883,RLP
chr03,Bn13559,13922776,74027244,60104468,RLK
chr03,Bn13560,66659082,94039799,27380717,RLP
chr03,Bn13561,32276659,97579933,65303274,TN
chr03,Bn13562,61593531,66150431,4556900,TN
chr03,Bn13563,47004470,64751039,17746569,NBS
chr03,Bn13564,84144126,96013365,11869239,RLP
chr03,Bn13565,42465780,79130205,36664425,CNL
chr03,Bn13566,68344781,87361265,19016484,NBS
chr03,Bn13567,3841435,73213006,69371571,TNL
chr03,Bn13568,24183929,87395988,63212059,TN
chr03,Bn13569,54869039,91238900,36369861,RLK
chr03,Bn13570,43518324,61672881,18154557,NBS
chr03,Bn13571,58525303,98468090,39942787,RLP
chr03,Bn13572,68441091,83040656,14599565,RLP
chr03,Bn13573,4224117,32533762,28309645,NBS
chr03,Bn13574,6666227,18586328,11920101,CN
chr03,Bn13575,94763512,96673853,1910341,TNL
chr03,Bn13576,38485028,94364025,55878997,TN
chr03,Bn13577,66992501,74706146,7713645,RLK
chr03,Bn13578,3121913,39993046,36871133,NBS
chr03,Bn13579,54491539,57523155,3031616,TNL
chr03,Bn13580,87597779,93772418,6174639,NBS
chr03,Bn13581,2531633,87168993,84637360,CN
chr03,Bn13582,75877339,98501078,22623739,CN
chr03,Bn13583,81647847,98407458,16759611,CNL
chr03,Bn13584,37439621,39349159,1909538,RLP
chr03,Bn13585,76423947,92052765,15628818,TNL
chr03,Bn13586,38993629,42224736,3231107,TNL
chr03,Bn13587,20006645,68193384,48186739,CN
chr03,Bn13588,71334246,95661048,24326802,NBS
chr03,Bn13589,69779567,83184980,13405413,CN
chr03,Bn13590,99708103,99917335,209232,CN
chr03,Bn13591,55133553,73546025,18412472,RLP
chr03,Bn13592,46292252,69506407,23214155,CNL
chr03,Bn13593,28524332,37195362,8671030,TN
chr03,Bn13594,8497825,66258640,57760815,TN
chr03,Bn13595,44562822,51382203,6819381,RLP
chr03,Bn13596,42169894,71344771,29174877,RLP
chr03,Bn13597,13230665,94607215,81376550,CNL
chr03,Bn13598,8240515,79970266,71729751,RLK
chr03,Bn13599,65297022,89656263,24359241,CNL
chr03,Bn13600,25644702,45164309,19519607,TN
chr03,Bn13601,92467614,92489210,21596,CNL
chr03,Bn13602,48755637,95150755,46395118,TN
chr03,Bn13603,70573437,74857097,4283660,CN
chr03,Bn13604,60262690,97253739,36991049,RLK
chr03,Bn13605,52716740,74308148,21591408,CN
chr03,Bn13606,47075867,55569028,8493161,TN
chr03,Bn13607,40222587,94541345,54318758,RLP
chr03,Bn13608,63631678,97843006,34211328,CN
chr03,Bn13609,94022175,94301117,278942,TN
chr03,Bn13610,24542151,76689402,52147251,NBS
chr03,Bn13611,38549770,74832799,36283029,RLP
chr03,Bn13612,23310231,40880021,17569790,TNL
chr03,Bn13613,23935275,99778584,75843309,TN
chr03,Bn13614,36680735,97155284,60474549,TN
chr03,Bn13615,38443031,73000743,34557712,RLK
chr03,Bn13616,47360233,80788915,33428682,NBS
chr03,Bn13617,41883901,42829295,945394,TN
chr03,Bn13618,71240965,78655902,7414937,TNL
chr03,Bn13619,7390567,26120266,18729699,CNL
chr03,Bn13620,12161856,70656479,58494623,RLP
chr03,Bn13621,68762147,95958864,27196717,NBS
chr03,Bn13622,37222719,72458728,35236009,RLP
chr03,Bn13623,68924330,74487243,5562913,NBS
chr03,Bn13624,97616906,99230790,1613884,CNL
chr03,Bn13625,44904354,50569677,5665323,CNL
chr03,Bn13626,40601735,41967382,1365647,TN
chr03,Bn13627,86566082,91973961,5407879,TNL
chr03,Bn13628,46601393,86808763,40207370,CNL
chr03,Bn13629,63869225,77070258,13201033,CN
chr03,Bn13630,32924302,58133022,25208720,TN
chr03,Bn13631,48320644,90658363,42337719,CNL
chr03,Bn13632,82843487,91120268,8276781,NBS
chr03,Bn13633,95914363,98408064,2493701,NBS
chr03,Bn13634,70479113,95274626,24795513,TN
chr03,Bn13635,42749863,87151305,44401442,CNL
chr03,Bn13636,75483967,93403629,17919662,TN
chr03,Bn13637,50334448,91062094,40727646,TN
chr03,Bn13638,96573421,98684801,2111380,NBS
chr03,Bn13639,60181730,72648382,12466652,RLP
chr03,Bn13640,72122790,90832268,18709478,TNL
chr03,Bn13641,54980451,98699931,43719480,NBS
chr03,Bn13642,32101166,60423868,28322702,RLK
chr03,Bn13643,54710349,58568408,3858059,CNL
chr03,Bn13644,75394550,76975455,1580905,CNL
chr03,Bn13645,62066354,78491635,16425281,CN
chr03,Bn13646,7597149,22370419,14773270,CNL
chr03,Bn13647,77131177,90313317,13182140,TN
chr03,Bn13648,91948123,93756523,1808400,CNL
chr03,Bn13649,75148397,94822115,19673718,TNL
chr03,Bn13650,23359217,24905064,1545847,CN
chr03,Bn13651,99424690,99706600,281910,CNL
chr03,Bn13652,82965374,88177143,5211769,CN
chr03,Bn13653,7826482,14741635,6915153,CNL
chr03,Bn13654,41874995,96813143,54938148,NBS
chr03,Bn13655,44218540,70265801,26047261,CN
chr03,Bn13656,24180450,43260747,19080297,NBS
chr03,Bn13657,66053659,87582537,21528878,TNL
chr03,Bn13658,57703728,93892906,36189178,TNL
chr03,Bn13659,18529774,39092102,20562328,TNL
chr03,Bn13660,79172971,85129302,5956331,TN
chr03,Bn13661,90035055,93593504,3558449,CN
chr03,Bn13662,93373131,99169743,5796612,CN
chr03,Bn13663,21974707,39398807,17424100,RLK
chr03,Bn13664,57465159,79866177,22401018,RLK
chr03,Bn13665,20130541,87123777,66993236,NBS
chr03,Bn13666,95861357,98100120,2238763,CN
chr03,Bn13667,47522500,78712516,31190016,RLK
chr03,Bn13668,62925331,80968117,18042786,RLK
chr03,Bn13669,93307066,99437365,6130299,RLK
chr03,Bn13670,92561154,96174824,3613670,CNL
chr03,Bn13671,62121599,85865631,23744032,RLK
chr03,Bn13672,13684029,57606461,43922432,NBS
chr03,Bn13673,59008443,80878760,21870317,TNL
chr03,Bn13674,65309140,92085620,26776480,NBS
chr03,Bn13675,28030337,70567907,42537570,NBS
chr03,Bn13676,90560901,95446722,4885821,RLK
chr03,Bn13677,99407175,99881673,474498,RLP
chr03,Bn13678,33755006,87807176,54052170,RLK
chr03,Bn13679,5963475,70425158,64461683,CNL
chr03,Bn13680,30814175,95327264,64513089,TN
chr03,Bn13681,47215412,64332791,17117379,RLK
chr03,Bn13682,21378420,59534117,38155697,TN
chr03,Bn13683,93307567,96893265,3585698,CNL
chr03,Bn13684,99966653,99978632,11979,NBS
chr03,Bn13685,3545718,45503734,41958016,TN
chr03,Bn13686,37621112,76670924,39049812,TN
chr03,Bn13687,90917109,97928299,7011190,CNL
chr03,Bn13688,75713945,99302363,23588418,TNL
chr03,Bn13689,17519298,44504152,26984854,CNL
chr03,Bn13690,60230995,69317339,9086344,CNL
chr03,Bn13691,46840375,55773338,8932963,CNL
chr03,Bn13692,3867136,85938261,82071125,TN
chr03,Bn13693,91339664,96450448,5110784,CNL
chr03,Bn13694,76863372,96112667,19249295,RLP
chr03,Bn13695,71004203,75928427,4924224,RLK
chr03,Bn13696,37968457,51956407,13987950,TNL
chr03,Bn13697,84922348,91042261,6119913,CN
chr03,Bn13698,4443667,24950894,20507227,RLP
chr03,Bn13699,53944974,58481114,4536140,CNL
chr03,Bn13700,82133129,99587713,17454584,NBS
chr03,Bn13701,26688657,73597950,46909293,CN
chr03,Bn13702,66500850,80004117,13503267,CNL
chr03,Bn13703,83922745,97401803,13479058,CNL
chr03,Bn13704,78931381,88281673,9350292,RLP
chr03,Bn13705,62847077,74950124,12103047,CN
chr03,Bn13706,5761735,21995734,16233999,CN
chr03,Bn13707,79559537,80214478,654941,CNL
chr03,Bn13708,58518612,78762149,20243537,CNL
chr03,Bn13709,80180989,95271860,15090871,CNL
chr03,Bn13710,70808567,82222349,11413782,CN
chr03,Bn13711,54079125,97126754,43047629,TNL
chr03,Bn13712,63891621,94630434,30738813,RLP
chr03,Bn13713,52561499,63019912,10458413,TN
chr03,Bn13714,74357778,90247957,15890179,TNL
chr03,Bn13715,55246101,59049071,3802970,RLP
chr03,Bn13716,65813160,85666955,19853795,CNL
chr03,Bn13717,55625647,93915706,38290059,TNL
chr03,Bn13718,73053588,77939175,4885587,CN
chr04,Bn13719,55839692,74105380,18265688,TN
chr04,Bn13720,22892339,91677136,68784797,TNL
chr04,Bn13721,34257202,42800994,8543792,RLK
chr04,Bn13722,23967464,91402863,67435399,CNL
chr04,Bn13723,75700631,77572059,1871428,TN
chr04,Bn13724,11197085,56152454,44955369,CNL
chr04,Bn13725,67667885,85744022,18076137,RLP
chr04,Bn13726,14121758,43966248,29844490,RLK
chr04,Bn13727,77252983,89065810,11812827,CNL
chr04,Bn13728,98755358,99540956,785598,CN
chr04,Bn13729,5509419,32620659,27111240,TN
chr04,Bn13730,20596038,41540247,20944209,RLP
chr04,Bn13731,53256658,71030958,17774300,TN
chr04,Bn13732,9777767,37426662,27648895,CN
chr04,Bn13733,88241617,89834365,1592748,TNL
chr04,Bn13734,29310885,82304097,52993212,TN
chr04,Bn13735,45969211,97548246,51579035,TN
chr04,Bn13736,98772842,99279162,506320,RLK
chr04,Bn13737,5382107,96422880,91040773,CN
chr04,Bn13738,31141471,32948899,1807428,CN
chr04,Bn13739,16502181,82850361,66348180,RLP
chr04,Bn13740,32529570,94394383,61864813,TNL
chr04,Bn13741,37550624,79506618,41955994,RLP
chr04,Bn13742,19573890,57986039,38412149,NBS
chr04,Bn13743,53946088,61754714,7808626,TNL
chr04,Bn13744,9621686,18478960,8857274,CNL
chr04,Bn13745,3206597,13687624,10481027,RLK
chr04,Bn13746,81149198,90217626,9068428,RLK
chr04,Bn13747,63656154,69379933,5723779,RLK
chr04,Bn13748,6309853,94775651,88465798,NBS
chr04,Bn13749,27575613,98745444,71169831,NBS
chr04,Bn13750,22536307,72531086,49994779,RLP
chr04,Bn13751,36252083,55101773,18849690,RLK
chr04,Bn13752,22576032,48296407,25720375,CNL
chr04,Bn13753,69592105,87799910,18207805,RLP
chr04,Bn13754,17960399,84624084,66663685,CNL
chr04,Bn13755,2420618,6412179,3991561,NBS
chr04,Bn13756,96524117,99831198,3307081,TN
chr04,Bn13757,92032697,92328740,296043,RLP
chr04,Bn13758,2542137,12807634,10265497,NBS
chr04,Bn13759,4782332,73699334,68917002,TNL
chr04,Bn13760,98115423,98640267,524844,TN
chr04,Bn13761,62817487,92581882,29764395,NBS
chr04,Bn13762,79489946,91346182,11856236,CNL
chr04,Bn13763,11653560,25400628,13747068,CNL
chr04,Bn13764,55438931,77657167,22218236,NBS
chr04,Bn13765,10205596,49529389,39323793,RLP
chr04,Bn13766,97091418,99525250,2433832,CN
chr04,Bn13767,86286508,87851095,1564587,CNL
chr04,Bn13768,31580258,67381291,35801033,CN
chr04,Bn13769,73736895,78289109,4552214,NBS
chr04,Bn13770,46063134,80447798,34384664,RLP
chr04,Bn13771,35885247,54570265,18685018,RLP
chr04,Bn13772,4022893,44007434,39984541,RLP
chr04,Bn13773,94946669,97896734,2950065,RLP
chr04,Bn13774,62636991,73103652,10466661,CNL
chr04,Bn13775,48145737,90890703,42744966,NBS
chr04,Bn13776,28849714,69223490,40373776,CN
chr04,Bn13777,77041612,86633140,9591528,TN
chr04,Bn13778,46373712,83521619,37147907,RLP
chr04,Bn13779,9215735,93091747,83876012,TNL
chr04,Bn13780,59553575,76401091,16847516,TN
chr04,Bn13781,52650621,94654095,42003474,TNL
chr04,Bn13782,85013715,94116435,9102720,RLK
chr04,Bn13783,34849484,39359523,4510039,CNL
chr04,Bn13784,1235569,63673736,62438167,CNL
chr04,Bn13785,85249238,99547335,14298097,CNL
chr04,Bn13786,99808940,99891689,82749,CNL
chr04,Bn13787,25946380,71212163,45265783,TN
chr04,Bn13788,82600573,97007588,14407015,TN
chr04,Bn13789,49874770,57347966,7473196,CN
chr04,Bn13790,13267954,17690646,4422692,NBS
chr04,Bn13791,86773382,91241362,4467980,CN
chr04,Bn13792,53282567,95783580,42501013,CNL
chr04,Bn13793,41265142,64756807,23491665,NBS
chr04,Bn13794,66734039,94405356,27671317,RLP
chr04,Bn13795,67403719,71257108,3853389,CNL
chr04,Bn13796,64629838,72996944,8367106,CNL
chr04,Bn13797,92931497,99833576,6902079,CNL
chr04,Bn13798,21521211,23770876,2249665,TNL
chr04,Bn13799,99848216,99928738,80522,CN
chr04,Bn13800,43197980,58758140,15560160,NBS
chr04,Bn13801,30354430,54027483,23673053,RLK
chr04,Bn13802,18277711,80365802,62088091,TN
chr04,Bn13803,48326656,94289292,45962636,NBS
chr04,Bn13804,82155213,97734038,15578825,TN
chr04,Bn13805,62040839,73958210,11917371,RLK
chr04,Bn13806,98294579,99270884,976305,RLK
chr04,Bn13807,42020143,88962939,46942796,CNL
chr04,Bn13808,32729614,88101135,55371521,TNL
chr04,Bn13809,53143501,91566163,38422662,RLK
chr04,Bn13810,93126675,93184196,57521,CNL
chr04,Bn13811,9556292,77776937,68220645,CN
chr04,Bn13812,1176407,54389341,53212934,NBS
chr04,Bn13813,25527621,32193945,6666324,TNL
chr04,Bn13814,78700429,85264739,6564310,RLP
chr04,Bn13815,46790580,66577118,19786538,RLK
chr04,Bn13816,80667348,89891444,9224096,TNL
chr04,Bn13817,54907202,94081139,39173937,CN
chr04,Bn13818,65747199,90254878,24507679,TN
chr04,Bn13819,95001796,99865878,4864082,TN
chr04,Bn13820,39675676,75322883,35647207,CNL
chr04,Bn13821,65888795,79542736,13653941,RLP
chr04,Bn13822,71105293,71898730,793437,RLP
chr04,Bn13823,5869788,83821914,77952126,TN
chr04,Bn13824,90247698,95250181,5002483,TN
chr04,Bn13825,83583101,97766422,14183321,RLP
chr04,Bn13826,67069949,76718921,9648972,CNL
chr04,Bn13827,98640372,99896681,1256309,RLK
chr04,Bn13828,50577284,97079343,46502059,CNL
chr04,Bn13829,88303142,93090416,4787274,CN
chr04,Bn13830,79643912,81975044,2331132,RLP
chr04,Bn13831,12080230,18162880,6082650,RLP
chr04,Bn13832,13222532,67985647,54763115,CNL
chr04,Bn13833,87795535,93829970,6034435,NBS
chr04,Bn13834,87066241,87331090,264849,RLK
chr04,Bn13835,7779149,87256616,79477467,TN
chr04,Bn13836,7736621,30456099,22719478,RLK
chr04,Bn13837,8433185,22045695,13612510,NBS
chr04,Bn13838,12714185,74565434,61851249,TNL
chr04,Bn13839,17745859,49133783,31387924,TNL
chr04,Bn13840,15724104,18309594,2585490,CN
chr04,Bn13841,20792327,33318491,12526164,CN
chr04,Bn13842,53852199,94927045,41074846,RLK
chr04,Bn13843,33639800,99632072,65992272,TNL
chr04,Bn13844,4922184,34322483,29400299,CN
chr04,Bn13845,40978057,66563258,25585201,CNL
chr04,Bn13846,74106375,94812295,20705920,NBS
chr04,Bn13847,10673296,65147633,54474337,NBS
chr04,Bn13848,81250670,90081652,8830982,NBS
chr04,Bn13849,47629198,85307928,37678730,TNL
chr04,Bn13850,66190479,96110607,29920128,TN
chr04,Bn13851,49969242,70564213,20594971,RLP
chr04,Bn13852,5662038,80568330,74906292,CN
chr04,Bn13853,27983678,41241615,13257937,TN
chr04,Bn13854,97863302,98284223,420921,RLP
chr04,Bn13855,24237917,95036693,70798776,TNL
chr04,Bn13856,23785698,76722208,52936510,RLK
chr04,Bn13857,16481659,65116269,48634610,NBS
chr04,Bn13858,67699517,99175256,31475739,TN
chr04,Bn13859,74126155,86996195,12870040,CNL
chr04,Bn13860,16422232,37772418,21350186,CNL
chr04,Bn13861,18683532,20930313,2246781,NBS
chr04,Bn13862,44897435,47323094,2425659,TNL
chr04,Bn13863,63175891,93497793,30321902,TN
chr04,Bn13864,10124085,54570222,44446137,CN
chr04,Bn13865,75101027,86461345,11360318,CNL
chr04,Bn13866,35539521,59773188,24233667,RLP
chr04,Bn13867,33957133,64541123,30583990,RLK
chr04,Bn13868,2492956,15311762,12818806,CN
chr04,Bn13869,83875412,97283900,13408488,CNL
chr04,Bn13870,29273485,59043938,29770453,NBS
chr04,Bn13871,34254850,77243832,42988982,TN
chr04,Bn13872,44040258,96816969,52776711,TN
chr04,Bn13873,99334728,99652509,317781,TNL
chr04,Bn13874,30849564,37670613,6821049,CNL
chr04,Bn13875,85408165,92431502,7023337,RLP
chr04,Bn13876,76776579,84981633,8205054,TNL
chr04,Bn13877,97141951,98129076,987125,NBS
chr04,Bn13878,23386753,33285163,9898410,NBS
chr04,Bn13879,83114360,91846576,8732216,CNL
chr04,Bn13880,84220781,84398607,177826,RLK
chr04,Bn13881,22195704,38112369,15916665,RLK
chr04,Bn13882,1492560,93111050,91618490,NBS
chr04,Bn13883,88749828,90453747,1703919,CNL
chr04,Bn13884,76030209,91908726,15878517,NBS
chr04,Bn13885,23354436,62081366,38726930,TNL
chr04,Bn13886,86793836,87344612,550776,NBS
chr04,Bn13887,57220262,69633894,12413632,RLP
chr04,Bn13888,86572864,94017007,7444143,CN
chr04,Bn13889,40376659,60332688,19956029,NBS
chr04,Bn13890,5060963,41467939,36406976,TN
chr04,Bn13891,93890820,99029623,5138803,NBS
chr04,Bn13892,73643173,88101232,14458059,RLP
chr04,Bn13893,29600466,47227989,17627523,RLP
chr04,Bn13894,6983519,76647409,69663890,CNL
chr04,Bn13895,3992910,25388757,21395847,CNL
chr04,Bn13896,4422509,29899696,25477187,RLP
chr04,Bn13897,36136021,97586156,61450135,CNL
chr04,Bn13898,76759462,93765312,17005850,RLP
chr04,Bn13899,56974254,82851370,25877116,TN
chr04,Bn13900,89950075,95984042,6033967,TNL
chr04,Bn13901,4815605,98235830,93420225,RLK
chr04,Bn13902,81466812,89101139,7634327,RLK
chr04,Bn13903,10726267,10959587,233320,RLK
chr04,Bn13904,7048958,15548180,8499222,CN
chr04,Bn13905,91617373,97231055,5613682,RLK
chr04,Bn13906,48079234,74598034,26518800,NBS
chr04,Bn13907,48270188,58091096,9820908,RLK
chr04,Bn13908,88812916,91847893,3034977,TNL
chr04,Bn13909,36163227,83031013,46867786,CN
chr04,Bn13910,10800391,67467689,56667298,TNL
chr04,Bn13911,91655645,98035756,6380111,RLP
chr04,Bn13912,87595137,94758594,7163457,CNL
chr04,Bn13913,33684573,35538829,1854256,RLK
chr04,Bn13914,98358744,98697589,338845,NBS
chr04,Bn13915,11201178,87242526,76041348,TNL
chr04,Bn13916,6459475,14434602,7975127,CN
chr04,Bn13917,31357628,76264999,44907371,NBS
chr04,Bn13918,55636504,93199794,37563290,CNL
chr04,Bn13919,73937524,76374215,2436691,TN
chr04,Bn13920,86548454,93333854,6785400,TNL
chr04,Bn13921,9172139,83229377,74057238,TNL
chr04,Bn13922,49742428,58498505,8756077,RLK
chr04,Bn13923,10667405,22727173,12059768,RLK
chr04,Bn13924,4336220,91941594,87605374,RLP
chr04,Bn13925,99950131,99995857,45726,NBS
chr04,Bn13926,1269161,34036227,32767066,RLP
chr04,Bn13927,71930319,86639135,14708816,TN
chr04,Bn13928,90190627,90205678,15051,RLK
chr04,Bn13929,32549407,67500887,34951480,CN
chr04,Bn13930,97974641,99246745,1272104,TNL
chr04,Bn13931,23721817,54551438,30829621,TN
chr04,Bn13932,46234075,53575582,7341507,RLK
chr04,Bn13933,7604692,50169330,42564638,RLK
chr04,Bn13934,18790569,35559369,16768800,TNL
chr04,Bn13935,82405210,98814363,16409153,TN
chr04,Bn13936,64685802,86720185,22034383,RLK
chr04,Bn13937,74854964,83746819,8891855,CN
chr04,Bn13938,9597927,73923194,64325267,CN
chr04,Bn13939,43679650,65712119,22032469,RLK
chr04,Bn13940,67914356,70135866,2221510,CNL
chr04,Bn13941,98113639,99316955,1203316,CNL
chr04,Bn13942,26596551,35335891,8739340,RLK
chr04,Bn13943,41015427,50925033,9909606,TN
chr04,Bn13944,21615812,96677710,75061898,NBS
chr04,Bn13945,66066376,96240930,30174554,RLK
chr04,Bn13946,36415399,70979770,34564371,TNL
chr04,Bn13947,33464683,93738758,60274075,RLP
chr04,Bn13948,46610451,70516529,23906078,NBS
chr04,Bn13949,9231463,65277255,56045792,RLK
chr04,Bn13950,10757083,91678234,80921151,NBS
chr04,Bn13951,41582134,55875603,14293469,RLK
chr04,Bn13952,26873139,53448358,26575219,TN
chr04,Bn13953,8154497,25500470,17345973,TNL
chr04,Bn13954,63338822,79350175,16011353,TNL
chr04,Bn13955,26886101,77082066,50195965,TN
chr04,Bn13956,72950176,86137402,13187226,CN
chr04,Bn13957,65630772,92124708,26493936,RLP
chr04,Bn13958,48236088,88502736,40266648,RLP
chr04,Bn13959,80665834,90251037,9585203,RLP
chr04,Bn13960,74114538,83873579,9759041,CN
chr04,Bn13961,70587853,76475128,5887275,TN
chr04,Bn13962,36390368,37651006,1260638,CN
chr04,Bn13963,8196931,90051020,81854089,NBS
chr04,Bn13964,99502031,99796970,294939,RLP
chr04,Bn13965,5804294,65184759,59380465,RLP
chr04,Bn13966,75290266,85127521,9837255,CNL
chr04,Bn13967,1224729,53184730,51960001,TN
chr04,Bn13968,76025853,84375073,8349220,TN
chr04,Bn13969,6607778,93496697,86888919,TN
chr04,Bn13970,7795598,87030857,79235259,RLK
chr04,Bn13971,11102338,11266799,164461,TNL
chr04,Bn13972,13522714,83837232,70314518,TN
chr04,Bn13973,81687872,84320399,2632527,TN
chr04,Bn13974,92915665,96076941,3161276,RLK
chr04,Bn13975,58846844,99579389,40732545,TNL
chr04,Bn13976,47680864,54177474,6496610,CNL
chr04,Bn13977,86930360,99983082,13052722,RLP
chr04,Bn13978,57915859,89602318,31686459,RLP
chr04,Bn13979,57319659,73753625,16433966,CNL
chr04,Bn13980,75294587,80895088,5600501,TNL
chr04,Bn13981,72070625,77095915,5025290,TNL
chr04,Bn13982,97237002,99530628,2293626,CN
chr04,Bn13983,69150540,86068024,16917484,NBS
chr04,Bn13984,78614507,83526075,4911568,TNL
chr04,Bn13985,2882867,31610641,28727774,CN
chr04,Bn13986,62876134,63150740,274606,TNL
chr04,Bn13987,15171334,74149515,58978181,TNL
chr04,Bn13988,60933872,72062188,11128316,RLK
chr04,Bn13989,99113854,99964651,850797,TNL
chr04,Bn13990,36501755,84328324,47826569,RLP
chr04,Bn13991,69846444,99326477,29480033,CN
chr04,Bn13992,72914038,89063004,16148966,TNL
chr04,Bn13993,12076492,62584582,50508090,RLP
chr04,Bn13994,28030109,77699808,49669699,CN
chr04,Bn13995,43707232,57759543,14052311,RLP
chr04,Bn13996,10709680,86238103,75528423,RLP
chr04,Bn13997,45806150,83306639,37500489,CNL
chr04,Bn13998,14090777,63517369,49426592,TNL
chr04,Bn13999,78594368,91705374,13111006,TNL
chr04,Bn14000,95704013,99943724,4239711,TN
chr04,Bn14001,29806209,89993238,60187029,RLP
chr04,Bn14002,78401801,79174188,772387,CN
chr04,Bn14003,55624704,72696126,17071422,NBS
chr04,Bn14004,90685203,94767202,4081999,TN
chr04,Bn14005,6416127,62391081,55974954,CN
chr04,Bn14006,19376586,78450116,59073530,CN
chr04,Bn14007,8860434,49539030,40678596,CNL
chr04,Bn14008,93231847,93954709,722862,TNL
chr04,Bn14009,54729060,57324489,2595429,TN
chr04,Bn14010,62103579,62843090,739511,CNL
chr04,Bn14011,31155867,93609708,62453841,CN
chr04,Bn14012,37364486,93725642,56361156,CNL
chr04,Bn14013,27078818,67721480,40642662,CN
chr04,Bn14014,67027172,86871050,19843878,CN
chr04,Bn14015,42048911,63151697,21102786,RLP
chr04,Bn14016,43037598,74060800,31023202,RLP
chr04,Bn14017,31424773,57369122,25944349,TN
chr04,Bn14018,61972583,81980631,20008048,TNL
chr04,Bn14019,20160305,75512207,55351902,RLP
chr04,Bn14020,62238840,79063922,16825082,TN
chr04,Bn14021,75092948,76304547,1211599,CNL
chr04,Bn14022,52396579,73419540,21022961,RLK
chr04,Bn14023,66144047,77527785,11383738,CN
chr04,Bn14024,58014463,93594829,35580366,RLP
chr04,Bn14025,23650195,62879815,39229620,RLK
chr04,Bn14026,2952614,70312523,67359909,RLK
chr04,Bn14027,53595857,54086073,490216,TN
chr04,Bn14028,42608733,57000836,14392103,RLP
chr04,Bn14029,45699405,52439181,6739776,CN
chr04,Bn14030,61014569,76343670,15329101,CN
chr04,Bn14031,9114033,47135268,38021235,CNL
chr04,Bn14032,1056659,64477032,63420373,TNL
chr04,Bn14033,45159553,62553452,17393899,CNL
chr04,Bn14034,19975327,75786624,55811297,TNL
chr04,Bn14035,80853589,90414509,9560920,TNL
chr04,Bn14036,34696774,43469992,8773218,RLK
chr04,Bn14037,68189497,76041093,7851596,TN
chr04,Bn14038,71329935,85610725,14280790,RLK
chr04,Bn14039,77016636,79193413,2176777,RLP
chr04,Bn14040,84370161,87101686,2731525,CNL
chr04,Bn14041,62314881,89098997,26784116,NBS
chr04,Bn14042,95225905,96295860,1069955,RLK
chr04,Bn14043,21310293,24803685,3493392,CNL
chr04,Bn14044,11305653,22907296,11601643,RLP
chr04,Bn14045,89874645,96731648,6857003,CNL
chr04,Bn14046,44063421,67958469,23895048,NBS
chr04,Bn14047,54397538,67783904,13386366,CNL
chr04,Bn14048,64111648,81845609,17733961,RLK
chr04,Bn14049,49576699,90584042,41007343,CNL
chr04,Bn14050,84442082,88145664,3703582,CNL
chr04,Bn14051,57530564,98351050,40820486,TN
chr04,Bn14052,74164835,87184992,13020157,RLK
chr04,Bn14053,66898569,96558933,29660364,CN
chr04,Bn14054,11724401,68665540,56941139,CNL
chr04,Bn14055,1969491,9405942,7436451,CN
chr04,Bn14056,51762929,71077650,19314721,RLK
chr04,Bn14057,89107580,94092350,4984770,RLP
chr04,Bn14058,49274500,88535465,39260965,RLK
chr04,Bn14059,72067082,73299540,1232458,CNL
chr04,Bn14060,84050476,86291205,2240729,RLP
chr04,Bn14061,34872147,42183365,7311218,TNL
chr04,Bn14062,46776898,85692681,38915783,CN
chr04,Bn14063,29840422,82852306,53011884,TN
chr04,Bn14064,23530899,63581908,40051009,TNL
chr04,Bn14065,36118199,75829499,39711300,TN
chr04,Bn14066,34695152,69799730,35104578,NBS
chr04,Bn14067,48127080,92991612,44864532,CN
chr04,Bn14068,80807280,87606239,6798959,RLP
chr04,Bn14069,79244074,91837990,12593916,CNL
chr04,Bn14070,22012792,96847768,74834976,NBS
chr04,Bn14071,36879278,61019754,24140476,NBS
chr04,Bn14072,51031639,90268663,39237024,CN
chr04,Bn14073,76287705,76515053,227348,TN
chr04,Bn14074,35177157,49468098,14290941,TNL
chr04,Bn14075,27804248,84004281,56200033,TN
chr04,Bn14076,27587675,68140401,40552726,RLP
chr04,Bn14077,17805612,64869272,47063660,CNL
chr04,Bn14078,96355899,97316223,960324,CN
chr04,Bn14079,3394889,49518324,46123435,NBS
chr04,Bn14080,58155466,69311853,11156387,CNL
chr04,Bn14081,37696100,94942546,57246446,RLP
chr04,Bn14082,36620491,44724507,8104016,CNL
chr04,Bn14083,14013467,80239773,66226306,NBS
chr04,Bn14084,42580647,86936905,44356258,CN
chr04,Bn14085,68112874,76084003,7971129,RLP
chr04,Bn14086,17960935,66520630,48559695,RLK
chr04,Bn14087,54719087,97530111,42811024,CN
chr04,Bn14088,10545435,15796470,5251035,NBS
chr04,Bn14089,66735741,66850227,114486,CNL
chr04,Bn14090,74460491,89430094,14969603,TNL
chr04,Bn14091,48649621,54006284,5356663,NBS
chr04,Bn14092,60026418,70599062,10572644,CNL
chr04,Bn14093,95517829,97712462,2194633,NBS
chr04,Bn14094,99153722,99901835,748113,RLP
chr04,Bn14095,39649469,56713510,17064041,CNL
chr04,Bn14096,38982693,59349866,20367173,TNL
chr04,Bn14097,6738699,20001225,13262526,RLK
chr04,Bn14098,61921000,88178078,26257078,NBS
chr04,Bn14099,12993141,44976199,31983058,RLP
chr04,Bn14100,87359436,96622765,9263329,TNL
chr04,Bn14101,1149243,8766166,7616923,CN
chr04,Bn14102,66523461,99264302,32740841,CN
chr04,Bn14103,36665959,57042798,20376839,NBS
chr04,Bn14104,73318420,90443920,17125500,RLP
chr04,Bn14105,71036355,78419288,7382933,TNL
chr04,Bn14106,50796947,96900881,46103934,TNL
chr04,Bn14107,38368320,69466145,31097825,TN
chr04,Bn14108,77283105,84002041,6718936,TNL
chr04,Bn14109,91460328,98715461,7255133,CNL
chr04,Bn14110,96837927,97322389,484462,TNL
chr04,Bn14111,60443015,95098260,34655245,TNL
chr04,Bn14112,29958727,78570734,48612007,TNL
chr04,Bn14113,36781814,83950130,47168316,TN
chr04,Bn14114,49766541,51539806,1773265,CN
chr04,Bn14115,84088647,96111982,12023335,RLP
chr04,Bn14116,41509062,48936905,7427843,TNL
chr04,Bn14117,30851132,65162288,34311156,CN
chr04,Bn14118,90966354,94014425,3048071,RLK
chr04,Bn14119,28087831,64857643,36769812,TN
chr04,Bn14120,77521591,80322562,2800971,CNL
chr04,Bn14121,75973739,93409737,17435998,CN
chr04,Bn14122,42461709,51379384,8917675,CNL
chr04,Bn14123,19001363,51443921,32442558,TN
chr04,Bn14124,38320139,84234647,45914508,CN
chr04,Bn14125,96833893,97421568,587675,TNL
chr04,Bn14126,96940221,99474002,2533781,TN
chr04,Bn14127,5398644,84062605,78663961,TN
chr04,Bn14128,73819586,75449193,1629607,RLP
chr04,Bn14129,27616573,46065677,18449104,CNL
chr04,Bn14130,45619701,86789683,41169982,TNL
chr04,Bn14131,77623715,95187817,17564102,CNL
chr04,Bn14132,30792147,84224463,53432316,TNL
chr04,Bn14133,97812144,98507269,695125,TNL
chr04,Bn14134,95345326,96719898,1374572,CNL
chr04,Bn14135,53747059,84662971,30915912,NBS
chr04,Bn14136,11166045,79175786,68009741,TNL
chr04,Bn14137,63670086,69997982,6327896,RLK
chr04,Bn14138,65529222,73845339,8316117,TN
chr04,Bn14139,67590433,92896378,25305945,CNL
chr04,Bn14140,3042657,16501704,13459047,RLP
chr04,Bn14141,78126332,96805001,18678669,CNL
chr04,Bn14142,70732560,98560256,27827696,RLK
chr04,Bn14143,79415619,93207146,13791527,NBS
chr04,Bn14144,95104103,95545248,441145,TN
chr04,Bn14145,17488660,50384663,32896003,TNL
chr04,Bn14146,56368175,98060665,41692490,RLK
chr04,Bn14147,16674242,73603480,56929238,CNL
chr04,Bn14148,51922977,54798574,2875597,TNL
chr04,Bn14149,90981329,98932450,7951121,RLP
chr04,Bn14150,51622703,79417750,27795047,TNL
chr04,Bn14151,46990453,82160532,35170079,CN
chr04,Bn14152,38937047,96010281,57073234,NBS
chr04,Bn14153,37688827,84859905,47171078,NBS
chr04,Bn14154,80701240,82152729,1451489,CN
chr04,Bn14155,4571455,35302591,30731136,RLP
chr04,Bn14156,34015049,98435253,64420204,TN
chr04,Bn14157,48249803,49282327,1032524,CN
chr04,Bn14158,15426468,85326440,69899972,RLK
chr04,Bn14159,56591585,80219526,23627941,RLP
chr04,Bn14160,13630523,41562116,27931593,CN
chr04,Bn14161,58522418,80195364,21672946,RLK
chr04,Bn14162,27987104,75221992,47234888,CN
chr04,Bn14163,74595120,91046143,16451023,TN
chr04,Bn14164,35531685,75980229,40448544,RLP
chr04,Bn14165,48794504,64381107,15586603,CNL
chr04,Bn14166,43812935,97946695,54133760,CNL
chr04,Bn14167,15192931,83363085,68170154,RLK
chr04,Bn14168,18840177,51105001,32264824,CN
chr04,Bn14169,89548235,96378531,6830296,CNL
chr04,Bn14170,48190462,87789457,39598995,TNL
chr04,Bn14171,84546848,96881415,12334567,CN
chr04,Bn14172,88956617,91247830,2291213,TNL
chr04,Bn14173,44823322,72106376,27283054,RLK
chr04,Bn14174,46104249,80281164,34176915,TN
chr04,Bn14175,12380682,80261347,67880665,CNL
chr04,Bn14176,87821060,90289087,2468027,RLP
chr04,Bn14177,45404477,86148909,40744432,CNL
chr04,Bn14178,7935943,89771466,81835523,TNL
chr04,Bn14179,86971795,99212664,12240869,NBS
chr04,Bn14180,94351240,95401911,1050671,CN
chr04,Bn14181,84281218,92883083,8601865,TN
chr04,Bn14182,37670406,47151365,9480959,RLK
chr04,Bn14183,75952979,92014193,16061214,RLK
chr04,Bn14184,72108510,89995242,17886732,RLP
chr04,Bn14185,54492485,79753568,25261083,RLK
chr04,Bn14186,47538280,56396510,8858230,RLP
chr04,Bn14187,31709759,94081082,62371323,TNL
chr04,Bn14188,29799837,70480800,40680963,RLK
chr04,Bn14189,12830507,43098362,30267855,TNL
chr04,Bn14190,97091025,98528701,1437676,TNL
chr04,Bn14191,37597464,89706406,52108942,RLP
chr04,Bn14192,14637041,62273133,47636092,RLK
chr04,Bn14193,87427061,90237999,2810938,CNL
chr04,Bn14194,65143502,89056094,23912592,CN
chr04,Bn14195,7159348,24794744,17635396,NBS
chr04,Bn14196,54523168,87450401,32927233,CN
chr04,Bn14197,19263727,20244882,981155,CN
chr04,Bn14198,2064763,41556426,39491663,RLP
chr04,Bn14199,12200487,73283611,61083124,NBS
chr04,Bn14200,96085322,97720432,1635110,TN
chr04,Bn14201,22346369,85547432,63201063,CN
chr04,Bn14202,37685515,78258018,40572503,CN
chr04,Bn14203,70384910,94334736,23949826,CN
chr04,Bn14204,29167649,34332129,5164480,NBS
chr04,Bn14205,17577994,18265080,687086,NBS
chr04,Bn14206,22571198,65534594,42963396,RLP
chr04,Bn14207,68535844,97607015,29071171,TN
chr04,Bn14208,46468205,55810517,9342312,RLP
chr04,Bn14209,56395847,62667345,6271498,RLP
chr04,Bn14210,75010566,97661452,22650886,RLP
chr04,Bn14211,40179171,67535378,27356207,CN
chr04,Bn14212,56502560,80219611,23717051,TNL
chr04,Bn14213,44114488,79150087,35035599,RLK
chr04,Bn14214,39741490,49366375,9624885,CNL
chr04,Bn14215,6826801,14229705,7402904,NBS
chr04,Bn14216,26493497,56316381,29822884,NBS
chr04,Bn14217,55503312,69099466,13596154,CN
chr04,Bn14218,87048667,91008788,3960121,CN
chr04,Bn14219,85324012,89726827,4402815,TNL
chr04,Bn14220,94113683,98553704,4440021,TN
chr04,Bn14221,2573902,27104590,24530688,NBS
chr04,Bn14222,82270712,98513248,16242536,RLK
chr04,Bn14223,67566515,68745888,1179373,RLK
chr04,Bn14224,18141756,53721313,35579557,CN
chr04,Bn14225,76371147,92505106,16133959,RLP
chr04,Bn14226,92093460,95823911,3730451,CN
chr04,Bn14227,60896373,78360833,17464460,TNL
chr04,Bn14228,77781455,96331033,18549578,RLP
chr04,Bn14229,20233613,28872905,8639292,NBS
chr04,Bn14230,80003709,88854425,8850716,RLK
chr04,Bn14231,26068702,52920257,26851555,CNL
chr04,Bn14232,35751622,41195148,5443526,RLP
chr04,Bn14233,8515869,8783989,268120,TN
chr04,Bn14234,43822480,74736546,30914066,CN
chr04,Bn14235,40140670,81673634,41532964,CNL
chr04,Bn14236,7181647,83034887,75853240,TN
chr04,Bn14237,56303845,78536813,22232968,CN
chr04,Bn14238,54409441,73891879,19482438,CNL
chr04,Bn14239,2058535,2303753,245218,CNL
chr04,Bn14240,47780126,64800369,17020243,CNL
chr04,Bn14241,35620528,40967688,5347160,TNL
chr04,Bn14242,6556603,40259868,33703265,CN
chr04,Bn14243,77382326,87531674,10149348,TNL
chr04,Bn14244,6139314,98800422,92661108,TN
chr04,Bn14245,61408488,93334156,31925668,CN
chr04,Bn14246,64129836,98924715,34794879,TN
chr04,Bn14247,3784841,78664464,74879623,CN
chr04,Bn14248,78882869,84893848,6010979,TNL
chr04,Bn14249,11396397,46431307,35034910,CNL
chr04,Bn14250,79196691,82456849,3260158,RLP
chr04,Bn14251,6065046,66570176,60505130,CN
chr04,Bn14252,12153460,17309294,5155834,CNL
chr04,Bn14253,4667822,37322562,32654740,CN
chr04,Bn14254,89885432,94578968,4693536,CNL
chr04,Bn14255,69186162,90023346,20837184,RLP
chr04,Bn14256,14876387,19930044,5053657,CN
chr04,Bn14257,90845744,94309708,3463964,TNL
chr04,Bn14258,61506208,98834910,37328702,TN
chr04,Bn14259,32313072,97003809,64690737,NBS
chr04,Bn14260,41625124,57422863,15797739,TNL
chr04,Bn14261,24880758,75018831,50138073,CN
chr04,Bn14262,72559067,88779818,16220751,TNL
chr04,Bn14263,17440824,73556966,56116142,TNL
chr04,Bn14264,74474506,81069828,6595322,RLP
chr04,Bn14265,21461745,24017726,2555981,RLP
chr04,Bn14266,52678110,87104107,34425997,TNL
chr04,Bn14267,48576321,88149793,39573472,CNL
chr04,Bn14268,35670553,66814804,31144251,CNL
chr04,Bn14269,50094141,71628741,21534600,RLP
chr04,Bn14270,91562887,98434480,6871593,TNL
chr04,Bn14271,17639078,41906200,24267122,RLP
chr04,Bn14272,53721160,54931839,1210679,CNL
chr04,Bn14273,17862955,79987791,62124836,TN
chr04,Bn14274,34939121,72260800,37321679,TN
chr04,Bn14275,46037107,72299413,26262306,TNL
chr04,Bn14276,1321647,52570986,51249339,TNL
chr04,Bn14277,22587563,24655384,2067821,RLP
chr04,Bn14278,1582552,51745771,50163219,TNL
chr04,Bn14279,82113143,89201384,7088241,RLP
chr04,Bn14280,81060019,89217670,8157651,RLP
chr04,Bn14281,13270771,21070091,7799320,TN
chr04,Bn14282,49194995,80482440,31287445,TN
chr04,Bn14283,84197752,90800036,6602284,TN
chr04,Bn14284,91373611,96871427,5497816,NBS
chr04,Bn14285,23057691,27424510,4366819,CNL
chr04,Bn14286,62748115,78545614,15797499,CNL
chr04,Bn14287,56129959,86350177,30220218,NBS
chr04,Bn14288,89210572,92610185,3399613,RLK
chr04,Bn14289,76149917,98954352,22804435,CNL
chr04,Bn14290,98683974,99117718,433744,RLP
chr04,Bn14291,58434962,60606444,2171482,RLP
chr04,Bn14292,74933941,98717079,23783138,RLK
chr04,Bn14293,77907089,84671710,6764621,RLP
chr04,Bn14294,10285932,88612343,78326411,TNL
chr04,Bn14295,13319692,34906489,21586797,NBS
chr04,Bn14296,98920181,98972850,52669,TNL
chr04,Bn14297,83455963,95373670,11917707,CN
chr04,Bn14298,33741544,63803697,30062153,CNL
chr04,Bn14299,63193993,67174755,3980762,RLP
chr04,Bn14300,6179886,61061203,54881317,RLK
chr04,Bn14301,10700573,96684310,85983737,CNL
chr04,Bn14302,52836187,74171485,21335298,RLK
chr04,Bn14303,93966503,97980652,4014149,TN
chr04,Bn14304,7167220,71580942,64413722,RLK
chr04,Bn14305,49871770,63163500,13291730,RLK
chr04,Bn14306,63694942,84435334,20740392,TN
chr04,Bn14307,13653919,51482707,37828788,TNL
chr04,Bn14308,50075700,91377981,41302281,CNL
chr04,Bn14309,37457228,87069882,49612654,TNL
chr04,Bn14310,12065492,92506475,80440983,TNL
chr04,Bn14311,5048870,27712541,22663671,NBS
chr04,Bn14312,17052404,81454572,64402168,TNL
chr04,Bn14313,26569803,82306611,55736808,RLP
chr04,Bn14314,2896311,46453297,43556986,TN
chr04,Bn14315,3781141,75792740,72011599,NBS
chr04,Bn14316,34428642,92537815,58109173,RLP
chr04,Bn14317,36431468,77373945,40942477,TN
chr04,Bn14318,38680902,58997138,20316236,CNL
chr04,Bn14319,15845862,40341526,24495664,NBS
chr04,Bn14320,70046458,89588493,19542035,CNL
chr04,Bn14321,96939827,99787555,2847728,RLP
chr04,Bn14322,36383816,56061663,19677847,RLK
chr04,Bn14323,60278856,87466684,27187828,RLP
chr04,Bn14324,72094264,93138375,21044111,TNL
chr04,Bn14325,16144245,76518738,60374493,NBS
chr04,Bn14326,65914959,95500469,29585510,CN
chr04,Bn14327,17264521,27791639,10527118,TN
chr04,Bn14328,24254796,92089278,67834482,CN
chr04,Bn14329,2892991,75662416,72769425,TNL
chr04,Bn14330,84101874,96785169,12683295,CN
chr04,Bn14331,50654591,67568095,16913504,TN
chr04,Bn14332,41253023,51519922,10266899,TNL
chr04,Bn14333,72214101,87201301,14987200,TN
chr04,Bn14334,84912511,85752744,840233,TN
chr04,Bn14335,56960469,66031343,9070874,RLK
chr04,Bn14336,11260401,79383507,68123106,RLP
chr04,Bn14337,17804320,21890528,4086208,RLP
chr04,Bn14338,26883915,97924091,71040176,TN
chr04,Bn14339,25269198,73527482,48258284,RLK
chr04,Bn14340,66358964,74322124,7963160,RLK
chr04,Bn14341,9414653,30344836,20930183,TNL
chr04,Bn14342,34706566,43526375,8819809,CN
chr04,Bn14343,18192773,96070466,77877693,CN
chr04,Bn14344,72667940,98565839,25897899,TN
chr04,Bn14345,36146541,38806387,2659846,RLP
chr04,Bn14346,90202750,90229737,26987,CNL
chr04,Bn14347,87197985,98326281,11128296,NBS
chr04,Bn14348,66116538,92489430,26372892,NBS
chr04,Bn14349,38328389,59590567,21262178,CNL
chr04,Bn14350,86510933,89737633,3226700,NBS
chr04,Bn14351,67921866,81372278,13450412,CNL
chr04,Bn14352,32019943,87848684,55828741,TN
chr04,Bn14353,29809414,75678167,45868753,RLK
chr04,Bn14354,31857761,92352438,60494677,RLP
chr04,Bn14355,11408631,59695192,48286561,RLK
chr04,Bn14356,10179182,57614823,47435641,NBS
chr04,Bn14357,29850098,87956534,58106436,TNL
chr04,Bn14358,63533721,74840458,11306737,TN
chr04,Bn14359,23983714,78716112,54732398,TN
chr04,Bn14360,20967709,87039140,66071431,TNL
chr04,Bn14361,51112833,93435280,42322447,TN
chr04,Bn14362,54043388,76876695,22833307,NBS
chr04,Bn14363,77360072,77879403,519331,TN
chr04,Bn14364,60360471,75543529,15183058,RLK
chr04,Bn14365,39801074,91957920,52156846,TN
chr04,Bn14366,76188020,94811845,18623825,NBS
chr04,Bn14367,39300755,72145624,32844869,NBS
chr04,Bn14368,61957896,83283805,21325909,TNL
chr04,Bn14369,98158668,99673543,1514875,TNL
chr04,Bn14370,12997727,41561983,28564256,CNL
chr04,Bn14371,14563946,96849880,82285934,CN
chr04,Bn14372,78342717,78699123,356406,TN
chr04,Bn14373,2194531,6174124,3979593,CNL
chr04,Bn14374,78043975,90705571,12661596,CNL
chr04,Bn14375,40847328,43656792,2809464,TN
chr04,Bn14376,53011783,64034240,11022457,RLK
chr04,Bn14377,65152741,80347813,15195072,TNL
chr04,Bn14378,81756322,84673861,2917539,NBS
chr04,Bn14379,3883848,83014364,79130516,NBS
chr04,Bn14380,9500064,28372422,18872358,RLP
chr04,Bn14381,66028909,94601030,28572121,TNL
chr04,Bn14382,80040596,84838571,4797975,RLP
chr04,Bn14383,40901867,73434599,32532732,CN
chr04,Bn14384,34982353,91895483,56913130,RLP
chr04,Bn14385,9130678,91019172,81888494,CN
chr04,Bn14386,46800022,85863863,39063841,RLP
chr04,Bn14387,28188545,40754258,12565713,CN
chr04,Bn14388,30641902,59163970,28522068,CN
chr04,Bn14389,76053495,80328624,4275129,TNL
chr04,Bn14390,90591592,94937075,4345483,CNL
chr04,Bn14391,47413354,63191808,15778454,TN
chr04,Bn14392,19632548,45792826,26160278,RLK
chr04,Bn14393,6129744,65910114,59780370,CN
chr04,Bn14394,58172891,78125157,19952266,CN
chr04,Bn14395,65834298,65916360,82062,CNL
chr04,Bn14396,89231828,94819145,5587317,RLK
chr04,Bn14397,77940234,81266883,3326649,CN
chr04,Bn14398,82151940,86266698,4114758,NBS
chr04,Bn14399,63384318,80983876,17599558,RLP
chr04,Bn14400,50740082,63893949,13153867,RLP
chr04,Bn14401,29161839,50682296,21520457,CN
chr04,Bn14402,58583401,86818007,28234606,RLP
chr04,Bn14403,84509466,90761804,6252338,CN
chr04,Bn14404,48131788,76259164,28127376,CNL
chr04,Bn14405,54609895,85371197,30761302,RLK
chr04,Bn14406,87699960,88266500,566540,RLK
chr04,Bn14407,68974184,84877444,15903260,CNL
chr04,Bn14408,76983541,95887268,18903727,RLP
chr04,Bn14409,77181364,77983878,802514,NBS
chr04,Bn14410,31497809,91571024,60073215,TNL
chr04,Bn14411,25943300,43364360,17421060,TN
chr04,Bn14412,42699716,52133782,9434066,CNL
chr04,Bn14413,22662064,93376184,70714120,NBS
chr04,Bn14414,26764818,81742364,54977546,NBS
chr04,Bn14415,34496314,38223879,3727565,CNL
chr04,Bn14416,68790763,91959178,23168415,TN
chr04,Bn14417,99760781,99916646,155865,TNL
chr04,Bn14418,37800852,80904983,43104131,RLK
chr04,Bn14419,16793716,81318610,64524894,RLK
chr04,Bn14420,61906010,69427756,7521746,NBS
chr04,Bn14421,1809404,43333696,41524292,CNL
chr04,Bn14422,33331423,93133599,59802176,CNL
chr04,Bn14423,21790718,78532351,56741633,TNL
chr04,Bn14424,73127805,92178197,19050392,NBS
chr04,Bn14425,55151530,78576911,23425381,CNL
chr04,Bn14426,22097499,38677771,16580272,CN
chr04,Bn14427,53544505,61051217,7506712,TNL
chr04,Bn14428,94311721,98164636,3852915,TN
chr04,Bn14429,8405618,54381809,45976191,CN
chr04,Bn14430,36797245,79453788,42656543,CN
chr04,Bn14431,96072277,97929590,1857313,RLP
chr04,Bn14432,82208372,92715249,10506877,CNL
chr04,Bn14433,51187451,87695261,36507810,CN
chr04,Bn14434,59590092,86805629,27215537,TNL
chr04,Bn14435,36170203,75551715,39381512,TNL
chr04,Bn14436,14227780,81965783,67738003,RLK
chr04,Bn14437,98675313,98893883,218570,CNL
chr04,Bn14438,27763526,71125605,43362079,CN
chr04,Bn14439,84917876,85771774,853898,CNL
chr04,Bn14440,74083807,76861433,2777626,NBS
chr04,Bn14441,50911107,81633252,30722145,TN
chr04,Bn14442,87111472,96277083,9165611,NBS
chr04,Bn14443,62524782,70970153,8445371,TNL
chr04,Bn14444,98065404,99317934,1252530,RLP
chr04,Bn14445,63848320,69168641,5320321,TN
chr04,Bn14446,99017610,99178686,161076,TNL
chr04,Bn14447,51973224,63936043,11962819,NBS
chr04,Bn14448,50467722,60954963,10487241,RLP
chr04,Bn14449,97889146,98729043,839897,CN
chr04,Bn14450,12950758,43224928,30274170,RLP
chr04,Bn14451,70392595,97086129,26693534,TNL
chr04,Bn14452,53532703,67012098,13479395,TNL
chr04,Bn14453,56068890,90040450,33971560,TNL
chr04,Bn14454,51381075,99552222,48171147,TNL
chr04,Bn14455,20925958,39003424,18077466,NBS
chr04,Bn14456,62306164,83927159,21620995,TN
chr04,Bn14457,44473704,82107351,37633647,TN
chr04,Bn14458,30485047,44959022,14473975,CNL
chr04,Bn14459,80021498,94607449,14585951,NBS
chr04,Bn14460,76064465,85860561,9796096,CNL
chr04,Bn14461,94146860,96848485,2701625,TNL
chr04,Bn14462,61090497,75945497,14855000,CN
chr04,Bn14463,49118380,73159220,24040840,NBS
chr04,Bn14464,44533907,61860427,17326520,TNL
chr04,Bn14465,17139626,21453864,4314238,CNL
chr04,Bn14466,96911716,99828060,2916344,TNL
chr04,Bn14467,33400879,76426464,43025585,TNL
chr04,Bn14468,95147562,97852313,2704751,TN
chr04,Bn14469,88178173,89986296,1808123,CNL
chr04,Bn14470,80106599,98672541,18565942,TNL
chr04,Bn14471,58311674,95074985,36763311,CNL
chr04,Bn14472,34025790,96090115,62064325,TN
chr04,Bn14473,45410318,61332310,15921992,NBS
chr04,Bn14474,8066962,47471420,39404458,RLP
chr04,Bn14475,8160204,72725110,64564906,TNL
chr04,Bn14476,2245472,87112992,84867520,TN
chr04,Bn14477,92517609,94861947,2344338,RLP
chr04,Bn14478,54770262,84404576,29634314,CNL
chr04,Bn14479,26809978,99061690,72251712,TN
chr04,Bn14480,98949335,99364636,415301,RLK
chr04,Bn14481,83056206,85847972,2791766,CN
chr04,Bn14482,63649830,71402865,7753035,RLP
chr04,Bn14483,1908451,24309307,22400856,NBS
chr04,Bn14484,19314737,85704350,66389613,TN
chr04,Bn14485,15794465,24715263,8920798,RLP
chr04,Bn14486,52145483,61585729,9440246,RLK
chr04,Bn14487,47140398,77338555,30198157,CN
chr04,Bn14488,95920473,98203267,2282794,RLP
chr04,Bn14489,33331972,96193055,62861083,RLP
chr04,Bn14490,34130639,87703890,53573251,CNL
chr04,Bn14491,75085929,78123325,3037396,CNL
chr04,Bn14492,63705477,71734654,8029177,CN
chr04,Bn14493,41219031,50338758,9119727,RLP
chr04,Bn14494,77449165,94325264,16876099,TN
chr04,Bn14495,81764558,99793821,18029263,NBS
chr04,Bn14496,95269032,99178395,3909363,NBS
chr04,Bn14497,1336217,72304304,70968087,NBS
chr04,Bn14498,3398161,28655022,25256861,NBS
chr04,Bn14499,29028904,73822982,44794078,RLP
chr04,Bn14500,94549310,98482662,3933352,RLK
chr04,Bn14501,20948463,49725687,28777224,RLK
chr04,Bn14502,31120843,43093324,11972481,TN
chr04,Bn14503,66388010,80263557,13875547,NBS
chr04,Bn14504,21328869,32735106,11406237,TNL
chr04,Bn14505,62614462,84222581,21608119,NBS
chr04,Bn14506,95642966,99249163,3606197,TNL
chr04,Bn14507,3945428,26481001,22535573,TNL
chr04,Bn14508,61420482,94146842,32726360,RLP
chr04,Bn14509,86508009,89231388,2723379,NBS
chr04,Bn14510,44766931,64230440,19463509,TN
chr04,Bn14511,72079294,84860766,12781472,RLP
chr04,Bn14512,80474062,97531132,17057070,RLP
chr04,Bn14513,33466565,50670879,17204314,RLK
chr04,Bn14514,79448496,82730320,3281824,NBS
chr04,Bn14515,72402664,95696546,23293882,CN
chr04,Bn14516,22703086,29287885,6584799,RLK
chr04,Bn14517,39936256,45212005,5275749,TN
chr04,Bn14518,62826895,88653934,25827039,TN
chr04,Bn14519,95609939,98700270,3090331,CN
chr04,Bn14520,29316661,98757492,69440831,RLP
chr04,Bn14521,44830628,89488605,44657977,CN
chr04,Bn14522,59706561,93814065,34107504,RLP
chr04,Bn14523,82156172,85575839,3419667,CNL
chr04,Bn14524,73302723,77456132,4153409,CN
chr04,Bn14525,3673906,64521962,60848056,NBS
chr04,Bn14526,71444502,87495696,16051194,RLP
chr04,Bn14527,90477015,97042289,6565274,CNL
chr04,Bn14528,49312982,66853793,17540811,CNL
chr04,Bn14529,45366975,79667700,34300725,CN
chr04,Bn14530,67129697,78394646,11264949,CN
chr04,Bn14531,9049234,44275704,35226470,CNL
chr04,Bn14532,43011307,66168709,23157402,TN
chr04,Bn14533,94606127,95994756,1388629,TNL
chr04,Bn14534,52469075,67550374,15081299,TNL
chr04,Bn14535,66929615,98172745,31243130,TN
chr04,Bn14536,88218640,91266726,3048086,RLK
chr04,Bn14537,61330504,80873932,19543428,CN
chr04,Bn14538,70069108,75791661,5722553,CN
chr04,Bn14539,25399196,90356655,64957459,RLP
chr04,Bn14540,91892770,92474962,582192,TNL
chr04,Bn14541,82637324,93880212,11242888,RLK
chr04,Bn14542,75465570,80016288,4550718,RLK
chr04,Bn14543,63895478,81055146,17159668,CNL
chr04,Bn14544,39864940,73803824,33938884,TN
chr04,Bn14545,77259741,85760109,8500368,TN
chr04,Bn14546,1501351,5270907,3769556,TN
chr04,Bn14547,18847013,48905200,30058187,CN
chr04,Bn14548,71942679,86092325,14149646,RLK
chr04,Bn14549,20632294,31941118,11308824,TN
chr04,Bn14550,9613839,42012267,32398428,TN
chr04,Bn14551,23664825,52601759,28936934,TNL
chr04,Bn14552,87606143,94743600,7137457,NBS
chr04,Bn14553,34688920,79526517,44837597,RLK
chr04,Bn14554,53920061,55751274,1831213,CNL
chr04,Bn14555,44177149,75117304,30940155,CN
chr04,Bn14556,81571513,99390087,17818574,CN
chr04,Bn14557,79831304,81280073,1448769,CNL
chr04,Bn14558,80741923,94951595,14209672,CN
chr04,Bn14559,50435295,68011867,17576572,CN
chr04,Bn14560,80228190,87586711,7358521,TN
chr04,Bn14561,10416811,47675037,37258226,TN
chr04,Bn14562,10715790,96865658,86149868,CNL
chr04,Bn14563,74966361,86200406,11234045,CN
chr04,Bn14564,36785916,50800894,14014978,RLK
chr04,Bn14565,83439981,92051242,8611261,CNL
chr04,Bn14566,97646780,99554456,1907676,NBS
chr04,Bn14567,3129885,8493815,5363930,RLK
chr04,Bn14568,92783057,98852681,6069624,RLK
chr04,Bn14569,81448065,99691660,18243595,NBS
chr04,Bn14570,80076280,95974804,15898524,TNL
chr04,Bn14571,30008581,71951048,41942467,NBS
chr04,Bn14572,10562981,60484187,49921206,TN
chr04,Bn14573,88312838,98671683,10358845,NBS
chr04,Bn14574,56355969,80067012,23711043,TNL
chr04,Bn14575,22975412,76677044,53701632,NBS
chr04,Bn14576,23405402,70760298,47354896,RLK
chr04,Bn14577,33489814,49574523,16084709,CN
chr04,Bn14578,61597443,85364100,23766657,CN
chr04,Bn14579,88707397,90483075,1775678,RLP
chr04,Bn14580,3980294,31938750,27958456,NBS
chr04,Bn14581,72230717,99493530,27262813,CNL
chr04,Bn14582,89800244,94382996,4582752,RLP
chr04,Bn14583,74492134,78567789,4075655,NBS
chr04,Bn14584,12647550,37314421,24666871,RLP
chr04,Bn14585,17558705,71423706,53865001,TN
chr04,Bn14586,85635953,90181009,4545056,NBS
chr04,Bn14587,54444466,55751877,1307411,CNL
chr04,Bn14588,23972749,61623082,37650333,NBS
chr04,Bn14589,50291862,54079251,3787389,CNL
chr04,Bn14590,24071985,91333308,67261323,CN
chr04,Bn14591,94378560,98742203,4363643,RLK
chr04,Bn14592,96435926,97395659,959733,CN
chr04,Bn14593,64665644,97053431,32387787,NBS
chr04,Bn14594,84395695,96270837,11875142,TNL
chr04,Bn14595,39007744,57553778,18546034,TN
chr04,Bn14596,13995198,36517308,22522110,TN
chr04,Bn14597,81578903,86647671,5068768,NBS
chr04,Bn14598,47138905,57197496,10058591,RLK
chr04,Bn14599,23351833,66006278,42654445,CN
chr04,Bn14600,24415314,77846987,53431673,RLK
chr04,Bn14601,5669672,67524957,61855285,CNL
chr04,Bn14602,8779235,74285751,65506516,RLP
chr04,Bn14603,67614409,75536963,7922554,CN
chr04,Bn14604,77250137,97318821,20068684,NBS
chr04,Bn14605,20812935,89540934,68727999,RLP
chr04,Bn14606,73988313,84701761,10713448,CN
chr04,Bn14607,99828196,99989422,161226,CN
chr04,Bn14608,78331482,95113921,16782439,CNL
chr04,Bn14609,78857287,85935536,7078249,CNL
chr04,Bn14610,4132627,29648978,25516351,RLK
chr04,Bn14611,21668933,81875124,60206191,TN
chr04,Bn14612,43475827,46180413,2704586,TNL
chr04,Bn14613,6457064,20902844,14445780,RLK
chr04,Bn14614,73645413,80694284,7048871,TNL
chr04,Bn14615,94235515,94748048,512533,TNL
chr04,Bn14616,76575625,81168084,4592459,TNL
chr04,Bn14617,60238171,73658731,13420560,CN
chr04,Bn14618,94544940,94665820,120880,CNL
chr04,Bn14619,43891546,81741725,37850179,TN
chr04,Bn14620,81928033,98641057,16713024,NBS
chr04,Bn14621,48451171,81257142,32805971,RLP
chr04,Bn14622,60389995,80872237,20482242,RLP
chr04,Bn14623,47692201,86219297,38527096,RLK
chr04,Bn14624,92641113,97300801,4659688,CN
chr04,Bn14625,86105027,95439164,9334137,CN
chr04,Bn14626,55260978,99917723,44656745,TNL
chr04,Bn14627,46820032,71210979,24390947,TN
chr04,Bn14628,75262625,87007942,11745317,TN
chr04,Bn14629,66292551,82881394,16588843,TN
chr04,Bn14630,61561633,96347671,34786038,NBS
chr04,Bn14631,56888240,58798671,1910431,CNL
chr04,Bn14632,6212720,13687347,7474627,NBS
chr04,Bn14633,7420486,72960617,65540131,RLP
chr04,Bn14634,85073851,92189589,7115738,CN
chr04,Bn14635,92360165,95055703,2695538,RLP
chr04,Bn14636,92669223,94628185,1958962,TNL
chr04,Bn14637,79265735,84380849,5115114,TNL
chr04,Bn14638,7482951,69790139,62307188,TN
chr04,Bn14639,44258295,78938011,34679716,RLP
chr04,Bn14640,29654222,97441135,67786913,RLP
chr04,Bn14641,49984652,76245330,26260678,CNL
chr04,Bn14642,16718714,20470755,3752041,TN
chr04,Bn14643,89960987,99133145,9172158,RLK
chr04,Bn14644,49351642,72470434,23118792,CNL
chr04,Bn14645,47907422,76545367,28637945,NBS
chr04,Bn14646,7349426,21231130,13881704,RLP
chr04,Bn14647,28265915,38679483,10413568,TN
chr04,Bn14648,46639139,48090004,1450865,CNL
chr04,Bn14649,88008632,98635738,10627106,CNL
chr04,Bn14650,14827087,67004829,52177742,RLP
chr04,Bn14651,22133064,31938584,9805520,RLP
chr04,Bn14652,69684863,82761929,13077066,NBS
chr04,Bn14653,68994179,86010111,17015932,TNL
chr04,Bn14654,24287081,89989904,65702823,RLP
chr04,Bn14655,21747269,24028704,2281435,NBS
chr04,Bn14656,60551926,85267960,24716034,CN
chr04,Bn14657,55134650,64380452,9245802,NBS
chr04,Bn14658,70180049,90989260,20809211,TN
chr04,Bn14659,78577278,91383597,12806319,RLK
chr04,Bn14660,78256359,98562057,20305698,NBS
chr04,Bn14661,77314733,94799488,17484755,CNL
chr04,Bn14662,81500944,82260756,759812,CNL
chr04,Bn14663,5909765,97920109,92010344,RLP
chr04,Bn14664,54740163,54851546,111383,RLK
chr04,Bn14665,73869281,82013405,8144124,NBS
chr04,Bn14666,13121484,98257852,85136368,NBS
chr04,Bn14667,90272213,97576318,7304105,RLP
chr04,Bn14668,77061858,92293501,15231643,TNL
chr04,Bn14669,89806114,94041299,4235185,RLK
chr04,Bn14670,59038652,69428960,10390308,CNL
chr04,Bn14671,23419242,26134573,2715331,RLP
chr04,Bn14672,78232583,83837776,5605193,RLP
chr04,Bn14673,83726051,96731366,13005315,CNL
chr04,Bn14674,54313857,91728908,37415051,RLK
chr04,Bn14675,54515785,72340976,17825191,TN
chr04,Bn14676,55395249,55898153,502904,NBS
chr04,Bn14677,15970781,60137874,44167093,TNL
chr04,Bn14678,35006461,35096321,89860,TN
chr04,Bn14679,42756838,63428208,20671370,TN
chr04,Bn14680,57664072,91972648,34308576,CN
chr04,Bn14681,72116729,99491422,27374693,RLK
chr04,Bn14682,58120349,69886302,11765953,NBS
chr04,Bn14683,38031184,60817519,22786335,CNL
chr04,Bn14684,17497863,97865085,80367222,CNL
chr04,Bn14685,83725703,84762880,1037177,CNL
chr04,Bn14686,6782257,22261487,15479230,TNL
chr04,Bn14687,44093062,52907555,8814493,RLP
chr04,Bn14688,19270607,79644602,60373995,NBS
chr04,Bn14689,11523065,53742150,42219085,TN
chr04,Bn14690,95454078,97720660,2266582,RLK
chr04,Bn14691,62609887,64065515,1455628,RLP
chr04,Bn14692,2209335,72809385,70600050,CN
chr04,Bn14693,96252755,98660949,2408194,TNL
chr04,Bn14694,21298130,36224345,14926215,RLP
chr04,Bn14695,76365751,86695845,10330094,RLP
chr04,Bn14696,60023131,75600459,15577328,TN
chr04,Bn14697,75376072,79837553,4461481,CN
chr04,Bn14698,32349000,37113554,4764554,RLK
chr04,Bn14699,12365648,49683345,37317697,TN
chr04,Bn14700,14283498,55385743,41102245,CNL
chr04,Bn14701,72956871,78820260,5863389,CN
chr04,Bn14702,37454974,50816802,13361828,RLP
chr04,Bn14703,3203083,46460432,43257349,CNL
chr04,Bn14704,38592508,44092819,5500311,TN
chr04,Bn14705,66671546,93818908,27147362,TN
chr04,Bn14706,6712678,24734944,18022266,CNL
chr04,Bn14707,34903246,71379476,36476230,RLP
chr04,Bn14708,59457106,64598078,5140972,NBS
chr04,Bn14709,56134350,99117806,42983456,CN
chr04,Bn14710,96741264,98562013,1820749,TN
chr04,Bn14711,42399292,69615211,27215919,TN
chr04,Bn14712,94356565,99949249,5592684,TNL
chr04,Bn14713,16156455,57273323,41116868,NBS
chr04,Bn14714,3763941,10991606,7227665,TN
chr04,Bn14715,87936706,91654227,3717521,TNL
chr04,Bn14716,10494398,44167491,33673093,NBS
chr04,Bn14717,6777089,88225624,81448535,RLK
chr04,Bn14718,71271826,74721114,3449288,CNL
chr04,Bn14719,91328034,98694507,7366473,TN
chr04,Bn14720,82107451,89148761,7041310,CN
chr04,Bn14721,44118947,89184195,45065248,TNL
chr04,Bn14722,83820524,84716788,896264,TNL
chr04,Bn14723,15900449,44815116,28914667,RLP
chr04,Bn14724,9374379,91502924,82128545,RLK
chr04,Bn14725,50652422,71249684,20597262,CNL
chr04,Bn14726,26015623,40671501,14655878,TN
chr04,Bn14727,23966647,50201714,26235067,TN
chr04,Bn14728,66374561,88753578,22379017,TN
chr04,Bn14729,21671845,23630608,1958763,CNL
chr04,Bn14730,99579323,99787519,208196,CNL
chr04,Bn14731,86946638,94106480,7159842,CN
chr04,Bn14732,53538373,89823282,36284909,CN
chr04,Bn14733,84800057,91600875,6800818,RLP
chr04,Bn14734,31389520,42722858,11333338,RLK
chr04,Bn14735,11418272,34535122,23116850,CNL
chr04,Bn14736,13010591,78800195,65789604,CN
chr04,Bn14737,68861854,80774740,11912886,NBS
chr04,Bn14738,75704917,80249488,4544571,TN
chr04,Bn14739,69261631,85472871,16211240,TNL
chr04,Bn14740,72799382,85676171,12876789,RLK
chr04,Bn14741,80000407,96352338,16351931,CN
chr04,Bn14742,20606157,48117306,27511149,RLK
chr04,Bn14743,22529231,77213383,54684152,RLK
chr04,Bn14744,76914527,91513571,14599044,NBS
chr04,Bn14745,99744900,99890469,145569,NBS
chr04,Bn14746,66523736,84004832,17481096,NBS
chr04,Bn14747,13477732,53717540,40239808,TNL
chr04,Bn14748,35210545,80076937,44866392,RLK
chr04,Bn14749,98971965,99785897,813932,NBS
chr04,Bn14750,21888867,68177521,46288654,CNL
chr04,Bn14751,7177276,36430944,29253668,RLP
chr04,Bn14752,13570624,19786906,6216282,CN
chr04,Bn14753,70437990,98096401,27658411,TNL
chr04,Bn14754,35931482,81568548,45637066,RLP
chr04,Bn14755,44208061,85087253,40879192,TN
chr04,Bn14756,15606964,54830676,39223712,TNL
chr04,Bn14757,61512262,95785088,34272826,CN
chr04,Bn14758,34444054,89848648,55404594,CN
chr04,Bn14759,95082514,98465313,3382799,RLK
chr04,Bn14760,4589623,60323971,55734348,TNL
chr04,Bn14761,51884159,85690480,33806321,TN
chr04,Bn14762,21305148,46620023,25314875,NBS
chr04,Bn14763,85572882,99323898,13751016,TN
chr04,Bn14764,50463933,53661847,3197914,RLP
chr04,Bn14765,91781463,95270600,3489137,RLP
chr04,Bn14766,96123341,97249013,1125672,NBS
chr04,Bn14767,73730102,90140481,16410379,NBS
chr04,Bn14768,54450370,96084585,41634215,TN
chr04,Bn14769,57093361,70533380,13440019,CN
chr04,Bn14770,98772871,99812947,1040076,CNL
chr04,Bn14771,80934699,98709540,17774841,RLK
chr04,Bn14772,24475308,65900170,41424862,CNL
chr04,Bn14773,18299420,82734971,64435551,CN
chr04,Bn14774,4187072,92718656,88531584,RLP
chr04,Bn14775,92736013,99369024,6633011,CN
chr04,Bn14776,82599153,86220270,3621117,RLP
chr04,Bn14777,9902004,19883231,9981227,RLK
chr04,Bn14778,1627719,56721114,55093395,CNL
chr04,Bn14779,30715764,56253208,25537444,CNL
chr04,Bn14780,14270674,30327256,16056582,RLK
chr04,Bn14781,50807584,80762920,29955336,RLP
chr04,Bn14782,22510275,36984953,14474678,TNL
chr04,Bn14783,47670723,53364876,5694153,CN
chr04,Bn14784,89368390,98892979,9524589,CN
chr04,Bn14785,5492617,66363529,60870912,CNL
chr04,Bn14786,21591546,99344767,77753221,TNL
chr04,Bn14787,98191240,98533407,342167,RLP
chr04,Bn14788,76057252,91453752,15396500,RLP
chr04,Bn14789,51528802,95862462,44333660,TN
chr04,Bn14790,92008662,95315908,3307246,CN
chr04,Bn14791,82310592,92506202,10195610,CNL
chr04,Bn14792,7184359,65967743,58783384,CN
chr04,Bn14793,21645471,84199195,62553724,CN
chr04,Bn14794,47707208,69409693,21702485,TN
chr04,Bn14795,96676374,98188928,1512554,NBS
chr04,Bn14796,9135484,86947945,77812461,CN
chr04,Bn14797,69921656,90157841,20236185,CNL
chr04,Bn14798,33889550,79519492,45629942,CN
chr04,Bn14799,90878766,94800073,3921307,NBS
chr04,Bn14800,40753712,86902980,46149268,TNL
chr04,Bn14801,38541204,85451944,46910740,TN
chr04,Bn14802,55364140,73790826,18426686,RLP
chr04,Bn14803,89775567,99499173,9723606,TNL
chr04,Bn14804,11800577,35486504,23685927,CNL
chr04,Bn14805,23141634,72059858,48918224,RLP
chr04,Bn14806,61210363,77352150,16141787,NBS
chr04,Bn14807,7357714,23548627,16190913,CN
chr04,Bn14808,73492232,88181582,14689350,CN
chr04,Bn14809,40397156,61772188,21375032,NBS
chr04,Bn14810,79157596,96684171,17526575,TN
chr04,Bn14811,73620651,74050644,429993,TNL
chr04,Bn14812,99311402,99652429,341027,RLK
chr04,Bn14813,89177641,90299440,1121799,CN
chr04,Bn14814,29852511,94056221,64203710,RLK
chr04,Bn14815,43864323,99430820,55566497,TNL
chr04,Bn14816,6745282,83388119,76642837,CNL
chr04,Bn14817,89153049,95050067,5897018,TNL
chr04,Bn14818,64539442,94452830,29913388,RLK
chr04,Bn14819,50012852,69429770,19416918,CNL
chr04,Bn14820,92107295,99814816,7707521,RLP
chr04,Bn14821,72715587,95030335,22314748,TN
chr04,Bn14822,74050343,91551439,17501096,RLP
chr04,Bn14823,12992674,19131747,6139073,TN
chr04,Bn14824,36520526,41280040,4759514,TN
chr04,Bn14825,12275864,86267138,73991274,RLP
chr04,Bn14826,77580754,93835345,16254591,NBS
chr04,Bn14827,59738426,59892380,153954,TNL
chr04,Bn14828,88525950,97472842,8946892,NBS
chr04,Bn14829,78324835,89251943,10927108,CNL
chr04,Bn14830,99549403,99723865,174462,NBS
chr04,Bn14831,50104231,75070013,24965782,TN
chr04,Bn14832,44726477,72766228,28039751,RLP
chr04,Bn14833,42763072,54750147,11987075,TN
chr04,Bn14834,24817363,94487883,69670520,TNL
chr04,Bn14835,72990595,95952226,22961631,RLK
chr04,Bn14836,6714828,62295317,55580489,TN
chr04,Bn14837,95571028,97521015,1949987,NBS
chr04,Bn14838,25124214,72430923,47306709,TN
chr04,Bn14839,8390021,84723013,76332992,TN
chr04,Bn14840,10035612,96418562,86382950,TN
chr04,Bn14841,69830756,79654640,9823884,CN
chr04,Bn14842,91090955,97486548,6395593,NBS
chr04,Bn14843,94489541,99022762,4533221,CN
chr04,Bn14844,73601420,73756978,155558,TNL
chr04,Bn14845,6764902,73856674,67091772,RLP
chr04,Bn14846,92684843,95390762,2705919,NBS
chr04,Bn14847,95731465,97001121,1269656,NBS
chr04,Bn14848,67369549,96489333,29119784,TN
chr04,Bn14849,57839937,88090412,30250475,NBS
chr04,Bn14850,23193500,87502009,64308509,TN
chr04,Bn14851,26347996,41701187,15353191,CN
chr04,Bn14852,14615210,84502840,69887630,CN
chr04,Bn14853,15857517,66752688,50895171,RLK
chr04,Bn14854,43262844,80707495,37444651,CNL
chr04,Bn14855,42159119,93818909,51659790,CNL
chr04,Bn14856,77415501,89964590,12549089,RLK
chr04,Bn14857,25282482,25351580,69098,NBS
chr04,Bn14858,74456608,92821001,18364393,CNL
chr04,Bn14859,52669800,69795812,17126012,TN
chr04,Bn14860,65431692,66025836,594144,RLK
chr04,Bn14861,91569763,97511073,5941310,TN
chr04,Bn14862,27834005,82732104,54898099,TN
chr04,Bn14863,8755726,11408422,2652696,CN
chr04,Bn14864,22354529,44228070,21873541,TNL
chr04,Bn14865,15572134,70462670,54890536,NBS
chr04,Bn14866,99844307,99895983,51676,CNL
chr04,Bn14867,6880168,77182363,70302195,CNL
chr04,Bn14868,65679572,66073890,394318,TNL
chr04,Bn14869,46115769,87163681,41047912,CN
chr04,Bn14870,77130263,86466862,9336599,CN
chr04,Bn14871,14283789,96624246,82340457,NBS
chr04,Bn14872,64854783,71299554,6444771,RLK
chr04,Bn14873,52620750,55120861,2500111,CNL
chr04,Bn14874,4558733,79851128,75292395,TN
chr04,Bn14875,15645088,23419558,7774470,TNL
chr04,Bn14876,33059444,49767775,16708331,TN
chr04,Bn14877,48674114,99477350,50803236,CN
chr04,Bn14878,86427932,90853987,4426055,RLP
chr04,Bn14879,75467138,82389883,6922745,NBS
chr04,Bn14880,35440127,36730892,1290765,CNL
chr04,Bn14881,7574171,34097419,26523248,TNL
chr04,Bn14882,41051306,45154350,4103044,CNL
chr04,Bn14883,44861621,93192707,48331086,TN
chr04,Bn14884,29521406,87030439,57509033,TN
chr04,Bn14885,70649805,91234087,20584282,TN
chr04,Bn14886,45260086,78611619,33351533,RLP
chr04,Bn14887,64443196,88626173,24182977,CNL
chr04,Bn14888,37159657,84743945,47584288,CNL
chr04,Bn14889,90599984,93030303,2430319,TN
chr04,Bn14890,75861176,76665183,804007,RLP
chr04,Bn14891,60849840,76471489,15621649,TN
chr04,Bn14892,58445103,90177480,31732377,RLK
chr04,Bn14893,9218451,90610049,81391598,TNL
chr04,Bn14894,26779650,41183788,14404138,TN
chr04,Bn14895,99639192,99732042,92850,NBS
chr04,Bn14896,66318854,86578292,20259438,RLP
chr04,Bn14897,60714606,75633808,14919202,NBS
chr04,Bn14898,41631017,96997429,55366412,CNL
chr04,Bn14899,71696143,73402262,1706119,CNL
chr04,Bn14900,64550722,86161786,21611064,TNL
chr04,Bn14901,69948999,92532747,22583748,CNL
chr04,Bn14902,48098257,52020257,3922000,NBS
chr04,Bn14903,62251516,63546395,1294879,CNL
chr04,Bn14904,66115277,76693255,10577978,NBS
chr04,Bn14905,82835250,84223920,1388670,CN
chr04,Bn14906,44050134,59178756,15128622,TNL
chr04,Bn14907,73399745,93407800,20008055,RLP
chr04,Bn14908,13580541,51420215,37839674,CN
chr04,Bn14909,85516667,93981454,8464787,CNL
chr04,Bn14910,28856617,59812747,30956130,CNL
chr04,Bn14911,16152765,40005116,23852351,TNL
chr04,Bn14912,99960054,99974839,14785,CNL
chr04,Bn14913,50964699,67411905,16447206,TN
chr04,Bn14914,54431743,93646049,39214306,CNL
chr04,Bn14915,9204362,68979621,59775259,TNL
chr04,Bn14916,87247364,93140488,5893124,RLK
chr04,Bn14917,36330905,91477669,55146764,TN
chr04,Bn14918,6177128,45195196,39018068,TN
chr04,Bn14919,53858789,74532932,20674143,TN
chr04,Bn14920,42690872,88948663,46257791,CN
chr04,Bn14921,83989781,96110751,12120970,NBS
chr04,Bn14922,64662411,88418765,23756354,RLP
chr04,Bn14923,81399793,81968239,568446,RLK
chr04,Bn14924,78603675,87098553,8494878,TNL
chr04,Bn14925,67063779,72895511,5831732,RLK
chr04,Bn14926,19048888,75906943,56858055,TN
chr04,Bn14927,39185749,59024729,19838980,CN
chr04,Bn14928,6782349,69546396,62764047,NBS
chr04,Bn14929,14725476,77718457,62992981,CN
chr04,Bn14930,28213801,64395702,36181901,RLP
chr04,Bn14931,95998973,98672813,2673840,TNL
chr04,Bn14932,21001419,97268704,76267285,TN
chr04,Bn14933,11087796,70799719,59711923,CN
chr04,Bn14934,79945874,80521244,575370,NBS
chr04,Bn14935,33875712,47490939,13615227,TN
chr04,Bn14936,92615826,97348964,4733138,TN
chr04,Bn14937,46653397,67084201,20430804,CN
chr04,Bn14938,2585966,13679968,11094002,RLK
chr04,Bn14939,16777790,67074682,50296892,RLP
chr04,Bn14940,11816419,20457044,8640625,NBS
chr04,Bn14941,28537726,39605218,11067492,TNL
chr04,Bn14942,16015483,39541004,23525521,RLP
chr04,Bn14943,25699459,49356001,23656542,TNL
chr04,Bn14944,96152815,97520894,1368079,TN
chr04,Bn14945,48284727,68000061,19715334,TN
chr04,Bn14946,10820233,74913818,64093585,RLK
chr04,Bn14947,47249413,66734479,19485066,TNL
chr04,Bn14948,79589684,97006174,17416490,CNL
chr04,Bn14949,55775848,63966972,8191124,CNL
chr04,Bn14950,42350120,49480752,7130632,NBS
chr04,Bn14951,85156905,99650856,14493951,CNL
chr04,Bn14952,51980425,64292678,12312253,TNL
chr04,Bn14953,17092946,70348591,53255645,RLP
chr04,Bn14954,38617543,47116633,8499090,NBS
chr04,Bn14955,49690154,84905511,35215357,TN
chr04,Bn14956,68743227,78371750,9628523,RLP
chr04,Bn14957,13309132,91233106,77923974,RLK
chr04,Bn14958,46115196,54114998,7999802,RLK
chr04,Bn14959,71335135,76885085,5549950,CN
chr04,Bn14960,31381451,69753538,38372087,NBS
chr04,Bn14961,24823669,27029653,2205984,NBS
chr04,Bn14962,66865146,90009544,23144398,TN
chr04,Bn14963,88042793,94052105,6009312,CNL
chr04,Bn14964,25166637,48218637,23052000,TN
chr04,Bn14965,41919268,65474094,23554826,CNL
chr04,Bn14966,34132534,50575410,16442876,TNL
chr04,Bn14967,45104371,79618676,34514305,TN
chr04,Bn14968,42395070,82047311,39652241,RLP
chr04,Bn14969,77252742,87588579,10335837,NBS
chr04,Bn14970,52292128,76055931,23763803,CNL
chr04,Bn14971,70433514,81418082,10984568,TNL
chr04,Bn14972,44024364,74694787,30670423,RLP
chr04,Bn14973,66420502,97638519,31218017,RLK
chr04,Bn14974,98846653,99307252,460599,RLK
chr04,Bn14975,59629366,85946470,26317104,CN
chr04,Bn14976,21211394,28379092,7167698,CN
chr04,Bn14977,40439099,97751934,57312835,TN
chr04,Bn14978,50967981,79757087,28789106,CN
chr04,Bn14979,78209500,81914264,3704764,RLP
chr04,Bn14980,44788905,83856105,39067200,NBS
chr04,Bn14981,84430595,99020494,14589899,NBS
chr04,Bn14982,51866948,81677329,29810381,CN
chr04,Bn14983,44166262,52088907,7922645,CN
chr04,Bn14984,89885448,91503510,1618062,CNL
chr04,Bn14985,32463362,90606821,58143459,TNL
chr04,Bn14986,31150123,67002069,35851946,RLP
chr04,Bn14987,53060961,59282585,6221624,CNL
chr04,Bn14988,99955661,99959090,3429,TNL
chr04,Bn14989,70838341,98751899,27913558,CN
chr04,Bn14990,46284273,50560942,4276669,TN
chr04,Bn14991,65975302,99444436,33469134,RLP
chr04,Bn14992,94956758,99646003,4689245,CN
chr04,Bn14993,33859731,97181615,63321884,TN
chr04,Bn14994,13139284,65596116,52456832,RLK
chr04,Bn14995,12318808,42418773,30099965,RLP
chr04,Bn14996,39494030,47334523,7840493,NBS
chr04,Bn14997,90146592,98558319,8411727,CN
chr04,Bn14998,65004724,95633427,30628703,CN
chr04,Bn14999,45254139,76066068,30811929,RLK
chr04,Bn15000,55590952,87869277,32278325,CN
chr04,Bn15001,1929123,13105758,11176635,TN
chr04,Bn15002,70092093,72836916,2744823,TN
chr04,Bn15003,27191002,46528829,19337827,TN
chr04,Bn15004,89886005,93508232,3622227,CN
chr04,Bn15005,5352960,67333094,61980134,RLK
chr04,Bn15006,25873801,51250878,25377077,CN
chr04,Bn15007,72540195,97764755,25224560,CNL
chr04,Bn15008,12135140,56160667,44025527,CNL
chr04,Bn15009,58320619,63989170,5668551,CNL
chr04,Bn15010,76903622,82579852,5676230,RLP
chr04,Bn15011,64726586,68654670,3928084,CNL
chr04,Bn15012,48197353,93216205,45018852,TN
chr04,Bn15013,65843611,92652385,26808774,RLP
chr04,Bn15014,32190974,45239135,13048161,RLK
chr04,Bn15015,61837159,82072162,20235003,TNL
chr04,Bn15016,15421064,23571794,8150730,TN
chr04,Bn15017,26853100,40929713,14076613,NBS
chr04,Bn15018,10494723,91785844,81291121,TN
chr04,Bn15019,34194411,62318155,28123744,CN
chr04,Bn15020,95330936,96599745,1268809,RLK
chr04,Bn15021,84507290,84937339,430049,RLP
chr04,Bn15022,41383049,44521473,3138424,TN
chr04,Bn15023,28226330,66846437,38620107,TNL
chr04,Bn15024,20129238,41621690,21492452,CN
chr04,Bn15025,26137169,66529788,40392619,CN
chr04,Bn15026,94394174,95975790,1581616,CN
chr04,Bn15027,56883394,78332255,21448861,TNL
chr04,Bn15028,97460668,99590303,2129635,TNL
chr04,Bn15029,64279783,71666134,7386351,RLP
chr04,Bn15030,50094448,73764771,23670323,RLK
chr04,Bn15031,75963085,91152496,15189411,RLP
chr04,Bn15032,77829708,80603439,2773731,RLP
chr04,Bn15033,71157870,84823301,13665431,TN
chr04,Bn15034,77688131,82377580,4689449,TN
chr04,Bn15035,73628693,78257503,4628810,RLP
chr04,Bn15036,25494496,65801439,40306943,RLK
chr04,Bn15037,93865035,94850009,984974,TN
chr04,Bn15038,88771377,94845385,6074008,NBS
chr04,Bn15039,23697592,68612521,44914929,NBS
chr04,Bn15040,83364355,96649888,13285533,CN
chr04,Bn15041,89346627,94094730,4748103,CN
chr04,Bn15042,99998933,99999974,1041,TN
chr04,Bn15043,8061267,44277727,36216460,RLK
chr04,Bn15044,53206921,77156616,23949695,CN
chr04,Bn15045,18374198,65488300,47114102,TN
chr04,Bn15046,50132462,81738591,31606129,NBS
chr04,Bn15047,98079179,98163225,84046,RLK
chr04,Bn15048,28120409,89417867,61297458,TNL
chr04,Bn15049,60014433,66097928,6083495,NBS
chr04,Bn15050,49487340,55402460,5915120,RLP
chr04,Bn15051,28873399,48544462,19671063,TN
chr04,Bn15052,98667718,99665939,998221,NBS
chr04,Bn15053,12827022,98961143,86134121,CNL
chr04,Bn15054,93557398,94148301,590903,CN
chr04,Bn15055,93346356,96535804,3189448,TN
chr04,Bn15056,30329433,43501049,13171616,NBS
chr04,Bn15057,27002067,85052579,58050512,RLK
chr04,Bn15058,52923115,64450741,11527626,RLK
chr04,Bn15059,73373675,83000611,9626936,NBS
chr04,Bn15060,65536282,82602488,17066206,RLP
chr04,Bn15061,80435192,95607682,15172490,CNL
chr04,Bn15062,23745836,89338020,65592184,TNL
chr04,Bn15063,99082762,99451459,368697,TN
chr04,Bn15064,88106040,90740588,2634548,CN
chr04,Bn15065,80465541,89039374,8573833,CNL
chr04,Bn15066,17128793,17944611,815818,RLK
chr04,Bn15067,68118737,72774135,4655398,RLK
chr04,Bn15068,38073751,62583642,24509891,CNL
chr04,Bn15069,12061055,19381476,7320421,CNL
chr04,Bn15070,70390094,87383143,16993049,CN
chr04,Bn15071,81313525,85614009,4300484,RLK
chr04,Bn15072,44036939,98402567,54365628,RLP
chr05,Bn15073,94769035,95467486,698451,RLP
chr05,Bn15074,90720115,94372581,3652466,RLK
chr05,Bn15075,1624247,30590439,28966192,TN
chr05,Bn15076,67061226,73247470,6186244,TNL
chr05,Bn15077,67123414,87345451,20222037,RLK
chr05,Bn15078,93800581,95499236,1698655,RLK
chr05,Bn15079,3453709,96042242,92588533,NBS
chr05,Bn15080,44921824,70137995,25216171,CN
chr05,Bn15081,28181126,63525440,35344314,TN
chr05,Bn15082,93648412,93784593,136181,CNL
chr05,Bn15083,57405409,71450999,14045590,CNL
chr05,Bn15084,53040346,77827908,24787562,TNL
chr05,Bn15085,85153101,92122367,6969266,RLP
chr05,Bn15086,13774435,52944448,39170013,RLK
chr05,Bn15087,36371290,52422543,16051253,CNL
chr05,Bn15088,87463410,89059350,1595940,NBS
chr05,Bn15089,45878304,66222196,20343892,RLP
chr05,Bn15090,99879164,99998835,119671,TN
chr05,Bn15091,50633528,99641835,49008307,CNL
chr05,Bn15092,18673854,49566671,30892817,TN
chr05,Bn15093,51786675,99869581,48082906,TNL
chr05,Bn15094,35264097,42636196,7372099,TNL
chr05,Bn15095,27615809,61789137,34173328,RLK
chr05,Bn15096,58632409,97289790,38657381,CNL
chr05,Bn15097,42306429,97095735,54789306,CNL
chr05,Bn15098,4576427,56321418,51744991,NBS
chr05,Bn15099,98294730,99144718,849988,CNL
chr05,Bn15100,9933508,54319000,44385492,CN
chr05,Bn15101,10811498,73714531,62903033,TN
chr05,Bn15102,68850101,86877919,18027818,TNL
chr05,Bn15103,47925708,84677320,36751612,NBS
chr05,Bn15104,66882481,72301452,5418971,CNL
chr05,Bn15105,21953242,73027848,51074606,NBS
chr05,Bn15106,71285778,96074403,24788625,RLK
chr05,Bn15107,65791022,85246550,19455528,CN
chr05,Bn15108,8313234,63391968,55078734,TNL
chr05,Bn15109,71429438,89244548,17815110,TNL
chr05,Bn15110,43137545,77425803,34288258,CN
chr05,Bn15111,72848124,90385001,17536877,TN
chr05,Bn15112,27351777,65166063,37814286,RLP
chr05,Bn15113,9789855,47514457,37724602,NBS
chr05,Bn15114,90082228,91324271,1242043,CNL
chr05,Bn15115,52646415,87415168,34768753,TN
chr05,Bn15116,7443355,14514683,7071328,CN
chr05,Bn15117,31824004,86421329,54597325,CNL
chr05,Bn15118,95361893,97218058,1856165,CNL
chr05,Bn15119,83572259,97649552,14077293,TNL
chr05,Bn15120,68234305,71874492,3640187,CN
chr05,Bn15121,73677779,74928675,1250896,CN
chr05,Bn15122,53948483,56112565,2164082,NBS
chr05,Bn15123,41626699,55800352,14173653,TN
chr05,Bn15124,86156580,97755347,11598767,RLK
chr05,Bn15125,30424553,75711161,45286608,CNL
chr05,Bn15126,8936752,42759762,33823010,CNL
chr05,Bn15127,35529273,75353156,39823883,CN
chr05,Bn15128,26168925,85473750,59304825,CN
chr05,Bn15129,67075480,70525909,3450429,RLK
chr05,Bn15130,87671961,97415074,9743113,CN
chr05,Bn15131,50633487,78941867,28308380,NBS
chr05,Bn15132,73376292,93259843,19883551,TN
chr05,Bn15133,63412866,92538608,29125742,CNL
chr05,Bn15134,36337838,91418672,55080834,NBS
chr05,Bn15135,92346180,93004658,658478,TN
chr05,Bn15136,1562241,64619664,63057423,NBS
chr05,Bn15137,87686967,94647102,6960135,TN
chr05,Bn15138,86985827,92903754,5917927,RLP
chr05,Bn15139,30045709,49998242,19952533,CN
chr05,Bn15140,34292568,82452439,48159871,TN
chr05,Bn15141,44394527,81858570,37464043,NBS
chr05,Bn15142,23090095,95312375,72222280,TNL
chr05,Bn15143,51664486,92948128,41283642,NBS
chr05,Bn15144,12251407,24155611,11904204,RLK
chr05,Bn15145,84337286,91968852,7631566,NBS
chr05,Bn15146,44984407,69252138,24267731,NBS
chr05,Bn15147,52535955,93402336,40866381,TNL
chr05,Bn15148,3101449,54969463,51868014,RLP
chr05,Bn15149,85892042,86331439,439397,RLP
chr05,Bn15150,19587762,21447109,1859347,TN
chr05,Bn15151,18173884,72134907,53961023,CN
chr05,Bn15152,4790390,44706756,39916366,NBS
chr05,Bn15153,7564683,97503274,89938591,CN
chr05,Bn15154,28697865,38607133,9909268,CNL
chr05,Bn15155,35235651,42603855,7368204,TN
chr05,Bn15156,63662632,79363080,15700448,TNL
chr05,Bn15157,65539663,93848286,28308623,TN
chr05,Bn15158,57619099,71404280,13785181,NBS
chr05,Bn15159,16288353,88178010,71889657,NBS
chr05,Bn15160,13715129,36231091,22515962,RLK
chr05,Bn15161,74360106,81455324,7095218,NBS
chr05,Bn15162,35032181,69057860,34025679,RLP
chr05,Bn15163,54977328,92553676,37576348,CN
chr05,Bn15164,40452858,56661651,16208793,RLP
chr05,Bn15165,83320685,95032798,11712113,TN
chr05,Bn15166,53455175,66588038,13132863,TN
chr05,Bn15167,47558403,64778733,17220330,RLK
chr05,Bn15168,46797634,82371533,35573899,CN
chr05,Bn15169,15954963,47255677,31300714,NBS
chr05,Bn15170,69547255,85354827,15807572,CN
chr05,Bn15171,27444320,92444767,65000447,TNL
chr05,Bn15172,2723910,44983505,42259595,NBS
chr05,Bn15173,64317032,67996637,3679605,RLP
chr05,Bn15174,10969980,35787813,24817833,RLK
chr05,Bn15175,14572964,92744050,78171086,TNL
chr05,Bn15176,19603033,78111547,58508514,RLK
chr05,Bn15177,5975841,75908725,69932884,TNL
chr05,Bn15178,36861196,47703501,10842305,TNL
chr05,Bn15179,3218498,20833780,17615282,NBS
chr05,Bn15180,92377230,97348100,4970870,RLK
chr05,Bn15181,31339876,44870238,13530362,CN
chr05,Bn15182,10975449,82738650,71763201,RLP
chr05,Bn15183,71151656,73761375,2609719,RLP
chr05,Bn15184,6948155,9776989,2828834,TN
chr05,Bn15185,35978043,91362743,55384700,NBS
chr05,Bn15186,96550232,99706160,3155928,TN
chr05,Bn15187,42159571,54189727,12030156,CNL
chr05,Bn15188,8346121,52900143,44554022,TN
chr05,Bn15189,46997461,57226054,10228593,CNL
chr05,Bn15190,62801519,86190198,23388679,RLP
chr05,Bn15191,98038131,98683625,645494,TN
chr05,Bn15192,50011885,69399181,19387296,RLK
chr05,Bn15193,87695972,90176636,2480664,CN
chr05,Bn15194,37708219,59653738,21945519,CN
chr05,Bn15195,57512155,96513763,39001608,NBS
chr05,Bn15196,30449578,80187719,49738141,RLK
chr05,Bn15197,66074235,76790079,10715844,RLP
chr05,Bn15198,16798225,99822034,83023809,TNL
chr05,Bn15199,47384363,50457712,3073349,RLK
chr05,Bn15200,40939973,82020297,41080324,RLK
chr05,Bn15201,95923609,99352700,3429091,RLK
chr05,Bn15202,30580265,50154707,19574442,RLK
chr05,Bn15203,23058457,76981218,53922761,RLK
chr05,Bn15204,97767774,98037799,270025,RLP
chr05,Bn15205,34635666,58150138,23514472,CN
chr05,Bn15206,26401535,52096521,25694986,NBS
chr05,Bn15207,46189498,98772937,52583439,TNL
chr05,Bn15208,77720747,81994254,4273507,CN
chr05,Bn15209,1457781,46021147,44563366,RLP
chr05,Bn15210,74229543,88222604,13993061,CNL
chr05,Bn15211,73799865,94809392,21009527,TN
chr05,Bn15212,53000676,62077993,9077317,RLP
chr05,Bn15213,33687948,47928350,14240402,CN
chr05,Bn15214,2613091,86746060,84132969,CN
chr05,Bn15215,62138701,76953965,14815264,CN
chr05,Bn15216,88571885,98676989,10105104,CNL
chr05,Bn15217,85390777,91851169,6460392,TNL
chr05,Bn15218,1883017,12635600,10752583,RLP
chr05,Bn15219,57238363,94606031,37367668,RLK
chr05,Bn15220,88893615,94778448,5884833,CN
chr05,Bn15221,66125153,67139539,1014386,TN
chr05,Bn15222,96379939,98390984,2011045,CNL
chr05,Bn15223,99796115,99986891,190776,RLP
chr05,Bn15224,70851033,93247495,22396462,RLP
chr05,Bn15225,99721939,99735662,13723,TN
chr05,Bn15226,49677754,88451626,38773872,RLP
chr05,Bn15227,65916127,87175138,21259011,CN
chr05,Bn15228,26699193,75757852,49058659,TN
chr05,Bn15229,15325791,78054630,62728839,CN
chr05,Bn15230,50509881,81219368,30709487,NBS
chr05,Bn15231,81405652,99378417,17972765,RLK
chr05,Bn15232,23039399,41697607,18658208,RLP
chr05,Bn15233,36860134,96135556,59275422,RLP
chr05,Bn15234,64010022,84564123,20554101,CN
chr05,Bn15235,49038359,56101064,7062705,RLK
chr05,Bn15236,31352903,35904901,4551998,RLK
chr05,Bn15237,77966783,82859162,4892379,CN
chr05,Bn15238,65110413,78769771,13659358,TNL
chr05,Bn15239,61417525,90308133,28890608,RLK
chr05,Bn15240,51454784,52889592,1434808,NBS
chr05,Bn15241,77603556,85561099,7957543,RLP
chr05,Bn15242,80726829,95477394,14750565,TNL
chr05,Bn15243,11442524,22720806,11278282,CNL
chr05,Bn15244,12375692,68939514,56563822,TN
chr05,Bn15245,22372125,99056939,76684814,TNL
chr05,Bn15246,14087653,97651260,83563607,RLP
chr05,Bn15247,22351083,53380139,31029056,CN
chr05,Bn15248,15732865,99964044,84231179,TNL
chr05,Bn15249,2462375,10626861,8164486,TN
chr05,Bn15250,34815384,92846018,58030634,CN
chr05,Bn15251,99530907,99863013,332106,TN
chr05,Bn15252,47627665,75541209,27913544,CNL
chr05,Bn15253,66891018,81113526,14222508,RLK
chr05,Bn15254,26838665,65825930,38987265,TN
chr05,Bn15255,69157777,71611823,2454046,CNL
chr05,Bn15256,78960137,80699102,1738965,RLK
chr05,Bn15257,95164693,99618364,4453671,CN
chr05,Bn15258,77385781,80204903,2819122,RLP
chr05,Bn15259,24905377,89715263,64809886,TN
chr05,Bn15260,83191785,88774957,5583172,RLK
chr05,Bn15261,96659830,97803735,1143905,TN
chr05,Bn15262,91849021,96052529,4203508,RLP
chr05,Bn15263,29635415,62839425,33204010,RLK
chr05,Bn15264,70711934,81632072,10920138,CN
chr05,Bn15265,32551059,58512644,25961585,TNL
chr05,Bn15266,96819278,98071953,1252675,CN
chr05,Bn15267,62764568,83835712,21071144,CN
chr05,Bn15268,30098463,62275411,32176948,NBS
chr05,Bn15269,22920011,99816061,76896050,CNL
chr05,Bn15270,20006267,79951261,59944994,RLP
chr05,Bn15271,89655653,90152681,497028,CNL
chr05,Bn15272,12846960,29406533,16559573,TN
chr05,Bn15273,37628814,42730690,5101876,TNL
chr05,Bn15274,35126793,70555012,35428219,TNL
chr05,Bn15275,17962212,71178616,53216404,CN
chr05,Bn15276,25206794,95935912,70729118,TN
chr05,Bn15277,82386022,97880513,15494491,RLP
chr05,Bn15278,43713742,94419141,50705399,CNL
chr05,Bn15279,97662484,97736920,74436,RLP
chr05,Bn15280,40564502,49386989,8822487,RLP
chr05,Bn15281,10919078,53068346,42149268,CN
chr05,Bn15282,8189576,26045858,17856282,NBS
chr05,Bn15283,6171141,77385376,71214235,CN
chr05,Bn15284,46620114,65703424,19083310,TN
chr05,Bn15285,40626917,86673163,46046246,CN
chr05,Bn15286,97275362,98742637,1467275,TN
chr05,Bn15287,35059846,59719753,24659907,CN
chr05,Bn15288,53548829,94858571,41309742,RLP
chr05,Bn15289,40076774,50864105,10787331,RLK
chr05,Bn15290,89244587,91583083,2338496,TNL
chr05,Bn15291,79009578,79732787,723209,CN
chr05,Bn15292,76657036,89524909,12867873,RLP
chr05,Bn15293,33787935,91957205,58169270,RLK
chr05,Bn15294,96919109,97567726,648617,NBS
chr05,Bn15295,56405440,96225757,39820317,TNL
chr05,Bn15296,55801321,95551935,39750614,RLK
chr05,Bn15297,12810142,32920379,20110237,RLK
chr05,Bn15298,73381389,78067210,4685821,CN
chr05,Bn15299,43660315,51730538,8070223,TN
chr05,Bn15300,19222012,70607723,51385711,RLK
chr05,Bn15301,60280515,69599061,9318546,RLP
chr05,Bn15302,12342380,30080523,17738143,RLP
chr05,Bn15303,61032927,66630030,5597103,RLK
chr05,Bn15304,84841396,98728874,13887478,RLK
chr05,Bn15305,63270128,95643293,32373165,CNL
chr05,Bn15306,78717232,93100160,14382928,RLP
chr05,Bn15307,99096991,99327056,230065,RLK
chr05,Bn15308,85802082,93278588,7476506,TNL
chr05,Bn15309,63339457,84904639,21565182,CN
chr05,Bn15310,58717557,81927240,23209683,CNL
chr05,Bn15311,3072633,92106459,89033826,RLK
chr05,Bn15312,87789752,91949182,4159430,RLP
chr05,Bn15313,82926881,85163681,2236800,RLK
chr05,Bn15314,41583334,76133577,34550243,CNL
chr05,Bn15315,4886169,75560842,70674673,TNL
chr05,Bn15316,16392670,34202044,17809374,RLP
chr05,Bn15317,2415447,41976002,39560555,RLK
chr05,Bn15318,39027885,53130395,14102510,TN
chr05,Bn15319,17892809,58397110,40504301,RLP
chr05,Bn15320,46471494,95416916,48945422,TN
chr05,Bn15321,70059619,82334648,12275029,RLK
chr05,Bn15322,3526334,21995102,18468768,TNL
chr05,Bn15323,1411892,90646482,89234590,CN
chr05,Bn15324,26668752,67820519,41151767,CNL
chr05,Bn15325,44248585,92476502,48227917,CNL
chr05,Bn15326,23089086,30350225,7261139,TN
chr05,Bn15327,43189562,72701591,29512029,CNL
chr05,Bn15328,64434993,66894497,2459504,RLP
chr05,Bn15329,93306256,97119111,3812855,TN
chr05,Bn15330,75965161,93677650,17712489,CNL
chr05,Bn15331,38345988,91571763,53225775,RLP
chr05,Bn15332,38073388,73597973,35524585,CNL
chr05,Bn15333,33935986,73677900,39741914,CNL
chr05,Bn15334,6806933,73278022,66471089,RLK
chr05,Bn15335,62382543,66209294,3826751,TN
chr05,Bn15336,88998427,95740963,6742536,CN
chr05,Bn15337,99059566,99788920,729354,CNL
chr05,Bn15338,28067362,63288173,35220811,TNL
chr05,Bn15339,45811374,91255373,45443999,RLP
chr05,Bn15340,89471461,92047290,2575829,NBS
chr05,Bn15341,64676390,82495699,17819309,RLK
chr05,Bn15342,20519396,75025694,54506298,TN
chr05,Bn15343,56680971,84935295,28254324,RLK
chr05,Bn15344,18409871,44379584,25969713,CN
chr05,Bn15345,75782635,81662618,5879983,CN
chr05,Bn15346,54851460,89534157,34682697,TN
chr05,Bn15347,50320428,78726883,28406455,NBS
chr05,Bn15348,56462691,79720051,23257360,CN
chr05,Bn15349,76621302,78774565,2153263,RLK
chr05,Bn15350,60334892,73547515,13212623,TN
chr05,Bn15351,85343792,90847305,5503513,RLP
chr05,Bn15352,84765128,99057743,14292615,RLK
chr05,Bn15353,63978469,70402877,6424408,RLK
chr05,Bn15354,65287189,89028918,23741729,TNL
chr05,Bn15355,23606106,52424846,28818740,TNL
chr05,Bn15356,54435286,67950381,13515095,TN
chr05,Bn15357,8266569,42049174,33782605,TN
chr05,Bn15358,87722067,95650259,7928192,CNL
chr05,Bn15359,79665019,94210478,14545459,CNL
chr05,Bn15360,41989109,43119742,1130633,NBS
chr05,Bn15361,61516983,80867899,19350916,CNL
chr05,Bn15362,65541912,68838624,3296712,CN
chr05,Bn15363,94154970,94484992,330022,RLP
chr05,Bn15364,21690312,34754301,13063989,TNL
chr05,Bn15365,40038193,47042502,7004309,NBS
chr05,Bn15366,85085754,96559228,11473474,RLP
chr05,Bn15367,25579410,92305800,66726390,RLP
chr05,Bn15368,30257455,76190512,45933057,CN
chr05,Bn15369,96481044,97103121,622077,CN
chr05,Bn15370,62415911,79812948,17397037,NBS
chr05,Bn15371,2782165,88012234,85230069,CN
chr05,Bn15372,53798198,62005746,8207548,CN
chr05,Bn15373,8649446,54104182,45454736,RLP
chr05,Bn15374,64896860,92280137,27383277,TNL
chr05,Bn15375,8410578,58599713,50189135,CN
chr05,Bn15376,77762202,97347826,19585624,CNL
chr05,Bn15377,64320383,94664699,30344316,RLK
chr05,Bn15378,1836715,74469463,72632748,CN
chr05,Bn15379,27369667,42746328,15376661,CNL
chr05,Bn15380,43463641,54434011,10970370,TN
chr05,Bn15381,74220733,75835180,1614447,NBS
chr05,Bn15382,94135030,97350997,3215967,TN
chr05,Bn15383,96476369,98368077,1891708,NBS
chr05,Bn15384,74119345,81542243,7422898,NBS
chr05,Bn15385,71672995,99849495,28176500,CN
chr05,Bn15386,9405770,87384153,77978383,RLK
chr05,Bn15387,75989607,97215319,21225712,NBS
chr05,Bn15388,84133090,85000669,867579,RLP
chr05,Bn15389,57938723,70965174,13026451,RLK
chr05,Bn15390,96893583,99943902,3050319,CNL
chr05,Bn15391,94307104,94761593,454489,CN
chr05,Bn15392,51714920,81133511,29418591,TNL
chr05,Bn15393,8427717,44483130,36055413,TNL
chr05,Bn15394,87700992,93634045,5933053,CNL
chr05,Bn15395,74363384,92943216,18579832,TNL
chr05,Bn15396,94860259,98783588,3923329,RLP
chr05,Bn15397,67240509,69311668,2071159,RLK
chr05,Bn15398,22014147,27915644,5901497,TNL
chr05,Bn15399,42522258,57203812,14681554,RLP
chr05,Bn15400,5716631,89147802,83431171,RLK
chr05,Bn15401,55437017,84077518,28640501,CNL
chr05,Bn15402,34027583,71274236,37246653,RLP
chr05,Bn15403,36554898,93259198,56704300,TNL
chr05,Bn15404,89063535,96554668,7491133,RLP
chr05,Bn15405,35365583,65500280,30134697,CN
chr05,Bn15406,50848274,91170256,40321982,NBS
chr05,Bn15407,60424171,87076987,26652816,CN
chr05,Bn15408,56508688,60680198,4171510,CNL
chr05,Bn15409,40978096,64000765,23022669,CN
chr05,Bn15410,48434746,65257605,16822859,RLP
chr05,Bn15411,21465734,94702795,73237061,CN
chr05,Bn15412,41377716,66726508,25348792,NBS
chr05,Bn15413,50705633,55326137,4620504,RLK
chr05,Bn15414,86198338,97266811,11068473,CN
chr05,Bn15415,84146566,91332179,7185613,CNL
chr05,Bn15416,85331324,99230061,13898737,TNL
chr05,Bn15417,22831087,31538421,8707334,RLK
chr05,Bn15418,59945003,68470611,8525608,RLP
chr05,Bn15419,88428296,90438164,2009868,RLK
chr05,Bn15420,50207922,60268271,10060349,TN
chr05,Bn15421,66953324,97806012,30852688,NBS
chr05,Bn15422,66309436,79408795,13099359,RLK
chr05,Bn15423,53198151,70950105,17751954,RLK
chr05,Bn15424,24909397,65325374,40415977,NBS
chr05,Bn15425,86188461,96581063,10392602,CNL
chr05,Bn15426,25334348,64975668,39641320,CNL
chr05,Bn15427,99745227,99922939,177712,RLK
chr05,Bn15428,51624340,71554698,19930358,RLK
chr05,Bn15429,23211728,84279467,61067739,RLP
chr05,Bn15430,8251104,23754234,15503130,RLK
chr05,Bn15431,82040510,94905442,12864932,RLP
chr05,Bn15432,6705694,46415182,39709488,NBS
chr05,Bn15433,63267111,67662716,4395605,CNL
chr05,Bn15434,22616832,55242732,32625900,RLP
chr05,Bn15435,90436415,94428537,3992122,RLK
chr05,Bn15436,94046557,97958306,3911749,TN
chr05,Bn15437,78939657,87632905,8693248,NBS
chr05,Bn15438,80930067,92315488,11385421,RLP
chr05,Bn15439,94915267,99910086,4994819,CN
chr05,Bn15440,3385006,60184823,56799817,NBS
chr05,Bn15441,90923704,94816406,3892702,TN
chr05,Bn15442,26912910,49790002,22877092,CN
chr05,Bn15443,73350375,85647073,12296698,TN
chr05,Bn15444,71655245,73053731,1398486,RLK
chr05,Bn15445,55104034,69397868,14293834,RLK
chr05,Bn15446,1125598,54143225,53017627,CNL
chr05,Bn15447,89304039,94081353,4777314,CNL
chr05,Bn15448,16478461,61313576,44835115,CN
chr05,Bn15449,45901209,64974412,19073203,CNL
chr05,Bn15450,93053112,94496913,1443801,RLK
chr05,Bn15451,33213189,74147504,40934315,RLK
chr05,Bn15452,42109842,75200084,33090242,NBS
chr05,Bn15453,47588544,55561652,7973108,CNL
chr05,Bn15454,15500076,60546240,45046164,TNL
chr05,Bn15455,60279588,74518123,14238535,NBS
chr05,Bn15456,73444666,89895838,16451172,TNL
chr05,Bn15457,36961685,39318314,2356629,RLP
chr05,Bn15458,57693743,62984939,5291196,NBS
chr05,Bn15459,74005229,92009199,18003970,NBS
chr05,Bn15460,2330830,52268158,49937328,RLK
chr05,Bn15461,14405129,31397128,16991999,RLP
chr05,Bn15462,29849850,69789735,39939885,NBS
chr05,Bn15463,22002083,85496583,63494500,TNL
chr05,Bn15464,96540733,99707868,3167135,NBS
chr05,Bn15465,97632355,99060875,1428520,CN
chr05,Bn15466,58094747,84957000,26862253,TN
chr05,Bn15467,14206543,92443346,78236803,TNL
chr05,Bn15468,37648264,55142012,17493748,RLP
chr05,Bn15469,30569602,81541455,50971853,RLK
chr05,Bn15470,4220787,79749643,75528856,RLP
chr05,Bn15471,86145390,88314869,2169479,RLK
chr05,Bn15472,87146558,90644124,3497566,TNL
chr05,Bn15473,81212663,81654744,442081,RLP
chr05,Bn15474,50313372,88946112,38632740,RLK
chr05,Bn15475,77566209,87509824,9943615,CNL
chr05,Bn15476,47078135,82568812,35490677,RLK
chr05,Bn15477,5652861,57528408,51875547,NBS
chr05,Bn15478,68964481,72997130,4032649,TNL
chr05,Bn15479,58369016,71553690,13184674,RLP
chr05,Bn15480,11907135,25436576,13529441,RLK
chr05,Bn15481,88073755,88813815,740060,CNL
chr05,Bn15482,93624755,97670091,4045336,CN
chr05,Bn15483,29528985,46859502,17330517,RLK
chr05,Bn15484,21200625,64847490,43646865,TN
chr05,Bn15485,81718638,84891277,3172639,NBS
chr05,Bn15486,72529913,96514590,23984677,CN
chr05,Bn15487,5453767,99442212,93988445,RLK
chr05,Bn15488,33961219,39366821,5405602,RLK
chr05,Bn15489,98515760,99711500,1195740,TNL
chr05,Bn15490,81627178,89809886,8182708,NBS
chr05,Bn15491,77100800,81198839,4098039,RLK
chr05,Bn15492,99560463,99913167,352704,TN
chr05,Bn15493,32780536,59912832,27132296,CNL
chr05,Bn15494,31573351,74284296,42710945,NBS
chr05,Bn15495,35901480,47831345,11929865,NBS
chr05,Bn15496,58807904,76486290,17678386,CNL
chr05,Bn15497,12053723,60657415,48603692,NBS
chr05,Bn15498,10552039,73602743,63050704,RLP
chr05,Bn15499,51990677,94773606,42782929,CNL
chr05,Bn15500,70626930,83182073,12555143,TN
chr05,Bn15501,42463653,67991828,25528175,RLP
chr05,Bn15502,62682696,79332219,16649523,NBS
chr05,Bn15503,83359058,91217108,7858050,TN
chr05,Bn15504,13679609,58039938,44360329,RLP
chr05,Bn15505,21071406,24827359,3755953,TN
chr05,Bn15506,47045683,81483443,34437760,NBS
chr05,Bn15507,50308823,53488668,3179845,TNL
chr05,Bn15508,64301152,75051032,10749880,NBS
chr05,Bn15509,98241842,99423400,1181558,CNL
chr05,Bn15510,45503637,82024623,36520986,NBS
chr05,Bn15511,71602438,85631022,14028584,NBS
chr05,Bn15512,50599060,77677517,27078457,CNL
chr05,Bn15513,96152417,98089011,1936594,CNL
chr05,Bn15514,15941690,19672627,3730937,RLK
chr05,Bn15515,1120593,75467493,74346900,TN
chr05,Bn15516,43763695,94616970,50853275,RLK
chr05,Bn15517,26151314,33249337,7098023,CNL
chr05,Bn15518,90805566,99590687,8785121,CN
chr05,Bn15519,83489798,83764755,274957,TN
chr05,Bn15520,71693424,93311443,21618019,CN
chr05,Bn15521,39080055,57860381,18780326,CNL
chr05,Bn15522,14410136,42303596,27893460,RLK
chr05,Bn15523,53224714,55912584,2687870,TN
chr05,Bn15524,97097320,97858644,761324,TNL
chr05,Bn15525,15203836,49670111,34466275,TNL
chr05,Bn15526,20653766,70608155,49954389,RLP
chr05,Bn15527,22313815,41565570,19251755,RLK
chr05,Bn15528,52981344,57357669,4376325,TNL
chr05,Bn15529,32079102,44235396,12156294,TN
chr05,Bn15530,58206444,94987831,36781387,NBS
chr05,Bn15531,47400346,49533540,2133194,TNL
chr05,Bn15532,75593846,77184786,1590940,TN
chr05,Bn15533,2130011,44826190,42696179,CNL
chr05,Bn15534,24877711,31233329,6355618,RLK
chr05,Bn15535,81346993,96975897,15628904,RLP
chr05,Bn15536,82609121,90796462,8187341,RLP
chr05,Bn15537,99090909,99595132,504223,RLK
chr05,Bn15538,21173909,79457477,58283568,CN
chr05,Bn15539,16462275,74382592,57920317,RLK
chr05,Bn15540,15938139,27276764,11338625,NBS
chr05,Bn15541,62241526,79558439,17316913,CN
chr05,Bn15542,35310174,35401676,91502,CN
chr05,Bn15543,12616762,25587700,12970938,CN
chr05,Bn15544,41850918,56759696,14908778,CNL
chr05,Bn15545,10595944,91104601,80508657,TN
chr05,Bn15546,19437247,84501424,65064177,CN
chr05,Bn15547,14629866,50465066,35835200,NBS
chr05,Bn15548,73834749,98715069,24880320,RLP
chr05,Bn15549,21279779,99672027,78392248,CN
chr05,Bn15550,69785736,92502260,22716524,TNL
chr05,Bn15551,46472710,57863509,11390799,TN
chr05,Bn15552,36231515,55952543,19721028,CNL
chr05,Bn15553,82385592,95704971,13319379,TNL
chr05,Bn15554,16121490,22568236,6446746,CN
chr05,Bn15555,93582186,95336234,1754048,TN
chr05,Bn15556,52630622,74723025,22092403,CNL
chr05,Bn15557,17622357,71153508,53531151,TN
chr05,Bn15558,27891914,41620979,13729065,TN
chr05,Bn15559,35504121,95777094,60272973,TN
chr05,Bn15560,44582003,47255030,2673027,TN
chr05,Bn15561,52845811,58655324,5809513,TNL
chr05,Bn15562,66796168,97540851,30744683,CNL
chr05,Bn15563,52458813,74568772,22109959,NBS
chr05,Bn15564,12038113,19592777,7554664,CN
chr05,Bn15565,85049917,98609483,13559566,TNL
chr05,Bn15566,33866043,55116988,21250945,CNL
chr05,Bn15567,63857145,83230469,19373324,TNL
chr05,Bn15568,63654213,78304509,14650296,TN
chr05,Bn15569,61006620,70067088,9060468,RLP
chr05,Bn15570,48876094,50427086,1550992,NBS
chr05,Bn15571,35001094,97811049,62809955,CN
chr05,Bn15572,89916798,91618395,1701597,CN
chr05,Bn15573,26536173,83924459,57388286,RLK
chr05,Bn15574,18916453,53907537,34991084,RLP
chr05,Bn15575,97725234,99798989,2073755,TN
chr05,Bn15576,80011322,86159521,6148199,CNL
chr05,Bn15577,31020109,77380677,46360568,CNL
chr05,Bn15578,20385401,75275009,54889608,NBS
chr05,Bn15579,54882773,84735111,29852338,CN
chr05,Bn15580,13331160,68341492,55010332,NBS
chr05,Bn15581,76645331,90482873,13837542,RLK
chr05,Bn15582,8315691,27454505,19138814,NBS
chr05,Bn15583,90879553,91675969,796416,NBS
chr05,Bn15584,12380098,25718291,13338193,TN
chr05,Bn15585,61632769,76748052,15115283,CN
chr05,Bn15586,14180796,40423971,26243175,TNL
chr05,Bn15587,52759253,70052714,17293461,RLP
chr05,Bn15588,15682430,76810648,61128218,RLP
chr05,Bn15589,75442268,80705812,5263544,RLK
chr05,Bn15590,44082595,99434798,55352203,TN
chr05,Bn15591,16525155,59128500,42603345,TNL
chr05,Bn15592,80059203,83675058,3615855,CN
chr05,Bn15593,47036057,78239242,31203185,RLP
chr05,Bn15594,24976991,79344930,54367939,RLP
chr05,Bn15595,75518315,83235783,7717468,NBS
chr05,Bn15596,19087935,74351740,55263805,RLK
chr05,Bn15597,6118029,42182310,36064281,NBS
chr05,Bn15598,24359665,62512835,38153170,RLP
chr05,Bn15599,58388181,59797532,1409351,CNL
chr05,Bn15600,70228634,97465569,27236935,NBS
chr05,Bn15601,43228852,45934213,2705361,RLK
chr05,Bn15602,30932241,59023233,28090992,RLP
chr05,Bn15603,12650628,56959413,44308785,RLK
chr05,Bn15604,51933899,55109617,3175718,CNL
chr05,Bn15605,32132127,83926686,51794559,TN
chr05,Bn15606,24396740,62986159,38589419,CNL
chr05,Bn15607,44561163,84964033,40402870,NBS
chr05,Bn15608,89121919,99651532,10529613,RLP
chr05,Bn15609,15222409,54562205,39339796,TN
chr05,Bn15610,21497195,86325233,64828038,TN
chr05,Bn15611,74893298,87383254,12489956,RLK
chr05,Bn15612,20884865,56960401,36075536,CNL
chr05,Bn15613,94470205,95500160,1029955,NBS
chr05,Bn15614,5940841,26996789,21055948,TNL
chr05,Bn15615,83853800,89113400,5259600,TN
chr05,Bn15616,74173844,80518773,6344929,TNL
chr05,Bn15617,34781296,56526978,21745682,CN
chr05,Bn15618,42298128,44417408,2119280,CN
chr05,Bn15619,70725261,80836879,10111618,RLK
chr05,Bn15620,33574260,70179689,36605429,CNL
chr05,Bn15621,41205519,69638623,28433104,TN
chr05,Bn15622,39896847,71084015,31187168,RLK
chr05,Bn15623,83085919,90445815,7359896,CNL
chr05,Bn15624,24174806,29863617,5688811,TNL
chr05,Bn15625,81208658,84018138,2809480,RLK
chr05,Bn15626,53406890,69295957,15889067,RLK
chr05,Bn15627,88937855,95767024,6829169,CN
chr05,Bn15628,41468036,83745177,42277141,CNL
chr05,Bn15629,52182392,61001432,8819040,TN
chr05,Bn15630,76237039,92740306,16503267,RLP
chr05,Bn15631,59027893,62345694,3317801,TNL
chr05,Bn15632,30085755,60508986,30423231,NBS
chr05,Bn15633,40947937,80613104,39665167,NBS
chr05,Bn15634,30788784,70906853,40118069,NBS
chr05,Bn15635,27497807,43111580,15613773,CN
chr05,Bn15636,89040784,91389459,2348675,RLP
chr05,Bn15637,40288691,67695206,27406515,CN
chr05,Bn15638,96371903,98852485,2480582,TN
chr05,Bn15639,32619862,87142274,54522412,NBS
chr05,Bn15640,25482140,28416026,2933886,CN
chr05,Bn15641,85152286,96264912,11112626,TNL
chr05,Bn15642,77899216,92320105,14420889,CN
chr05,Bn15643,39217775,92557218,53339443,TN
chr05,Bn15644,40562332,99901480,59339148,RLP
chr05,Bn15645,64797678,87739678,22942000,NBS
chr05,Bn15646,37629452,65121490,27492038,RLK
chr05,Bn15647,42970741,98009452,55038711,TNL
chr05,Bn15648,70853073,87217589,16364516,NBS
chr05,Bn15649,31580488,46660087,15079599,TN
chr05,Bn15650,82780004,97367474,14587470,RLK
chr05,Bn15651,79944004,81712111,1768107,CN
chr05,Bn15652,29564602,33395678,3831076,CN
chr05,Bn15653,68006263,78048862,10042599,TNL
chr05,Bn15654,56592293,93533635,36941342,TN
chr05,Bn15655,80765564,99410282,18644718,RLK
chr05,Bn15656,44142964,97262024,53119060,CNL
chr05,Bn15657,83726841,98584120,14857279,CN
chr05,Bn15658,6306514,84439969,78133455,TNL
chr05,Bn15659,17229908,70950212,53720304,TN
chr05,Bn15660,94910584,99470628,4560044,NBS
chr05,Bn15661,93768599,94673307,904708,CNL
chr05,Bn15662,30649168,39557590,8908422,NBS
chr05,Bn15663,23665894,35221021,11555127,NBS
chr05,Bn15664,56174670,79081231,22906561,CNL
chr05,Bn15665,14529007,67300099,52771092,NBS
chr05,Bn15666,31928003,37217230,5289227,TN
chr05,Bn15667,27723152,34843467,7120315,TNL
chr05,Bn15668,28314954,66221156,37906202,NBS
chr05,Bn15669,13675071,86907147,73232076,CN
chr05,Bn15670,53645889,76237797,22591908,NBS
chr05,Bn15671,5680265,29206188,23525923,CN
chr05,Bn15672,99000962,99705123,704161,CN
chr05,Bn15673,31113086,93342459,62229373,NBS
chr05,Bn15674,59800526,93543307,33742781,CN
chr05,Bn15675,59916915,80150858,20233943,CN
chr05,Bn15676,13885488,84420842,70535354,CN
chr05,Bn15677,53787876,63327547,9539671,TN
chr05,Bn15678,95972262,99244197,3271935,NBS
chr05,Bn15679,46284086,81092979,34808893,RLK
chr05,Bn15680,8109512,79661143,71551631,TNL
chr05,Bn15681,74045900,80926873,6880973,CNL
chr05,Bn15682,56377466,93682588,37305122,RLP
chr05,Bn15683,53101774,65586277,12484503,CNL
chr05,Bn15684,65791037,71627080,5836043,RLP
chr05,Bn15685,24693081,87041616,62348535,NBS
chr05,Bn15686,8034238,20154751,12120513,NBS
chr05,Bn15687,51403532,96136878,44733346,TN
chr05,Bn15688,91109065,97945736,6836671,RLK
chr05,Bn15689,80050020,98486317,18436297,NBS
chr05,Bn15690,54122203,56580942,2458739,RLP
chr05,Bn15691,49922234,64355936,14433702,TN
chr05,Bn15692,53059195,82086301,29027106,TNL
chr05,Bn15693,73420390,96518526,23098136,CNL
chr05,Bn15694,1136592,64283523,63146931,TN
chr05,Bn15695,4136170,95340463,91204293,RLP
chr05,Bn15696,25335155,32509252,7174097,RLK
chr05,Bn15697,20212698,86324201,66111503,CN
chr05,Bn15698,95730216,98578765,2848549,TNL
chr05,Bn15699,35838993,81759918,45920925,CNL
chr05,Bn15700,93773834,99761532,5987698,RLP
chr05,Bn15701,10087611,24698118,14610507,TN
chr05,Bn15702,74400167,83293283,8893116,TN
chr05,Bn15703,8647530,34762513,26114983,TN
chr05,Bn15704,36729024,55181653,18452629,RLK
chr05,Bn15705,32338324,59071717,26733393,NBS
chr05,Bn15706,72597645,97003899,24406254,TN
chr05,Bn15707,26481550,63091373,36609823,TN
chr05,Bn15708,29383100,54230676,24847576,RLP
chr05,Bn15709,90315937,92241594,1925657,RLK
chr05,Bn15710,28583253,90445546,61862293,NBS
chr05,Bn15711,22842376,52962991,30120615,RLK
chr05,Bn15712,23810284,28526162,4715878,CNL
chr05,Bn15713,81689343,95379113,13689770,CN
chr05,Bn15714,85146682,92299438,7152756,RLP
chr05,Bn15715,30753183,33931412,3178229,TN
chr05,Bn15716,80011727,86255543,6243816,TNL
chr05,Bn15717,43970147,99291692,55321545,CN
chr05,Bn15718,95656781,98147818,2491037,RLK
chr05,Bn15719,19923096,97369767,77446671,RLK
chr05,Bn15720,17994798,65106094,47111296,NBS
chr05,Bn15721,71478763,74224948,2746185,RLP
chr05,Bn15722,76601832,90683368,14081536,TN
chr05,Bn15723,9359356,25582442,16223086,TNL
chr05,Bn15724,46242320,98814701,52572381,NBS
chr05,Bn15725,79589917,88675849,9085932,CNL
chr05,Bn15726,41660899,75910689,34249790,NBS
chr05,Bn15727,75286232,78178331,2892099,TNL
chr05,Bn15728,9453829,68230707,58776878,TNL
chr05,Bn15729,96095445,96954701,859256,CN
chr05,Bn15730,37098935,42156410,5057475,CN
chr05,Bn15731,7427093,16511849,9084756,CNL
chr05,Bn15732,93819904,95434751,1614847,CN
chr05,Bn15733,62219329,85435075,23215746,CNL
chr05,Bn15734,65168536,65560326,391790,RLP
chr05,Bn15735,21567579,96039282,74471703,RLP
chr05,Bn15736,77990966,90191773,12200807,CNL
chr05,Bn15737,57365256,68925513,11560257,RLK
chr05,Bn15738,96182433,97664261,1481828,RLK
chr05,Bn15739,39927068,69706323,29779255,TNL
chr05,Bn15740,46855604,69014776,22159172,TNL
chr05,Bn15741,23888518,82638615,58750097,NBS
chr05,Bn15742,65370697,98152994,32782297,TN
chr05,Bn15743,84407246,94609141,10201895,TNL
chr05,Bn15744,93296015,94612667,1316652,NBS
chr05,Bn15745,21821150,94697642,72876492,RLP
chr05,Bn15746,3229384,38013932,34784548,TN
chr05,Bn15747,9554871,11120207,1565336,RLK
chr05,Bn15748,93077624,97317303,4239679,RLP
chr05,Bn15749,40124181,50230546,10106365,RLK
chr05,Bn15750,36052682,61634957,25582275,RLK
chr05,Bn15751,63814190,68270811,4456621,TNL
chr05,Bn15752,79655846,82994170,3338324,CN
chr05,Bn15753,26542739,56234538,29691799,RLP
chr05,Bn15754,60291172,90325933,30034761,TN
chr05,Bn15755,59161968,60477483,1315515,RLP
chr05,Bn15756,34586403,53624551,19038148,CN
chr05,Bn15757,10429957,61093280,50663323,CN
chr05,Bn15758,88000409,88441036,440627,CN
chr05,Bn15759,86956010,97987380,11031370,RLP
chr05,Bn15760,81619458,97954548,16335090,RLK
chr05,Bn15761,69431358,86201962,16770604,CN
chr05,Bn15762,80563715,88911637,8347922,TNL
chr05,Bn15763,85763156,96185715,10422559,CN
chr05,Bn15764,64820672,73651538,8830866,CN
chr05,Bn15765,84994377,86344736,1350359,TN
chr05,Bn15766,52767879,74425847,21657968,CNL
chr05,Bn15767,23769080,84113198,60344118,RLP
chr05,Bn15768,47657650,75478469,27820819,CNL
chr05,Bn15769,98697963,99870210,1172247,RLP
chr05,Bn15770,79095021,81801575,2706554,RLP
chr05,Bn15771,21558203,86092306,64534103,NBS
chr05,Bn15772,27352403,34105488,6753085,NBS
chr05,Bn15773,55812906,75460467,19647561,CNL
chr05,Bn15774,14489234,32269977,17780743,CNL
chr05,Bn15775,40271393,92149077,51877684,RLP
chr05,Bn15776,22301522,54673926,32372404,RLK
chr05,Bn15777,82065366,99276927,17211561,RLK
chr05,Bn15778,79919678,81543858,1624180,RLK
chr05,Bn15779,70467072,81306705,10839633,RLK
chr05,Bn15780,90322422,93079945,2757523,RLK
chr05,Bn15781,50008683,58239942,8231259,RLK
chr05,Bn15782,75899145,95101691,19202546,CN
chr05,Bn15783,18392384,27432459,9040075,RLP
chr05,Bn15784,2628082,65785863,63157781,NBS
chr05,Bn15785,88405423,92846758,4441335,CNL
chr05,Bn15786,78591914,84435316,5843402,NBS
chr05,Bn15787,64029795,88081256,24051461,RLP
chr05,Bn15788,70531271,97160441,26629170,RLK
chr05,Bn15789,54874779,89746742,34871963,NBS
chr05,Bn15790,28601233,70787304,42186071,TNL
chr05,Bn15791,36297117,75008578,38711461,TN
chr05,Bn15792,83022214,87003104,3980890,CN
chr05,Bn15793,32864926,69735605,36870679,TNL
chr05,Bn15794,58544342,97660870,39116528,TN
chr05,Bn15795,77852796,90842296,12989500,TNL
chr05,Bn15796,91983285,99331210,7347925,TNL
chr05,Bn15797,49456289,59014464,9558175,RLP
chr05,Bn15798,24566432,98094461,73528029,TN
chr05,Bn15799,13137771,55296482,42158711,RLP
chr05,Bn15800,63618553,73503560,9885007,TN
chr05,Bn15801,5281503,16968716,11687213,NBS
chr05,Bn15802,8873840,42579414,33705574,RLP
chr05,Bn15803,21540794,66260060,44719266,CN
chr05,Bn15804,49031548,86289923,37258375,TNL
chr05,Bn15805,59904060,93139550,33235490,TNL
chr05,Bn15806,59235468,84495687,25260219,TN
chr05,Bn15807,28373365,29854587,1481222,RLP
chr05,Bn15808,28769224,76587891,47818667,RLP
chr05,Bn15809,29485211,94339177,64853966,RLP
chr05,Bn15810,54145463,90011021,35865558,RLK
chr05,Bn15811,33104565,99119086,66014521,RLP
chr05,Bn15812,35535726,57409523,21873797,RLK
chr05,Bn15813,66606724,83614915,17008191,RLK
chr05,Bn15814,72785738,87081617,14295879,RLP
chr05,Bn15815,92992117,98390761,5398644,NBS
chr05,Bn15816,35759654,91905852,56146198,RLK
chr05,Bn15817,52127857,71830241,19702384,NBS
chr05,Bn15818,87246161,88811079,1564918,TNL
chr05,Bn15819,20313943,48509116,28195173,NBS
chr05,Bn15820,85376414,90251739,4875325,TNL
chr05,Bn15821,83431267,89007562,5576295,CN
chr05,Bn15822,19788136,74531497,54743361,TNL
chr05,Bn15823,85834138,93157792,7323654,TNL
chr05,Bn15824,38501754,78879079,40377325,RLP
chr05,Bn15825,66868663,81136897,14268234,CN
chr05,Bn15826,2812632,44178158,41365526,CNL
chr05,Bn15827,66964553,83702691,16738138,CNL
chr05,Bn15828,20990565,79277008,58286443,RLK
chr05,Bn15829,11370029,47361894,35991865,CN
chr05,Bn15830,1403996,31875995,30471999,TN
chr05,Bn15831,65993629,86042465,20048836,TN
chr05,Bn15832,98590400,99442850,852450,CN
chr05,Bn15833,93904690,99128260,5223570,RLP
chr05,Bn15834,12218736,23839503,11620767,CNL
chr05,Bn15835,41612458,66891349,25278891,TN
chr05,Bn15836,77377073,79070893,1693820,NBS
chr05,Bn15837,6539588,26025250,19485662,RLK
chr05,Bn15838,2394568,5185855,2791287,RLP
chr05,Bn15839,4768916,84179625,79410709,CNL
chr05,Bn15840,97927053,98767672,840619,RLK
chr05,Bn15841,98855310,99431384,576074,RLP
chr05,Bn15842,85113295,88128489,3015194,CNL
chr05,Bn15843,6363368,44674013,38310645,TN
chr05,Bn15844,82329949,90872279,8542330,CN
chr05,Bn15845,78810933,82895341,4084408,NBS
chr05,Bn15846,30500141,35098960,4598819,TNL
chr05,Bn15847,87196397,93033661,5837264,TNL
chr05,Bn15848,76692207,94937991,18245784,NBS
chr05,Bn15849,29294988,57680936,28385948,CN
chr05,Bn15850,36268603,83406103,47137500,TN
chr05,Bn15851,70568665,71407181,838516,RLK
chr05,Bn15852,6003552,82296473,76292921,CNL
chr05,Bn15853,69889861,84286541,14396680,RLK
chr05,Bn15854,6457692,89593977,83136285,NBS
chr05,Bn15855,22893379,75523413,52630034,RLP
chr05,Bn15856,33179546,97986116,64806570,CNL
chr05,Bn15857,97423895,98142716,718821,RLP
chr05,Bn15858,15748954,38348199,22599245,CNL
chr05,Bn15859,16136295,72717877,56581582,CNL
chr05,Bn15860,5506385,75925195,70418810,CNL
chr05,Bn15861,33188935,70470012,37281077,TNL
chr05,Bn15862,76177446,92090381,15912935,RLP
chr05,Bn15863,91820935,96784488,4963553,CNL
chr05,Bn15864,42827772,98056580,55228808,RLK
chr05,Bn15865,59155994,74909920,15753926,NBS
chr05,Bn15866,67923263,87714222,19790959,NBS
chr05,Bn15867,5288200,52076269,46788069,TN
chr05,Bn15868,34175896,89601156,55425260,CNL
chr05,Bn15869,27285003,72533127,45248124,RLP
chr05,Bn15870,23046714,82051999,59005285,NBS
chr05,Bn15871,90315473,97181363,6865890,RLP
chr05,Bn15872,82481057,82890474,409417,NBS
chr05,Bn15873,44675744,47559299,2883555,NBS
chr05,Bn15874,70559120,92926695,22367575,NBS
chr05,Bn15875,21693157,28231277,6538120,NBS
chr05,Bn15876,24761041,46843119,22082078,CN
chr05,Bn15877,71772608,93243576,21470968,TN
chr05,Bn15878,88922410,94756696,5834286,CNL
chr05,Bn15879,63468496,86843435,23374939,CNL
chr05,Bn15880,46451591,69721749,23270158,TN
chr05,Bn15881,51445542,98474671,47029129,RLP
chr05,Bn15882,76509146,90718419,14209273,TN
chr05,Bn15883,31609284,55060097,23450813,TN
chr05,Bn15884,52524450,78945984,26421534,CN
chr05,Bn15885,17449212,18923195,1473983,RLK
chr05,Bn15886,16113553,45246478,29132925,CNL
chr05,Bn15887,83174023,90630606,7456583,TNL
chr05,Bn15888,44537190,71915374,27378184,RLK
chr05,Bn15889,86321331,99621110,13299779,NBS
chr05,Bn15890,29165827,98030933,68865106,CN
chr05,Bn15891,92586385,92847705,261320,RLP
chr05,Bn15892,68002670,88293383,20290713,TNL
chr05,Bn15893,49727217,95387726,45660509,RLP
chr05,Bn15894,65072852,91407369,26334517,RLP
chr05,Bn15895,69975801,78440509,8464708,NBS
chr05,Bn15896,73349133,75160794,1811661,CNL
chr05,Bn15897,15459773,37260996,21801223,RLK
chr05,Bn15898,61882229,82208534,20326305,CNL
chr05,Bn15899,40678984,53554954,12875970,TNL
chr05,Bn15900,72901849,93362923,20461074,RLK
chr05,Bn15901,23368271,25505241,2136970,TN
chr05,Bn15902,44953352,51989771,7036419,TN
chr05,Bn15903,96903493,98877263,1973770,CN
chr05,Bn15904,9831334,84282060,74450726,RLK
chr05,Bn15905,69422332,94711667,25289335,NBS
chr05,Bn15906,57660874,80564282,22903408,RLP
chr05,Bn15907,78447188,90090937,11643749,CN
chr05,Bn15908,90495449,98884580,8389131,RLK
chr05,Bn15909,58913192,62002229,3089037,CN
chr05,Bn15910,87379850,87944751,564901,CN
chr05,Bn15911,33882477,42679643,8797166,TN
chr05,Bn15912,76252590,86051666,9799076,CN
chr05,Bn15913,2110020,62443927,60333907,RLK
chr05,Bn15914,98017224,99834412,1817188,RLK
chr05,Bn15915,64129331,97170196,33040865,NBS
chr05,Bn15916,66343253,70169545,3826292,CN
chr05,Bn15917,44885193,85233862,40348669,RLP
chr05,Bn15918,51382836,61736575,10353739,TN
chr05,Bn15919,44278282,73131047,28852765,NBS
chr05,Bn15920,73651791,87455974,13804183,TN
chr05,Bn15921,53716838,60764073,7047235,NBS
chr05,Bn15922,33343985,85833921,52489936,TNL
chr05,Bn15923,31615133,50815918,19200785,TN
chr05,Bn15924,60222712,62253496,2030784,RLK
chr05,Bn15925,7226613,81443028,74216415,RLP
chr05,Bn15926,27700539,86491405,58790866,NBS
chr05,Bn15927,21780277,40486533,18706256,NBS
chr05,Bn15928,87708110,87909069,200959,CNL
chr05,Bn15929,5028622,37826792,32798170,RLK
chr05,Bn15930,54612108,95657132,41045024,RLK
chr05,Bn15931,11112915,46261733,35148818,TNL
chr05,Bn15932,96934810,97645316,710506,RLP
chr05,Bn15933,63185019,94526372,31341353,RLP
chr05,Bn15934,9395714,72412200,63016486,TNL
chr05,Bn15935,81493078,95493186,14000108,RLK
chr05,Bn15936,86997817,90910023,3912206,TNL
chr05,Bn15937,38654214,55064873,16410659,CNL
chr05,Bn15938,51588493,96082414,44493921,RLK
chr05,Bn15939,70281197,72070898,1789701,RLK
chr05,Bn15940,92215090,99591419,7376329,RLK
chr05,Bn15941,99396598,99702126,305528,TNL
chr05,Bn15942,78823793,92338695,13514902,TNL
chr05,Bn15943,48153857,56023245,7869388,TN
chr05,Bn15944,40139889,44976174,4836285,NBS
chr05,Bn15945,88329723,91601508,3271785,CN
chr05,Bn15946,35108588,76443096,41334508,CNL
chr05,Bn15947,5209663,30137603,24927940,RLK
chr05,Bn15948,61917391,69254567,7337176,RLP
chr05,Bn15949,72128616,98714711,26586095,NBS
chr05,Bn15950,13987830,74554928,60567098,RLP
chr05,Bn15951,45418026,75873799,30455773,CN
chr05,Bn15952,10020999,47190543,37169544,CN
chr05,Bn15953,84392057,86893356,2501299,CNL
chr05,Bn15954,95583328,98649148,3065820,RLK
chr05,Bn15955,88932898,89328787,395889,RLK
chr05,Bn15956,51765055,94461544,42696489,RLP
chr05,Bn15957,95580531,95766177,185646,CN
chr05,Bn15958,37396597,70128639,32732042,CNL
chr05,Bn15959,5563772,63490929,57927157,TNL
chr05,Bn15960,71173605,85392218,14218613,TN
chr05,Bn15961,46578855,78463773,31884918,RLK
chr05,Bn15962,38221556,71418346,33196790,RLK
chr05,Bn15963,9969127,13154777,3185650,TNL
chr05,Bn15964,22197637,64572554,42374917,NBS
chr05,Bn15965,37242803,62874118,25631315,NBS
chr05,Bn15966,84356143,96802244,12446101,TNL
chr05,Bn15967,70761684,90688908,19927224,TNL
chr05,Bn15968,46606370,88491724,41885354,TNL
chr05,Bn15969,76802987,79630793,2827806,CN
chr05,Bn15970,56755799,68718717,11962918,CNL
chr05,Bn15971,41459764,52680944,11221180,TNL
chr05,Bn15972,53487428,85494442,32007014,TN
chr05,Bn15973,14361313,82084476,67723163,RLK
chr05,Bn15974,39882726,65797735,25915009,RLP
chr05,Bn15975,35106921,55222029,20115108,TNL
chr05,Bn15976,76674298,94908422,18234124,RLP
chr05,Bn15977,94966358,97641588,2675230,RLK
chr05,Bn15978,67408790,71409531,4000741,CN
chr05,Bn15979,95105014,98867255,3762241,TNL
chr05,Bn15980,56623128,83516363,26893235,RLK
chr05,Bn15981,59669472,99840902,40171430,CN
chr05,Bn15982,43831017,44492981,661964,CN
chr05,Bn15983,75711539,90717747,15006208,CNL
chr05,Bn15984,36340803,96775705,60434902,TN
chr05,Bn15985,6866600,67385659,60519059,NBS
chr05,Bn15986,52364369,80621507,28257138,TNL
chr05,Bn15987,12407032,61072965,48665933,RLP
chr05,Bn15988,26254699,61072231,34817532,CN
chr05,Bn15989,71819716,85888692,14068976,RLK
chr05,Bn15990,23073591,86870904,63797313,TN
chr05,Bn15991,81437100,92222542,10785442,TN
chr05,Bn15992,69687433,83343148,13655715,RLP
chr05,Bn15993,14190150,99865386,85675236,NBS
chr05,Bn15994,54238143,59087641,4849498,RLP
chr05,Bn15995,91441965,97029977,5588012,RLP
chr05,Bn15996,85203944,94773244,9569300,CN
chr05,Bn15997,95242522,96266052,1023530,RLK
chr05,Bn15998,23511706,24101646,589940,RLK
chr05,Bn15999,82188076,87614788,5426712,TNL
chr05,Bn16000,16916915,84145885,67228970,CNL
chr05,Bn16001,29482452,53383578,23901126,CNL
chr05,Bn16002,39619268,51037638,11418370,RLK
chr05,Bn16003,80734682,87525745,6791063,RLP
chr05,Bn16004,15906873,71037756,55130883,NBS
chr05,Bn16005,79991966,93331987,13340021,TN
chr05,Bn16006,53853115,89798786,35945671,RLK
chr05,Bn16007,47118984,62418388,15299404,TNL
chr05,Bn16008,39896305,48031090,8134785,RLP
chr05,Bn16009,78405727,78615094,209367,CNL
chr05,Bn16010,93996704,99227817,5231113,NBS
chr05,Bn16011,43632191,75633925,32001734,RLK
chr05,Bn16012,66873713,70587301,3713588,CNL
chr05,Bn16013,32953304,87760125,54806821,CNL
chr05,Bn16014,35579559,48031516,12451957,TN
chr05,Bn16015,8783543,99194351,90410808,CN
chr05,Bn16016,57869384,82824060,24954676,CNL
chr05,Bn16017,15023037,59530102,44507065,CN
chr05,Bn16018,15657960,82200009,66542049,CN
chr05,Bn16019,77351581,79974181,2622600,NBS
chr05,Bn16020,75229112,75914297,685185,CNL
chr05,Bn16021,28788275,56533702,27745427,CNL
chr05,Bn16022,68551740,86357985,17806245,CNL
chr05,Bn16023,29336585,89251944,59915359,RLP
chr05,Bn16024,18093649,27130855,9037206,CNL
chr05,Bn16025,42433030,82168465,39735435,CNL
chr05,Bn16026,27955697,43934958,15979261,CN
chr05,Bn16027,92338644,99716513,7377869,CNL
chr05,Bn16028,62859856,97444534,34584678,CNL
chr05,Bn16029,80420884,88047652,7626768,CNL
chr05,Bn16030,91396239,98537903,7141664,TNL
chr05,Bn16031,27197853,40222549,13024696,RLP
chr05,Bn16032,38297640,67556403,29258763,TN
chr05,Bn16033,35285726,85163004,49877278,TNL
chr05,Bn16034,55220137,76075471,20855334,TN
chr05,Bn16035,27444801,86228430,58783629,NBS
chr05,Bn16036,82682258,95642188,12959930,RLK
chr05,Bn16037,15071794,97811697,82739903,CNL
chr05,Bn16038,90953353,94800914,3847561,NBS
chr05,Bn16039,87277441,90924348,3646907,RLK
chr05,Bn16040,14438688,82274041,67835353,CNL
chr05,Bn16041,61140512,93253570,32113058,RLK
chr05,Bn16042,2808301,93053462,90245161,CNL
chr05,Bn16043,53872724,82286395,28413671,RLK
chr05,Bn16044,57315427,67094947,9779520,CNL
chr05,Bn16045,19017780,45802100,26784320,CN
chr05,Bn16046,11059820,58289503,47229683,CNL
chr05,Bn16047,65335150,84587489,19252339,NBS
chr05,Bn16048,60877709,86023352,25145643,TNL
chr05,Bn16049,34759450,44341411,9581961,RLK
chr05,Bn16050,69846012,87432309,17586297,NBS
chr05,Bn16051,66140120,78611688,12471568,RLK
chr05,Bn16052,20663024,26684932,6021908,CNL
chr05,Bn16053,17466835,81296046,63829211,TNL
chr05,Bn16054,18849935,52349064,33499129,RLP
chr05,Bn16055,16036069,68421672,52385603,TNL
chr05,Bn16056,89908898,91564359,1655461,RLK
chr05,Bn16057,88512757,90982858,2470101,RLK
chr05,Bn16058,54064560,77463364,23398804,NBS
chr05,Bn16059,91543863,91885273,341410,TN
chr05,Bn16060,87395425,87450952,55527,NBS
chr05,Bn16061,5802487,49616794,43814307,NBS
chr05,Bn16062,66663024,70552149,3889125,RLP
chr05,Bn16063,68659263,78408828,9749565,CN
chr05,Bn16064,22475549,89217378,66741829,TN
chr05,Bn16065,63633578,88323866,24690288,TNL
chr05,Bn16066,28532650,91890834,63358184,NBS
chr05,Bn16067,60816249,72233949,11417700,RLP
chr05,Bn16068,89985897,98462562,8476665,TN
chr05,Bn16069,67814230,82030942,14216712,NBS
chr05,Bn16070,62957278,97629025,34671747,TNL
chr05,Bn16071,97997288,98125116,127828,TNL
chr05,Bn16072,65408698,68899227,3490529,RLK
chr05,Bn16073,92208075,97681610,5473535,TN
chr05,Bn16074,16310186,47732972,31422786,TNL
chr05,Bn16075,10774194,44164103,33389909,CNL
chr05,Bn16076,90505393,96428691,5923298,CN
chr05,Bn16077,45419817,90226867,44807050,TN
chr05,Bn16078,97566007,99824900,2258893,TN
chr05,Bn16079,25590675,55190601,29599926,TN
chr05,Bn16080,11505535,47832849,36327314,CN
chr05,Bn16081,43916122,78803272,34887150,TN
chr05,Bn16082,65498323,77931688,12433365,RLK
chr05,Bn16083,20163580,32550837,12387257,CN
chr05,Bn16084,6810240,53648853,46838613,RLP
chr05,Bn16085,36345058,89549616,53204558,TN
chr05,Bn16086,65531724,82531537,16999813,TNL
chr05,Bn16087,85760986,91584661,5823675,TNL
chr05,Bn16088,37794594,85105727,47311133,TN
chr05,Bn16089,32121295,80969698,48848403,RLK
chr05,Bn16090,50396971,91443074,41046103,CNL
chr05,Bn16091,97770474,99012415,1241941,TN
chr05,Bn16092,70253621,86033704,15780083,CN
chr05,Bn16093,48786467,74123233,25336766,CNL
chr05,Bn16094,51636530,72061475,20424945,CN
chr05,Bn16095,30903433,31534158,630725,RLK
chr05,Bn16096,99932269,99942362,10093,RLP
chr05,Bn16097,76937395,84219657,7282262,NBS
chr05,Bn16098,93655793,98660819,5005026,RLP
chr05,Bn16099,82969756,92601610,9631854,TNL
chr05,Bn16100,37205151,50663057,13457906,CN
chr05,Bn16101,83148952,87952483,4803531,TN
chr05,Bn16102,29492632,36248396,6755764,TN
chr05,Bn16103,59189666,80199257,21009591,NBS
chr05,Bn16104,26117328,27368206,1250878,TN
chr05,Bn16105,93909505,97799320,3889815,CNL
chr05,Bn16106,61429392,78627041,17197649,CNL
chr05,Bn16107,73793628,96658183,22864555,TN
chr05,Bn16108,23769414,80317473,56548059,CN
chr05,Bn16109,72122649,74757525,2634876,TNL
chr05,Bn16110,1628261,96263040,94634779,CN
chr05,Bn16111,79863866,93318357,13454491,CN
chr05,Bn16112,15941241,46937454,30996213,CNL
chr05,Bn16113,60448931,73338796,12889865,RLK
chr05,Bn16114,22500971,80204905,57703934,NBS
chr05,Bn16115,92160762,96345119,4184357,RLK
chr05,Bn16116,5920511,66184716,60264205,CNL
chr05,Bn16117,98908524,99745730,837206,TNL
chr05,Bn16118,67177896,94718102,27540206,RLK
chr05,Bn16119,41916880,85088928,43172048,CN
chr05,Bn16120,78551681,93785294,15233613,TN
chr05,Bn16121,66992939,87921603,20928664,CN
chr05,Bn16122,76210933,81037545,4826612,TN
chr05,Bn16123,98882406,99139827,257421,TNL
chr05,Bn16124,64465370,95347353,30881983,RLP
chr05,Bn16125,72391832,88357665,15965833,TN
chr05,Bn16126,79998766,96756354,16757588,CNL
chr05,Bn16127,58797287,93800327,35003040,RLP
chr05,Bn16128,91754893,91890558,135665,TNL
chr05,Bn16129,77096578,80221473,3124895,CNL
chr05,Bn16130,13917668,36756042,22838374,TNL
chr05,Bn16131,58519134,58987791,468657,TN
chr05,Bn16132,22379810,91293487,68913677,TN
chr05,Bn16133,29816114,41786840,11970726,TNL
chr05,Bn16134,83627188,99045215,15418027,CN
chr05,Bn16135,50014390,79800754,29786364,TNL
chr05,Bn16136,98451311,99250040,798729,RLP
chr05,Bn16137,62536047,77986116,15450069,RLP
chr05,Bn16138,66894598,91159021,24264423,CN
chr05,Bn16139,27561779,56068566,28506787,TNL
chr05,Bn16140,94884384,97394972,2510588,RLP
chr05,Bn16141,24373401,80478761,56105360,TNL
chr05,Bn16142,52205393,74643721,22438328,NBS
chr05,Bn16143,3874068,64783278,60909210,TNL
chr05,Bn16144,83588918,88246669,4657751,TN
chr05,Bn16145,81720148,84716443,2996295,CN
chr05,Bn16146,35283188,61386768,26103580,CN
chr05,Bn16147,42748187,80113806,37365619,NBS
chr05,Bn16148,56182443,58398442,2215999,RLK
chr05,Bn16149,41017234,67509406,26492172,CNL
chr05,Bn16150,30553584,80938651,50385067,RLK
chr05,Bn16151,69281591,85220431,15938840,RLP
chr05,Bn16152,88661856,98762073,10100217,TNL
chr05,Bn16153,20076355,45489830,25413475,TNL
chr05,Bn16154,12626187,31946523,19320336,NBS
chr05,Bn16155,99122837,99866571,743734,CNL
chr05,Bn16156,12290231,93841291,81551060,NBS
chr05,Bn16157,36187085,53789654,17602569,CN
chr05,Bn16158,33094300,68993876,35899576,CN
chr05,Bn16159,94360085,98895503,4535418,TN
chr05,Bn16160,94832040,98458519,3626479,TN
chr05,Bn16161,89191744,99230706,10038962,NBS
chr05,Bn16162,33271739,60088725,26816986,TN
chr05,Bn16163,44374862,95332021,50957159,CNL
chr05,Bn16164,95475225,98571666,3096441,RLP
chr05,Bn16165,11767111,26980773,15213662,NBS
chr05,Bn16166,98182807,99238600,1055793,CNL
chr05,Bn16167,58352025,90993275,32641250,NBS
chr05,Bn16168,29988690,32009167,2020477,TNL
chr05,Bn16169,5261910,84584858,79322948,NBS
chr05,Bn16170,94902242,98831133,3928891,RLK
chr05,Bn16171,45054983,61752954,16697971,RLP
chr05,Bn16172,81825690,95179125,13353435,TNL
chr05,Bn16173,40831057,90440964,49609907,TNL
chr05,Bn16174,42869329,81255893,38386564,TN
chr05,Bn16175,71665638,90375545,18709907,RLK
chr05,Bn16176,19521970,67086397,47564427,TN
chr05,Bn16177,6448410,84172653,77724243,CN
chr05,Bn16178,29981381,56848128,26866747,RLK
chr05,Bn16179,23075274,82981193,59905919,RLK
chr05,Bn16180,65728228,80348197,14619969,TNL
chr05,Bn16181,54156911,96125180,41968269,NBS
chr05,Bn16182,67084201,77968532,10884331,TN
chr05,Bn16183,67529951,79615692,12085741,TN
chr05,Bn16184,80522257,87876192,7353935,TN
chr05,Bn16185,67860670,72955341,5094671,CN
chr05,Bn16186,52790792,53542309,751517,TNL
chr05,Bn16187,48536751,59050551,10513800,TNL
chr05,Bn16188,67138489,76048461,8909972,TNL
chr05,Bn16189,10813769,91867337,81053568,TN
chr05,Bn16190,46070054,84282522,38212468,CNL
chr05,Bn16191,29761176,77501721,47740545,RLK
chr05,Bn16192,42809657,64862908,22053251,CNL
chr05,Bn16193,18793700,85955959,67162259,CN
chr05,Bn16194,39775145,43152891,3377746,NBS
chr05,Bn16195,25800825,35913730,10112905,CNL
chr05,Bn16196,95936059,99210948,3274889,TNL
chr05,Bn16197,1282540,35345666,34063126,CN
chr05,Bn16198,85178699,87462742,2284043,RLP
chr05,Bn16199,93896286,95572603,1676317,TN
chr05,Bn16200,80068249,81118462,1050213,RLK
chr05,Bn16201,39416890,80994424,41577534,RLP
chr05,Bn16202,97619425,98499413,879988,TNL
chr05,Bn16203,29160053,81626378,52466325,RLP
chr05,Bn16204,87749547,95916054,8166507,CNL
chr05,Bn16205,8118804,13714533,5595729,TNL
chr05,Bn16206,9038722,20444673,11405951,CN
chr05,Bn16207,5357415,46759866,41402451,RLK
chr05,Bn16208,86511173,92447282,5936109,CNL
chr05,Bn16209,90771755,94225910,3454155,TNL
chr05,Bn16210,27834128,84240245,56406117,RLK
chr05,Bn16211,97052569,99776884,2724315,RLK
chr05,Bn16212,60349508,76106955,15757447,CNL
chr05,Bn16213,50765111,59755357,8990246,RLP
chr05,Bn16214,10794912,90825714,80030802,RLK
chr05,Bn16215,87963744,96705703,8741959,CNL
chr05,Bn16216,42658749,89455529,46796780,TN
chr05,Bn16217,99023809,99055070,31261,TNL
chr05,Bn16218,99610313,99799556,189243,TN
chr05,Bn16219,35141561,41245399,6103838,CN
chr05,Bn16220,81539917,91961266,10421349,NBS
chr05,Bn16221,67123014,70302594,3179580,TNL
chr05,Bn16222,14388629,64528772,50140143,TN
chr05,Bn16223,37122614,40745532,3622918,TN
chr05,Bn16224,57601092,99847427,42246335,NBS
chr05,Bn16225,29990723,45245873,15255150,RLK
chr05,Bn16226,1254502,55404798,54150296,CNL
chr05,Bn16227,36805594,78646262,41840668,CNL
chr05,Bn16228,63725755,68685096,4959341,RLP
chr05,Bn16229,96646982,97389700,742718,RLP
chr05,Bn16230,91952850,95889383,3936533,NBS
chr05,Bn16231,77459949,85525353,8065404,CN
chr05,Bn16232,13881032,89163464,75282432,RLK
chr05,Bn16233,31961640,41154189,9192549,RLP
chr05,Bn16234,23721458,81278439,57556981,TNL
chr05,Bn16235,83458440,92194304,8735864,CN
chr05,Bn16236,43646303,92058227,48411924,CN
chr05,Bn16237,38413698,70713246,32299548,TN
chr05,Bn16238,43059184,59718844,16659660,RLK
chr05,Bn16239,49310189,95400599,46090410,TN
chr05,Bn16240,95623289,95993595,370306,TN
chr05,Bn16241,52147625,66869014,14721389,RLP
chr05,Bn16242,96074878,97240738,1165860,NBS
chr05,Bn16243,63346151,98948454,35602303,TN
chr05,Bn16244,12734637,41063929,28329292,TN
chr05,Bn16245,83072081,89679053,6606972,TN
chr05,Bn16246,34707629,91374225,56666596,TN
chr05,Bn16247,22755230,80238681,57483451,RLK
chr05,Bn16248,88532178,98543776,10011598,CNL
chr05,Bn16249,25309776,28357827,3048051,RLK
chr05,Bn16250,65480587,98671978,33191391,RLP
chr05,Bn16251,33773781,37591265,3817484,NBS
chr05,Bn16252,88043448,93986802,5943354,NBS
chr05,Bn16253,23300268,58402983,35102715,TNL
chr05,Bn16254,31224831,43805183,12580352,TN
chr05,Bn16255,95787008,99287578,3500570,NBS
chr05,Bn16256,89953140,92392686,2439546,TNL
chr05,Bn16257,1794823,34847810,33052987,NBS
chr05,Bn16258,67454667,73181990,5727323,CNL
chr05,Bn16259,91078482,93711256,2632774,RLK
chr05,Bn16260,74616193,85719543,11103350,TN
chr05,Bn16261,67249846,77687441,10437595,RLP
chr05,Bn16262,93846426,98792324,4945898,TNL
chr05,Bn16263,61191557,62274869,1083312,CN
chr05,Bn16264,39899562,56011933,16112371,NBS
chr05,Bn16265,99784839,99909789,124950,CN
chr05,Bn16266,43510850,98036909,54526059,TN
chr05,Bn16267,74953389,79216152,4262763,CN
chr05,Bn16268,68049005,76283949,8234944,CN
chr05,Bn16269,20343986,39658246,19314260,CNL
chr05,Bn16270,2599587,16603938,14004351,TN
chr05,Bn16271,27534765,64372878,36838113,TN
chr05,Bn16272,88104938,88995425,890487,RLK
chr05,Bn16273,15161401,44876314,29714913,TN
chr05,Bn16274,90373276,96985692,6612416,RLP
chr05,Bn16275,40739241,84382311,43643070,TN
chr05,Bn16276,63976576,87322869,23346293,TNL
chr05,Bn16277,59660775,95467170,35806395,RLP
chr05,Bn16278,78530842,96990246,18459404,NBS
chr05,Bn16279,31449543,31804230,354687,TN
chr05,Bn16280,34657071,56157942,21500871,TN
chr05,Bn16281,56301802,59835253,3533451,CN
chr05,Bn16282,57427946,89148466,31720520,CNL
chr05,Bn16283,38863329,75498842,36635513,RLP
chr05,Bn16284,51878422,58791892,6913470,TN
chr05,Bn16285,46861711,81692717,34831006,TNL
chr05,Bn16286,59431408,76310304,16878896,NBS
chr05,Bn16287,94127865,94413015,285150,TNL
chr05,Bn16288,31459110,70652161,39193051,CN
chr05,Bn16289,21298168,44842093,23543925,TN
chr05,Bn16290,5631011,38352134,32721123,TNL
chr05,Bn16291,15417564,77590675,62173111,CN
chr05,Bn16292,4011261,89720007,85708746,CN
chr05,Bn16293,89560665,92941326,3380661,TNL
chr05,Bn16294,74001230,79586971,5585741,CN
chr05,Bn16295,2614830,56515648,53900818,CN
chr05,Bn16296,87857547,94604025,6746478,TN
chr05,Bn16297,80049239,97867782,17818543,RLP
chr05,Bn16298,17732386,74528641,56796255,TNL
chr05,Bn16299,51040783,83352337,32311554,CNL
chr05,Bn16300,95722971,97731511,2008540,CNL
chr05,Bn16301,11261471,57154458,45892987,CNL
chr05,Bn16302,98169433,99085564,916131,TNL
chr05,Bn16303,16233463,99196627,82963164,TNL
chr05,Bn16304,35648865,86877738,51228873,RLK
chr05,Bn16305,75912774,76019526,106752,RLK
chr05,Bn16306,26498043,29193813,2695770,RLP
chr05,Bn16307,82451820,84553047,2101227,CNL
chr05,Bn16308,69051375,72371596,3320221,NBS
chr05,Bn16309,55514436,56987903,1473467,RLK
chr05,Bn16310,79152079,89508714,10356635,CN
chr05,Bn16311,12106619,79060745,66954126,TN
chr05,Bn16312,16371176,24003703,7632527,RLP
chr05,Bn16313,19056250,85764998,66708748,TNL
chr05,Bn16314,63804620,96727830,32923210,CN
chr05,Bn16315,39692253,67115528,27423275,TNL
chr05,Bn16316,18616982,68771795,50154813,TNL
chr05,Bn16317,27475305,59067704,31592399,TN
chr05,Bn16318,81807753,85909786,4102033,CN
chr05,Bn16319,60729152,95616173,34887021,RLP
chr05,Bn16320,70631179,71322036,690857,CNL
chr05,Bn16321,85887853,95471798,9583945,RLK
chr05,Bn16322,8898368,27817631,18919263,TN
chr05,Bn16323,94597152,96466824,1869672,CN
chr05,Bn16324,19159066,37667605,18508539,RLP
chr05,Bn16325,95988348,97114290,1125942,TNL
chr05,Bn16326,8442033,34251924,25809891,NBS
chr05,Bn16327,52621970,90908074,38286104,TNL
chr05,Bn16328,58903829,90569751,31665922,RLP
chr05,Bn16329,80261069,94069056,13807987,TNL
chr05,Bn16330,65001307,71691199,6689892,NBS
chr05,Bn16331,1603834,55368791,53764957,CN
chr05,Bn16332,27739202,75309242,47570040,CNL
chr05,Bn16333,80309661,90163040,9853379,RLP
chr05,Bn16334,78960594,83325900,4365306,TNL
chr05,Bn16335,43592845,90209166,46616321,RLP
chr05,Bn16336,69266567,98028743,28762176,TNL
chr05,Bn16337,97317979,99457229,2139250,TNL
chr05,Bn16338,1557158,27117727,25560569,RLK
chr05,Bn16339,93359283,98067229,4707946,NBS
chr05,Bn16340,76015366,78890545,2875179,TNL
chr05,Bn16341,20780773,28988997,8208224,TNL
chr05,Bn16342,87224373,90452538,3228165,CN
chr05,Bn16343,70133440,96738237,26604797,RLP
chr05,Bn16344,87326447,96204039,8877592,RLK
chr05,Bn16345,24448906,51947749,27498843,CNL
chr05,Bn16346,23035550,32822651,9787101,TN
chr05,Bn16347,83622817,92670295,9047478,TNL
chr05,Bn16348,3130165,40709633,37579468,CNL
chr05,Bn16349,32197453,95451125,63253672,TN
chr05,Bn16350,97703089,98325318,622229,TN
chr05,Bn16351,28117403,86517862,58400459,NBS
chr05,Bn16352,54569029,68030283,13461254,NBS
chr05,Bn16353,42523872,73709741,31185869,TNL
chr05,Bn16354,14905867,44963918,30058051,RLK
chr05,Bn16355,16376284,50603836,34227552,CNL
chr05,Bn16356,51254775,79517126,28262351,CNL
chr05,Bn16357,45953368,89577947,43624579,CNL
chr05,Bn16358,36482452,81082245,44599793,CN
chr05,Bn16359,75084705,95031680,19946975,NBS
chr05,Bn16360,5325311,83801988,78476677,RLK
chr05,Bn16361,89399528,98418579,9019051,TN
chr05,Bn16362,1748295,28325546,26577251,RLK
chr05,Bn16363,10304969,25213071,14908102,RLP
chr05,Bn16364,90457263,98419570,7962307,RLP
chr05,Bn16365,35156781,48221188,13064407,CN
chr05,Bn16366,45748276,63557651,17809375,RLP
chr05,Bn16367,82957914,95220580,12262666,TN
chr05,Bn16368,79677710,86572178,6894468,NBS
chr05,Bn16369,10711521,79491395,68779874,RLK
chr05,Bn16370,23451399,42707689,19256290,CN
chr05,Bn16371,15605580,56117670,40512090,TN
chr05,Bn16372,56398622,66746381,10347759,TN
chr05,Bn16373,44226383,63234864,19008481,TN
chr05,Bn16374,75662199,92477135,16814936,CN
chr05,Bn16375,92107938,93633972,1526034,NBS
chr05,Bn16376,27942322,31683178,3740856,RLP
chr05,Bn16377,25381341,41923112,16541771,RLK
chr05,Bn16378,56114203,60779623,4665420,TNL
chr05,Bn16379,5026718,79938688,74911970,RLK
chr05,Bn16380,17020139,61567228,44547089,RLK
chr05,Bn16381,35719681,91080167,55360486,TNL
chr05,Bn16382,85631321,87513033,1881712,CN
chr05,Bn16383,24266224,59032159,34765935,CN
chr05,Bn16384,32381761,58877495,26495734,RLK
chr05,Bn16385,3941490,66884213,62942723,CNL
chr05,Bn16386,3660631,91209471,87548840,NBS
chr05,Bn16387,36012934,47575132,11562198,TN
chr05,Bn16388,56815861,82116738,25300877,TNL
chr05,Bn16389,18043874,49905651,31861777,TN
chr05,Bn16390,22403186,65758518,43355332,NBS
chr05,Bn16391,9849240,65990442,56141202,TN
chr05,Bn16392,95056792,97894869,2838077,CN
chr05,Bn16393,74560280,85267196,10706916,TN
chr05,Bn16394,44037945,74418008,30380063,TNL
chr05,Bn16395,20997010,35056506,14059496,RLP
chr05,Bn16396,66275844,71685371,5409527,TNL
chr05,Bn16397,37617419,57351231,19733812,CNL
chr05,Bn16398,32878344,39810138,6931794,NBS
chr05,Bn16399,99334856,99388658,53802,NBS
chr05,Bn16400,66607538,82239952,15632414,CN
chr05,Bn16401,13127014,15626720,2499706,TN
chr05,Bn16402,69305224,84781209,15475985,NBS
chr05,Bn16403,68540233,72531006,3990773,TNL
chr05,Bn16404,76697936,90362687,13664751,TN
chr05,Bn16405,81298042,91606693,10308651,RLP
chr05,Bn16406,95642234,98387322,2745088,NBS
chr05,Bn16407,64395435,99843839,35448404,RLK
chr05,Bn16408,25009735,51862727,26852992,RLK
chr05,Bn16409,51701366,57604507,5903141,TNL
chr05,Bn16410,81525489,87421321,5895832,TNL
chr05,Bn16411,18783774,85034553,66250779,RLP
chr05,Bn16412,65133846,87833802,22699956,TNL
chr05,Bn16413,4140006,14143596,10003590,NBS
chr05,Bn16414,69448359,83345183,13896824,RLK
chr05,Bn16415,6604693,99283868,92679175,CNL
chr05,Bn16416,98302622,98749216,446594,CNL
chr05,Bn16417,25915553,41545137,15629584,CN
chr05,Bn16418,87740665,99380185,11639520,CNL
chr05,Bn16419,13517820,48360772,34842952,RLK
chr05,Bn16420,62147996,89163952,27015956,CNL
chr05,Bn16421,42606964,65171003,22564039,RLP
chr05,Bn16422,86224165,89004042,2779877,RLP
chr05,Bn16423,46863882,66139668,19275786,CN
chr05,Bn16424,90643334,95736626,5093292,TNL
chr05,Bn16425,52128466,84379555,32251089,RLK
chr05,Bn16426,76315585,81776701,5461116,RLK
chr05,Bn16427,55468223,59312417,3844194,CNL
chr05,Bn16428,54513858,68816810,14302952,CNL
chr05,Bn16429,4939603,58444241,53504638,TN
chr05,Bn16430,58308464,81751940,23443476,RLP
chr05,Bn16431,91022315,98166003,7143688,CN
chr05,Bn16432,24269214,47138503,22869289,CNL
chr05,Bn16433,74965154,78363484,3398330,NBS
chr05,Bn16434,86148507,91470072,5321565,RLP
chr05,Bn16435,89395587,94473512,5077925,NBS
chr05,Bn16436,48179782,53676588,5496806,RLK
chr05,Bn16437,77887251,99416526,21529275,NBS
chr05,Bn16438,83266643,95590550,12323907,CN
chr05,Bn16439,33862341,98090917,64228576,CNL
chr05,Bn16440,34443648,56320654,21877006,RLP
chr05,Bn16441,61396766,95823858,34427092,CNL
chr05,Bn16442,38463552,99074114,60610562,RLP
chr05,Bn16443,14536352,57010522,42474170,NBS
chr05,Bn16444,77444836,98857742,21412906,NBS
chr05,Bn16445,39730594,71798814,32068220,RLK
chr05,Bn16446,88175880,90803470,2627590,CN
chr05,Bn16447,64846423,68131124,3284701,RLP
chr05,Bn16448,56178578,85132954,28954376,RLK
chr05,Bn16449,16495239,79964513,63469274,RLK
chr05,Bn16450,37687254,47844621,10157367,TNL
chr05,Bn16451,20300717,85148572,64847855,NBS
chr05,Bn16452,16243555,61867738,45624183,TNL
chr05,Bn16453,49434324,62260723,12826399,RLP
chr05,Bn16454,29966732,95307729,65340997,TNL
chr05,Bn16455,42902912,67643435,24740523,CNL
chr05,Bn16456,45547405,50788210,5240805,NBS
chr05,Bn16457,64641931,65259473,617542,RLP
chr05,Bn16458,28458440,96210100,67751660,RLK
chr05,Bn16459,59802595,66612634,6810039,RLP
chr05,Bn16460,20066663,88523958,68457295,NBS
chr05,Bn16461,11682957,26223055,14540098,NBS
chr05,Bn16462,49709352,91106303,41396951,TNL
chr05,Bn16463,12270552,19513613,7243061,TNL
chr05,Bn16464,97853947,99281288,1427341,TN
chr05,Bn16465,41472236,82902372,41430136,TN
chr05,Bn16466,16969416,46742803,29773387,CN
chr05,Bn16467,59909952,93415485,33505533,NBS
chr05,Bn16468,7419765,64160673,56740908,RLK
chr05,Bn16469,99045886,99550006,504120,TN
chr05,Bn16470,22060205,87231058,65170853,RLP
chr05,Bn16471,61625697,88163161,26537464,NBS
chr05,Bn16472,72800759,82367683,9566924,TN
chr05,Bn16473,94072745,96177168,2104423,CN
chr05,Bn16474,50195857,91137420,40941563,CN
chr05,Bn16475,3612230,26609181,22996951,CN
chr05,Bn16476,40456266,96923463,56467197,TNL
chr05,Bn16477,94188331,99973322,5784991,TN
chr05,Bn16478,23888202,78833816,54945614,TNL
chr05,Bn16479,71491800,87816692,16324892,TN
chr05,Bn16480,51313085,91819620,40506535,RLP
chr05,Bn16481,73786926,91341462,17554536,CN
chr05,Bn16482,8610196,31248033,22637837,CN
chr05,Bn16483,88599318,93841349,5242031,NBS
chr05,Bn16484,67852169,71145821,3293652,TNL
chr05,Bn16485,86285828,91166013,4880185,NBS
chr05,Bn16486,44449834,64923543,20473709,RLP
chr05,Bn16487,74483569,80589378,6105809,TN
chr05,Bn16488,48895491,94791815,45896324,CN
chr05,Bn16489,55959575,63777910,7818335,NBS
chr05,Bn16490,38995910,75344673,36348763,TNL
chr05,Bn16491,90553623,94149705,3596082,CNL
chr05,Bn16492,47591855,51007934,3416079,RLK
chr05,Bn16493,63246576,79881455,16634879,CN
chr05,Bn16494,18775907,44787782,26011875,RLK
chr05,Bn16495,30959553,47273321,16313768,RLK
chr05,Bn16496,26239665,30589635,4349970,CN
chr05,Bn16497,67482745,73785930,6303185,NBS
chr05,Bn16498,6300325,98285097,91984772,RLP
chr05,Bn16499,6735229,46606430,39871201,RLK
chr05,Bn16500,21531011,43689815,22158804,NBS
chr05,Bn16501,8403780,74005574,65601794,RLP
chr05,Bn16502,50130013,52555490,2425477,RLP
chr05,Bn16503,43867426,61652252,17784826,CN
chr05,Bn16504,24361383,36191981,11830598,TNL
chr05,Bn16505,68352109,94606203,26254094,RLP
chr05,Bn16506,68257811,68930119,672308,CNL
chr05,Bn16507,85247677,91599280,6351603,TN
chr05,Bn16508,15355236,92029785,76674549,TNL
chr05,Bn16509,61188196,64470814,3282618,CNL
chr05,Bn16510,92477377,92735728,258351,CNL
chr05,Bn16511,42180326,80627866,38447540,RLP
chr05,Bn16512,24581166,96116743,71535577,RLK
chr05,Bn16513,30050892,45833937,15783045,RLP
chr05,Bn16514,11761577,55386515,43624938,RLK
chr05,Bn16515,38175810,59066538,20890728,CN
chr05,Bn16516,50054530,62848999,12794469,RLP
chr05,Bn16517,15991886,79090199,63098313,NBS
chr05,Bn16518,19824408,60169163,40344755,TN
chr05,Bn16519,50947144,71504525,20557381,NBS
chr05,Bn16520,35359103,42059012,6699909,RLK
chr05,Bn16521,59753789,87655174,27901385,TN
chr05,Bn16522,18528703,35144914,16616211,TNL
chr05,Bn16523,9848882,52095301,42246419,NBS
chr05,Bn16524,51374092,72541056,21166964,CN
chr05,Bn16525,43108777,88729564,45620787,TN
chr05,Bn16526,70702268,88031259,17328991,RLP
chr05,Bn16527,52585265,65454958,12869693,CNL
chr05,Bn16528,6577554,37836673,31259119,RLP
chr05,Bn16529,27994777,87135164,59140387,RLK
chr05,Bn16530,64597282,70701710,6104428,TNL
chr05,Bn16531,42311323,78243437,35932114,RLP
chr05,Bn16532,58303554,83577071,25273517,RLK
chr05,Bn16533,68410847,83469852,15059005,RLP
chr05,Bn16534,47410542,77384938,29974396,TNL
chr05,Bn16535,24481202,35289123,10807921,CN
chr05,Bn16536,20956690,37320431,16363741,TN
chr05,Bn16537,76350379,77781830,1431451,CN
chr05,Bn16538,81117875,93563408,12445533,TN
chr05,Bn16539,26858398,38098134,11239736,CN
chr05,Bn16540,86960535,97983567,11023032,NBS
chr05,Bn16541,53956295,72420958,18464663,TNL
chr05,Bn16542,39298713,79843938,40545225,RLP
chr05,Bn16543,2248594,93153966,90905372,TN
chr05,Bn16544,82688732,87259603,4570871,TN
chr05,Bn16545,17268349,62792070,45523721,CN
chr05,Bn16546,1954749,82525824,80571075,RLP
chr05,Bn16547,37537774,99172686,61634912,CNL
chr05,Bn16548,83014239,92727412,9713173,RLK
chr05,Bn16549,33878385,72159733,38281348,TN
chr05,Bn16550,98761727,99079880,318153,NBS
chr05,Bn16551,93171249,95974304,2803055,NBS
chr05,Bn16552,98526653,98556253,29600,CN
chr05,Bn16553,54279449,67394540,13115091,NBS
chr05,Bn16554,25399125,61119863,35720738,RLP
chr05,Bn16555,27870574,48525004,20654430,TN
chr05,Bn16556,17273476,26514398,9240922,RLK
chr05,Bn16557,54730564,94281443,39550879,CNL
chr05,Bn16558,33262293,42899497,9637204,RLP
chr05,Bn16559,53794026,71501107,17707081,RLK
chr05,Bn16560,63873964,82501885,18627921,CN
chr05,Bn16561,43792952,55222437,11429485,TNL
chr05,Bn16562,97501061,98530808,1029747,NBS
chr05,Bn16563,89467385,94774592,5307207,TN
chr05,Bn16564,65986297,67666022,1679725,RLP
chr05,Bn16565,84332866,85473914,1141048,CN
chr05,Bn16566,79799308,89719603,9920295,RLP
chr05,Bn16567,15289232,63807835,48518603,TNL
chr05,Bn16568,35176021,92041780,56865759,RLK
chr05,Bn16569,81338561,82173681,835120,RLK
chr05,Bn16570,67445224,78899143,11453919,RLK
chr05,Bn16571,35032444,43630296,8597852,RLP
chr05,Bn16572,9055541,67738683,58683142,RLK
chr05,Bn16573,92093328,94087216,1993888,NBS
chr05,Bn16574,95960526,98355354,2394828,RLK
chr05,Bn16575,94234191,95325360,1091169,CN
chr05,Bn16576,63308315,66085663,2777348,RLK
chr05,Bn16577,51885768,72251277,20365509,CN
chr05,Bn16578,20771905,36013512,15241607,TNL
chr05,Bn16579,5824602,98348937,92524335,NBS
chr05,Bn16580,4693583,19566040,14872457,RLK
chr05,Bn16581,12034169,89376299,77342130,NBS
chr05,Bn16582,41642876,93331373,51688497,RLK
chr05,Bn16583,91812507,96146492,4333985,TN
chr05,Bn16584,47834215,73419469,25585254,RLK
chr05,Bn16585,51299866,62179481,10879615,TN
chr05,Bn16586,16630544,46592705,29962161,TNL
chr05,Bn16587,85301085,85593715,292630,CNL
chr05,Bn16588,89915134,93978044,4062910,TN
chr05,Bn16589,55637636,82723672,27086036,CNL
chr05,Bn16590,81339808,87964514,6624706,RLK
chr05,Bn16591,90672309,95555382,4883073,RLP
chr05,Bn16592,76458741,80871416,4412675,RLP
chr05,Bn16593,37551409,68128992,30577583,TN
chr05,Bn16594,41682506,99266168,57583662,CNL
chr05,Bn16595,74003408,98874818,24871410,RLK
chr05,Bn16596,11505399,66948912,55443513,TN
chr05,Bn16597,22615120,72624238,50009118,CNL
chr05,Bn16598,99818450,99944391,125941,TN
chr05,Bn16599,30951525,95975520,65023995,CNL
chr05,Bn16600,50728561,80547661,29819100,NBS
chr05,Bn16601,3021077,44381597,41360520,CNL
chr05,Bn16602,25415325,40006384,14591059,TNL
chr05,Bn16603,40985599,63418965,22433366,RLK
chr05,Bn16604,31462166,45668116,14205950,TNL
chr05,Bn16605,99191044,99197736,6692,NBS
chr05,Bn16606,4030575,58902709,54872134,NBS
chr05,Bn16607,11262238,16151378,4889140,CNL
chr05,Bn16608,40880992,93863546,52982554,CN
chr05,Bn16609,24824256,97715162,72890906,TNL
chr05,Bn16610,25925356,42478317,16552961,TNL
chr05,Bn16611,39073455,93973864,54900409,RLK
chr05,Bn16612,92236225,96463333,4227108,TNL
chr05,Bn16613,23724728,92286090,68561362,CN
chr05,Bn16614,44256107,95974370,51718263,CN
chr05,Bn16615,24301472,67120088,42818616,NBS
chr05,Bn16616,93402010,94607556,1205546,CN
chr05,Bn16617,95205578,96503972,1298394,TN
chr05,Bn16618,89655562,93567664,3912102,TN
chr05,Bn16619,1825111,89866791,88041680,NBS
chr05,Bn16620,43175290,62414799,19239509,CNL
chr05,Bn16621,61659551,91870978,30211427,CNL
chr05,Bn16622,26136373,47710191,21573818,NBS
chr05,Bn16623,15979064,81527275,65548211,RLP
chr05,Bn16624,96241306,96290500,49194,TNL
chr05,Bn16625,74037897,99451564,25413667,CNL
chr05,Bn16626,46702808,84367442,37664634,NBS
chr05,Bn16627,62782121,63319529,537408,RLP
chr05,Bn16628,3728076,81581168,77853092,CNL
chr05,Bn16629,34389704,44651552,10261848,CNL
chr05,Bn16630,55171004,82826061,27655057,RLP
chr05,Bn16631,21935496,63037340,41101844,NBS
chr05,Bn16632,44625291,50313066,5687775,TN
chr05,Bn16633,81297539,83586593,2289054,CN
chr05,Bn16634,9354336,25548093,16193757,CN
chr05,Bn16635,91926170,92775796,849626,TN
chr05,Bn16636,78478799,86019164,7540365,TNL
chr05,Bn16637,83752108,91692537,7940429,NBS
chr05,Bn16638,15917552,49843957,33926405,NBS
chr05,Bn16639,51101696,62975008,11873312,RLK
chr05,Bn16640,99883998,99990816,106818,TN
chr05,Bn16641,63523186,89959924,26436738,CN
chr05,Bn16642,90536111,98566129,8030018,CN
chr05,Bn16643,3126735,91628818,88502083,TNL
chr05,Bn16644,14729397,92756924,78027527,TN
chr05,Bn16645,27688217,35675225,7987008,TN
chr05,Bn16646,38978016,79098788,40120772,CN
chr05,Bn16647,29218632,90180947,60962315,CN
chr05,Bn16648,65817074,98234839,32417765,TN
chr05,Bn16649,91954227,93101522,1147295,RLK
chr05,Bn16650,84660286,98410179,13749893,TNL
chr05,Bn16651,33862475,70067284,36204809,RLP
chr05,Bn16652,66786990,95950316,29163326,TNL
chr05,Bn16653,39073070,95692026,56618956,RLK
chr05,Bn16654,95018773,99769944,4751171,NBS
chr05,Bn16655,82899171,84766354,1867183,TN
chr05,Bn16656,58834199,59928096,1093897,RLP
chr05,Bn16657,34661959,76766022,42104063,TNL
chr05,Bn16658,95127041,96692378,1565337,TNL
chr05,Bn16659,74673840,85715731,11041891,NBS
chr05,Bn16660,51496544,63790426,12293882,RLP
chr05,Bn16661,28376649,71743329,43366680,NBS
chr05,Bn16662,91630622,92661884,1031262,TNL
chr05,Bn16663,91487566,96374709,4887143,RLK
chr05,Bn16664,70021597,92913118,22891521,RLP
chr05,Bn16665,90655973,92834264,2178291,RLP
chr05,Bn16666,94102567,97248493,3145926,CN
chr05,Bn16667,26808426,70814619,44006193,RLK
chr05,Bn16668,73603779,85629245,12025466,CN
chr05,Bn16669,20728975,45027506,24298531,RLP
chr05,Bn16670,21845511,34924012,13078501,TNL
chr05,Bn16671,62760950,86424295,23663345,CNL
chr05,Bn16672,89629024,94881872,5252848,NBS
chr05,Bn16673,84471874,94198195,9726321,CNL
chr05,Bn16674,12659525,83708715,71049190,CN
chr05,Bn16675,67365388,74122207,6756819,TN
chr05,Bn16676,3441645,46596855,43155210,RLP
chr05,Bn16677,77689620,95476807,17787187,TN
chr05,Bn16678,77625769,78516784,891015,RLP
chr05,Bn16679,7451807,87391882,79940075,NBS
chr05,Bn16680,93805751,94337587,531836,NBS
chr05,Bn16681,56084114,67117098,11032984,TNL
chr05,Bn16682,95844590,99385242,3540652,TN
chr05,Bn16683,43118354,74572890,31454536,CNL
chr05,Bn16684,14681341,88739242,74057901,RLK
chr05,Bn16685,70954665,78199765,7245100,RLP
chr05,Bn16686,39968772,63343651,23374879,TN
chr05,Bn16687,73484795,95628448,22143653,CNL
chr05,Bn16688,30790264,81141991,50351727,TN
chr05,Bn16689,46264610,92235914,45971304,NBS
chr05,Bn16690,64706866,84717561,20010695,RLP
chr05,Bn16691,5244699,62681566,57436867,RLP
chr05,Bn16692,48998331,56959647,7961316,NBS
chr05,Bn16693,68068233,77554883,9486650,CN
chr05,Bn16694,65923654,76430691,10507037,TN
chr05,Bn16695,76388222,86052897,9664675,CNL
chr05,Bn16696,8517961,12196869,3678908,CN
chr05,Bn16697,42001451,65837084,23835633,TNL
chr05,Bn16698,74382179,95507608,21125429,TN
chr05,Bn16699,7236243,43705035,36468792,TNL
chr05,Bn16700,2174077,27445175,25271098,NBS
chr05,Bn16701,88552787,98477611,9924824,RLP
chr05,Bn16702,75992373,96759062,20766689,CNL
chr05,Bn16703,33472870,85178661,51705791,CNL
chr05,Bn16704,48857288,74659506,25802218,RLP
chr05,Bn16705,45145969,95274990,50129021,TN
chr05,Bn16706,63056886,72102281,9045395,TNL
chr05,Bn16707,57299284,84163246,26863962,TNL
chr05,Bn16708,96452401,98195450,1743049,CN
chr05,Bn16709,66192505,83625594,17433089,CNL
chr05,Bn16710,35225871,58137169,22911298,CNL
chr05,Bn16711,82731294,92896069,10164775,CNL
chr05,Bn16712,77261807,84254944,6993137,TN
chr05,Bn16713,9513717,11936319,2422602,CNL
chr05,Bn16714,87931184,98626703,10695519,TN
chr05,Bn16715,83115815,97779916,14664101,TNL
chr05,Bn16716,21460166,96265683,74805517,RLK
chr05,Bn16717,33880070,73262639,39382569,NBS
chr05,Bn16718,48431488,53928434,5496946,NBS
chr05,Bn16719,22809589,31794677,8985088,TN
chr05,Bn16720,83906721,89442612,5535891,RLK
chr05,Bn16721,57200785,98836659,41635874,TNL
chr05,Bn16722,97253253,98443867,1190614,TN
chr05,Bn16723,24236047,82135077,57899030,TNL
chr05,Bn16724,64060591,66668526,2607935,TN
chr05,Bn16725,79538604,85617877,6079273,NBS
chr05,Bn16726,44379565,86019269,41639704,CNL
chr05,Bn16727,19117934,19376679,258745,NBS
chr05,Bn16728,68967065,88041014,19073949,RLP
chr05,Bn16729,50556559,63200384,12643825,TN
chr05,Bn16730,15369203,50444583,35075380,TNL
chr05,Bn16731,83583267,94085226,10501959,CNL
chr05,Bn16732,82019205,84378715,2359510,CNL
chr05,Bn16733,4836052,6835792,1999740,RLK
chr05,Bn16734,76542026,88041461,11499435,TNL
chr05,Bn16735,59906407,96847783,36941376,CNL
chr05,Bn16736,49402262,56729607,7327345,CN
chr05,Bn16737,53405834,57232329,3826495,RLK
chr05,Bn16738,72547030,97016389,24469359,TN
chr05,Bn16739,10481089,94527060,84045971,RLK
chr05,Bn16740,42138934,90499386,48360452,RLK
chr05,Bn16741,79919348,97984216,18064868,CN
chr05,Bn16742,47449869,98362350,50912481,NBS
chr05,Bn16743,84124679,92031958,7907279,CNL
chr05,Bn16744,72433067,77712971,5279904,TNL
chr05,Bn16745,54041666,66807745,12766079,TNL
chr05,Bn16746,37922830,88394691,50471861,RLP
chr05,Bn16747,4035590,35931196,31895606,NBS
chr05,Bn16748,89393980,98578512,9184532,TNL
chr05,Bn16749,81556584,91649255,10092671,RLK
chr05,Bn16750,62327196,72495316,10168120,TNL
chr05,Bn16751,90506497,95950984,5444487,CNL
chr05,Bn16752,36275883,62323259,26047376,NBS
chr05,Bn16753,81986696,95165704,13179008,RLK
chr05,Bn16754,89320279,89922664,602385,TN
chr05,Bn16755,46382047,53136576,6754529,TN
chr05,Bn16756,37522081,94352238,56830157,NBS
chr05,Bn16757,35019947,95836519,60816572,CN
chr05,Bn16758,81980426,85417784,3437358,NBS
chr05,Bn16759,40616936,87656530,47039594,RLK
chr05,Bn16760,7434384,28547193,21112809,TN
chr05,Bn16761,51404802,77250593,25845791,CNL
chr05,Bn16762,62290305,76477137,14186832,TNL
chr05,Bn16763,20889036,49261093,28372057,RLK
chr05,Bn16764,45101955,94309029,49207074,NBS
chr05,Bn16765,98709810,99666535,956725,TN
chr05,Bn16766,98215279,99543664,1328385,NBS
chr05,Bn16767,43038218,79230130,36191912,NBS
chr05,Bn16768,29050573,48179984,19129411,RLK
chr05,Bn16769,26325578,31252900,4927322,TNL
chr05,Bn16770,76523324,83170147,6646823,RLK
chr05,Bn16771,66379280,76614005,10234725,CNL
chr05,Bn16772,22082036,93817968,71735932,TN
chr05,Bn16773,60131763,87072368,26940605,RLP
chr05,Bn16774,8148723,39179006,31030283,CN
chr05,Bn16775,3415430,20760110,17344680,NBS
chr05,Bn16776,54109592,68600070,14490478,CN
chr05,Bn16777,93151650,99203344,6051694,NBS
chr05,Bn16778,49269020,69199650,19930630,CNL
chr05,Bn16779,97904175,98713012,808837,TNL
chr05,Bn16780,88056812,89872092,1815280,CN
chr05,Bn16781,10736816,26410684,15673868,CN
chr05,Bn16782,31176787,41846779,10669992,TNL
chr05,Bn16783,75636252,77330486,1694234,CN
chr05,Bn16784,30373680,84095738,53722058,TNL
chr05,Bn16785,29806192,72177806,42371614,TNL
chr05,Bn16786,49399231,96241250,46842019,RLK
chr05,Bn16787,97285724,98194248,908524,TN
chr05,Bn16788,86174701,98779206,12604505,RLP
chr05,Bn16789,19171017,44812841,25641824,NBS
chr05,Bn16790,30754520,87323270,56568750,CNL
chr05,Bn16791,66607921,87171439,20563518,NBS
chr05,Bn16792,14729688,87743934,73014246,RLP
chr05,Bn16793,76593341,81605857,5012516,TNL
chr05,Bn16794,67609150,84774746,17165596,NBS
chr05,Bn16795,42811182,55589416,12778234,RLK
chr05,Bn16796,50096799,89197250,39100451,RLK
chr05,Bn16797,83041117,87024070,3982953,TNL
chr05,Bn16798,23706648,37303509,13596861,TN
chr05,Bn16799,30133020,88324156,58191136,TN
chr05,Bn16800,23792321,82492400,58700079,TNL
chr05,Bn16801,49305948,63585251,14279303,TNL
chr05,Bn16802,79946235,99448760,19502525,NBS
chr05,Bn16803,84048156,94826576,10778420,NBS
chr05,Bn16804,17002278,49801061,32798783,CN
chr05,Bn16805,19306831,45544396,26237565,NBS
chr05,Bn16806,71452866,82206059,10753193,CN
chr05,Bn16807,13601956,92697305,79095349,CNL
chr05,Bn16808,76631680,94687818,18056138,TN
chr05,Bn16809,68855296,84865938,16010642,CN
chr05,Bn16810,40783164,65984444,25201280,CNL
chr05,Bn16811,52927626,54737816,1810190,NBS
chr05,Bn16812,34508182,41775554,7267372,NBS
chr05,Bn16813,75998419,86452876,10454457,NBS
chr05,Bn16814,27814207,83365179,55550972,TN
chr05,Bn16815,87872180,98717568,10845388,TNL
chr05,Bn16816,91980809,96025764,4044955,TNL
chr05,Bn16817,83303647,86390412,3086765,RLK
chr05,Bn16818,28176253,97845917,69669664,NBS
chr05,Bn16819,67578096,85012058,17433962,NBS
chr05,Bn16820,6561320,42103914,35542594,RLK
chr05,Bn16821,52733370,93778218,41044848,RLK
chr05,Bn16822,3992211,85520156,81527945,TNL
chr05,Bn16823,5661886,19316193,13654307,CN
chr05,Bn16824,24989972,78827657,53837685,CN
chr05,Bn16825,9267622,82089780,72822158,NBS
chr05,Bn16826,42799136,47239222,4440086,RLK
chr05,Bn16827,46730480,48199224,1468744,CN
chr05,Bn16828,98599269,98935011,335742,NBS
chr05,Bn16829,20515928,38698584,18182656,RLK
chr05,Bn16830,50827317,84374317,33547000,RLK
chr05,Bn16831,15040539,73121549,58081010,CN
chr05,Bn16832,40892835,68417621,27524786,CNL
chr05,Bn16833,20629375,56071496,35442121,CN
chr05,Bn16834,71308139,88229902,16921763,TNL
chr05,Bn16835,96591973,97514059,922086,RLK
chr05,Bn16836,14058634,28185113,14126479,NBS
chr05,Bn16837,35606794,54225239,18618445,RLP
chr05,Bn16838,1186750,41462813,40276063,NBS
chr05,Bn16839,2911947,21540154,18628207,NBS
chr05,Bn16840,67344934,84433655,17088721,TNL
chr05,Bn16841,52758701,60237069,7478368,TN
chr05,Bn16842,74496897,77254929,2758032,CN
chr05,Bn16843,32091500,32877417,785917,TNL
chr05,Bn16844,7505455,90213240,82707785,TNL
chr05,Bn16845,41253827,57788019,16534192,CNL
chr05,Bn16846,16057750,70289835,54232085,CNL
chr05,Bn16847,72985611,83108829,10123218,RLK
chr05,Bn16848,72633701,90888092,18254391,TN
chr05,Bn16849,62917418,72756036,9838618,NBS
chr05,Bn16850,91961643,95754649,3793006,RLP
chr05,Bn16851,58038699,97552349,39513650,NBS
chr05,Bn16852,63247841,82207488,18959647,RLK
chr05,Bn16853,42140379,50448594,8308215,RLP
chr05,Bn16854,60313084,99272519,38959435,TN
chr05,Bn16855,49292688,94834274,45541586,TN
chr05,Bn16856,69158582,80617468,11458886,TNL
chr05,Bn16857,1125460,85846605,84721145,NBS
chr05,Bn16858,98928898,99893184,964286,RLP
chr05,Bn16859,79899247,86427528,6528281,RLP
chr05,Bn16860,49444798,88127408,38682610,RLP
chr05,Bn16861,83426853,94010413,10583560,CN
chr05,Bn16862,84835514,91080415,6244901,NBS
chr05,Bn16863,76185142,92527479,16342337,TNL
chr05,Bn16864,95733179,99531019,3797840,RLK
chr05,Bn16865,60160515,67883574,7723059,NBS
chr05,Bn16866,44903335,49840611,4937276,RLK
chr05,Bn16867,88633753,93374979,4741226,RLP
chr05,Bn16868,87774348,94924705,7150357,CN
chr05,Bn16869,91917828,98600554,6682726,TNL
chr05,Bn16870,35096389,91015557,55919168,RLP
chr05,Bn16871,5068514,26288970,21220456,RLP
chr05,Bn16872,12879498,40416700,27537202,TN
chr05,Bn16873,26427089,73450408,47023319,TNL
chr05,Bn16874,88173190,95746148,7572958,CNL
chr05,Bn16875,65867500,86027020,20159520,TNL
chr05,Bn16876,49649865,87300244,37650379,NBS
chr05,Bn16877,64336593,80455337,16118744,NBS
chr05,Bn16878,80284696,80465170,180474,RLK
chr05,Bn16879,32878577,81417846,48539269,TN
chr05,Bn16880,43558835,72587582,29028747,NBS
chr05,Bn16881,93709250,95914489,2205239,TN
chr05,Bn16882,76898990,87925219,11026229,CNL
chr05,Bn16883,57633583,86792038,29158455,CNL
chr05,Bn16884,38738236,43851476,5113240,NBS
chr05,Bn16885,94670071,96510476,1840405,CN
chr05,Bn16886,97236819,98165955,929136,TNL
chr05,Bn16887,87202427,90314826,3112399,CN
chr05,Bn16888,35204331,87042937,51838606,RLK
chr05,Bn16889,36372204,59526445,23154241,CN
chr05,Bn16890,89764604,91210855,1446251,RLK
chr05,Bn16891,45522331,55015227,9492896,NBS
chr05,Bn16892,47519847,88048708,40528861,CNL
chr05,Bn16893,73305855,89882840,16576985,RLK
chr05,Bn16894,35777432,78489872,42712440,NBS
chr05,Bn16895,34163047,56944904,22781857,CNL
chr05,Bn16896,41057635,60724925,19667290,RLK
chr05,Bn16897,15814487,98955795,83141308,RLP
chr05,Bn16898,89409760,91606860,2197100,TN
chr05,Bn16899,47733397,89172313,41438916,TNL
chr05,Bn16900,89715922,95355123,5639201,CN
chr05,Bn16901,44794675,78585656,33790981,TN
chr05,Bn16902,68792959,78242329,9449370,CN
chr05,Bn16903,78533208,90067291,11534083,CN
chr05,Bn16904,99033672,99413636,379964,RLK
chr05,Bn16905,61064222,75499408,14435186,CN
chr05,Bn16906,19705566,71287192,51581626,CN
chr05,Bn16907,19903811,63360170,43456359,TNL
chr05,Bn16908,52376601,57386425,5009824,NBS
chr05,Bn16909,44641946,65973888,21331942,TN
chr05,Bn16910,95533608,97117495,1583887,NBS
chr05,Bn16911,38732886,89391438,50658552,CNL
chr05,Bn16912,78547044,95027258,16480214,TN
chr05,Bn16913,91411758,92643775,1232017,RLK
chr05,Bn16914,50899756,69959059,19059303,RLP
chr05,Bn16915,5428789,84913002,79484213,TNL
chr05,Bn16916,90250667,92249324,1998657,TNL
chr05,Bn16917,33588241,82761214,49172973,RLK
chr05,Bn16918,27575350,55254998,27679648,NBS
chr05,Bn16919,9291866,59740944,50449078,CNL
chr05,Bn16920,24722371,50016395,25294024,CN
chr05,Bn16921,9494902,62299800,52804898,CN
chr05,Bn16922,49255896,61755125,12499229,TNL
chr05,Bn16923,37032826,42748417,5715591,RLK
chr05,Bn16924,46292983,78104450,31811467,CN
chr05,Bn16925,50890998,89631922,38740924,NBS
chr05,Bn16926,24674967,71710869,47035902,NBS
chr05,Bn16927,6765233,60828801,54063568,CN
chr05,Bn16928,49190996,88586475,39395479,NBS
chr05,Bn16929,99402445,99470546,68101,CN
chr05,Bn16930,68453425,79184436,10731011,CN
chr05,Bn16931,46779209,73526415,26747206,NBS
chr05,Bn16932,76980848,91803196,14822348,RLK
chr05,Bn16933,82519660,83343160,823500,RLK
chr05,Bn16934,80581885,97310049,16728164,RLP
chr05,Bn16935,81007885,86266985,5259100,TNL
chr05,Bn16936,2242228,97062114,94819886,TNL
chr05,Bn16937,24952940,41301395,16348455,TN
chr05,Bn16938,79297838,90813967,11516129,NBS
chr05,Bn16939,58886331,66450564,7564233,NBS
chr05,Bn16940,92049877,92393246,343369,CNL
chr05,Bn16941,66198482,94872945,28674463,CNL
chr05,Bn16942,62845792,67774453,4928661,TN
chr05,Bn16943,31594333,58779161,27184828,CNL
chr05,Bn16944,92109924,95557356,3447432,TNL
chr05,Bn16945,86903072,93898128,6995056,CNL
chr05,Bn16946,88588997,99193922,10604925,RLK
chr05,Bn16947,26150495,48728689,22578194,RLP
chr05,Bn16948,48971041,86240491,37269450,NBS
chr05,Bn16949,71435868,79287809,7851941,NBS
chr05,Bn16950,66355298,94783454,28428156,TN
chr05,Bn16951,75264761,93389653,18124892,CNL
chr05,Bn16952,10372696,63160747,52788051,TN
chr05,Bn16953,40677234,91548597,50871363,TNL
chr05,Bn16954,7156392,57138519,49982127,NBS
chr05,Bn16955,47011388,83653470,36642082,TNL
chr05,Bn16956,62512513,99776843,37264330,TNL
chr05,Bn16957,46803094,55915324,9112230,TN
chr05,Bn16958,42580704,44390227,1809523,RLP
chr05,Bn16959,73808726,98560407,24751681,RLP
chr05,Bn16960,29018973,54744652,25725679,CN
chr05,Bn16961,42345827,75231177,32885350,RLK
chr05,Bn16962,43132670,64406563,21273893,TNL
chr05,Bn16963,74015583,95551973,21536390,NBS
chr05,Bn16964,51107661,66977765,15870104,RLP
chr05,Bn16965,55039695,95123490,40083795,CN
chr05,Bn16966,91489286,95324482,3835196,CN
chr05,Bn16967,10425798,76207345,65781547,TNL
chr05,Bn16968,24537069,32378967,7841898,RLP
chr05,Bn16969,55313169,80474179,25161010,CNL
chr05,Bn16970,16759652,36270344,19510692,CN
chr05,Bn16971,80390473,84628400,4237927,TN
chr05,Bn16972,15721984,48351277,32629293,TNL
chr05,Bn16973,85472851,92907895,7435044,TN
chr05,Bn16974,83112369,90339752,7227383,TNL
chr05,Bn16975,86280781,94925739,8644958,TNL
chr05,Bn16976,83955355,95059709,11104354,CNL
chr05,Bn16977,50306821,95156755,44849934,RLP
chr05,Bn16978,26812752,30833447,4020695,CN
chr05,Bn16979,85153805,98740327,13586522,NBS
chr05,Bn16980,66302818,68083696,1780878,CNL
chr05,Bn16981,50413216,84365350,33952134,TNL
chr05,Bn16982,89643002,93077569,3434567,RLP
chr05,Bn16983,45351435,74124521,28773086,RLK
chr05,Bn16984,1934390,39306283,37371893,RLP
chr05,Bn16985,7425694,67625106,60199412,CN
chr05,Bn16986,83596891,92889633,9292742,RLP
chr05,Bn16987,16568119,83122545,66554426,RLK
chr05,Bn16988,38273623,59848275,21574652,RLK
chr05,Bn16989,65700213,66172977,472764,NBS
chr05,Bn16990,30417049,42453202,12036153,NBS
chr05,Bn16991,93997424,97906426,3909002,RLP
chr05,Bn16992,8251121,42944723,34693602,RLK
chr05,Bn16993,79158001,81659193,2501192,TN
chr05,Bn16994,90138256,95225198,5086942,NBS
chr05,Bn16995,86171469,96533889,10362420,CN
chr05,Bn16996,23113376,64918177,41804801,NBS
chr05,Bn16997,32074689,84084373,52009684,RLP
chr05,Bn16998,26334846,92329961,65995115,RLP
chr05,Bn16999,8204853,96360499,88155646,TNL
chr05,Bn17000,94133701,98823309,4689608,NBS
chr05,Bn17001,12821596,17855525,5033929,RLP
chr05,Bn17002,12130297,93122142,80991845,CN
chr05,Bn17003,34532142,94675403,60143261,RLK
chr05,Bn17004,54112034,74046372,19934338,CNL
chr05,Bn17005,4146851,42049683,37902832,CN
chr05,Bn17006,87557494,96855806,9298312,RLK
chr05,Bn17007,93077594,97842151,4764557,NBS
chr05,Bn17008,16962354,31371630,14409276,NBS
chr05,Bn17009,40568039,99501518,58933479,RLK
chr05,Bn17010,55216049,72369552,17153503,CN
chr05,Bn17011,75275231,94520252,19245021,NBS
chr05,Bn17012,26570196,74195396,47625200,CNL
chr05,Bn17013,74539858,87819970,13280112,CN
chr05,Bn17014,35937338,56919665,20982327,RLP
chr05,Bn17015,95915294,98574007,2658713,RLK
chr05,Bn17016,98691716,99532823,841107,TN
chr05,Bn17017,20754307,76348793,55594486,CN
chr05,Bn17018,22681705,32498865,9817160,TN
chr05,Bn17019,40671487,86635058,45963571,RLP
chr05,Bn17020,69786027,83182374,13396347,CNL
chr05,Bn17021,81209457,86591112,5381655,TNL
chr05,Bn17022,17977012,42737923,24760911,NBS
chr05,Bn17023,84647864,91010735,6362871,NBS
chr05,Bn17024,97706585,99634749,1928164,CNL
chr05,Bn17025,65731042,65948657,217615,CNL
chr05,Bn17026,85338595,92743684,7405089,TNL
chr05,Bn17027,31301359,71514651,40213292,RLK
chr05,Bn17028,43335124,91256364,47921240,NBS
chr05,Bn17029,19397453,44122305,24724852,RLK
chr05,Bn17030,19026238,62952167,43925929,CN
chr05,Bn17031,55109295,62656574,7547279,RLK
chr05,Bn17032,61081243,72716298,11635055,NBS
chr05,Bn17033,4001867,47293200,43291333,TN
chr05,Bn17034,22541864,78531925,55990061,RLP
chr05,Bn17035,83444924,92783780,9338856,RLK
chr05,Bn17036,1809832,58714693,56904861,TNL
chr05,Bn17037,79204665,90596037,11391372,CNL
chr05,Bn17038,16118071,55892684,39774613,TN
chr05,Bn17039,66610196,93145273,26535077,RLP
chr05,Bn17040,84769216,95558548,10789332,TNL
chr05,Bn17041,61178782,67194762,6015980,NBS
chr05,Bn17042,34453051,62965746,28512695,CN
chr05,Bn17043,46400314,53712571,7312257,TN
chr05,Bn17044,13930971,17091436,3160465,TN
chr05,Bn17045,38772928,78003482,39230554,CN
chr05,Bn17046,70260724,73947078,3686354,CNL
chr05,Bn17047,59484050,93820765,34336715,RLP
chr05,Bn17048,38065679,99157771,61092092,TNL
chr05,Bn17049,83574578,88620940,5046362,CN
chr05,Bn17050,98190841,98200584,9743,CNL
chr05,Bn17051,67232479,85413064,18180585,TNL
chr05,Bn17052,31894838,82424255,50529417,TNL
chr05,Bn17053,69803181,72242713,2439532,RLP
chr05,Bn17054,19607349,63239476,43632127,RLK
chr05,Bn17055,24415755,74852304,50436549,CNL
chr05,Bn17056,36077808,72906854,36829046,CN
chr05,Bn17057,45408285,78452085,33043800,TN
chr05,Bn17058,92142481,94944566,2802085,TN
chr05,Bn17059,55424107,97207231,41783124,RLK
chr05,Bn17060,92436393,93459844,1023451,CNL
chr05,Bn17061,17163066,58789553,41626487,RLP
chr05,Bn17062,20522157,66670698,46148541,TN
chr05,Bn17063,91063971,94740215,3676244,CN
chr05,Bn17064,93902830,97061058,3158228,TN
chr05,Bn17065,86752764,99464244,12711480,TN
chr05,Bn17066,32088841,71089040,39000199,RLP
chr05,Bn17067,10701401,90079964,79378563,NBS
chr05,Bn17068,83011743,99621618,16609875,NBS
chr05,Bn17069,45819344,66246489,20427145,NBS
chr05,Bn17070,60580533,69526923,8946390,TNL
chr05,Bn17071,29448133,75690198,46242065,RLK
chr05,Bn17072,18944820,40104408,21159588,TNL
chr05,Bn17073,76962237,92743844,15781607,NBS
chr05,Bn17074,5214236,39724515,34510279,CNL
chr05,Bn17075,39308031,72795235,33487204,NBS
chr05,Bn17076,1264459,45744877,44480418,TNL
chr05,Bn17077,90436325,94809728,4373403,CN
chr05,Bn17078,67553300,79915494,12362194,TN
chr05,Bn17079,40394427,48859481,8465054,CN
chr05,Bn17080,48529919,69737819,21207900,CNL
chr05,Bn17081,33335602,82833643,49498041,CN
chr05,Bn17082,65716645,77858250,12141605,TNL
chr05,Bn17083,50445431,54558852,4113421,CN
chr05,Bn17084,49017101,91769117,42752016,CN
chr05,Bn17085,38920512,64937119,26016607,NBS
chr05,Bn17086,98352603,99360645,1008042,NBS
chr05,Bn17087,40174647,53821997,13647350,TN
chr05,Bn17088,84933874,90501339,5567465,CN
chr05,Bn17089,97538401,98863539,1325138,TN
chr05,Bn17090,22769792,82944686,60174894,CNL
chr05,Bn17091,12019083,28946383,16927300,NBS
chr05,Bn17092,84764349,85335750,571401,TN
chr05,Bn17093,99696290,99986108,289818,RLP
chr05,Bn17094,20619110,50671923,30052813,RLP
chr05,Bn17095,51657933,96745289,45087356,CN
chr05,Bn17096,14675766,73233207,58557441,CNL
chr05,Bn17097,97481452,99874490,2393038,NBS
chr05,Bn17098,21203606,68548156,47344550,TN
chr05,Bn17099,8949736,45183401,36233665,CN
chr05,Bn17100,49444125,68363747,18919622,TN
chr05,Bn17101,78126491,96572424,18445933,CNL
chr05,Bn17102,56745528,99754403,43008875,NBS
chr05,Bn17103,75477885,93628857,18150972,RLP
chr05,Bn17104,46461950,80835387,34373437,TN
chr05,Bn17105,85442589,87762370,2319781,RLK
chr05,Bn17106,12861110,41233338,28372228,CN
chr05,Bn17107,74131502,95158726,21027224,TNL
chr05,Bn17108,87118275,98853802,11735527,CN
chr05,Bn17109,55855046,57982399,2127353,RLK
chr05,Bn17110,75017350,92932856,17915506,RLP
chr05,Bn17111,11154735,20478440,9323705,TNL
chr05,Bn17112,11566416,94979011,83412595,TNL
chr05,Bn17113,13639446,83855718,70216272,CNL
chr05,Bn17114,79183703,98070416,18886713,RLK
chr05,Bn17115,23737217,31666194,7928977,TNL
chr05,Bn17116,73938162,95004362,21066200,CN
chr05,Bn17117,15374508,40636047,25261539,TN
chr05,Bn17118,67992631,73032532,5039901,TNL
chr05,Bn17119,19720207,59480635,39760428,TNL
chr05,Bn17120,97469147,97858382,389235,TNL
chr05,Bn17121,28990673,95896911,66906238,CN
chr05,Bn17122,3215560,34433493,31217933,CNL
chr05,Bn17123,8997774,84293696,75295922,CNL
chr05,Bn17124,22135457,30957184,8821727,CNL
chr05,Bn17125,59072820,67836826,8764006,NBS
chr05,Bn17126,50433698,63946153,13512455,CN
chr05,Bn17127,58435297,65341529,6906232,RLK
chr05,Bn17128,22873436,95429158,72555722,TN
chr05,Bn17129,69023885,85452702,16428817,NBS
chr05,Bn17130,86376688,92452355,6075667,TNL
chr05,Bn17131,79003229,87830449,8827220,TN
chr05,Bn17132,24577147,94936185,70359038,CNL
chr05,Bn17133,59986113,63052099,3065986,CNL
chr05,Bn17134,97751609,99899153,2147544,RLK
chr05,Bn17135,29006266,80251992,51245726,NBS
chr05,Bn17136,37173673,76110219,38936546,CNL
chr05,Bn17137,42933335,68305318,25371983,TNL
chr05,Bn17138,51515556,58025155,6509599,CNL
chr05,Bn17139,89584715,95424807,5840092,RLK
chr05,Bn17140,41102189,50264552,9162363,RLP
chr05,Bn17141,24387321,88685841,64298520,CN
chr05,Bn17142,44985599,67645424,22659825,TNL
chr05,Bn17143,72085806,78284969,6199163,RLK
chr05,Bn17144,43185739,45721823,2536084,RLP
chr05,Bn17145,95337774,99971119,4633345,NBS
chr05,Bn17146,95930487,96528686,598199,TNL
chr05,Bn17147,90424403,98715915,8291512,CN
chr05,Bn17148,5224951,71866348,66641397,CN
chr05,Bn17149,91907859,91983144,75285,RLK
chr05,Bn17150,82791432,89747676,6956244,TN
chr05,Bn17151,79846139,91340869,11494730,CN
chr05,Bn17152,36541898,74647435,38105537,TNL
chr05,Bn17153,66858174,88632325,21774151,TN
chr05,Bn17154,68447289,86767849,18320560,NBS
chr05,Bn17155,76104121,92216727,16112606,TN
chr05,Bn17156,10643244,10667508,24264,TNL
chr05,Bn17157,87318421,97514735,10196314,RLK
chr05,Bn17158,23103996,70958853,47854857,TNL
chr05,Bn17159,57759036,68616212,10857176,RLK
chr05,Bn17160,36581459,70591406,34009947,RLK
chr05,Bn17161,56813153,83724258,26911105,TN
chr05,Bn17162,85755970,93986619,8230649,TNL
chr05,Bn17163,23355448,77593868,54238420,RLP
chr05,Bn17164,26609843,99743454,73133611,CN
chr05,Bn17165,4846527,11499991,6653464,TN
chr05,Bn17166,20850452,70993402,50142950,CNL
chr05,Bn17167,38378633,62080836,23702203,RLP
chr05,Bn17168,20863380,85056261,64192881,CN
chr05,Bn17169,80732232,83702479,2970247,TNL
chr05,Bn17170,81653696,95012995,13359299,TN
chr05,Bn17171,9879678,49497402,39617724,CNL
chr05,Bn17172,15328281,30357685,15029404,CNL
chr05,Bn17173,77017204,99816006,22798802,TN
chr05,Bn17174,22635463,59270680,36635217,CN
chr05,Bn17175,55612976,72632979,17020003,RLP
chr05,Bn17176,44949524,70033484,25083960,CN
chr05,Bn17177,97661259,98703595,1042336,NBS
chr05,Bn17178,43952225,49402538,5450313,RLP
chr05,Bn17179,70882423,84914629,14032206,TN
chr05,Bn17180,6861418,16146386,9284968,RLP
chr05,Bn17181,6856553,41031992,34175439,CNL
chr05,Bn17182,58164939,59866194,1701255,RLP
chr05,Bn17183,4052522,6867861,2815339,TN
chr05,Bn17184,56014901,62519311,6504410,NBS
chr05,Bn17185,39127597,82223607,43096010,CN
chr05,Bn17186,82604938,92813114,10208176,TNL
chr05,Bn17187,27841684,88558713,60717029,TNL
chr05,Bn17188,58848609,59908128,1059519,TN
chr05,Bn17189,2315981,96590610,94274629,TNL
chr05,Bn17190,33988319,36266577,2278258,TN
chr05,Bn17191,31337581,85952483,54614902,CNL
chr05,Bn17192,62685118,87898175,25213057,CNL
chr05,Bn17193,75773350,83130184,7356834,TN
chr05,Bn17194,93285379,99164284,5878905,NBS
chr05,Bn17195,22057673,77157668,55099995,RLP
chr05,Bn17196,40059493,46918309,6858816,CN
chr05,Bn17197,70172448,97889097,27716649,CN
chr05,Bn17198,8151052,72722381,64571329,NBS
chr05,Bn17199,2957989,35536564,32578575,CNL
chr05,Bn17200,98882990,99174067,291077,NBS
chr05,Bn17201,18717344,99955584,81238240,CNL
chr05,Bn17202,83593697,84313378,719681,CN
chr05,Bn17203,94299593,97652252,3352659,RLP
chr05,Bn17204,93701309,94989656,1288347,NBS
chr05,Bn17205,37500275,71599623,34099348,TN
chr05,Bn17206,58501100,58589419,88319,TN
chr05,Bn17207,54623578,61133475,6509897,RLP
chr05,Bn17208,78584433,95775247,17190814,CN
chr05,Bn17209,4005886,25458742,21452856,CN
chr05,Bn17210,29698346,85191629,55493283,TN
chr05,Bn17211,69967593,91685361,21717768,TN
chr05,Bn17212,32743945,83686109,50942164,CNL
chr05,Bn17213,68016827,86350700,18333873,TNL
chr05,Bn17214,8459326,49787840,41328514,CNL
chr05,Bn17215,61921251,92274686,30353435,CNL
chr05,Bn17216,62705965,72751969,10046004,CNL
chr05,Bn17217,76439529,80563467,4123938,CNL
chr05,Bn17218,19385672,20653066,1267394,TN
chr05,Bn17219,32185857,97611672,65425815,RLK
chr05,Bn17220,34425166,55430513,21005347,TNL
chr05,Bn17221,70134799,80148637,10013838,NBS
chr05,Bn17222,28412070,71171961,42759891,CN
chr05,Bn17223,54100053,78809620,24709567,TN
chr05,Bn17224,93079541,97843994,4764453,TN
chr05,Bn17225,30768216,54772009,24003793,TNL
chr05,Bn17226,23117868,53246013,30128145,TN
chr05,Bn17227,80676321,92618504,11942183,RLP
chr05,Bn17228,27179614,82070523,54890909,CN
chr05,Bn17229,45043959,92843456,47799497,RLP
chr05,Bn17230,27816973,61890562,34073589,TN
chr05,Bn17231,67459317,95731662,28272345,RLP
chr05,Bn17232,57146896,76249017,19102121,CNL
chr05,Bn17233,23753965,66308988,42555023,RLP
chr05,Bn17234,66966521,98761584,31795063,CNL
chr05,Bn17235,98780938,98937963,157025,CN
chr05,Bn17236,97968287,99884371,1916084,RLP
chr05,Bn17237,65821712,89025253,23203541,RLK
chr05,Bn17238,99885334,99997979,112645,TN
chr05,Bn17239,67063251,79566164,12502913,CNL
chr05,Bn17240,41301144,87656484,46355340,CNL
chr05,Bn17241,9051491,62823259,53771768,RLK
chr05,Bn17242,33057902,33627672,569770,TNL
chr05,Bn17243,76973982,83902105,6928123,RLK
chr05,Bn17244,69130663,98885266,29754603,CN
chr05,Bn17245,49611674,59143721,9532047,TNL
chr05,Bn17246,56682487,69945084,13262597,CN
chr05,Bn17247,83965597,84293057,327460,RLP
chr05,Bn17248,3336557,11315242,7978685,CN
chr05,Bn17249,59164408,93313517,34149109,RLP
chr05,Bn17250,4255812,75633809,71377997,RLK
chr05,Bn17251,59601361,90389519,30788158,RLP
chr05,Bn17252,25530453,25602663,72210,RLP
chr05,Bn17253,77360957,90772671,13411714,TNL
chr05,Bn17254,33578005,92819513,59241508,CNL
chr05,Bn17255,76886002,92216222,15330220,RLP
chr05,Bn17256,54719149,82855342,28136193,TNL
chr05,Bn17257,19856655,99567412,79710757,CNL
chr05,Bn17258,69729241,80030082,10300841,RLK
chr05,Bn17259,53021099,79976218,26955119,TNL
chr05,Bn17260,74927357,92759573,17832216,CNL
chr05,Bn17261,26317553,99423016,73105463,NBS
chr05,Bn17262,96066436,97017300,950864,TNL
chr05,Bn17263,80498120,87351569,6853449,NBS
chr05,Bn17264,3209658,30142008,26932350,TN
chr05,Bn17265,10367274,11209267,841993,RLK
chr05,Bn17266,78858834,90371651,11512817,TN
chr05,Bn17267,43041300,58198619,15157319,TNL
chr05,Bn17268,68157286,91626565,23469279,CNL
chr05,Bn17269,60144593,63755928,3611335,CN
chr05,Bn17270,31064067,79966715,48902648,CN
chr05,Bn17271,14535941,56186549,41650608,CN
chr05,Bn17272,82455808,84532612,2076804,RLK
chr05,Bn17273,87157824,92521541,5363717,RLP
chr05,Bn17274,77998030,93763430,15765400,CN
chr05,Bn17275,51384837,89914523,38529686,TN
chr05,Bn17276,52718356,60267265,7548909,RLK
chr05,Bn17277,48914074,76221390,27307316,CNL
chr05,Bn17278,20154268,86820061,66665793,RLK
chr05,Bn17279,14595241,19296981,4701740,NBS
chr05,Bn17280,73441185,96499210,23058025,TN
chr05,Bn17281,45229084,81338276,36109192,TNL
chr05,Bn17282,88288682,98718874,10430192,NBS
chr05,Bn17283,52022574,73192382,21169808,CNL
chr05,Bn17284,57356035,93140608,35784573,CN
chr05,Bn17285,86179269,94389843,8210574,RLK
chr05,Bn17286,3413642,39765027,36351385,CN
chr05,Bn17287,92932821,99379135,6446314,CNL
chr05,Bn17288,77999317,92750027,14750710,TNL
chr05,Bn17289,1669569,70285937,68616368,RLK
chr05,Bn17290,98764845,99030000,265155,NBS
chr05,Bn17291,98046706,99446162,1399456,NBS
chr05,Bn17292,57253306,85095313,27842007,RLP
chr05,Bn17293,9739592,20964816,11225224,TNL
chr05,Bn17294,67540846,75273867,7733021,CNL
chr05,Bn17295,36340605,55662115,19321510,TNL
chr05,Bn17296,67203003,76557379,9354376,TN
chr05,Bn17297,49725576,65330452,15604876,RLK
chr05,Bn17298,31515858,80149683,48633825,TN
chr05,Bn17299,6680159,79327172,72647013,RLP
chr05,Bn17300,34246617,86491381,52244764,RLP
chr05,Bn17301,87674103,87938732,264629,NBS
chr05,Bn17302,95931429,98264955,2333526,TN
chr05,Bn17303,92863520,99767127,6903607,TNL
chr05,Bn17304,25537396,36671933,11134537,NBS
chr05,Bn17305,13645046,50011685,36366639,RLP
chr05,Bn17306,11509058,58539122,47030064,NBS
chr05,Bn17307,70282595,81208370,10925775,NBS
chr05,Bn17308,1572359,90584843,89012484,TN
chr05,Bn17309,70354112,79254386,8900274,CN
chr05,Bn17310,92608250,94182071,1573821,TNL
chr05,Bn17311,63561253,82130783,18569530,TNL
chr05,Bn17312,58762473,61816390,3053917,CNL
chr05,Bn17313,21275510,96566684,75291174,CNL
chr05,Bn17314,41138466,90240482,49102016,CN
chr05,Bn17315,20888389,62171038,41282649,TNL
chr05,Bn17316,59425265,67563360,8138095,CN
chr05,Bn17317,51932518,64475491,12542973,CNL
chr05,Bn17318,83430128,87484577,4054449,CN
chr05,Bn17319,92205313,94139832,1934519,TN
chr05,Bn17320,41299985,89833455,48533470,RLP
chr05,Bn17321,97318964,99126552,1807588,CNL
chr05,Bn17322,76850970,94915634,18064664,CN
chr05,Bn17323,48055686,68822920,20767234,CN
chr05,Bn17324,8088865,41913451,33824586,RLP
chr05,Bn17325,7273533,82580828,75307295,TNL
chr05,Bn17326,67507403,68572351,1064948,RLP
chr05,Bn17327,61298355,77879834,16581479,RLK
chr05,Bn17328,14359663,92316398,77956735,TN
chr05,Bn17329,76807305,99433886,22626581,RLK
chr05,Bn17330,2321673,69961516,67639843,RLP
chr05,Bn17331,89455788,92794647,3338859,CN
chr05,Bn17332,12437849,94341366,81903517,NBS
chr05,Bn17333,31137466,31728388,590922,RLP
chr05,Bn17334,20325375,48177293,27851918,RLP
chr05,Bn17335,5379386,27139368,21759982,RLP
chr05,Bn17336,62181726,67775383,5593657,TN
chr05,Bn17337,65388429,78779786,13391357,TN
chr05,Bn17338,38200771,55341435,17140664,RLP
chr05,Bn17339,2459352,15036834,12577482,CN
chr05,Bn17340,67847121,86081190,18234069,NBS
chr05,Bn17341,38097358,54904353,16806995,RLP
chr05,Bn17342,15420854,30859193,15438339,RLK
chr05,Bn17343,21640575,77621474,55980899,CN
chr05,Bn17344,51302600,62328010,11025410,TNL
chr05,Bn17345,27089535,84371085,57281550,CN
chr05,Bn17346,56429225,81300732,24871507,TN
chr05,Bn17347,45784980,67342979,21557999,CN
chr05,Bn17348,65683301,78000070,12316769,TN
chr05,Bn17349,99175753,99254612,78859,CNL
chr05,Bn17350,11088044,65258189,54170145,TN
chr05,Bn17351,24680183,27963407,3283224,RLK
chr05,Bn17352,83096664,92746613,9649949,CNL
chr05,Bn17353,44748838,58654491,13905653,CNL
chr05,Bn17354,43791725,44485679,693954,NBS
chr05,Bn17355,10751821,71933246,61181425,NBS
chr05,Bn17356,55535880,64009903,8474023,CNL
chr05,Bn17357,93254529,93499754,245225,TN
chr05,Bn17358,15978980,32939892,16960912,CN
chr05,Bn17359,54353746,84199022,29845276,CN
chr05,Bn17360,8890883,33247946,24357063,CN
chr05,Bn17361,21831125,89632436,67801311,NBS
chr05,Bn17362,22427055,58284874,35857819,CN
chr05,Bn17363,28295041,41088563,12793522,CNL
chr05,Bn17364,55026436,96623377,41596941,NBS
chr05,Bn17365,9827605,16495918,6668313,TN
chr05,Bn17366,5653933,81302680,75648747,NBS
chr05,Bn17367,71300743,82023591,10722848,TNL
chr05,Bn17368,55349412,84080141,28730729,NBS
chr05,Bn17369,93538831,98686872,5148041,NBS
chr05,Bn17370,14492066,23752197,9260131,CN
chr05,Bn17371,45079165,67116540,22037375,TN
chr05,Bn17372,29591976,66657915,37065939,TN
chr05,Bn17373,62217794,80192201,17974407,NBS
chr05,Bn17374,99074489,99994125,919636,CNL
chr05,Bn17375,39493595,61837405,22343810,CNL
chr05,Bn17376,48477902,62887920,14410018,CNL
chr05,Bn17377,89579547,89586948,7401,TN
chr05,Bn17378,9002394,99784272,90781878,TN
chr05,Bn17379,60389560,98410682,38021122,NBS
chr05,Bn17380,59259530,79700668,20441138,TN
chr05,Bn17381,93576948,93917549,340601,RLP
chr05,Bn17382,44163138,49965976,5802838,NBS
chr05,Bn17383,98119827,98852745,732918,TN
chr05,Bn17384,62808956,77742506,14933550,TNL
chr05,Bn17385,69550773,82767421,13216648,TN
chr05,Bn17386,91114146,93276763,2162617,CN
chr05,Bn17387,22174769,77891362,55716593,CN
chr05,Bn17388,3870063,44883606,41013543,TNL
chr05,Bn17389,50258685,65887557,15628872,CNL
chr05,Bn17390,64494428,66342519,1848091,TNL
chr05,Bn17391,56076111,75529765,19453654,CN
chr05,Bn17392,10025636,92381117,82355481,TN
chr05,Bn17393,76153082,82183073,6029991,CNL
chr05,Bn17394,10427549,83178552,72751003,TNL
chr05,Bn17395,99541313,99692697,151384,CN
chr05,Bn17396,84396949,97812006,13415057,TN
chr05,Bn17397,96247656,99249266,3001610,CN
chr05,Bn17398,60234249,63348928,3114679,TN
chr05,Bn17399,89102449,95915311,6812862,CNL
chr05,Bn17400,81435205,81593926,158721,NBS
chr05,Bn17401,61718432,75215293,13496861,TN
chr05,Bn17402,5845518,39039604,33194086,CN
chr05,Bn17403,76424081,94762412,18338331,NBS
chr05,Bn17404,39411250,50769625,11358375,TNL
chr05,Bn17405,57016557,73868966,16852409,TN
chr05,Bn17406,74006681,94882126,20875445,RLP
chr05,Bn17407,85375626,90156351,4780725,NBS
chr05,Bn17408,99084873,99956876,872003,CNL
chr05,Bn17409,99679231,99719344,40113,CN
chr05,Bn17410,92878136,95419162,2541026,RLK
chr05,Bn17411,40270287,41180569,910282,TN
chr05,Bn17412,56460721,98765696,42304975,NBS
chr05,Bn17413,61876803,69184398,7307595,RLK
chr05,Bn17414,66913347,71656229,4742882,CNL
chr05,Bn17415,61436771,71213964,9777193,TN
chr05,Bn17416,78443343,85152698,6709355,TNL
chr05,Bn17417,78534668,90167608,11632940,RLP
chr05,Bn17418,77692997,89518119,11825122,TN
chr05,Bn17419,24149391,52249753,28100362,CN
chr05,Bn17420,25816871,54336188,28519317,TNL
chr05,Bn17421,20418686,75918251,55499565,RLP
chr05,Bn17422,46315348,56097653,9782305,TNL
chr05,Bn17423,13267488,65694842,52427354,TNL
chr05,Bn17424,80656316,98400203,17743887,CNL
chr05,Bn17425,6303624,59515588,53211964,CN
chr05,Bn17426,48114338,54992029,6877691,NBS
chr05,Bn17427,15848230,47602666,31754436,NBS
chr05,Bn17428,95072971,95649653,576682,NBS
chr05,Bn17429,83083049,92962053,9879004,CNL
chr05,Bn17430,81297819,81333351,35532,TNL
chr05,Bn17431,83899306,85079029,1179723,RLK
chr05,Bn17432,30528263,58549801,28021538,NBS
chr05,Bn17433,33179738,37172897,3993159,RLP
chr05,Bn17434,66460927,83082987,16622060,NBS
chr05,Bn17435,39675265,60612642,20937377,RLP
chr05,Bn17436,7435360,53297115,45861755,TN
chr05,Bn17437,58431330,90406745,31975415,TN
chr05,Bn17438,44662581,51881357,7218776,TNL
chr05,Bn17439,1082220,13271727,12189507,RLK
chr05,Bn17440,96731323,97058174,326851,RLK
chr05,Bn17441,24067435,76640264,52572829,TNL
chr05,Bn17442,91134647,95706788,4572141,CN
chr05,Bn17443,37065833,50812428,13746595,CN
chr05,Bn17444,3934489,95630854,91696365,CNL
chr05,Bn17445,54766600,72656570,17889970,RLK
chr05,Bn17446,99843756,99991545,147789,RLP
chr05,Bn17447,66544525,85718546,19174021,CN
chr05,Bn17448,40635712,50571474,9935762,NBS
chr05,Bn17449,42739056,84882969,42143913,NBS
chr05,Bn17450,4830739,54227664,49396925,TNL
chr05,Bn17451,73281650,90249113,16967463,TN
chr05,Bn17452,59540044,59590202,50158,RLK
chr05,Bn17453,48773658,67454250,18680592,CN
chr05,Bn17454,71234603,79848327,8613724,RLK
chr05,Bn17455,43124547,63085389,19960842,NBS
chr05,Bn17456,52740677,97769849,45029172,NBS
chr05,Bn17457,38787965,65344216,26556251,TN
chr05,Bn17458,4053406,15895687,11842281,NBS
chr05,Bn17459,86841922,90558954,3717032,RLK
chr05,Bn17460,82213588,82372653,159065,RLK
chr05,Bn17461,69290335,74727946,5437611,RLP
chr05,Bn17462,28846090,85062038,56215948,RLP
chr05,Bn17463,41596421,95825814,54229393,RLK
chr05,Bn17464,52690013,60321352,7631339,TN
chr05,Bn17465,11075965,26534488,15458523,CN
chr05,Bn17466,5863295,90331050,84467755,CNL
chr05,Bn17467,60127923,73166723,13038800,CN
chr05,Bn17468,29235887,99802685,70566798,CNL
chr05,Bn17469,85246530,85455728,209198,RLK
chr05,Bn17470,20093205,70752467,50659262,RLP
chr05,Bn17471,68393672,89586322,21192650,RLK
chr05,Bn17472,44849457,62046828,17197371,TN
chr05,Bn17473,62267708,93397747,31130039,CNL
chr05,Bn17474,73608612,90776931,17168319,RLP
chr05,Bn17475,90905499,94294412,3388913,TN
chr05,Bn17476,34884309,87598381,52714072,TNL
chr05,Bn17477,53200484,93714452,40513968,TNL
chr05,Bn17478,76437880,90385544,13947664,TN
chr05,Bn17479,80873152,80882908,9756,CNL
chr05,Bn17480,14897274,63435937,48538663,NBS
chr05,Bn17481,48623324,86704998,38081674,NBS
chr05,Bn17482,46952956,49021532,2068576,CNL
chr05,Bn17483,55565082,97568139,42003057,CNL
chr05,Bn17484,67837409,94499668,26662259,CN
chr05,Bn17485,14033821,55065716,41031895,RLP
chr05,Bn17486,43797879,69366623,25568744,CN
chr05,Bn17487,56625183,79658438,23033255,TN
chr05,Bn17488,78635187,89183591,10548404,RLP
chr05,Bn17489,43261731,85379916,42118185,TNL
chr05,Bn17490,81627997,83924843,2296846,RLK
chr05,Bn17491,26090677,34804153,8713476,TNL
chr05,Bn17492,3740431,96918059,93177628,RLP
chr05,Bn17493,19606905,30042256,10435351,CN
chr05,Bn17494,14832039,46869336,32037297,CNL
chr05,Bn17495,63317247,78266533,14949286,TNL
chr05,Bn17496,61594713,84540329,22945616,NBS
chr05,Bn17497,84887449,97810854,12923405,RLK
chr05,Bn17498,84054332,88198076,4143744,NBS
chr05,Bn17499,49950943,61967485,12016542,TNL
chr05,Bn17500,57501911,70516600,13014689,NBS
chr05,Bn17501,91559339,97148549,5589210,RLP
chr05,Bn17502,16339023,34729179,18390156,RLK
chr05,Bn17503,34240091,45034785,10794694,RLK
chr05,Bn17504,87330425,94886235,7555810,NBS
chr05,Bn17505,93845049,97081606,3236557,RLP
chr05,Bn17506,82334892,94521084,12186192,RLP
chr05,Bn17507,84474390,96001997,11527607,TN
chr05,Bn17508,72771675,73041135,269460,CN
chr05,Bn17509,22976365,56368163,33391798,NBS
chr05,Bn17510,40959966,70202095,29242129,CN
chr05,Bn17511,32708638,82863770,50155132,RLP
chr05,Bn17512,41170180,49470255,8300075,TN
chr05,Bn17513,21099957,64543516,43443559,TNL
chr05,Bn17514,78184870,78835463,650593,RLK
chr05,Bn17515,2748826,21934442,19185616,CN
chr05,Bn17516,75380848,88257798,12876950,TN
chr05,Bn17517,81672214,98499906,16827692,TN
chr05,Bn17518,79160348,82384549,3224201,CNL
chr05,Bn17519,41943874,52449962,10506088,NBS
chr05,Bn17520,22571313,36037045,13465732,CN
chr05,Bn17521,98194183,98390766,196583,NBS
chr05,Bn17522,13036009,35868717,22832708,TNL
chr05,Bn17523,77252089,96166812,18914723,RLP
chr05,Bn17524,48240215,96082853,47842638,TNL
chr05,Bn17525,56168806,90088167,33919361,TN
chr05,Bn17526,11213536,96497675,85284139,CN
chr05,Bn17527,59831110,95552214,35721104,NBS
chr05,Bn17528,34346643,51582299,17235656,CNL
chr05,Bn17529,54373277,81061980,26688703,RLK
chr05,Bn17530,70673509,89641746,18968237,RLK
chr05,Bn17531,33424491,54669681,21245190,RLP
chr05,Bn17532,32696899,87209820,54512921,TN
chr05,Bn17533,54718853,96632010,41913157,RLK
chr05,Bn17534,31469045,75873856,44404811,NBS
chr05,Bn17535,92202488,96211899,4009411,CN
chr05,Bn17536,15818621,23739935,7921314,RLP
chr05,Bn17537,81513142,96750775,15237633,RLK
chr05,Bn17538,49594841,77229006,27634165,CNL
chr05,Bn17539,85400852,86978767,1577915,TNL
chr05,Bn17540,7055297,17111213,10055916,NBS
chr05,Bn17541,6115878,40339982,34224104,NBS
chr05,Bn17542,32774735,85428258,52653523,RLP
chr05,Bn17543,17220473,55412822,38192349,CN
chr05,Bn17544,81055109,94535592,13480483,NBS
chr05,Bn17545,2410226,81053106,78642880,RLK
chr05,Bn17546,67460363,99411252,31950889,TNL
chr05,Bn17547,20924183,22017040,1092857,TN
chr05,Bn17548,11564184,23242935,11678751,TN
chr05,Bn17549,50977178,53498817,2521639,CNL
chr05,Bn17550,92610431,95593763,2983332,NBS
chr05,Bn17551,71579263,74739166,3159903,CN
chr05,Bn17552,20950564,21528199,577635,TNL
chr05,Bn17553,25535488,91583457,66047969,NBS
chr05,Bn17554,44073043,74070961,29997918,RLK
chr05,Bn17555,70172253,83895780,13723527,RLP
chr05,Bn17556,47910096,69433033,21522937,TNL
chr05,Bn17557,24762913,29845697,5082784,TN
chr05,Bn17558,74897584,86296007,11398423,RLP
chr05,Bn17559,18847958,74093090,55245132,CNL
chr05,Bn17560,73137503,96596616,23459113,TNL
chr05,Bn17561,51160462,79144208,27983746,RLP
chr05,Bn17562,32048250,81768690,49720440,NBS
chr05,Bn17563,26854296,51153263,24298967,CNL
chr05,Bn17564,63429522,84517643,21088121,CNL
chr05,Bn17565,97165539,97291405,125866,TNL
chr05,Bn17566,9671212,28857645,19186433,CNL
chr05,Bn17567,75047778,76992250,1944472,CNL
chr05,Bn17568,55824872,94155543,38330671,RLK
chr05,Bn17569,27803242,28194653,391411,RLP
chr05,Bn17570,43740209,53897429,10157220,CN
chr05,Bn17571,34331911,44917755,10585844,TNL
chr05,Bn17572,79543731,80965875,1422144,RLP
chr05,Bn17573,81672973,97035394,15362421,RLK
chr05,Bn17574,41246728,64890868,23644140,RLP
chr05,Bn17575,76667809,79206979,2539170,RLK
chr05,Bn17576,33895547,55419948,21524401,CN
chr05,Bn17577,54591406,81535882,26944476,CNL
chr05,Bn17578,32050997,37109706,5058709,TN
chr05,Bn17579,36571376,46953892,10382516,CN
chr05,Bn17580,10389640,37600240,27210600,RLP
chr05,Bn17581,61250611,87774510,26523899,NBS
chr05,Bn17582,18930203,68861196,49930993,CN
chr05,Bn17583,78579434,98551489,19972055,CNL
chr05,Bn17584,73123679,99285824,26162145,TNL
chr05,Bn17585,26190485,37100599,10910114,TN
chr05,Bn17586,75817481,80675842,4858361,RLP
chr05,Bn17587,52228542,88492320,36263778,NBS
chr05,Bn17588,96768663,97483512,714849,CN
chr05,Bn17589,25806759,71129346,45322587,RLK
chr05,Bn17590,75506704,97041289,21534585,NBS
chr05,Bn17591,22444452,65972540,43528088,TNL
chr05,Bn17592,38091306,98810524,60719218,CNL
chr05,Bn17593,34763570,86097669,51334099,CNL
chr05,Bn17594,46733589,51063724,4330135,RLP
chr05,Bn17595,80462236,95283937,14821701,CN
chr05,Bn17596,70569586,78902801,8333215,TN
chr05,Bn17597,52050393,98336300,46285907,RLP
chr05,Bn17598,50109130,67369951,17260821,TNL
chr05,Bn17599,16718718,62095220,45376502,TN
chr05,Bn17600,13728879,30917501,17188622,RLK
chr05,Bn17601,99932561,99968465,35904,RLP
chr05,Bn17602,57717458,76961650,19244192,RLK
chr05,Bn17603,53543157,82185163,28642006,RLP
chr05,Bn17604,9191731,50301384,41109653,RLK
chr05,Bn17605,25817434,65647628,39830194,CNL
chr05,Bn17606,35169918,52727284,17557366,TNL
chr05,Bn17607,82730163,93721172,10991009,CN
chr05,Bn17608,73808429,86044732,12236303,TNL
chr05,Bn17609,32291254,87039798,54748544,RLP
chr05,Bn17610,47557266,53785173,6227907,CN
chr05,Bn17611,82822278,84385920,1563642,TN
chr05,Bn17612,58049757,58558588,508831,TN
chr05,Bn17613,4082308,39683915,35601607,TN
chr05,Bn17614,5849934,82790835,76940901,TNL
chr05,Bn17615,12540557,28768869,16228312,CN
chr05,Bn17616,97907883,99669228,1761345,CN
chr05,Bn17617,35157528,60475265,25317737,CNL
chr05,Bn17618,88927955,96707739,7779784,RLP
chr05,Bn17619,53497240,68115526,14618286,RLK
chr05,Bn17620,36498975,66496773,29997798,RLP
chr05,Bn17621,42186998,74247897,32060899,NBS
chr05,Bn17622,84529204,86880558,2351354,NBS
chr05,Bn17623,60874197,91259221,30385024,CN
chr05,Bn17624,25314332,39848258,14533926,CNL
chr05,Bn17625,79203542,81948251,2744709,RLP
chr05,Bn17626,27304934,62649281,35344347,CN
chr05,Bn17627,17069385,85499380,68429995,NBS
chr05,Bn17628,6719258,74515479,67796221,NBS
chr05,Bn17629,16438735,97697973,81259238,TN
chr05,Bn17630,33020280,89365282,56345002,NBS
chr05,Bn17631,13197847,56806798,43608951,NBS
chr05,Bn17632,68072118,94632022,26559904,CNL
chr05,Bn17633,37830884,77365959,39535075,CN
chr05,Bn17634,11218165,79886443,68668278,TN
chr05,Bn17635,49768280,70471363,20703083,RLK
chr05,Bn17636,57568415,93511279,35942864,CNL
chr05,Bn17637,77478112,88523933,11045821,RLK
chr05,Bn17638,51414347,79058896,27644549,CN
chr05,Bn17639,88071985,88841699,769714,CN
chr05,Bn17640,23429499,57398762,33969263,RLK
chr05,Bn17641,66932244,74645502,7713258,RLP
chr05,Bn17642,90065091,95687393,5622302,TNL
chr05,Bn17643,81456183,83363067,1906884,NBS
chr05,Bn17644,38437405,81384386,42946981,RLP
chr05,Bn17645,26318022,36586929,10268907,TN
chr05,Bn17646,63190835,67882677,4691842,RLK
chr05,Bn17647,42225174,61336916,19111742,CN
chr05,Bn17648,14452073,27032021,12579948,CNL
chr05,Bn17649,17631305,30579917,12948612,TNL
chr05,Bn17650,78602245,78717565,115320,RLP
chr05,Bn17651,53763431,68000887,14237456,TNL
chr05,Bn17652,49945636,54120672,4175036,NBS
chr05,Bn17653,25276302,66066582,40790280,TNL
chr05,Bn17654,65128499,71066427,5937928,CNL
chr05,Bn17655,48239737,85501816,37262079,RLP
chr05,Bn17656,63607472,94103361,30495889,CNL
chr05,Bn17657,69715173,86340291,16625118,CNL
chr05,Bn17658,42077858,51347359,9269501,TN
chr05,Bn17659,85339483,88067670,2728187,NBS
chr05,Bn17660,49021199,57322051,8300852,RLP
chr05,Bn17661,58022620,63095046,5072426,RLK
chr05,Bn17662,16932620,68975197,52042577,RLK
chr05,Bn17663,71526459,96044676,24518217,CNL
chr05,Bn17664,87383433,89600433,2217000,CNL
chr05,Bn17665,49706074,84099740,34393666,NBS
chr05,Bn17666,74354100,83202209,8848109,TN
chr05,Bn17667,86247667,94496817,8249150,RLK
chr05,Bn17668,91175429,99014839,7839410,RLK
chr05,Bn17669,50113954,57837022,7723068,CNL
chr05,Bn17670,31850874,35279853,3428979,TN
chr05,Bn17671,64205716,68160704,3954988,RLK
chr05,Bn17672,30027118,71559409,41532291,CNL
chr05,Bn17673,21756965,47471734,25714769,TN
chr05,Bn17674,57689381,74167240,16477859,CN
chr05,Bn17675,5051025,82789362,77738337,RLP
chr05,Bn17676,33797553,60105365,26307812,TN
chr05,Bn17677,96686663,97354984,668321,CNL
chr05,Bn17678,9970929,19812317,9841388,CN
chr05,Bn17679,65329858,99153461,33823603,RLP
chr05,Bn17680,92713197,93355101,641904,TN
chr05,Bn17681,11778996,86153947,74374951,TN
chr05,Bn17682,56409042,88745737,32336695,RLK
chr05,Bn17683,80500900,88844304,8343404,TNL
chr05,Bn17684,55770071,68212336,12442265,NBS
chr05,Bn17685,59544456,79091354,19546898,TNL
chr05,Bn17686,1023177,16451099,15427922,TNL
chr05,Bn17687,1742202,43460336,41718134,RLP
chr05,Bn17688,22538434,33244520,10706086,TNL
chr05,Bn17689,25582902,33886395,8303493,CNL
chr05,Bn17690,52387674,80506190,28118516,CN
chr05,Bn17691,49243555,50057773,814218,NBS
chr05,Bn17692,92635856,93442350,806494,TN
chr05,Bn17693,18317919,78914017,60596098,CNL
chr05,Bn17694,35745911,44098445,8352534,CNL
chr05,Bn17695,29814479,51607962,21793483,RLP
chr05,Bn17696,85232006,89836200,4604194,TNL
chr05,Bn17697,71486980,78426871,6939891,NBS
chr05,Bn17698,55677605,94281120,38603515,CNL
chr05,Bn17699,20291780,82637673,62345893,TNL
chr05,Bn17700,78797311,78870667,73356,CNL
chr05,Bn17701,92529412,99474931,6945519,TN
chr05,Bn17702,18918436,51944081,33025645,CN
chr05,Bn17703,44470665,75520860,31050195,RLK
chr05,Bn17704,53662901,58082704,4419803,RLK
chr05,Bn17705,22950343,70630037,47679694,RLP
chr05,Bn17706,87122687,94165653,7042966,CN
chr05,Bn17707,54974438,91737622,36763184,RLK
chr05,Bn17708,94699045,96077213,1378168,TN
chr05,Bn17709,98379164,99469605,1090441,RLP
chr05,Bn17710,4318235,82708676,78390441,TN
chr05,Bn17711,2917737,91038856,88121119,TN
chr05,Bn17712,16993584,31679322,14685738,CNL
chr05,Bn17713,99888705,99906095,17390,TNL
chr05,Bn17714,67887557,97123152,29235595,CNL
chr05,Bn17715,21850964,60063806,38212842,CNL
chr05,Bn17716,85381697,96397588,11015891,NBS
chr05,Bn17717,39569133,78349304,38780171,CN
chr05,Bn17718,14392183,39159748,24767565,TNL
chr05,Bn17719,18861125,39273247,20412122,RLK
chr05,Bn17720,58314485,74816927,16502442,RLK
chr05,Bn17721,73557495,98041578,24484083,RLP
chr05,Bn17722,76173272,92384686,16211414,RLP
chr05,Bn17723,46962695,54710577,7747882,TNL
chr05,Bn17724,64259903,83952871,19692968,CN
chr05,Bn17725,55542956,95479286,39936330,TN
chr05,Bn17726,92321972,93152600,830628,CNL
chr05,Bn17727,10578962,25097572,14518610,TN
chr05,Bn17728,80864710,85401115,4536405,CN
chr05,Bn17729,34373868,47504297,13130429,RLK
chr05,Bn17730,12592793,99364306,86771513,CN
chr05,Bn17731,73228275,78255148,5026873,RLK
chr05,Bn17732,56572074,79039026,22466952,RLK
chr05,Bn17733,9095528,29770438,20674910,NBS
chr05,Bn17734,69188087,93266057,24077970,RLK
chr05,Bn17735,3779060,21539419,17760359,CNL
chr05,Bn17736,85225716,98156876,12931160,TNL
chr05,Bn17737,50993407,56806115,5812708,RLP
chr05,Bn17738,61480619,72654683,11174064,TN
chr05,Bn17739,89143968,89885580,741612,RLK
chr05,Bn17740,64829687,74042796,9213109,TNL
chr05,Bn17741,55009541,77517250,22507709,RLK
chr05,Bn17742,68313572,75189009,6875437,RLP
chr05,Bn17743,45405565,86316631,40911066,NBS
chr05,Bn17744,72613868,90280046,17666178,TN
chr05,Bn17745,74540146,96981120,22440974,CN
chr05,Bn17746,27607251,62107334,34500083,RLP
chr05,Bn17747,85125870,93628824,8502954,TNL
chr05,Bn17748,25094781,96147942,71053161,TNL
chr05,Bn17749,23823442,85497982,61674540,CN
chr05,Bn17750,18447273,58079970,39632697,RLP
chr05,Bn17751,56001153,83632572,27631419,RLK
chr05,Bn17752,73818701,89533334,15714633,CN
chr05,Bn17753,67837777,96186270,28348493,RLK
chr05,Bn17754,37940620,56971360,19030740,CNL
chr05,Bn17755,33145161,69288825,36143664,RLP
chr05,Bn17756,77233790,88246372,11012582,CNL
chr05,Bn17757,52039249,67019986,14980737,TN
chr05,Bn17758,76290850,96158251,19867401,TNL
chr05,Bn17759,64271950,71004927,6732977,CNL
chr05,Bn17760,19738890,31520550,11781660,CN
chr05,Bn17761,91073404,97745638,6672234,TNL
chr05,Bn17762,64867185,65806277,939092,RLK
chr05,Bn17763,82320641,99992286,17671645,CN
chr05,Bn17764,40189024,84340318,44151294,TNL
chr05,Bn17765,52457095,69982743,17525648,CNL
chr05,Bn17766,35741577,63994746,28253169,TNL
chr05,Bn17767,75774365,89091081,13316716,NBS
chr05,Bn17768,39734837,80178440,40443603,TNL
chr05,Bn17769,72768173,73613066,844893,TN
chr05,Bn17770,67437166,86518152,19080986,TNL
chr05,Bn17771,55183969,74346726,19162757,RLK
chr05,Bn17772,98524120,99313363,789243,RLK
chr05,Bn17773,42840393,91477306,48636913,CNL
chr05,Bn17774,49249652,75052985,25803333,TN
chr05,Bn17775,31689104,86884045,55194941,RLP
chr05,Bn17776,86724142,92818874,6094732,NBS
chr05,Bn17777,71072638,72498576,1425938,CN
chr05,Bn17778,69483637,97555715,28072078,TN
chr05,Bn17779,95066635,97102824,2036189,TNL
chr05,Bn17780,50932663,54665824,3733161,CNL
chr05,Bn17781,24957889,27395351,2437462,CN
chr05,Bn17782,35543535,76023094,40479559,TN
chr05,Bn17783,76110991,95123985,19012994,CNL
chr05,Bn17784,40904873,95477625,54572752,TNL
chr05,Bn17785,10362282,60571935,50209653,CNL
chr05,Bn17786,51812830,72497867,20685037,RLK
chr05,Bn17787,76115497,93097902,16982405,RLK
chr05,Bn17788,22838905,81369133,58530228,CNL
chr05,Bn17789,49410522,56791748,7381226,TN
chr05,Bn17790,73057105,83662027,10604922,NBS
chr05,Bn17791,42308376,97605158,55296782,TNL
chr05,Bn17792,57173471,77943427,20769956,RLK
chr05,Bn17793,84604269,88785598,4181329,RLP
chr05,Bn17794,44799010,78547876,33748866,TNL
chr05,Bn17795,21087435,81580827,60493392,CNL
chr05,Bn17796,39326752,83153407,43826655,CNL
chr05,Bn17797,36900866,39733139,2832273,NBS
chr05,Bn17798,86258240,96127188,9868948,RLP
chr05,Bn17799,8546581,36559648,28013067,TN
chr05,Bn17800,83903792,92014067,8110275,RLP
chr05,Bn17801,14188867,42269016,28080149,RLP
chr05,Bn17802,9497981,10700621,1202640,NBS
chr05,Bn17803,74685335,85252371,10567036,NBS
chr05,Bn17804,67980317,91788398,23808081,NBS
chr05,Bn17805,6543315,69363972,62820657,CNL
chr05,Bn17806,49544455,91586084,42041629,NBS
chr05,Bn17807,67606799,98477780,30870981,CN
chr05,Bn17808,7085879,53011610,45925731,NBS
chr05,Bn17809,59568384,92207579,32639195,TNL
chr05,Bn17810,36012103,97176580,61164477,NBS
chr05,Bn17811,13897604,77095263,63197659,RLK
chr05,Bn17812,6885247,81857428,74972181,TN
chr05,Bn17813,12726223,22057508,9331285,TN
chr05,Bn17814,37226206,68203451,30977245,TNL
chr05,Bn17815,6185442,51120653,44935211,TNL
chr05,Bn17816,31716552,35454079,3737527,TNL
chr05,Bn17817,20882291,72879084,51996793,TN
chr05,Bn17818,31955029,38081049,6126020,CNL
chr05,Bn17819,23463187,91594909,68131722,CN
chr05,Bn17820,90348634,90440532,91898,CN
chr05,Bn17821,73210291,89818709,16608418,CN
chr05,Bn17822,54000927,78758467,24757540,RLP
chr05,Bn17823,66703320,66734119,30799,RLK
chr05,Bn17824,14939422,89529497,74590075,TN
chr05,Bn17825,94912939,98801486,3888547,TN
chr05,Bn17826,74299787,99109311,24809524,TN
chr05,Bn17827,93962529,94291173,328644,TNL
chr05,Bn17828,44204234,75783203,31578969,NBS
chr05,Bn17829,62246488,77622544,15376056,CNL
chr05,Bn17830,47211993,55541135,8329142,TN
chr05,Bn17831,43056133,83022790,39966657,TN
chr05,Bn17832,27298615,52265708,24967093,TN
chr05,Bn17833,86078952,94283612,8204660,CN
chr05,Bn17834,32608143,49331225,16723082,RLK
chr05,Bn17835,17858747,21270476,3411729,TNL
chr05,Bn17836,50459426,89203194,38743768,TN
chr05,Bn17837,21799984,45223367,23423383,NBS
chr05,Bn17838,6589982,18255583,11665601,RLK
chr05,Bn17839,16518742,84888576,68369834,RLK
chr05,Bn17840,70424639,75933527,5508888,RLP
chr05,Bn17841,87543371,93707852,6164481,CN
chr05,Bn17842,63595400,64220683,625283,NBS
chr05,Bn17843,40925809,95630259,54704450,TN
chr05,Bn17844,37062095,69665783,32603688,NBS
chr05,Bn17845,62795133,88731515,25936382,TNL
chr05,Bn17846,48928854,53182838,4253984,RLK
chr05,Bn17847,97092549,97320574,228025,RLP
chr05,Bn17848,34528459,74576380,40047921,RLK
chr05,Bn17849,75786577,91386573,15599996,RLK
chr05,Bn17850,93416148,98734399,5318251,TNL
chr05,Bn17851,45034000,58459966,13425966,NBS
chr05,Bn17852,97053783,97155801,102018,RLK
chr05,Bn17853,20495601,62379309,41883708,RLK
chr05,Bn17854,99307745,99685083,377338,TNL
chr05,Bn17855,52381490,57226095,4844605,TNL
chr05,Bn17856,3975381,82061947,78086566,CNL
chr05,Bn17857,58102496,84653587,26551091,TNL
chr05,Bn17858,25180756,90188121,65007365,RLK
chr05,Bn17859,5262694,78417217,73154523,TNL
chr05,Bn17860,84663979,85787763,1123784,TN
chr05,Bn17861,4642563,21792775,17150212,TNL
chr05,Bn17862,62380185,95739319,33359134,NBS
chr05,Bn17863,25488199,59632364,34144165,TNL
chr05,Bn17864,10217673,20779941,10562268,NBS
chr05,Bn17865,41102745,51595759,10493014,NBS
chr05,Bn17866,98891207,99804883,913676,RLK
chr05,Bn17867,90441156,98601323,8160167,RLK
chr05,Bn17868,44660172,67817544,23157372,RLK
chr05,Bn17869,98927284,98975463,48179,NBS
chr05,Bn17870,5351742,92582871,87231129,NBS
chr05,Bn17871,44669875,87002218,42332343,RLK
chr05,Bn17872,61886958,75408955,13521997,CNL
chr05,Bn17873,88555256,99075010,10519754,CN
chr05,Bn17874,63822669,84503353,20680684,CN
chr05,Bn17875,12027141,42636777,30609636,RLK
chr05,Bn17876,41426355,74105376,32679021,RLP
chr05,Bn17877,48948126,73604664,24656538,NBS
chr05,Bn17878,86518244,87146192,627948,CN
chr05,Bn17879,60228148,86200980,25972832,TNL
chr05,Bn17880,73346429,74239333,892904,CNL
chr05,Bn17881,26861157,33097900,6236743,CN
chr05,Bn17882,43686208,53007868,9321660,NBS
chr05,Bn17883,62997727,66258134,3260407,CNL
chr05,Bn17884,92591576,97535179,4943603,NBS
chr05,Bn17885,58170963,98591510,40420547,RLP
chr05,Bn17886,24615803,87700096,63084293,TNL
chr05,Bn17887,62674131,92976030,30301899,CN
chr05,Bn17888,72292796,97104887,24812091,CNL
chr05,Bn17889,65212784,80319896,15107112,RLP
chr05,Bn17890,15866218,90720178,74853960,TNL
chr05,Bn17891,50585609,67821935,17236326,TN
chr05,Bn17892,59860042,95807738,35947696,TNL
chr05,Bn17893,23341452,27993443,4651991,TNL
chr05,Bn17894,51175222,57305346,6130124,CNL
chr05,Bn17895,46220780,54471301,8250521,CNL
chr05,Bn17896,22454883,40952555,18497672,TNL
chr05,Bn17897,49538784,50753882,1215098,RLK
chr05,Bn17898,51479725,59723259,8243534,NBS
chr05,Bn17899,95607512,96513905,906393,CNL
chr05,Bn17900,46323916,55348479,9024563,CN
chr05,Bn17901,21559225,26487122,4927897,CN
chr05,Bn17902,15213921,27435050,12221129,NBS
chr05,Bn17903,4106205,81504234,77398029,CN
chr05,Bn17904,50582118,70471960,19889842,TNL
chr05,Bn17905,90664996,93911959,3246963,TN
chr05,Bn17906,27542385,96487144,68944759,CNL
chr05,Bn17907,11086577,30582854,19496277,NBS
chr05,Bn17908,38674413,69302157,30627744,CNL
chr05,Bn17909,52104747,93653014,41548267,NBS
chr05,Bn17910,54807632,61244208,6436576,NBS
chr05,Bn17911,93754150,93813972,59822,NBS
chr05,Bn17912,1614299,97870437,96256138,RLK
chr05,Bn17913,19790704,81225776,61435072,CNL
chr05,Bn17914,78762375,91378446,12616071,CN
chr05,Bn17915,33099562,66459114,33359552,RLP
chr05,Bn17916,12971025,73596475,60625450,RLP
chr05,Bn17917,84278962,84890872,611910,TN
chr05,Bn17918,97890519,99422468,1531949,RLP
chr05,Bn17919,61552988,83690787,22137799,TNL
chr05,Bn17920,55258782,62559399,7300617,CNL
chr05,Bn17921,52029352,80467764,28438412,CNL
chr05,Bn17922,47918188,58120100,10201912,CN
chr05,Bn17923,43015688,71719602,28703914,TNL
chr05,Bn17924,18387230,82187328,63800098,RLP
chr05,Bn17925,5894227,52490434,46596207,RLP
chr05,Bn17926,20453605,27271686,6818081,NBS
chr05,Bn17927,26669310,48444705,21775395,RLP
chr05,Bn17928,43277614,45981538,2703924,TN
chr05,Bn17929,39811261,60857609,21046348,CN
chr05,Bn17930,98428692,99405601,976909,TN
chr05,Bn17931,55294007,83920163,28626156,TN
chr05,Bn17932,1337065,25781952,24444887,NBS
chr05,Bn17933,46978829,68272636,21293807,NBS
chr05,Bn17934,89087017,94047577,4960560,RLP
chr05,Bn17935,43068007,96147367,53079360,CNL
chr05,Bn17936,12974568,44718325,31743757,CN
chr05,Bn17937,2223642,41255039,39031397,TNL
chr05,Bn17938,27424714,32236880,4812166,TNL
chr05,Bn17939,57442802,86662351,29219549,TN
chr05,Bn17940,27114120,43379261,16265141,TNL
chr05,Bn17941,74441940,80773031,6331091,TNL
chr05,Bn17942,99157168,99688273,531105,CN
chr05,Bn17943,68179715,84367545,16187830,CNL
chr05,Bn17944,26830170,70281158,43450988,RLP
chr05,Bn17945,62975510,70533984,7558474,RLK
chr05,Bn17946,17158197,29865869,12707672,NBS
chr05,Bn17947,93152518,96853139,3700621,TNL
chr05,Bn17948,4347589,27378087,23030498,NBS
chr05,Bn17949,23843609,30015476,6171867,CN
chr05,Bn17950,98526478,99707463,1180985,TN
chr05,Bn17951,63767377,74751733,10984356,TNL
chr05,Bn17952,86633226,94248422,7615196,RLP
chr05,Bn17953,2082796,30481259,28398463,TNL
chr05,Bn17954,57240845,58579690,1338845,CN
chr05,Bn17955,64903054,93279503,28376449,TNL
chr05,Bn17956,82347043,99571244,17224201,CN
chr05,Bn17957,97886766,98457920,571154,RLK
chr05,Bn17958,2656092,31580627,28924535,RLK
chr05,Bn17959,7156730,13284515,6127785,TN
chr05,Bn17960,24230220,84062229,59832009,RLP
chr05,Bn17961,39220891,43296857,4075966,RLP
chr05,Bn17962,2669961,28279935,25609974,TN
chr05,Bn17963,41005867,99680677,58674810,TN
chr05,Bn17964,33868484,51669225,17800741,NBS
chr05,Bn17965,57140328,69794727,12654399,CN
chr05,Bn17966,68834419,86705180,17870761,CNL
chr05,Bn17967,65094722,87839856,22745134,RLP
chr05,Bn17968,56030941,56513325,482384,TNL
chr05,Bn17969,90796357,91769758,973401,TNL
chr05,Bn17970,35099055,52828488,17729433,RLK
chr05,Bn17971,64604547,88741367,24136820,NBS
chr05,Bn17972,24557219,73212270,48655051,RLK
chr05,Bn17973,25074726,37861847,12787121,TNL
chr05,Bn17974,33546831,69265279,35718448,CN
chr05,Bn17975,73378468,91950457,18571989,TN
chr05,Bn17976,25565371,66899984,41334613,TN
chr05,Bn17977,65760974,71190229,5429255,RLP
chr05,Bn17978,75958334,88925835,12967501,CNL
chr05,Bn17979,2873701,19334725,16461024,TNL
chr05,Bn17980,51459133,85250059,33790926,RLK
chr05,Bn17981,6794311,87063217,80268906,CNL
chr05,Bn17982,79657045,87627670,7970625,TNL
chr05,Bn17983,4131233,56433357,52302124,CN
chr05,Bn17984,39988715,82838394,42849679,NBS
chr05,Bn17985,69319591,80054530,10734939,TNL
chr05,Bn17986,96626095,98649778,2023683,CNL
chr05,Bn17987,86876606,99896655,13020049,TN
chr05,Bn17988,43864158,90355981,46491823,CNL
chr05,Bn17989,66022419,96622149,30599730,RLP
chr05,Bn17990,22766259,87706838,64940579,CNL
chr05,Bn17991,31869658,50747798,18878140,TN
chr05,Bn17992,71065580,91396083,20330503,TNL
chr05,Bn17993,54467958,71056607,16588649,NBS
chr05,Bn17994,39118525,72298133,33179608,CNL
chr05,Bn17995,65118167,78054456,12936289,RLK
chr05,Bn17996,78537034,89198569,10661535,NBS
chr05,Bn17997,31742517,68383092,36640575,TN
chr05,Bn17998,75793849,99123071,23329222,RLP
chr05,Bn17999,84283744,90032496,5748752,TNL
chr05,Bn18000,39626111,94754760,55128649,CNL
chr05,Bn18001,53649124,97937102,44287978,TN
chr05,Bn18002,89348621,96047882,6699261,RLK
chr05,Bn18003,51921448,83503074,31581626,TN
chr05,Bn18004,47703422,83202145,35498723,RLP
chr05,Bn18005,48357182,76405578,28048396,RLP
chr05,Bn18006,34433732,93097416,58663684,CN
chr05,Bn18007,84309754,93421007,9111253,TN
chr05,Bn18008,18448728,40862026,22413298,RLP
chr05,Bn18009,67005362,95697421,28692059,TN
chr05,Bn18010,77002417,86944115,9941698,NBS
chr05,Bn18011,33319086,76640281,43321195,TN
chr05,Bn18012,28283024,74684048,46401024,CN
chr05,Bn18013,69045118,91692059,22646941,RLK
chr05,Bn18014,39512141,74566278,35054137,CNL
chr05,Bn18015,68306817,96510431,28203614,CNL
chr05,Bn18016,80661319,81248968,587649,RLP
chr05,Bn18017,92302621,92984819,682198,NBS
chr05,Bn18018,96863915,97211875,347960,RLK
chr05,Bn18019,52648563,73463298,20814735,NBS
chr05,Bn18020,38178159,75733731,37555572,CN
chr05,Bn18021,28475085,93461155,64986070,TNL
chr05,Bn18022,38884319,55845200,16960881,TNL
chr05,Bn18023,31527072,41763331,10236259,NBS
chr05,Bn18024,12097321,23099035,11001714,CN
chr05,Bn18025,71327250,75202863,3875613,TNL
chr05,Bn18026,70975143,74255791,3280648,NBS
chr05,Bn18027,75107739,76013158,905419,RLP
chr05,Bn18028,29362908,93365349,64002441,RLK
chr05,Bn18029,73630447,80994310,7363863,RLK
chr05,Bn18030,14235480,32589391,18353911,CN
chr05,Bn18031,92925476,95794450,2868974,RLP
chr05,Bn18032,55233163,90870216,35637053,TN
chr05,Bn18033,45080585,91858096,46777511,RLK
chr05,Bn18034,90933767,97886657,6952890,NBS
chr05,Bn18035,13969116,98254372,84285256,CN
chr05,Bn18036,42902432,55889844,12987412,TNL
chr05,Bn18037,77024417,97777856,20753439,RLK
chr05,Bn18038,14223573,98694824,84471251,TN
chr05,Bn18039,34443826,59778909,25335083,CN
chr05,Bn18040,10422340,84637530,74215190,TN
chr05,Bn18041,7310489,68087939,60777450,NBS
chr05,Bn18042,2636189,67936714,65300525,CN
chr05,Bn18043,93562927,99571772,6008845,TNL
chr05,Bn18044,32690268,42928344,10238076,TN
chr05,Bn18045,79447566,86995259,7547693,TN
chr05,Bn18046,36819796,63192749,26372953,TN
chr05,Bn18047,66134932,90813613,24678681,TNL
chr05,Bn18048,41782552,76540907,34758355,RLK
chr05,Bn18049,68905806,96183978,27278172,CNL
chr05,Bn18050,42399938,52610756,10210818,RLP
chr05,Bn18051,49198093,80236531,31038438,RLP
chr05,Bn18052,89467961,93551333,4083372,RLK
chr05,Bn18053,35930099,96486003,60555904,CNL
chr05,Bn18054,10248340,23290246,13041906,TNL
chr05,Bn18055,10456500,61555803,51099303,RLP
chr05,Bn18056,38894592,81454084,42559492,TNL
chr05,Bn18057,80779283,84213939,3434656,TN
chr05,Bn18058,21026289,34869163,13842874,TNL
chr05,Bn18059,77026269,94928630,17902361,CNL
chr05,Bn18060,14016302,64948201,50931899,RLK
chr05,Bn18061,21450484,28224041,6773557,NBS
chr05,Bn18062,40224088,70908657,30684569,CN
chr05,Bn18063,8798179,33524887,24726708,CN
chr05,Bn18064,39054445,83026896,43972451,TNL
chr05,Bn18065,36301106,59635633,23334527,CNL
chr05,Bn18066,47430268,62947007,15516739,TNL
chr05,Bn18067,85594991,89870667,4275676,CN
chr05,Bn18068,86836576,88074841,1238265,TN
chr05,Bn18069,34414280,85863842,51449562,NBS
chr05,Bn18070,69261425,70880073,1618648,NBS
chr05,Bn18071,32209776,41229559,9019783,TNL
chr05,Bn18072,63199498,66130550,2931052,TN
chr05,Bn18073,76249780,84738308,8488528,RLK
chr05,Bn18074,60142444,65245064,5102620,CN
chr05,Bn18075,48436299,95028063,46591764,TN
chr05,Bn18076,12392371,80205051,67812680,TNL
chr05,Bn18077,53439462,63540758,10101296,NBS
chr05,Bn18078,33651521,90214793,56563272,RLP
chr05,Bn18079,41420152,69024644,27604492,RLK
chr05,Bn18080,49726204,60376023,10649819,TNL
chr05,Bn18081,68342285,77017135,8674850,RLK
chr05,Bn18082,95041423,96536972,1495549,TN
chr05,Bn18083,39645251,87511014,47865763,NBS
chr05,Bn18084,58407402,78572843,20165441,RLP
chr05,Bn18085,59560065,91707996,32147931,RLP
chr05,Bn18086,90353001,91423901,1070900,CNL
chr05,Bn18087,80559913,83425376,2865463,TN
chr05,Bn18088,63357229,91929545,28572316,RLK
chr05,Bn18089,23873838,95229390,71355552,TN
chr05,Bn18090,69309014,95220348,25911334,RLK
chr05,Bn18091,36648347,43580782,6932435,CN
chr05,Bn18092,53241044,93173938,39932894,CNL
chr05,Bn18093,20960070,21673213,713143,TNL
chr05,Bn18094,8150902,9587280,1436378,RLP
chr05,Bn18095,53769145,88605885,34836740,NBS
chr05,Bn18096,3604519,39622322,36017803,CNL
chr05,Bn18097,36324725,77068245,40743520,RLK
chr05,Bn18098,76724131,89799899,13075768,CNL
chr05,Bn18099,63450525,66103339,2652814,NBS
chr05,Bn18100,87043031,89707688,2664657,CN
chr05,Bn18101,51286047,90758711,39472664,RLP
chr05,Bn18102,2226883,62448804,60221921,NBS
chr05,Bn18103,89603961,89612193,8232,RLK
chr05,Bn18104,32261418,57015345,24753927,CNL
chr05,Bn18105,83798001,96658959,12860958,TN
chr05,Bn18106,20618857,23902943,3284086,CNL
chr05,Bn18107,40320211,50808725,10488514,TNL
chr05,Bn18108,87505405,87945582,440177,RLK
chr05,Bn18109,14729048,52200936,37471888,CNL
chr05,Bn18110,28965900,83687543,54721643,TNL
chr05,Bn18111,77732670,97049175,19316505,TN
chr05,Bn18112,67990214,90032889,22042675,TN
chr05,Bn18113,1655572,24038577,22383005,TN
chr05,Bn18114,46621966,54243550,7621584,RLK
chr05,Bn18115,94657503,98573164,3915661,RLP
chr05,Bn18116,11345858,75564377,64218519,NBS
chr05,Bn18117,87399029,98618385,11219356,CN
chr05,Bn18118,17145386,46279187,29133801,CN
chr05,Bn18119,30566693,59229151,28662458,CN
chr05,Bn18120,5313564,38649976,33336412,CN
chr05,Bn18121,51811634,62200825,10389191,NBS
chr05,Bn18122,51490971,66149325,14658354,RLK
chr05,Bn18123,27281379,97013317,69731938,TN
chr05,Bn18124,20609758,55060919,34451161,CN
chr05,Bn18125,94857470,99412736,4555266,CNL
chr05,Bn18126,19141885,29994193,10852308,NBS
chr05,Bn18127,69444112,81935216,12491104,TN
chr05,Bn18128,21483092,69957748,48474656,RLK
chr05,Bn18129,72258432,83561586,11303154,RLP
chr05,Bn18130,16130429,74102870,57972441,CN
chr05,Bn18131,57258539,96751928,39493389,CNL
chr05,Bn18132,91951929,94010924,2058995,CNL
chr05,Bn18133,78512881,86932722,8419841,CNL
chr05,Bn18134,17543926,62442236,44898310,RLK
chr05,Bn18135,56603489,72573058,15969569,NBS
chr05,Bn18136,39560094,46243254,6683160,NBS
chr05,Bn18137,99113924,99758762,644838,CNL
chr05,Bn18138,35140971,41154596,6013625,RLK
chr05,Bn18139,98248714,99045967,797253,CNL
chr05,Bn18140,37072084,40676832,3604748,RLP
chr05,Bn18141,96270949,99447131,3176182,RLK
chr05,Bn18142,92216291,96749777,4533486,NBS
chr05,Bn18143,70730803,93094105,22363302,TN
chr05,Bn18144,86606773,90612867,4006094,RLP
chr05,Bn18145,81987580,91706135,9718555,NBS
chr05,Bn18146,19977648,45318562,25340914,CNL
chr05,Bn18147,84846202,87489157,2642955,RLK
chr05,Bn18148,2591175,55886844,53295669,NBS
chr05,Bn18149,91940786,95537701,3596915,CNL
chr05,Bn18150,97254790,99633918,2379128,CN
chr05,Bn18151,49380265,99741682,50361417,CNL
chr05,Bn18152,84920326,90892477,5972151,CNL
chr05,Bn18153,6802237,31682548,24880311,TNL
chr05,Bn18154,68697275,74012280,5315005,NBS
chr05,Bn18155,42324841,96282203,53957362,NBS
chr05,Bn18156,53256760,96135650,42878890,TNL
chr05,Bn18157,42865424,45071209,2205785,NBS
chr05,Bn18158,88554629,99194457,10639828,TNL
chr05,Bn18159,1323766,99086256,97762490,CN
chr05,Bn18160,68154757,77152590,8997833,RLK
chr05,Bn18161,97888348,98571802,683454,CN
chr05,Bn18162,56312626,77351055,21038429,CNL
chr05,Bn18163,97845388,99711076,1865688,CN
chr05,Bn18164,94333003,96380424,2047421,RLP
chr05,Bn18165,17306138,82764453,65458315,CN
chr05,Bn18166,14902120,59357241,44455121,CN
chr05,Bn18167,26138013,74946337,48808324,RLK
chr05,Bn18168,88735568,99796066,11060498,TN
chr05,Bn18169,64958624,78736991,13778367,RLK
chr05,Bn18170,60457523,69161244,8703721,RLP
chr05,Bn18171,24364886,88004709,63639823,RLK
chr05,Bn18172,75673413,96805783,21132370,TNL
chr05,Bn18173,68713417,90141172,21427755,RLP
chr05,Bn18174,22677200,98863704,76186504,CN
chr05,Bn18175,23858101,39270437,15412336,TN
chr05,Bn18176,90894891,93007578,2112687,CN
chr05,Bn18177,21955461,40578882,18623421,RLP
chr05,Bn18178,91754075,98553036,6798961,NBS
chr05,Bn18179,28686857,58891411,30204554,TNL
chr05,Bn18180,95858937,98708694,2849757,TNL
chr05,Bn18181,55546637,65183230,9636593,TN
chr05,Bn18182,44257481,87686005,43428524,NBS
chr05,Bn18183,7074859,81774626,74699767,TNL
chr05,Bn18184,84702504,96213168,11510664,CN
chr05,Bn18185,68069712,94386418,26316706,RLK
chr05,Bn18186,94957846,96971167,2013321,CNL
chr05,Bn18187,54784772,74246700,19461928,RLP
chr05,Bn18188,19239275,99175218,79935943,TNL
chr05,Bn18189,55802050,62269707,6467657,CNL
chr05,Bn18190,21305934,34634591,13328657,CN
chr05,Bn18191,96715345,98966913,2251568,RLK
chr05,Bn18192,71209282,83878260,12668978,CN
chr05,Bn18193,27612247,77893914,50281667,CN
chr05,Bn18194,59248438,96375086,37126648,RLP
chr05,Bn18195,11597162,97913308,86316146,NBS
chr05,Bn18196,20060264,28432503,8372239,TN
chr05,Bn18197,87740063,88422811,682748,TNL
chr05,Bn18198,38813232,89391478,50578246,CN
chr05,Bn18199,77111856,85376403,8264547,RLK
chr05,Bn18200,28919210,96472086,67552876,TNL
chr05,Bn18201,4745190,66296381,61551191,CN
chr05,Bn18202,69601032,90098351,20497319,TN
chr05,Bn18203,93836230,99122672,5286442,CN
chr05,Bn18204,30358748,88438979,58080231,CN
chr05,Bn18205,2192977,58387607,56194630,RLK
chr05,Bn18206,16270758,61325929,45055171,RLP
chr05,Bn18207,60632493,96255300,35622807,CN
chr05,Bn18208,3344045,61524888,58180843,RLK
chr05,Bn18209,86675764,97624823,10949059,RLP
chr05,Bn18210,79578408,87978514,8400106,TN
chr05,Bn18211,20545549,33090524,12544975,NBS
chr05,Bn18212,19746310,53510986,33764676,RLK
chr05,Bn18213,28603242,89178902,60575660,RLK
chr05,Bn18214,44259730,78272835,34013105,RLK
chr05,Bn18215,44735442,86621795,41886353,CNL
chr05,Bn18216,47625893,68775163,21149270,TN
chr05,Bn18217,89526403,94587221,5060818,CNL
chr05,Bn18218,3591858,28302585,24710727,TNL
chr05,Bn18219,57016625,81615174,24598549,TN
chr05,Bn18220,91027870,93829142,2801272,NBS
chr05,Bn18221,19202595,32913773,13711178,TN
chr05,Bn18222,22635409,66594268,43958859,TN
chr05,Bn18223,11974824,81981236,70006412,TNL
chr05,Bn18224,12743454,28985123,16241669,TN
chr05,Bn18225,77006092,82452221,5446129,RLK
chr05,Bn18226,69339193,70808973,1469780,TNL
chr05,Bn18227,40863008,80297192,39434184,CN
chr05,Bn18228,86857122,90611769,3754647,TN
chr05,Bn18229,77715821,96549597,18833776,RLP
chr05,Bn18230,78992006,80624216,1632210,NBS
chr05,Bn18231,64051234,97528252,33477018,TN
chr05,Bn18232,96183924,99777908,3593984,CN
chr05,Bn18233,16713142,41402300,24689158,CNL
chr05,Bn18234,71563709,87462689,15898980,RLK
chr05,Bn18235,18940425,34581831,15641406,TN
chr05,Bn18236,70063079,98543617,28480538,RLK
chr05,Bn18237,79948648,96070304,16121656,RLP
chr05,Bn18238,60976669,97675660,36698991,RLK
chr05,Bn18239,71667517,95427649,23760132,RLK
chr05,Bn18240,29395495,76277579,46882084,TNL
chr05,Bn18241,4529761,40699051,36169290,CNL
chr05,Bn18242,77708651,97222077,19513426,RLP
chr05,Bn18243,28332930,68951549,40618619,RLP
chr05,Bn18244,75161073,90799456,15638383,CNL
chr05,Bn18245,89077785,98136374,9058589,NBS
chr05,Bn18246,24654232,39365115,14710883,TN
chr05,Bn18247,74085152,88333537,14248385,TN
chr05,Bn18248,58610938,66441942,7831004,CNL
chr05,Bn18249,20798853,98091142,77292289,RLP
chr05,Bn18250,39818307,51410282,11591975,CNL
chr05,Bn18251,56560358,95791150,39230792,TNL
chr05,Bn18252,93085354,93231598,146244,TN
chr05,Bn18253,18435244,64688713,46253469,TNL
chr05,Bn18254,54486490,84974917,30488427,RLK
chr05,Bn18255,89940309,93190704,3250395,TN
chr05,Bn18256,12297455,95768505,83471050,CN
chr05,Bn18257,77100678,95090233,17989555,CNL
chr05,Bn18258,72827974,87355503,14527529,TNL
chr05,Bn18259,15629732,93955687,78325955,CN
chr05,Bn18260,70237204,79245350,9008146,TNL
chr05,Bn18261,98836348,99308570,472222,NBS
chr05,Bn18262,97278395,99853093,2574698,RLK
chr05,Bn18263,47854485,86370892,38516407,CN
chr05,Bn18264,58137235,64590783,6453548,NBS
chr05,Bn18265,11910725,47681940,35771215,TNL
chr05,Bn18266,93202447,96128362,2925915,TNL
chr05,Bn18267,24860010,93098023,68238013,RLP
chr05,Bn18268,48521269,66001210,17479941,RLP
chr05,Bn18269,6137526,8570021,2432495,CNL
chr05,Bn18270,39069711,52084579,13014868,NBS
chr05,Bn18271,37411210,94467833,57056623,RLK
chr05,Bn18272,59686007,84275992,24589985,CN
chr05,Bn18273,6812789,79145304,72332515,TNL
chr05,Bn18274,22727013,25651909,2924896,RLP
chr05,Bn18275,22096632,92950496,70853864,NBS
chr05,Bn18276,99503765,99633903,130138,RLK
chr05,Bn18277,98394480,99913283,1518803,TN
chr05,Bn18278,77686840,97258728,19571888,RLK
chr05,Bn18279,53312245,71478138,18165893,NBS
chr05,Bn18280,36623915,95880807,59256892,RLK
chr05,Bn18281,99583052,99928634,345582,NBS
chr05,Bn18282,46875487,83110563,36235076,TN
chr05,Bn18283,69761576,77364308,7602732,TNL
chr05,Bn18284,27300852,36556055,9255203,TNL
chr05,Bn18285,15694243,17452511,1758268,CN
chr05,Bn18286,13859902,65645542,51785640,TN
chr05,Bn18287,47860852,68915391,21054539,CNL
chr05,Bn18288,54047590,86059405,32011815,CN
chr05,Bn18289,17481728,79579831,62098103,CNL
chr05,Bn18290,38885514,52911331,14025817,CNL
chr05,Bn18291,14113274,80280415,66167141,NBS
chr05,Bn18292,27282935,91355463,64072528,NBS
chr05,Bn18293,68481584,97134424,28652840,CN
chr05,Bn18294,82172071,82195214,23143,RLP
chr05,Bn18295,41789366,86228678,44439312,CN
chr05,Bn18296,37229498,76581612,39352114,CN
chr05,Bn18297,17971846,99232593,81260747,TNL
chr05,Bn18298,99283048,99733880,450832,RLK
chr05,Bn18299,40639810,56963804,16323994,CNL
chr05,Bn18300,26430693,78377687,51946994,CNL
chr05,Bn18301,22526599,62249569,39722970,TN
chr05,Bn18302,44560613,57022251,12461638,CN
chr05,Bn18303,28978529,95866006,66887477,TNL
chr05,Bn18304,56011091,73342939,17331848,RLP
chr05,Bn18305,93077617,98117128,5039511,TNL
chr05,Bn18306,43871913,55829751,11957838,NBS
chr05,Bn18307,8055562,76052240,67996678,RLK
chr05,Bn18308,60932534,62347784,1415250,NBS
chr05,Bn18309,31707324,98547657,66840333,RLK
chr05,Bn18310,86496422,88196797,1700375,TN
chr05,Bn18311,92177263,95131237,2953974,CN
chr05,Bn18312,65871897,84951785,19079888,RLP
chr05,Bn18313,50890028,67519608,16629580,NBS
chr05,Bn18314,16949354,53245980,36296626,NBS
chr05,Bn18315,55165398,77316092,22150694,CN
chr05,Bn18316,99182289,99381458,199169,RLP
chr05,Bn18317,7591531,62770889,55179358,NBS
chr05,Bn18318,36480911,70847663,34366752,NBS
chr05,Bn18319,11514495,91932551,80418056,TNL
chr05,Bn18320,3210839,25761814,22550975,TN
chr05,Bn18321,91988279,97432356,5444077,CN
chr05,Bn18322,15017476,56449911,41432435,CN
chr05,Bn18323,55995419,96382259,40386840,TN
chr05,Bn18324,56336720,89316512,32979792,NBS
chr05,Bn18325,81456966,98111113,16654147,RLP
chr05,Bn18326,53407167,59700159,6292992,NBS
chr05,Bn18327,1022144,87352317,86330173,CN
chr05,Bn18328,82430641,98531110,16100469,CNL
chr05,Bn18329,96007468,98567704,2560236,RLP
chr05,Bn18330,55428366,91017154,35588788,CN
chr05,Bn18331,90357113,95365658,5008545,CNL
chr05,Bn18332,39348230,48651323,9303093,TN
chr05,Bn18333,90239958,92587844,2347886,CNL
chr05,Bn18334,77593509,97667745,20074236,NBS
chr05,Bn18335,54725822,69159525,14433703,TN
chr05,Bn18336,75265248,78657858,3392610,TNL
chr05,Bn18337,46455081,61318962,14863881,TNL
chr05,Bn18338,81606731,93948587,12341856,CN
chr05,Bn18339,35475734,59383129,23907395,CNL
chr05,Bn18340,30520239,66013755,35493516,RLP
chr05,Bn18341,60981543,92487487,31505944,TNL
chr05,Bn18342,90287288,91046551,759263,CNL
chr05,Bn18343,40599160,69914997,29315837,RLP
chr05,Bn18344,7434828,43649435,36214607,RLP
chr05,Bn18345,23814212,36562937,12748725,RLK
chr05,Bn18346,54216425,98188803,43972378,NBS
chr05,Bn18347,52796778,56693678,3896900,RLP
chr05,Bn18348,66006712,72939590,6932878,NBS
chr05,Bn18349,35347330,82838075,47490745,TNL
chr05,Bn18350,91717743,93432010,1714267,CNL
chr05,Bn18351,94538759,99830176,5291417,RLK
chr05,Bn18352,63012035,71806498,8794463,TN
chr05,Bn18353,51742674,54191238,2448564,CN
chr05,Bn18354,35181045,97056497,61875452,TNL
chr05,Bn18355,17795213,97617427,79822214,CNL
chr05,Bn18356,66000261,83604575,17604314,TN
chr05,Bn18357,99340071,99556047,215976,TN
chr05,Bn18358,22729821,47996377,25266556,RLK
chr05,Bn18359,89077401,95503837,6426436,TNL
chr05,Bn18360,77791045,81925538,4134493,CNL
chr05,Bn18361,26834071,57634854,30800783,TNL
chr05,Bn18362,94512934,99482089,4969155,CN
chr05,Bn18363,23609644,59145957,35536313,TNL
chr05,Bn18364,37442006,49282665,11840659,TNL
chr05,Bn18365,96881690,98075176,1193486,NBS
chr05,Bn18366,28275159,51177671,22902512,CN
chr05,Bn18367,56594581,86981736,30387155,RLP
chr05,Bn18368,64657947,93554780,28896833,CNL
chr05,Bn18369,88909784,96818338,7908554,RLK
chr05,Bn18370,53087745,55708809,2621064,CNL
chr05,Bn18371,63089454,92845443,29755989,TN
chr05,Bn18372,62605928,83075980,20470052,TN
chr05,Bn18373,12574957,60574253,47999296,RLK
chr05,Bn18374,96926996,99409145,2482149,NBS
chr05,Bn18375,23693227,78553525,54860298,RLP
chr05,Bn18376,54796768,90067981,35271213,RLP
chr05,Bn18377,21271398,71397448,50126050,RLK
chr05,Bn18378,18276135,38904062,20627927,RLK
chr05,Bn18379,9480860,23119917,13639057,RLK
chr05,Bn18380,98399928,98469273,69345,CN
chr05,Bn18381,44054510,95839592,51785082,RLK
chr05,Bn18382,83988088,97056992,13068904,CN
chr05,Bn18383,40382563,66283227,25900664,RLP
chr05,Bn18384,63618075,99397765,35779690,CN
chr05,Bn18385,17962013,85948503,67986490,CN
chr05,Bn18386,93905530,96792665,2887135,CN
chr05,Bn18387,48368092,48855744,487652,TNL
chr05,Bn18388,53072686,92537813,39465127,TNL
chr05,Bn18389,2479026,64790151,62311125,NBS
chr05,Bn18390,36615251,97485295,60870044,TNL
chr05,Bn18391,94279240,98445541,4166301,CN
chr05,Bn18392,2617553,37128184,34510631,CN
chr05,Bn18393,40024936,94774618,54749682,RLK
chr05,Bn18394,38342606,52261941,13919335,TN
chr05,Bn18395,47745832,58078462,10332630,RLK
chr05,Bn18396,24515654,99320008,74804354,CNL
chr05,Bn18397,80999019,94562575,13563556,TNL
chr05,Bn18398,20540489,35229617,14689128,RLP
chr05,Bn18399,62904502,72533880,9629378,CN
chr05,Bn18400,32415014,79900118,47485104,TN
chr05,Bn18401,49579082,98631817,49052735,TN
chr05,Bn18402,86216326,86487044,270718,RLK
chr05,Bn18403,13048400,66470531,53422131,CNL
chr05,Bn18404,26328395,64488489,38160094,TN
chr05,Bn18405,47266555,78014241,30747686,TNL
chr05,Bn18406,59604945,77947113,18342168,TN
chr05,Bn18407,36758750,37586908,828158,RLK
chr05,Bn18408,55545108,61497263,5952155,CNL
chr05,Bn18409,71693393,80783551,9090158,CNL
chr05,Bn18410,92640324,97080260,4439936,CN
chr05,Bn18411,14133191,98052101,83918910,RLK
chr05,Bn18412,4314635,45387999,41073364,NBS
chr05,Bn18413,16189222,27259760,11070538,RLK
chr05,Bn18414,58525986,69094921,10568935,RLP
chr05,Bn18415,93465123,94861067,1395944,TNL
chr05,Bn18416,73530325,84000050,10469725,RLP
chr05,Bn18417,67349134,87141241,19792107,CN
chr05,Bn18418,36925218,95396246,58471028,RLP
chr05,Bn18419,82815593,83209233,393640,TNL
chr05,Bn18420,18305911,52937065,34631154,RLK
chr05,Bn18421,96556770,99697820,3141050,RLP
chr05,Bn18422,87617467,97121638,9504171,TN
chr05,Bn18423,27619813,80720357,53100544,TN
chr05,Bn18424,83102300,90918480,7816180,CNL
chr05,Bn18425,91173261,99157014,7983753,CN
chr05,Bn18426,89807133,94670966,4863833,TN
chr05,Bn18427,21562165,93861394,72299229,CN
chr05,Bn18428,66752130,89958896,23206766,CN
chr05,Bn18429,35667772,73436584,37768812,RLK
chr05,Bn18430,40307547,46037309,5729762,CN
chr05,Bn18431,28085019,42778020,14693001,TNL
chr05,Bn18432,31903211,80251267,48348056,RLK
chr05,Bn18433,48372968,91981210,43608242,CN
chr05,Bn18434,78047472,85221501,7174029,TNL
chr05,Bn18435,95892462,99665595,3773133,RLK
chr05,Bn18436,5306861,92433199,87126338,RLP
chr05,Bn18437,77982495,95381223,17398728,NBS
chr05,Bn18438,30069886,78212203,48142317,RLP
chr05,Bn18439,6889851,87858658,80968807,NBS
chr05,Bn18440,65436070,81780423,16344353,RLK
chr05,Bn18441,42771100,54452112,11681012,CNL
chr05,Bn18442,12591469,75451471,62860002,TNL
chr05,Bn18443,34154062,40370212,6216150,RLK
chr05,Bn18444,81160629,89790545,8629916,CN
chr05,Bn18445,90661825,99886730,9224905,TN
chr05,Bn18446,15243774,47597457,32353683,CN
chr05,Bn18447,94912690,97581957,2669267,CN
chr05,Bn18448,14026296,42545094,28518798,NBS
chr05,Bn18449,37764589,69561449,31796860,RLK
chr05,Bn18450,1071432,29215224,28143792,TN
chr05,Bn18451,27140599,38964812,11824213,TN
chr05,Bn18452,72456276,91817841,19361565,CN
chr05,Bn18453,83168714,99752277,16583563,RLP
chr05,Bn18454,14822615,39520764,24698149,CNL
chr05,Bn18455,20877448,67350208,46472760,TNL
chr05,Bn18456,46500501,75702508,29202007,TN
chr05,Bn18457,78162297,80813077,2650780,NBS
chr05,Bn18458,4282395,66600424,62318029,CN
chr05,Bn18459,25830976,28446493,2615517,RLP
chr05,Bn18460,20213883,97029566,76815683,TN
chr05,Bn18461,35643400,99800316,64156916,CNL
chr05,Bn18462,52889970,81867035,28977065,CN
chr05,Bn18463,9847294,77239107,67391813,TN
chr05,Bn18464,93094667,99527950,6433283,CN
chr05,Bn18465,13846537,49947234,36100697,CNL
chr05,Bn18466,41242055,92814650,51572595,CNL
chr05,Bn18467,10255915,50092340,39836425,RLP
chr05,Bn18468,55415163,94787042,39371879,RLP
chr05,Bn18469,12202972,83986288,71783316,CN
chr05,Bn18470,75771266,90558773,14787507,RLP
chr05,Bn18471,27271947,29732862,2460915,RLK
chr05,Bn18472,32971188,71273672,38302484,NBS
chr05,Bn18473,7600188,65950284,58350096,CNL
chr05,Bn18474,91142602,98606652,7464050,CNL
chr05,Bn18475,61009277,83056044,22046767,CNL
chr05,Bn18476,81930386,88884870,6954484,TNL
chr05,Bn18477,7178616,18425665,11247049,CN
chr05,Bn18478,90724947,98803719,8078772,CN
chr05,Bn18479,21990246,67542259,45552013,RLK
chr05,Bn18480,43871341,87217417,43346076,CN
chr05,Bn18481,83071177,90608023,7536846,CN
chr05,Bn18482,90111087,97857529,7746442,CNL
chr05,Bn18483,6578573,54868364,48289791,CN
chr05,Bn18484,42276069,46498230,4222161,CNL
chr05,Bn18485,51133960,96252365,45118405,RLK
chr05,Bn18486,40797821,45720523,4922702,RLK
chr05,Bn18487,27212231,41060476,13848245,NBS
chr05,Bn18488,33927041,87137712,53210671,TNL
chr05,Bn18489,43007776,96261513,53253737,NBS
chr05,Bn18490,55868254,69176802,13308548,TNL
chr05,Bn18491,84085430,85584872,1499442,CNL
chr05,Bn18492,81637270,91724465,10087195,TN
chr05,Bn18493,14493151,34753192,20260041,CN
chr05,Bn18494,18094785,34961934,16867149,NBS
chr05,Bn18495,65781292,92290788,26509496,NBS
chr05,Bn18496,74150021,92899397,18749376,RLP
chr05,Bn18497,70274472,82108089,11833617,RLP
chr05,Bn18498,60367628,86332010,25964382,CNL
chr05,Bn18499,77068470,90787052,13718582,RLK
chr05,Bn18500,34142206,78511131,44368925,TN
chr05,Bn18501,28660717,77714224,49053507,CNL
chr05,Bn18502,65912365,70154311,4241946,RLK
chr05,Bn18503,83321609,94746739,11425130,RLP
chr05,Bn18504,32151525,84552465,52400940,NBS
chr05,Bn18505,98691406,98730434,39028,RLP
chr05,Bn18506,29105671,43510061,14404390,TN
chr05,Bn18507,77884900,90319780,12434880,CN
chr05,Bn18508,76100462,95483813,19383351,TNL
chr05,Bn18509,76919254,98672732,21753478,CN
chr05,Bn18510,38809359,94881210,56071851,RLK
chr05,Bn18511,33430440,68176562,34746122,TN
chr05,Bn18512,59859661,72137395,12277734,TN
chr05,Bn18513,60705735,84067691,23361956,RLP
chr05,Bn18514,31441485,33866274,2424789,CN
chr05,Bn18515,23466632,87055709,63589077,RLK
chr05,Bn18516,81382013,97377308,15995295,CNL
chr05,Bn18517,32372642,44447891,12075249,CNL
chr05,Bn18518,17781629,54164604,36382975,RLP
chr05,Bn18519,37623884,86734344,49110460,TNL
chr05,Bn18520,30063275,60408839,30345564,RLP
chr05,Bn18521,92433574,95419428,2985854,RLK
chr05,Bn18522,57634712,64969732,7335020,RLP
chr05,Bn18523,89968607,94102589,4133982,NBS
chr05,Bn18524,72538780,79412759,6873979,CN
chr05,Bn18525,76255520,86927101,10671581,NBS
chr05,Bn18526,79237625,80805707,1568082,CNL
chr05,Bn18527,13784451,62163005,48378554,TN
chr05,Bn18528,36731476,93095758,56364282,RLK
chr05,Bn18529,60856405,94379847,33523442,TN
chr05,Bn18530,76314303,89127882,12813579,NBS
chr05,Bn18531,49434454,91168641,41734187,TNL
chr05,Bn18532,86393132,88967211,2574079,RLK
chr05,Bn18533,13323814,21933059,8609245,CN
chr05,Bn18534,52228790,54065778,1836988,TN
chr05,Bn18535,14864342,35171954,20307612,RLP
chr05,Bn18536,10489575,74745001,64255426,CNL
chr05,Bn18537,50648579,60858707,10210128,RLK
chr05,Bn18538,30511010,77018715,46507705,RLK
chr05,Bn18539,22018641,46717028,24698387,TN
chr05,Bn18540,61829709,67085873,5256164,RLK
chr05,Bn18541,90389749,91538458,1148709,CNL
chr05,Bn18542,46881351,66635552,19754201,TNL
chr05,Bn18543,78238277,80435725,2197448,CNL
chr05,Bn18544,3129420,51414511,48285091,CN
chr05,Bn18545,22621936,56102499,33480563,TN
chr05,Bn18546,97933259,98212280,279021,CNL
chr05,Bn18547,36526644,61095320,24568676,RLK
chr05,Bn18548,30911928,94966289,64054361,RLP
chr05,Bn18549,49232541,84922852,35690311,RLK
chr05,Bn18550,7145562,80516003,73370441,CN
chr05,Bn18551,66039869,78843178,12803309,RLK
chr05,Bn18552,83198121,94906460,11708339,TN
chr05,Bn18553,22197187,30055338,7858151,NBS
chr05,Bn18554,75323736,78290965,2967229,NBS
chr05,Bn18555,23855279,84085518,60230239,TN
chr05,Bn18556,20093620,42381770,22288150,TNL
chr05,Bn18557,23137835,53673567,30535732,RLP
chr05,Bn18558,5649112,16025090,10375978,TN
chr05,Bn18559,78894402,89224793,10330391,CN
chr05,Bn18560,57575358,95613005,38037647,CN
chr05,Bn18561,48916943,77456680,28539737,TNL
chr05,Bn18562,86849997,90329954,3479957,TNL
chr05,Bn18563,35636838,85465232,49828394,RLP
chr05,Bn18564,73323679,77000957,3677278,CNL
chr05,Bn18565,41603090,54838079,13234989,TNL
chr05,Bn18566,97825271,99580666,1755395,NBS
chr05,Bn18567,27048078,36120852,9072774,TN
chr05,Bn18568,91085673,96664616,5578943,CN
chr05,Bn18569,87188202,95785588,8597386,RLK
chr05,Bn18570,70192923,79463883,9270960,TN
chr05,Bn18571,7623082,81307363,73684281,RLK
chr05,Bn18572,55821540,69783189,13961649,RLP
chr05,Bn18573,63093643,79926174,16832531,TN
chr05,Bn18574,35094792,60486522,25391730,TN
chr05,Bn18575,60120769,99992810,39872041,CNL
chr05,Bn18576,38988701,50992328,12003627,CNL
chr05,Bn18577,47513498,68790767,21277269,TN
chr05,Bn18578,8471890,42261086,33789196,RLK
chr05,Bn18579,88084533,96089897,8005364,TN
chr05,Bn18580,80602725,96598900,15996175,CNL
chr05,Bn18581,8348808,94366380,86017572,TNL
chr05,Bn18582,16075499,37818999,21743500,NBS
chr05,Bn18583,68606009,76448056,7842047,CNL
chr05,Bn18584,95870840,99688625,3817785,CNL
chr05,Bn18585,84143124,91334394,7191270,NBS
chr05,Bn18586,63608023,71839029,8231006,CNL
chr05,Bn18587,5410588,33844664,28434076,TN
chr05,Bn18588,95234407,96054518,820111,CNL
chr05,Bn18589,11747792,18960361,7212569,RLK
chr05,Bn18590,87130127,87556071,425944,CN
chr05,Bn18591,1686131,69062673,67376542,TN
chr05,Bn18592,4862612,30069277,25206665,CNL
chr05,Bn18593,12241390,35338081,23096691,NBS
chr05,Bn18594,28239318,80203222,51963904,RLK
chr05,Bn18595,83707623,96198405,12490782,CN
chr05,Bn18596,65524966,98134138,32609172,TN
chr05,Bn18597,85490350,99986673,14496323,RLK
chr05,Bn18598,68198697,87063715,18865018,TNL
chr05,Bn18599,78440173,88633174,10193001,RLP
chr05,Bn18600,89285975,92890939,3604964,RLK
chr05,Bn18601,78987748,83368895,4381147,CNL
chr05,Bn18602,89130274,89542827,412553,CNL
chr05,Bn18603,54671380,93139291,38467911,RLP
chr05,Bn18604,76570775,98139706,21568931,RLK
chr05,Bn18605,22918659,80150578,57231919,CN
chr05,Bn18606,56086802,94123033,38036231,TNL
chr05,Bn18607,45915258,74712685,28797427,RLK
chr05,Bn18608,58793514,80517763,21724249,NBS
chr05,Bn18609,44803793,95727559,50923766,TN
chr05,Bn18610,53118144,85465311,32347167,RLP
chr05,Bn18611,45944592,59008538,13063946,CN
chr05,Bn18612,59960325,96412459,36452134,TNL
chr05,Bn18613,23167372,55454626,32287254,CNL
chr05,Bn18614,45861614,68240709,22379095,NBS
chr05,Bn18615,19087290,65564471,46477181,NBS
chr05,Bn18616,82586866,89302062,6715196,NBS
chr05,Bn18617,41389974,99654352,58264378,TNL
chr05,Bn18618,96252251,96806225,553974,TNL
chr05,Bn18619,23641815,26657919,3016104,CNL
chr05,Bn18620,83744875,92778495,9033620,RLK
chr05,Bn18621,94520324,96040085,1519761,TNL
chr05,Bn18622,50487777,54327612,3839835,CNL
chr05,Bn18623,29542861,42856482,13313621,NBS
chr05,Bn18624,2138865,45091595,42952730,CN
chr05,Bn18625,18856751,86622308,67765557,TN
chr05,Bn18626,51403124,74912997,23509873,TNL
chr05,Bn18627,11679977,90992594,79312617,CN
chr05,Bn18628,45538321,93399457,47861136,CNL
chr05,Bn18629,6472836,83493098,77020262,CN
chr05,Bn18630,75838323,89251314,13412991,CN
chr05,Bn18631,32108102,35761861,3653759,RLK
chr05,Bn18632,73952545,94379826,20427281,CN
chr05,Bn18633,74440645,82851044,8410399,RLP
chr05,Bn18634,47751719,51979668,4227949,CNL
chr05,Bn18635,2270878,80149058,77878180,TN
chr05,Bn18636,74522804,95626761,21103957,CNL
chr05,Bn18637,15176273,93635421,78459148,RLP
chr05,Bn18638,68378147,96341166,27963019,CN
chr05,Bn18639,33853388,54124559,20271171,CN
chr05,Bn18640,62824576,74029597,11205021,RLP
chr05,Bn18641,54503925,83969872,29465947,CNL
chr05,Bn18642,58262330,76038506,17776176,RLP
chr05,Bn18643,94109562,96755132,2645570,CN
chr05,Bn18644,38268768,51127482,12858714,RLK
chr05,Bn18645,89175555,97318379,8142824,TN
chr05,Bn18646,4561993,9063406,4501413,CNL
chr05,Bn18647,82306999,82455105,148106,CN
chr05,Bn18648,71440660,86800256,15359596,TNL
chr05,Bn18649,5210034,35956509,30746475,TNL
chr05,Bn18650,18116781,61823838,43707057,TNL
chr05,Bn18651,98440059,99870520,1430461,RLP
chr05,Bn18652,25718646,33588290,7869644,CN
chr05,Bn18653,96964729,98596010,1631281,RLP
chr05,Bn18654,21989353,86853126,64863773,CNL
chr05,Bn18655,84631164,86114921,1483757,TNL
chr05,Bn18656,77426471,79017790,1591319,CNL
chr05,Bn18657,13184416,49724574,36540158,RLP
chr05,Bn18658,11288379,28987629,17699250,CNL
chr05,Bn18659,37211603,53677126,16465523,CN
chr05,Bn18660,78790055,91315336,12525281,TNL
chr05,Bn18661,15569082,82643040,67073958,RLK
chr05,Bn18662,51942981,63940871,11997890,RLK
chr05,Bn18663,48356367,92856828,44500461,RLP
chr05,Bn18664,73382240,82828096,9445856,CNL
chr05,Bn18665,26763165,76526401,49763236,RLK
chr05,Bn18666,91872245,95164243,3291998,TNL
chr05,Bn18667,6998464,29458411,22459947,CNL
chr05,Bn18668,49553942,99392144,49838202,TN
chr05,Bn18669,78113282,98183657,20070375,RLP
chr05,Bn18670,3415559,9593615,6178056,TN
chr05,Bn18671,64361157,76503879,12142722,NBS
chr05,Bn18672,29159508,41996795,12837287,TN
chr05,Bn18673,35158058,46398012,11239954,NBS
chr05,Bn18674,36619455,41777731,5158276,CN
chr05,Bn18675,71227436,88838331,17610895,CN
chr05,Bn18676,19918322,30726444,10808122,TNL
chr05,Bn18677,52819968,73701861,20881893,NBS
chr05,Bn18678,74752635,98973350,24220715,NBS
chr05,Bn18679,39208022,94555303,55347281,CNL
chr05,Bn18680,25856368,48859922,23003554,RLK
chr05,Bn18681,70353327,93335962,22982635,TNL
chr05,Bn18682,36322351,76368487,40046136,CNL
chr05,Bn18683,86585024,92646441,6061417,RLP
chr05,Bn18684,55361000,56201498,840498,TNL
chr05,Bn18685,20625489,67555538,46930049,RLP
chr05,Bn18686,26619994,42341154,15721160,TNL
chr05,Bn18687,31670749,53529054,21858305,CNL
chr05,Bn18688,21462789,77085245,55622456,CNL
chr05,Bn18689,16190539,76410967,60220428,RLP
chr05,Bn18690,57307163,64360413,7053250,CNL
chr05,Bn18691,48708047,53498145,4790098,CN
chr05,Bn18692,58304778,76519425,18214647,RLK
chr05,Bn18693,74833984,87221845,12387861,RLK
chr05,Bn18694,54212220,96624029,42411809,TN
chr05,Bn18695,56073883,78137450,22063567,RLP
chr05,Bn18696,94681204,95112393,431189,RLP
chr05,Bn18697,41114748,69758309,28643561,TNL
chr05,Bn18698,5436767,92122446,86685679,NBS
chr05,Bn18699,86531144,86656440,125296,RLP
chr05,Bn18700,32796589,93301127,60504538,CN
chr05,Bn18701,83283282,93960889,10677607,TN
chr05,Bn18702,50062675,86186751,36124076,NBS
chr05,Bn18703,27828144,41556504,13728360,TN
chr05,Bn18704,86577871,96511124,9933253,CN
chr05,Bn18705,82767098,97426762,14659664,TNL
chr05,Bn18706,70518450,76562297,6043847,RLK
chr05,Bn18707,94971866,98029107,3057241,TN
chr05,Bn18708,66794735,98278583,31483848,RLP
chr05,Bn18709,7091329,84041671,76950342,RLK
chr05,Bn18710,82684621,89432043,6747422,CNL
chr05,Bn18711,18052174,43995780,25943606,RLK
chr05,Bn18712,59328429,64333485,5005056,RLP
chr05,Bn18713,34477425,39659762,5182337,RLK
chr05,Bn18714,51640059,69662552,18022493,TN
chr05,Bn18715,6609073,99377216,92768143,TNL
chr05,Bn18716,76654872,97680431,21025559,CNL
chr05,Bn18717,35584345,70730051,35145706,CN
chr05,Bn18718,98009501,98689760,680259,TN
chr05,Bn18719,63154997,66553460,3398463,TN
chr05,Bn18720,18290734,24507609,6216875,CNL
chr05,Bn18721,80520087,81618996,1098909,NBS
chr05,Bn18722,14299808,73774581,59474773,NBS
chr05,Bn18723,13037030,53742978,40705948,CN
chr05,Bn18724,65875710,92807474,26931764,RLP
chr05,Bn18725,76209359,90320993,14111634,RLK
chr05,Bn18726,75623275,87941987,12318712,RLK
chr05,Bn18727,23589299,53616705,30027406,TN
chr05,Bn18728,13246751,23497177,10250426,NBS
chr05,Bn18729,52623113,67806755,15183642,RLP
chr05,Bn18730,40737589,86155766,45418177,TNL
chr05,Bn18731,84193062,89904322,5711260,RLK
chr05,Bn18732,62190251,71898425,9708174,CNL
chr05,Bn18733,78626295,79773719,1147424,RLP
chr05,Bn18734,81970683,84201766,2231083,TN
chr05,Bn18735,91158435,99891205,8732770,CN
chr05,Bn18736,28295391,69311991,41016600,CNL
chr05,Bn18737,4434516,57636143,53201627,TN
chr05,Bn18738,17284036,62384937,45100901,NBS
chr05,Bn18739,71694700,75067987,3373287,NBS
chr05,Bn18740,51164530,68365635,17201105,NBS
chr05,Bn18741,22953542,58527273,35573731,RLK
chr05,Bn18742,94316081,98670650,4354569,TN
chr05,Bn18743,73869438,81288946,7419508,RLK
chr05,Bn18744,76574232,80838470,4264238,RLP
chr05,Bn18745,90353242,99689898,9336656,RLK
chr05,Bn18746,94622365,98862552,4240187,CN
chr05,Bn18747,36694235,44419358,7725123,TN
chr05,Bn18748,66476059,83180628,16704569,TNL
chr05,Bn18749,38653195,91333677,52680482,RLK
chr05,Bn18750,84574392,86481865,1907473,NBS
chr05,Bn18751,31693783,65263378,33569595,CNL
chr05,Bn18752,24713733,29237984,4524251,TNL
chr05,Bn18753,46799970,85301620,38501650,TNL
chr05,Bn18754,37317828,89512590,52194762,NBS
chr05,Bn18755,33744193,35659972,1915779,NBS
chr05,Bn18756,66712975,74605317,7892342,RLP
chr05,Bn18757,19494012,64113046,44619034,RLP
chr05,Bn18758,77757227,91487701,13730474,CN
chr05,Bn18759,74655774,96242740,21586966,TNL
chr05,Bn18760,42567210,54113350,11546140,CN
chr05,Bn18761,26686811,48067346,21380535,TN
chr05,Bn18762,64273818,78918553,14644735,RLP
chr05,Bn18763,83425754,93146510,9720756,TN
chr05,Bn18764,92959789,93158578,198789,NBS
chr05,Bn18765,41275182,68551907,27276725,RLK
chr05,Bn18766,72481208,73651973,1170765,RLK
chr05,Bn18767,57099014,83258205,26159191,CNL
chr05,Bn18768,68777407,79106200,10328793,RLP
chr05,Bn18769,7201756,72077069,64875313,CN
chr05,Bn18770,82051501,95813428,13761927,CNL
chr05,Bn18771,37518326,51104744,13586418,CN
chr05,Bn18772,71911043,86948076,15037033,RLP
chr05,Bn18773,62009246,66530589,4521343,NBS
chr05,Bn18774,49554448,60853190,11298742,CN
chr05,Bn18775,66252080,93440800,27188720,TN
chr05,Bn18776,13070866,40090860,27019994,TNL
chr05,Bn18777,46856989,93487073,46630084,TN
chr05,Bn18778,60304368,78609858,18305490,CNL
chr05,Bn18779,13378356,35393230,22014874,TN
chr05,Bn18780,49747233,93194867,43447634,TN
chr05,Bn18781,11050681,40010107,28959426,TN
chr05,Bn18782,54375264,66022389,11647125,TN
chr05,Bn18783,42619915,88124834,45504919,TNL
chr05,Bn18784,38270161,42323397,4053236,CN
chr05,Bn18785,61512013,74373845,12861832,RLK
chr05,Bn18786,32693276,57070202,24376926,TN
chr05,Bn18787,21083211,69319232,48236021,CNL
chr05,Bn18788,46378352,99260013,52881661,TN
chr05,Bn18789,55407417,58982939,3575522,CNL
chr05,Bn18790,30543728,55763198,25219470,RLP
chr05,Bn18791,55153022,65511899,10358877,TN
chr05,Bn18792,75660166,79945283,4285117,RLP
chr05,Bn18793,26676440,29772883,3096443,TN
chr05,Bn18794,87154016,97772541,10618525,TN
chr05,Bn18795,44416088,95762143,51346055,RLP
chr05,Bn18796,13049699,32627441,19577742,RLK
chr05,Bn18797,73271123,76054838,2783715,RLK
chr05,Bn18798,39338064,65088445,25750381,NBS
chr05,Bn18799,1952272,97916964,95964692,CN
chr05,Bn18800,56883793,85967434,29083641,RLK
chr05,Bn18801,26877987,92722039,65844052,RLK
chr05,Bn18802,35851868,37662487,1810619,NBS
chr05,Bn18803,92636088,98699474,6063386,NBS
chr05,Bn18804,6334370,78217717,71883347,TNL
chr05,Bn18805,36231213,36937124,705911,NBS
chr05,Bn18806,89100535,91655328,2554793,TNL
chr05,Bn18807,68651719,74425287,5773568,CNL
chr05,Bn18808,61777912,98970401,37192489,TN
chr05,Bn18809,52610439,78634545,26024106,RLK
chr05,Bn18810,67983292,95318920,27335628,CNL
chr05,Bn18811,3653867,80622453,76968586,RLP
chr05,Bn18812,6142515,60699197,54556682,CN
chr05,Bn18813,94416479,94750483,334004,TNL
chr05,Bn18814,69722263,87555134,17832871,CN
chr05,Bn18815,5225834,25813808,20587974,RLP
chr05,Bn18816,79799737,87471046,7671309,TN
chr05,Bn18817,65914365,91784385,25870020,NBS
chr05,Bn18818,19379102,74358946,54979844,TNL
chr05,Bn18819,80013886,97482555,17468669,TNL
chr05,Bn18820,84476733,94786303,10309570,CN
chr05,Bn18821,78032424,98285336,20252912,TN
chr05,Bn18822,55936185,78156714,22220529,NBS
chr05,Bn18823,14148020,75640388,61492368,RLP
chr05,Bn18824,39207397,81985103,42777706,TNL
chr05,Bn18825,11462898,43895009,32432111,NBS
chr05,Bn18826,99150757,99940500,789743,TNL
chr05,Bn18827,9975653,10018099,42446,TNL
chr05,Bn18828,91519383,99902449,8383066,RLP
chr05,Bn18829,68928690,89474888,20546198,TN
chr05,Bn18830,34080024,74955839,40875815,TNL
chr05,Bn18831,71184635,73297566,2112931,CN
chr05,Bn18832,60507620,80375135,19867515,TNL
chr05,Bn18833,71427347,97419080,25991733,TN
chr05,Bn18834,10081014,69571557,59490543,TNL
chr05,Bn18835,43958182,71316983,27358801,TNL
chr05,Bn18836,37886887,80279306,42392419,CN
chr05,Bn18837,51616988,69362213,17745225,CNL
chr05,Bn18838,40399653,56936966,16537313,TNL
chr05,Bn18839,85349145,85541969,192824,CN
chr05,Bn18840,68687666,72778324,4090658,TNL
chr05,Bn18841,56790006,85293200,28503194,RLP
chr05,Bn18842,95790485,97709530,1919045,RLP
chr05,Bn18843,64426320,99393268,34966948,TNL
chr05,Bn18844,56011445,80869275,24857830,RLP
chr05,Bn18845,28012177,68529534,40517357,RLK
chr05,Bn18846,75103376,92691354,17587978,CN
chr05,Bn18847,40571297,77867791,37296494,NBS
chr05,Bn18848,47602941,63900592,16297651,CNL
chr05,Bn18849,23951740,72965498,49013758,CNL
chr05,Bn18850,50442405,71899217,21456812,RLP
chr05,Bn18851,20257846,41816944,21559098,NBS
chr05,Bn18852,9873633,37340461,27466828,RLK
chr05,Bn18853,4455684,18023101,13567417,RLP
chr05,Bn18854,47391707,69359731,21968024,CNL
chr05,Bn18855,9971036,61590380,51619344,CNL
chr05,Bn18856,31336341,54458686,23122345,TN
chr05,Bn18857,38765341,60030570,21265229,NBS
chr05,Bn18858,42893756,99463773,56570017,TNL
chr05,Bn18859,2363038,66676909,64313871,CNL
chr05,Bn18860,14452390,89339397,74887007,RLK
chr05,Bn18861,73180376,77855784,4675408,NBS
chr05,Bn18862,44810220,48365522,3555302,NBS
chr05,Bn18863,72922808,90246081,17323273,RLP
chr05,Bn18864,64973686,90654914,25681228,RLP
chr05,Bn18865,83119916,94768986,11649070,NBS
chr05,Bn18866,95455523,96263419,807896,TN
chr05,Bn18867,76353305,87285462,10932157,CN
chr05,Bn18868,39149859,60497975,21348116,CN
chr05,Bn18869,6713226,33130803,26417577,TN
chr05,Bn18870,30207106,67137628,36930522,RLK
chr05,Bn18871,69514233,91512767,21998534,CNL
chr05,Bn18872,40131526,50949234,10817708,TNL
chr05,Bn18873,86657798,91418927,4761129,CNL
chr05,Bn18874,72682415,84223243,11540828,RLP
chr05,Bn18875,29372111,35841438,6469327,CNL
chr05,Bn18876,50158636,89190838,39032202,NBS
chr05,Bn18877,32921739,71731584,38809845,NBS
chr05,Bn18878,20280841,91762215,71481374,RLP
chr05,Bn18879,95768731,96534033,765302,CN
chr05,Bn18880,70960694,95785058,24824364,TNL
chr05,Bn18881,15591401,48290799,32699398,TNL
chr05,Bn18882,53965247,84045292,30080045,CNL
chr05,Bn18883,13335137,96451952,83116815,CNL
chr05,Bn18884,83785757,93711168,9925411,RLP
chr05,Bn18885,7765632,84545155,76779523,RLK
chr05,Bn18886,96994244,98165744,1171500,RLP
chr05,Bn18887,6061471,91313639,85252168,RLP
chr05,Bn18888,34268987,42156771,7887784,RLP
chr05,Bn18889,28091646,30956308,2864662,TNL
chr05,Bn18890,46350295,80833298,34483003,NBS
chr05,Bn18891,29432512,93563226,64130714,CN
chr05,Bn18892,25100102,44162856,19062754,RLK
chr05,Bn18893,95585898,95745049,159151,TNL
chr05,Bn18894,80989212,89614502,8625290,TNL
chr05,Bn18895,16214047,62913633,46699586,NBS
chr05,Bn18896,57691207,69837684,12146477,TN
chr05,Bn18897,76145370,80981988,4836618,RLP
chr05,Bn18898,67152783,72714749,5561966,TNL
chr05,Bn18899,96532315,99601521,3069206,CN
chr05,Bn18900,26570109,26980544,410435,CNL
chr05,Bn18901,14526346,37180423,22654077,TN
chr05,Bn18902,49114720,99811883,50697163,RLP
chr05,Bn18903,3733895,91818836,88084941,CN
chr05,Bn18904,95116068,99708686,4592618,RLP
chr05,Bn18905,67877027,68654041,777014,RLP
chr05,Bn18906,60432594,99203896,38771302,NBS
chr05,Bn18907,88963553,92739214,3775661,RLP
chr05,Bn18908,90038902,95146821,5107919,NBS
chr05,Bn18909,23515711,64090206,40574495,NBS
chr05,Bn18910,96154308,99257303,3102995,NBS
chr05,Bn18911,56421879,63056178,6634299,RLK
chr05,Bn18912,14293975,92417939,78123964,RLP
chr05,Bn18913,73649300,79685949,6036649,CN
chr05,Bn18914,92421227,99204797,6783570,RLP
chr05,Bn18915,92544696,94235524,1690828,CN
chr05,Bn18916,84466035,98510047,14044012,TN
chr05,Bn18917,51984534,81116717,29132183,CN
chr05,Bn18918,40380625,53344411,12963786,CN
chr05,Bn18919,84324489,99141518,14817029,RLK
chr05,Bn18920,26299871,27709019,1409148,NBS
chr05,Bn18921,34733180,80948730,46215550,RLK
chr05,Bn18922,21334717,81630324,60295607,TNL
chr05,Bn18923,21909919,33390314,11480395,RLP
chr05,Bn18924,76148583,95973904,19825321,CNL
chr05,Bn18925,58059112,98199875,40140763,TN
chr05,Bn18926,16928278,27846635,10918357,CN
chr05,Bn18927,37326654,95614853,58288199,NBS
chr05,Bn18928,63832671,65117049,1284378,CNL
chr05,Bn18929,32930406,37726165,4795759,CN
chr05,Bn18930,43725451,68679055,24953604,TNL
chr05,Bn18931,14312926,48992951,34680025,TNL
chr05,Bn18932,82302576,99207050,16904474,TN
chr05,Bn18933,21656401,33630114,11973713,CNL
chr05,Bn18934,96318978,96633024,314046,TNL
chr05,Bn18935,9121303,72153842,63032539,CNL
chr05,Bn18936,7640291,43937179,36296888,TNL
chr05,Bn18937,73508696,91203902,17695206,CN
chr05,Bn18938,16425931,19700091,3274160,NBS
chr05,Bn18939,48290380,80715946,32425566,CNL
chr05,Bn18940,68924804,87533518,18608714,RLK
chr05,Bn18941,90189728,96926479,6736751,RLP
chr05,Bn18942,78978031,88360264,9382233,CN
chr05,Bn18943,69527655,70972170,1444515,TNL
chr05,Bn18944,33955468,59713827,25758359,TN
chr05,Bn18945,90941811,91324572,382761,CNL
chr05,Bn18946,79903333,90507964,10604631,RLK
chr05,Bn18947,61026911,81308506,20281595,RLK
chr05,Bn18948,97809164,98957643,1148479,RLK
chr05,Bn18949,39858946,52637122,12778176,RLP
chr05,Bn18950,71729056,72349535,620479,RLP
chr05,Bn18951,54723052,62825278,8102226,TN
chr05,Bn18952,82864829,94092178,11227349,RLP
chr05,Bn18953,87948963,88791885,842922,TN
chr05,Bn18954,59448442,99535938,40087496,CNL
chr05,Bn18955,18120868,53334682,35213814,TN
chr05,Bn18956,63408653,65979211,2570558,CN
chr05,Bn18957,76470625,79005717,2535092,RLP
chr05,Bn18958,88801069,98513512,9712443,TN
chr05,Bn18959,38339654,74398346,36058692,CNL
chr05,Bn18960,95443360,98814195,3370835,RLP
chr05,Bn18961,20545931,42324149,21778218,TN
chr05,Bn18962,33717192,62098648,28381456,NBS
chr05,Bn18963,69225188,75630525,6405337,TNL
chr05,Bn18964,20057461,57422084,37364623,CN
chr05,Bn18965,1049501,82358459,81308958,RLP
chr05,Bn18966,65345538,66689293,1343755,RLK
chr05,Bn18967,87670708,97205548,9534840,CN
chr05,Bn18968,68142583,74242222,6099639,CN
chr05,Bn18969,20751477,33528895,12777418,RLK
chr05,Bn18970,72532026,76238304,3706278,TN
chr05,Bn18971,4975324,50788055,45812731,CNL
chr05,Bn18972,59759281,73440502,13681221,NBS
chr05,Bn18973,81491517,99047540,17556023,NBS
chr05,Bn18974,87587381,94032524,6445143,CN
chr05,Bn18975,60686649,85555274,24868625,RLK
chr05,Bn18976,33035315,63452952,30417637,RLK
chr05,Bn18977,4571082,44924611,40353529,NBS
chr05,Bn18978,34108531,88804457,54695926,NBS
chr05,Bn18979,68380219,95443156,27062937,TNL
chr05,Bn18980,49088264,61543315,12455051,CNL
chr05,Bn18981,64261880,80340375,16078495,TNL
chr05,Bn18982,37161461,63636485,26475024,RLK
chr05,Bn18983,82341582,86331937,3990355,RLP
chr05,Bn18984,95096324,97952851,2856527,TN
chr05,Bn18985,56581232,68525956,11944724,RLP
chr05,Bn18986,30758033,94891003,64132970,RLP
chr05,Bn18987,88014852,99011562,10996710,RLK
chr05,Bn18988,73298166,84133692,10835526,CN
chr05,Bn18989,50419969,53944091,3524122,CNL
chr05,Bn18990,52799940,73039579,20239639,CNL
chr05,Bn18991,83337908,89801835,6463927,CN
chr05,Bn18992,56251527,79385101,23133574,CN
chr05,Bn18993,66123057,93271816,27148759,TNL
chr05,Bn18994,86179817,94780727,8600910,RLK
chr05,Bn18995,43611144,63635251,20024107,CN
chr05,Bn18996,95274535,96328313,1053778,CN
chr05,Bn18997,1708808,9150304,7441496,RLK
chr05,Bn18998,4715566,56779630,52064064,TN
chr05,Bn18999,95498853,98873568,3374715,TN
chr05,Bn19000,5157934,5802410,644476,TN
chr05,Bn19001,59503824,65017541,5513717,TNL
chr05,Bn19002,91587829,98517971,6930142,TN
chr05,Bn19003,8271450,40935433,32663983,TNL
chr05,Bn19004,42926684,94990844,52064160,CNL
chr05,Bn19005,69797572,74742416,4944844,CNL
chr05,Bn19006,45699194,51198313,5499119,RLK
chr05,Bn19007,82065710,96808060,14742350,CN
chr05,Bn19008,31188447,36442379,5253932,CNL
chr05,Bn19009,49091244,51673569,2582325,TNL
chr05,Bn19010,45436356,57322399,11886043,TN
chr05,Bn19011,92921693,98246455,5324762,CN
chr05,Bn19012,58107829,95340243,37232414,CN
chr05,Bn19013,63788713,92034841,28246128,NBS
chr05,Bn19014,3260380,88993017,85732637,TNL
chr05,Bn19015,99988601,99998491,9890,RLK
chr05,Bn19016,50694014,53787696,3093682,CN
chr05,Bn19017,34527254,84655419,50128165,CNL
chr05,Bn19018,80827217,96186090,15358873,RLP
chr05,Bn19019,33914314,53805436,19891122,RLP
chr05,Bn19020,43132077,87831145,44699068,RLP
chr05,Bn19021,99365691,99653081,287390,TNL
chr05,Bn19022,51274855,63826408,12551553,CNL
chr05,Bn19023,69191168,83718659,14527491,NBS
chr05,Bn19024,98443059,99126591,683532,TN
chr05,Bn19025,32357891,76514098,44156207,TNL
chr05,Bn19026,61993202,98346393,36353191,RLK
chr05,Bn19027,55546827,91376068,35829241,TNL
chr05,Bn19028,41556201,55628746,14072545,CNL
chr05,Bn19029,11822783,82070269,70247486,RLP
chr05,Bn19030,20706272,61846795,41140523,RLP
chr05,Bn19031,46576070,79604463,33028393,RLP
chr05,Bn19032,99089145,99987489,898344,TN
chr05,Bn19033,98717238,99424112,706874,RLK
chr05,Bn19034,47479365,88653694,41174329,CNL
chr05,Bn19035,75249662,89655220,14405558,NBS
chr05,Bn19036,45087412,57431716,12344304,CN
chr05,Bn19037,81594555,88662514,7067959,TN
chr05,Bn19038,78619635,83675436,5055801,RLP
chr05,Bn19039,7381956,82292217,74910261,CNL
chr05,Bn19040,80177080,84057181,3880101,NBS
chr05,Bn19041,86085914,95998664,9912750,TN
chr05,Bn19042,15446839,61825167,46378328,RLK
chr05,Bn19043,17506029,87727780,70221751,RLK
chr05,Bn19044,82992546,99861116,16868570,CNL
chr05,Bn19045,33363694,67371251,34007557,TNL
chr05,Bn19046,15201407,86242767,71041360,NBS
chr05,Bn19047,28333632,77395494,49061862,TNL
chr05,Bn19048,92492536,99180109,6687573,CN
chr05,Bn19049,51729439,52840273,1110834,NBS
chr05,Bn19050,5816633,77546405,71729772,RLK
chr05,Bn19051,18913707,66950178,48036471,CNL
chr05,Bn19052,36661053,41654990,4993937,TN
chr05,Bn19053,64056621,67571931,3515310,RLK
chr05,Bn19054,96735746,96839272,103526,NBS
chr05,Bn19055,5735891,51314950,45579059,CN
chr05,Bn19056,38255861,70358945,32103084,NBS
chr05,Bn19057,97691089,99388363,1697274,TN
chr05,Bn19058,92989565,96521171,3531606,NBS
chr05,Bn19059,88357490,93856026,5498536,TNL
chr05,Bn19060,17279059,86660670,69381611,RLK
chr05,Bn19061,70279654,74132543,3852889,CNL
chr05,Bn19062,5069357,23445342,18375985,CN
chr05,Bn19063,84864347,87867068,3002721,TN
chr05,Bn19064,24172118,62272799,38100681,CNL
chr05,Bn19065,55645258,94226144,38580886,CNL
chr05,Bn19066,58353347,88318426,29965079,RLK
chr05,Bn19067,96554328,97951671,1397343,TNL
chr05,Bn19068,12173847,16191988,4018141,TN
chr05,Bn19069,16564099,98963106,82399007,TN
chr05,Bn19070,95187815,95576887,389072,CNL
chr05,Bn19071,64061532,74452760,10391228,TN
chr05,Bn19072,18864942,61080307,42215365,RLP
chr05,Bn19073,9566802,88136191,78569389,TNL
chr05,Bn19074,94268387,95278132,1009745,CNL
chr05,Bn19075,9835846,64798743,54962897,CNL
chr05,Bn19076,64554700,70564164,6009464,CNL
chr05,Bn19077,44631113,48671142,4040029,RLK
chr05,Bn19078,91562116,94154546,2592430,RLK
chr05,Bn19079,64126815,79917419,15790604,TN
chr05,Bn19080,90095147,98386241,8291094,TNL
chr05,Bn19081,65627114,81444240,15817126,TNL
chr05,Bn19082,53703809,97285416,43581607,CNL
chr05,Bn19083,39547434,57608635,18061201,TN
chr05,Bn19084,23940566,48228835,24288269,CN
chr05,Bn19085,18085823,18759260,673437,TNL
chr05,Bn19086,23891619,79211242,55319623,TN
chr05,Bn19087,51457108,60871103,9413995,NBS
chr05,Bn19088,79502310,94463702,14961392,TN
chr05,Bn19089,42269862,90490791,48220929,CN
chr05,Bn19090,18665458,65205369,46539911,CNL
chr05,Bn19091,48050338,94849481,46799143,TN
chr05,Bn19092,98743428,99722589,979161,CN
chr05,Bn19093,7918792,57488732,49569940,TN
chr05,Bn19094,67593902,86719766,19125864,TNL
chr05,Bn19095,4532741,27225640,22692899,CNL
chr05,Bn19096,10097857,16361452,6263595,CNL
chr05,Bn19097,38509397,81031170,42521773,NBS
chr05,Bn19098,22358461,34079163,11720702,CNL
chr05,Bn19099,46541872,61117733,14575861,NBS
chr05,Bn19100,60067669,91234668,31166999,RLP
chr05,Bn19101,11034604,76746082,65711478,RLK
chr05,Bn19102,19244768,78407785,59163017,CN
chr05,Bn19103,96679438,99357347,2677909,TN
chr05,Bn19104,11336433,21970960,10634527,RLP
chr05,Bn19105,23219665,87901229,64681564,TN
chr05,Bn19106,12279259,26768534,14489275,RLP
chr05,Bn19107,4577124,76338132,71761008,RLP
chr05,Bn19108,41325634,75843695,34518061,RLK
chr05,Bn19109,24882483,91665755,66783272,CN
chr05,Bn19110,80206376,84041340,3834964,NBS
chr05,Bn19111,75743202,79745719,4002517,CN
chr05,Bn19112,30022412,33116562,3094150,CN
chr05,Bn19113,89685659,93069949,3384290,TN
chr05,Bn19114,87551680,90555440,3003760,TNL
chr05,Bn19115,44722735,88592290,43869555,NBS
chr05,Bn19116,81539738,91277446,9737708,RLP
chr05,Bn19117,65870797,81722733,15851936,TN
chr05,Bn19118,32462472,49886249,17423777,CNL
chr05,Bn19119,64265407,82681491,18416084,CN
chr05,Bn19120,78531923,80137079,1605156,NBS
chr05,Bn19121,36044637,61857074,25812437,TN
chr05,Bn19122,32611179,91336398,58725219,RLP
chr05,Bn19123,15048185,77660631,62612446,RLK
chr05,Bn19124,65794926,94399021,28604095,TNL
chr05,Bn19125,62400499,81149587,18749088,CNL
chr05,Bn19126,44224334,84928700,40704366,NBS
chr05,Bn19127,12969794,84495167,71525373,RLP
chr05,Bn19128,57487490,67838804,10351314,NBS
chr05,Bn19129,72995677,92766732,19771055,CNL
chr05,Bn19130,11888756,72479246,60590490,TN
chr05,Bn19131,47887260,99290167,51402907,CN
chr05,Bn19132,23895867,32003991,8108124,RLK
chr05,Bn19133,29996528,66954246,36957718,TN
chr05,Bn19134,76267516,86824872,10557356,CN
chr05,Bn19135,15963737,54261525,38297788,CNL
chr05,Bn19136,15649692,58755996,43106304,TNL
chr05,Bn19137,81933194,99197711,17264517,CNL
chr05,Bn19138,94583511,95594916,1011405,TNL
chr05,Bn19139,70894739,77977499,7082760,TN
chr05,Bn19140,94272675,94944355,671680,CN
chr05,Bn19141,14981738,32680959,17699221,CNL
chr05,Bn19142,24111920,34426573,10314653,CN
chr05,Bn19143,99882126,99991034,108908,RLP
chr05,Bn19144,96243930,98046422,1802492,NBS
chr05,Bn19145,29930164,74700660,44770496,TN
chr05,Bn19146,35539246,54310154,18770908,NBS
chr05,Bn19147,35550143,73210344,37660201,TN
chr05,Bn19148,74458698,89627642,15168944,TNL
chr05,Bn19149,21370470,65378224,44007754,CNL
chr05,Bn19150,1824755,19006645,17181890,RLP
chr05,Bn19151,65194135,77255927,12061792,RLK
chr05,Bn19152,19902080,55853729,35951649,TN
chr05,Bn19153,67670434,83069062,15398628,CN
chr05,Bn19154,75931201,79917746,3986545,RLP
chr05,Bn19155,69073080,85152514,16079434,TNL
chr05,Bn19156,66595209,78744787,12149578,TNL
chr05,Bn19157,60514922,69923025,9408103,RLP
chr05,Bn19158,39452802,66060064,26607262,RLP
chr05,Bn19159,32393765,67275720,34881955,NBS
chr05,Bn19160,49936442,69553986,19617544,RLK
chr05,Bn19161,74051302,82071505,8020203,CN
chr05,Bn19162,73401872,92552324,19150452,NBS
chr05,Bn19163,95140693,99119150,3978457,CNL
chr05,Bn19164,55353571,73771665,18418094,RLP
chr05,Bn19165,19648368,90623212,70974844,RLK
chr05,Bn19166,6651656,84159963,77508307,RLK
chr05,Bn19167,52746592,69327926,16581334,NBS
chr05,Bn19168,99183912,99745488,561576,TNL
chr05,Bn19169,63165994,90036394,26870400,CN
chr05,Bn19170,47408743,78340434,30931691,CNL
chr05,Bn19171,47160877,96846644,49685767,CNL
chr05,Bn19172,51927975,85898434,33970459,CN
chr05,Bn19173,7359793,72650193,65290400,TN
chr05,Bn19174,77087004,97199325,20112321,NBS
chr05,Bn19175,11334281,42353129,31018848,NBS
chr05,Bn19176,7322197,56543140,49220943,TN
chr05,Bn19177,5929496,67684444,61754948,TNL
chr05,Bn19178,3268701,39642712,36374011,RLP
chr05,Bn19179,69571944,85014284,15442340,CN
chr05,Bn19180,22270015,45769698,23499683,TN
chr05,Bn19181,54960480,76345457,21384977,RLP
chr05,Bn19182,23765065,27811918,4046853,TNL
chr05,Bn19183,55208119,75531927,20323808,TNL
chr05,Bn19184,57147540,66131895,8984355,NBS
chr05,Bn19185,64570155,92675139,28104984,CN
chr05,Bn19186,94376896,99991292,5614396,CNL
chr05,Bn19187,47009354,50970062,3960708,RLK
chr05,Bn19188,61128443,85669564,24541121,TN
chr05,Bn19189,87937195,95326405,7389210,CN
chr05,Bn19190,97354212,99554455,2200243,TNL
chr05,Bn19191,19978607,69062189,49083582,TNL
chr05,Bn19192,6735796,23867918,17132122,CNL
chr05,Bn19193,23747871,88834208,65086337,RLK
chr05,Bn19194,50058717,97100885,47042168,RLP
chr05,Bn19195,55793176,66871332,11078156,TN
chr05,Bn19196,10906968,69505552,58598584,CNL
chr05,Bn19197,91508172,92411485,903313,TN
chr05,Bn19198,81919861,99850590,17930729,CNL
chr05,Bn19199,20176721,94587967,74411246,CNL
chr05,Bn19200,26780663,78543641,51762978,CN
chr05,Bn19201,79504700,86698132,7193432,RLK
chr05,Bn19202,93615282,99898282,6283000,NBS
chr05,Bn19203,44935783,95586942,50651159,TN
chr05,Bn19204,60683879,91508300,30824421,TNL
chr05,Bn19205,3786701,15413417,11626716,NBS
chr05,Bn19206,97483770,98948350,1464580,RLP
chr05,Bn19207,49619635,60188712,10569077,NBS
chr05,Bn19208,19044996,38664124,19619128,TN
chr05,Bn19209,22363984,27385399,5021415,RLP
chr05,Bn19210,5877759,37962319,32084560,TNL
chr05,Bn19211,40845563,51028040,10182477,TNL
chr05,Bn19212,28704205,86427892,57723687,NBS
chr05,Bn19213,8257009,21444832,13187823,TN
chr05,Bn19214,18184225,24478282,6294057,CN
chr05,Bn19215,4576334,76488278,71911944,CNL
chr05,Bn19216,70364152,84008032,13643880,CN
chr05,Bn19217,49448306,75278977,25830671,RLP
chr05,Bn19218,52011388,56395895,4384507,NBS
chr05,Bn19219,40551064,41797956,1246892,TN
chr05,Bn19220,41749348,91433585,49684237,RLK
chr05,Bn19221,55549057,66218017,10668960,TNL
chr05,Bn19222,49578122,85657630,36079508,TN
chr05,Bn19223,80335438,98497034,18161596,RLP
chr05,Bn19224,56183533,82064498,25880965,CN
chr05,Bn19225,99514854,99760816,245962,NBS
chr05,Bn19226,73562196,85925785,12363589,TN
chr05,Bn19227,90280722,92744421,2463699,RLP
chr05,Bn19228,15014151,91681237,76667086,TN
chr05,Bn19229,86974263,89798923,2824660,RLK
chr05,Bn19230,50263608,63249814,12986206,TN
chr05,Bn19231,56896756,94418956,37522200,RLP
chr05,Bn19232,45994392,73788058,27793666,RLP
chr05,Bn19233,69247566,96248018,27000452,RLP
chr05,Bn19234,5413629,73686071,68272442,TN
chr05,Bn19235,53195731,95439187,42243456,CN
chr05,Bn19236,70534921,88759316,18224395,TN
chr05,Bn19237,96283770,99723427,3439657,NBS
chr05,Bn19238,7718329,31242204,23523875,TN
chr05,Bn19239,99516546,99615185,98639,TNL
chr05,Bn19240,57029339,83924229,26894890,RLK
chr05,Bn19241,18825770,68421722,49595952,TNL
chr05,Bn19242,71633505,88976651,17343146,TNL
chr05,Bn19243,54740976,77148053,22407077,CN
chr05,Bn19244,82359296,95129392,12770096,TN
chr05,Bn19245,7080952,56757630,49676678,TNL
chr05,Bn19246,70608411,82034704,11426293,TN
chr05,Bn19247,41385173,54524212,13139039,RLK
chr05,Bn19248,43112293,89096295,45984002,TNL
chr05,Bn19249,26510070,69739307,43229237,TNL
chr05,Bn19250,70170691,70601790,431099,NBS
chr05,Bn19251,61484472,95563051,34078579,CN
chr05,Bn19252,54325511,91013900,36688389,RLK
chr05,Bn19253,73760717,93283709,19522992,TN
chr05,Bn19254,86910761,90255021,3344260,CN
chr05,Bn19255,63827737,90823672,26995935,CN
chr05,Bn19256,51061023,56111012,5049989,CN
chr05,Bn19257,25704630,85542595,59837965,CN
chr05,Bn19258,19961546,30561423,10599877,NBS
chr05,Bn19259,40164871,41480653,1315782,RLP
chr05,Bn19260,5087030,59306676,54219646,CN
chr05,Bn19261,20193339,20531275,337936,TN
chr05,Bn19262,28732461,76117005,47384544,NBS
chr05,Bn19263,66673388,78702326,12028938,RLP
chr05,Bn19264,14547236,70321699,55774463,RLP
chr05,Bn19265,5925679,45203876,39278197,NBS
chr05,Bn19266,74804688,83043362,8238674,CNL
chr05,Bn19267,18743656,50157417,31413761,TN
chr05,Bn19268,14777218,15781085,1003867,TN
chr05,Bn19269,19411385,64353632,44942247,CNL
chr05,Bn19270,30011456,36191726,6180270,TNL
chr05,Bn19271,81599965,88144895,6544930,CNL
chr05,Bn19272,23762119,36677426,12915307,CN
chr05,Bn19273,72286043,95673893,23387850,TNL
chr05,Bn19274,16374622,36707631,20333009,TN
chr05,Bn19275,4537522,50080121,45542599,CN
chr05,Bn19276,64250760,69072770,4822010,RLP
chr05,Bn19277,75640868,96333477,20692609,TN
chr05,Bn19278,26880949,32879825,5998876,RLK
chr05,Bn19279,66903149,67555097,651948,CN
chr05,Bn19280,17027869,55870280,38842411,RLP
chr05,Bn19281,6920328,46518053,39597725,RLP
chr05,Bn19282,74863698,89548414,14684716,TNL
chr05,Bn19283,11838882,96121589,84282707,TNL
chr05,Bn19284,96544584,98072678,1528094,CN
chr05,Bn19285,7571678,72271699,64700021,CNL
chr05,Bn19286,40240181,85729085,45488904,CNL
chr05,Bn19287,44729794,83706213,38976419,CNL
chr05,Bn19288,11693245,15669392,3976147,RLK
chr05,Bn19289,36598695,47674661,11075966,RLP
chr05,Bn19290,74606814,83938390,9331576,RLP
chr05,Bn19291,4668908,43569911,38901003,CNL
chr05,Bn19292,76736910,88018648,11281738,CNL
chr05,Bn19293,25220506,88896811,63676305,TNL
chr05,Bn19294,58287837,98222478,39934641,TNL
chr05,Bn19295,78143032,96847087,18704055,NBS
chr05,Bn19296,79636893,83982077,4345184,NBS
chr05,Bn19297,55541199,76865867,21324668,TN
chr05,Bn19298,87065455,93230182,6164727,NBS
chr05,Bn19299,14423474,74398950,59975476,TN
chr05,Bn19300,33846845,37415237,3568392,TN
chr05,Bn19301,55199800,74149261,18949461,NBS
chr05,Bn19302,4399181,35166060,30766879,TNL
chr05,Bn19303,45486521,63470234,17983713,TN
chr05,Bn19304,28471051,33247523,4776472,TN
chr05,Bn19305,48810037,55982940,7172903,CN
chr05,Bn19306,96196877,97857337,1660460,TNL
chr05,Bn19307,97886114,99869689,1983575,CNL
chr05,Bn19308,52311073,58188490,5877417,RLK
chr05,Bn19309,9380258,37372266,27992008,CN
chr05,Bn19310,12011306,53044736,41033430,CNL
chr05,Bn19311,58726285,61603048,2876763,CNL
chr05,Bn19312,69703214,75065012,5361798,TN
chr05,Bn19313,65137633,71895230,6757597,CNL
chr05,Bn19314,94646131,96192720,1546589,TN
chr05,Bn19315,56124340,82928350,26804010,NBS
chr05,Bn19316,74131560,79540880,5409320,TN
chr05,Bn19317,15481746,87762505,72280759,CNL
chr05,Bn19318,20701521,99902920,79201399,RLP
chr05,Bn19319,8765220,19844039,11078819,NBS
chr05,Bn19320,87569380,96548032,8978652,RLK
chr05,Bn19321,4303941,48503033,44199092,CNL
chr05,Bn19322,82498765,97536913,15038148,NBS
chr05,Bn19323,64338404,77688665,13350261,CNL
chr05,Bn19324,60118620,73534179,13415559,CNL
chr05,Bn19325,23364097,29539073,6174976,RLP
chr05,Bn19326,93657985,95561478,1903493,TNL
chr05,Bn19327,76768795,83003551,6234756,RLK
chr05,Bn19328,88420127,97361669,8941542,CN
chr05,Bn19329,2872299,90110322,87238023,RLP
chr05,Bn19330,15684503,81324981,65640478,TN
chr05,Bn19331,30720516,95848771,65128255,CNL
chr05,Bn19332,88522569,88951870,429301,CN
chr05,Bn19333,14562892,44562146,29999254,TNL
chr05,Bn19334,68205436,83693215,15487779,TNL
chr05,Bn19335,97493384,99949208,2455824,TN
chr05,Bn19336,70405245,91902545,21497300,CNL
chr05,Bn19337,94034798,98404894,4370096,RLP
chr05,Bn19338,61167822,78350497,17182675,RLK
chr05,Bn19339,77126715,89076592,11949877,TN
chr05,Bn19340,53162828,67341916,14179088,TNL
chr05,Bn19341,85969386,86527798,558412,TN
chr05,Bn19342,85466265,86693390,1227125,CNL
chr05,Bn19343,10230436,73565651,63335215,TN
chr05,Bn19344,32786951,55109656,22322705,RLK
chr05,Bn19345,78770028,98026273,19256245,TNL
chr05,Bn19346,31784005,50996473,19212468,NBS
chr05,Bn19347,53423324,59990159,6566835,CNL
chr05,Bn19348,97570955,98001289,430334,RLK
chr05,Bn19349,68113049,86761005,18647956,NBS
chr05,Bn19350,27101383,80060793,52959410,CN
chr05,Bn19351,84924139,91696303,6772164,CN
chr05,Bn19352,90405149,91113503,708354,RLK
chr05,Bn19353,14622288,48233167,33610879,RLK
chr05,Bn19354,12436944,21572313,9135369,RLK
chr05,Bn19355,19270667,88960851,69690184,CNL
chr05,Bn19356,37103070,49241755,12138685,RLP
chr05,Bn19357,24361548,78597600,54236052,TNL
chr05,Bn19358,94992331,96573152,1580821,NBS
chr05,Bn19359,30995211,43213183,12217972,RLK
chr05,Bn19360,16046732,64499848,48453116,RLP
chr05,Bn19361,51234035,66804420,15570385,RLK
chr05,Bn19362,17893355,83469229,65575874,TNL
chr05,Bn19363,75930323,78523113,2592790,NBS
chr05,Bn19364,15169392,52908798,37739406,NBS
chr05,Bn19365,22074691,64389566,42314875,TNL
chr05,Bn19366,68556415,88400094,19843679,RLK
chr05,Bn19367,40304813,73444841,33140028,TN
chr05,Bn19368,83464540,96151715,12687175,TNL
chr05,Bn19369,19049699,46987556,27937857,TN
chr05,Bn19370,24918504,46971791,22053287,TNL
chr05,Bn19371,32570799,95849489,63278690,NBS
chr05,Bn19372,46252635,87844181,41591546,CNL
chr05,Bn19373,75816413,93476841,17660428,TN
chr05,Bn19374,69916183,73565937,3649754,TNL
chr05,Bn19375,83666167,92680765,9014598,NBS
chr05,Bn19376,62713845,78563639,15849794,CN
chr05,Bn19377,88817404,94234093,5416689,TN
chr05,Bn19378,59198494,64744479,5545985,TN
chr05,Bn19379,35258406,36753629,1495223,CN
chr05,Bn19380,51654787,61368007,9713220,NBS
chr05,Bn19381,56267446,57257159,989713,RLP
chr05,Bn19382,62204249,83915319,21711070,RLP
chr05,Bn19383,3462389,57556327,54093938,CN
chr05,Bn19384,76394867,88118991,11724124,CNL
chr05,Bn19385,50498291,56695745,6197454,RLK
chr05,Bn19386,1122166,8383108,7260942,NBS
chr05,Bn19387,46519876,78535021,32015145,RLP
chr05,Bn19388,98925163,99998745,1073582,TNL
chr05,Bn19389,82828450,83831888,1003438,CN
chr05,Bn19390,91356413,98990068,7633655,CNL
chr05,Bn19391,63983943,87568292,23584349,RLP
chr05,Bn19392,64160504,73269409,9108905,CN
chr05,Bn19393,59409091,80745279,21336188,RLP
chr05,Bn19394,2766804,68053711,65286907,CNL
chr05,Bn19395,30381944,43624208,13242264,RLK
chr05,Bn19396,25583854,26371669,787815,RLP
chr05,Bn19397,84509657,86175100,1665443,TN
chr05,Bn19398,76364264,93107935,16743671,TN
chr05,Bn19399,9087863,91272168,82184305,CN
chr05,Bn19400,85283438,89822683,4539245,RLP
chr05,Bn19401,44310067,70294313,25984246,CNL
chr05,Bn19402,64976568,77216651,12240083,RLP
chr05,Bn19403,68885500,72978146,4092646,NBS
chr05,Bn19404,41560337,74441219,32880882,RLK
chr05,Bn19405,51187261,83186816,31999555,TN
chr05,Bn19406,59308071,82687687,23379616,CN
chr05,Bn19407,5905097,70041310,64136213,CN
chr05,Bn19408,15687845,33514441,17826596,CN
chr05,Bn19409,71949151,94239748,22290597,CN
chr05,Bn19410,58860404,92232206,33371802,CN
chr05,Bn19411,94323825,96849862,2526037,CNL
chr05,Bn19412,8527333,73362739,64835406,RLP
chr05,Bn19413,13982828,49301385,35318557,RLK
chr05,Bn19414,35555796,70157290,34601494,TN
chr05,Bn19415,40671893,87362081,46690188,TN
chr05,Bn19416,46124036,58758187,12634151,RLP
chr05,Bn19417,62091297,69511758,7420461,CNL
chr05,Bn19418,44041370,66455455,22414085,CNL
chr05,Bn19419,11921668,40345736,28424068,CN
chr05,Bn19420,98104818,98184722,79904,CN
chr05,Bn19421,33865048,60303757,26438709,RLP
chr05,Bn19422,66483632,73824251,7340619,CNL
chr05,Bn19423,84591953,87183359,2591406,RLP
chr05,Bn19424,69309279,98047091,28737812,NBS
chr05,Bn19425,57271047,75847427,18576380,TN
chr05,Bn19426,36177764,43939874,7762110,RLP
chr05,Bn19427,66751145,86027721,19276576,TN
chr05,Bn19428,17026557,20955292,3928735,RLP
chr05,Bn19429,29937787,98286967,68349180,CNL
chr05,Bn19430,34464513,46463482,11998969,NBS
chr05,Bn19431,46577722,88583825,42006103,CN
chr05,Bn19432,21525159,74836397,53311238,RLK
chr05,Bn19433,45162513,70102325,24939812,TN
chr05,Bn19434,45240322,66064765,20824443,CNL
chr05,Bn19435,21447056,86244526,64797470,CN
chr05,Bn19436,69467603,97051440,27583837,NBS
chr05,Bn19437,88667059,95722961,7055902,CN
chr05,Bn19438,39362736,46401862,7039126,TNL
chr05,Bn19439,19916176,61783689,41867513,CNL
chr05,Bn19440,51496369,51839690,343321,CNL
chr05,Bn19441,58657077,73701705,15044628,CN
chr05,Bn19442,40211894,79439106,39227212,TNL
chr05,Bn19443,62790910,65575924,2785014,RLK
chr05,Bn19444,30853508,99721616,68868108,RLK
chr05,Bn19445,55143642,71303256,16159614,CN
chr05,Bn19446,15160003,90654721,75494718,TNL
chr05,Bn19447,58842151,63135167,4293016,CNL
chr05,Bn19448,80704313,86442828,5738515,CN
chr05,Bn19449,2710981,92684534,89973553,NBS
chr05,Bn19450,87654152,88471013,816861,RLK
chr05,Bn19451,19149244,45423622,26274378,NBS
chr05,Bn19452,80663399,96119069,15455670,NBS
chr05,Bn19453,33575836,38138516,4562680,RLP
chr05,Bn19454,97997214,98479138,481924,NBS
chr05,Bn19455,99861149,99948354,87205,NBS
chr05,Bn19456,70216416,76290673,6074257,NBS
chr05,Bn19457,34930576,92150128,57219552,TN
chr05,Bn19458,92190553,93331713,1141160,TN
chr05,Bn19459,94458155,98711267,4253112,RLK
chr05,Bn19460,65787388,75524416,9737028,TN
chr05,Bn19461,3218558,57242682,54024124,CNL
chr05,Bn19462,38899697,80897818,41998121,TN
chr05,Bn19463,97838913,98902586,1063673,CNL
chr05,Bn19464,84070583,90696660,6626077,CN
chr05,Bn19465,20685138,74214334,53529196,NBS
chr05,Bn19466,96160827,98232614,2071787,RLK
chr05,Bn19467,76761439,87884242,11122803,TNL
chr05,Bn19468,67270411,83509017,16238606,TNL
chr05,Bn19469,5542884,45750871,40207987,NBS
chr05,Bn19470,5230483,5520064,289581,NBS
chr05,Bn19471,27473035,34322807,6849772,NBS
chr05,Bn19472,66135463,77589061,11453598,CN
chr05,Bn19473,76892713,98096208,21203495,RLK
chr05,Bn19474,55311379,83982966,28671587,TNL
chr05,Bn19475,65769008,74826016,9057008,RLK
chr05,Bn19476,41183394,48090408,6907014,CN
chr05,Bn19477,33161356,71297368,38136012,TN
chr05,Bn19478,8550594,47505643,38955049,RLK
chr05,Bn19479,21341980,23095717,1753737,TNL
chr05,Bn19480,64159723,81043015,16883292,CNL
chr05,Bn19481,23892229,67521949,43629720,CN
chr05,Bn19482,96727074,99764133,3037059,RLP
chr05,Bn19483,6432772,60366432,53933660,RLK
chr05,Bn19484,56078333,85017385,28939052,CNL
chr05,Bn19485,18202143,32874349,14672206,RLP
chr05,Bn19486,50968971,90310824,39341853,NBS
chr05,Bn19487,82660244,84814590,2154346,TNL
chr05,Bn19488,95904066,98749021,2844955,RLP
chr05,Bn19489,34481781,90552672,56070891,RLP
chr05,Bn19490,61900331,92480952,30580621,TN
chr05,Bn19491,56463968,73035613,16571645,CN
chr05,Bn19492,27502952,50817255,23314303,TNL
chr05,Bn19493,50347132,57291663,6944531,CNL
chr05,Bn19494,6255215,67144192,60888977,RLK
chr05,Bn19495,14458285,60442086,45983801,NBS
chr05,Bn19496,14610982,68474545,53863563,RLP
chr05,Bn19497,29895120,30873122,978002,TNL
chr05,Bn19498,76681239,90749574,14068335,RLP
chr05,Bn19499,75447310,99958018,24510708,CNL
chr05,Bn19500,68051177,69660224,1609047,CNL
chr05,Bn19501,73185884,86793862,13607978,TNL
chr05,Bn19502,27215123,36147504,8932381,CN
chr05,Bn19503,74109674,77662499,3552825,CN
chr05,Bn19504,2341192,60892717,58551525,CN
chr05,Bn19505,17139160,30440559,13301399,CNL
chr05,Bn19506,38507452,57500607,18993155,TN
chr05,Bn19507,14177674,49436359,35258685,NBS
chr05,Bn19508,7467026,20515421,13048395,TN
chr05,Bn19509,82375284,95101237,12725953,CNL
chr05,Bn19510,93327386,97826629,4499243,RLK
chr05,Bn19511,34569725,48075913,13506188,NBS
chr05,Bn19512,21888118,32699677,10811559,CN
chr05,Bn19513,83559430,83816687,257257,TNL
chr05,Bn19514,35586685,57958924,22372239,TNL
chr05,Bn19515,88959209,90835576,1876367,RLP
chr05,Bn19516,72721367,93043908,20322541,NBS
chr05,Bn19517,50726723,77323301,26596578,CNL
chr05,Bn19518,34478070,82768473,48290403,NBS
chr05,Bn19519,63599469,66181196,2581727,NBS
chr05,Bn19520,60195918,70932371,10736453,CN
chr05,Bn19521,26299398,68308313,42008915,CNL
chr05,Bn19522,14749992,75406224,60656232,RLK
chr05,Bn19523,65329872,98933151,33603279,RLP
chr05,Bn19524,18538499,67461707,48923208,RLP
chr05,Bn19525,38693244,76797548,38104304,TN
chr05,Bn19526,62146524,73790679,11644155,TNL
chr05,Bn19527,31961103,35323559,3362456,RLP
chr05,Bn19528,4727371,52348993,47621622,CN
chr05,Bn19529,63933453,69833486,5900033,CNL
chr05,Bn19530,20661322,57812590,37151268,TN
chr05,Bn19531,60679735,79252811,18573076,NBS
chr05,Bn19532,90430296,98913872,8483576,CNL
chr05,Bn19533,51968241,85579730,33611489,RLP
chr05,Bn19534,22510559,71480339,48969780,TNL
chr05,Bn19535,20917537,89932623,69015086,NBS
chr05,Bn19536,78970150,80954049,1983899,RLK
chr05,Bn19537,86668492,87294808,626316,RLP
chr05,Bn19538,52751425,91270576,38519151,TNL
chr05,Bn19539,92116621,95757881,3641260,TN
chr05,Bn19540,96286551,96441066,154515,CN
chr05,Bn19541,28590671,86377218,57786547,RLP
chr05,Bn19542,80090050,83205711,3115661,CN
chr05,Bn19543,66759014,77176587,10417573,TNL
chr05,Bn19544,57095261,88882496,31787235,CN
chr05,Bn19545,53120935,57011457,3890522,RLP
chr05,Bn19546,98071968,98440190,368222,TN
chr05,Bn19547,56493744,58995422,2501678,RLK
chr05,Bn19548,89662366,90759062,1096696,CN
chr05,Bn19549,49193403,54625587,5432184,NBS
chr05,Bn19550,67028906,83411539,16382633,CN
chr05,Bn19551,42220579,91446315,49225736,RLP
chr05,Bn19552,4752645,34747812,29995167,CNL
chr05,Bn19553,9276415,73563957,64287542,CN
chr05,Bn19554,21502358,23832134,2329776,RLK
chr05,Bn19555,68592337,80550015,11957678,TN
chr05,Bn19556,92965397,96064643,3099246,RLK
chr05,Bn19557,21603962,80143091,58539129,NBS
chr05,Bn19558,84316696,95767343,11450647,CN
chr05,Bn19559,79558248,89521193,9962945,CN
chr05,Bn19560,79969033,97150090,17181057,RLP
chr05,Bn19561,41899427,88148232,46248805,TNL
chr05,Bn19562,23002079,81077011,58074932,TN
chr05,Bn19563,63587928,74640531,11052603,RLP
chr05,Bn19564,23237273,85298257,62060984,TN
chr05,Bn19565,92667918,92730612,62694,RLP
chr05,Bn19566,80572859,83318368,2745509,NBS
chr05,Bn19567,60906090,83835653,22929563,NBS
chr05,Bn19568,15851094,37833313,21982219,TNL
chr05,Bn19569,91282959,96595208,5312249,RLK
chr05,Bn19570,47679632,70817106,23137474,TN
chr05,Bn19571,88598889,94656677,6057788,TNL
chr05,Bn19572,73223912,78374878,5150966,CNL
chr05,Bn19573,31227583,64192643,32965060,CN
chr05,Bn19574,88293430,94731232,6437802,TNL
chr05,Bn19575,46420410,60989511,14569101,NBS
chr05,Bn19576,83679771,88457575,4777804,TN
chr05,Bn19577,18298506,83447211,65148705,NBS
chr05,Bn19578,8322356,61819781,53497425,RLK
chr05,Bn19579,9434934,53131639,43696705,CNL
chr05,Bn19580,74220861,78757943,4537082,RLK
chr05,Bn19581,57939915,73342298,15402383,CNL
chr05,Bn19582,53915725,57706034,3790309,CN
chr05,Bn19583,43779782,97841836,54062054,TNL
chr05,Bn19584,33532015,37327710,3795695,RLP
chr05,Bn19585,44615184,47764382,3149198,RLK
chr05,Bn19586,88795025,99657857,10862832,CNL
chr05,Bn19587,25160969,67434790,42273821,TNL
chr05,Bn19588,72781040,72809682,28642,RLP
chr05,Bn19589,57244276,81046291,23802015,TN
chr05,Bn19590,28228755,62851412,34622657,NBS
chr05,Bn19591,79081165,83360066,4278901,CN
chr05,Bn19592,43080181,92245868,49165687,NBS
chr05,Bn19593,82719548,90132687,7413139,CNL
chr05,Bn19594,20660474,38473652,17813178,TNL
chr05,Bn19595,82531651,87920207,5388556,CN
chr05,Bn19596,35943505,89380111,53436606,CNL
chr05,Bn19597,8258577,42212423,33953846,RLK
chr05,Bn19598,88763921,90986199,2222278,RLP
chr05,Bn19599,42893170,55685825,12792655,NBS
chr05,Bn19600,85821797,87584763,1762966,NBS
chr05,Bn19601,67878812,98905613,31026801,TN
chr05,Bn19602,84222007,90793702,6571695,NBS
chr05,Bn19603,49361672,62413663,13051991,NBS
chr05,Bn19604,95608440,99830113,4221673,NBS
chr05,Bn19605,7931033,29064578,21133545,NBS
chr05,Bn19606,7359608,68265087,60905479,TN
chr05,Bn19607,78994071,82363412,3369341,TNL
chr05,Bn19608,36755724,56635339,19879615,CN
chr05,Bn19609,12466810,86984651,74517841,RLK
chr05,Bn19610,38371765,45931301,7559536,CN
chr05,Bn19611,72759173,91383602,18624429,RLK
chr05,Bn19612,29268213,55260907,25992694,NBS
chr05,Bn19613,33612918,92226258,58613340,RLP
chr05,Bn19614,24234810,70365319,46130509,CNL
chr05,Bn19615,53283684,64396805,11113121,TNL
chr05,Bn19616,15326941,40306474,24979533,CN
chr05,Bn19617,60461654,68567057,8105403,NBS
chr05,Bn19618,70723776,71775989,1052213,CNL
chr05,Bn19619,50326393,67689799,17363406,RLK
chr05,Bn19620,46221894,47403411,1181517,TNL
chr05,Bn19621,32254181,76331785,44077604,CN
chr05,Bn19622,43901406,68208702,24307296,RLK
chr05,Bn19623,19628055,97869763,78241708,RLK
chr05,Bn19624,42594001,60702726,18108725,RLK
chr05,Bn19625,52801679,72071753,19270074,RLK
chr05,Bn19626,92988553,96044470,3055917,CN
chr05,Bn19627,58059324,97821036,39761712,CNL
chr05,Bn19628,23220598,25766517,2545919,TNL
chr05,Bn19629,42897180,73596927,30699747,CNL
chr05,Bn19630,3974757,13568356,9593599,CNL
chr05,Bn19631,14890389,47171608,32281219,RLP
chr05,Bn19632,52461189,81849369,29388180,CN
chr05,Bn19633,21681989,78921144,57239155,TN
chr05,Bn19634,40524511,98072276,57547765,RLK
chr05,Bn19635,24352677,72369118,48016441,NBS
chr05,Bn19636,92856130,96256118,3399988,RLP
chr05,Bn19637,42164955,95305862,53140907,RLK
chr05,Bn19638,41828335,49215131,7386796,NBS
chr05,Bn19639,38981962,68184654,29202692,CNL
chr05,Bn19640,82926526,92932897,10006371,RLK
chr05,Bn19641,58727544,73930446,15202902,TNL
chr05,Bn19642,76763942,77375954,612012,TN
chr05,Bn19643,72706639,74099211,1392572,RLP
chr05,Bn19644,58519794,88648744,30128950,TNL
chr05,Bn19645,7023556,26373478,19349922,RLP
chr05,Bn19646,74638924,83831781,9192857,TNL
chr05,Bn19647,67398871,91237240,23838369,CNL
chr05,Bn19648,13345396,50817442,37472046,CN
chr05,Bn19649,67484898,88512916,21028018,TNL
chr05,Bn19650,9364643,96723883,87359240,TN
chr05,Bn19651,16847873,65950318,49102445,CN
chr05,Bn19652,54498320,90703155,36204835,CNL
chr05,Bn19653,7949967,98678810,90728843,RLK
chr05,Bn19654,96786950,98013629,1226679,TN
chr05,Bn19655,57208914,86732542,29523628,RLP
chr05,Bn19656,29474598,36473642,6999044,TNL
chr05,Bn19657,17059697,76231156,59171459,TN
chr05,Bn19658,49290994,97706309,48415315,CNL
chr05,Bn19659,10660381,35961951,25301570,CN
chr05,Bn19660,13321316,95954853,82633537,RLP
chr05,Bn19661,92757597,97513512,4755915,CN
chr05,Bn19662,43333334,65988739,22655405,TN
chr05,Bn19663,83906436,85411888,1505452,NBS
chr05,Bn19664,86302724,99814996,13512272,TN
chr05,Bn19665,43218135,51306325,8088190,NBS
chr05,Bn19666,96326429,99278281,2951852,CNL
chr05,Bn19667,2187284,84816827,82629543,NBS
chr05,Bn19668,95726072,98442265,2716193,NBS
chr05,Bn19669,55945929,95528405,39582476,RLP
chr05,Bn19670,97071468,97784932,713464,CN
chr05,Bn19671,16946292,30810275,13863983,TN
chr05,Bn19672,89410374,97080158,7669784,CN
chr05,Bn19673,1017765,75273404,74255639,RLP
chr05,Bn19674,84448771,88252005,3803234,CNL
chr05,Bn19675,70469790,80333885,9864095,TNL
chr05,Bn19676,90434456,94094055,3659599,RLP
chr05,Bn19677,4804166,14558020,9753854,CNL
chr05,Bn19678,96399690,96837705,438015,TNL
chr05,Bn19679,48607968,82549674,33941706,CN
chr05,Bn19680,92588421,95929698,3341277,RLK
chr05,Bn19681,10483599,42818417,32334818,RLP
chr05,Bn19682,88961418,93193531,4232113,TNL
chr05,Bn19683,97290101,97878505,588404,TN
chr05,Bn19684,48981296,91722018,42740722,TNL
chr05,Bn19685,64498519,93548217,29049698,NBS
chr05,Bn19686,54403748,70137010,15733262,CN
chr05,Bn19687,73073559,73845128,771569,NBS
chr05,Bn19688,83928625,94122172,10193547,CNL
chr05,Bn19689,98204339,98815205,610866,CNL
chr05,Bn19690,21016274,57697264,36680990,TN
chr05,Bn19691,90408187,92703234,2295047,CNL
chr05,Bn19692,85206424,92303787,7097363,TN
chr05,Bn19693,10406864,27751056,17344192,TN
chr05,Bn19694,69021482,98664984,29643502,NBS
chr05,Bn19695,46074300,76978625,30904325,CNL
chr05,Bn19696,10790867,62484819,51693952,RLK
chr05,Bn19697,67454659,93066618,25611959,NBS
chr05,Bn19698,74008310,99294050,25285740,RLK
chr05,Bn19699,67952438,74467624,6515186,RLK
chr05,Bn19700,13767049,65859527,52092478,TN
chr05,Bn19701,79269465,83665269,4395804,CNL
chr05,Bn19702,94075622,97450546,3374924,CN
chr05,Bn19703,6591476,30965780,24374304,CN
chr05,Bn19704,90456267,92845891,2389624,RLP
chr05,Bn19705,40483347,53445842,12962495,TNL
chr05,Bn19706,73795629,76653255,2857626,TNL
chr05,Bn19707,6908790,48729848,41821058,CNL
chr05,Bn19708,11522841,53525821,42002980,CNL
chr05,Bn19709,95237125,98452258,3215133,CN
chr05,Bn19710,89464631,95301970,5837339,CNL
chr05,Bn19711,63911739,67569847,3658108,TNL
chr05,Bn19712,43388596,51185570,7796974,CN
chr05,Bn19713,41533955,52558801,11024846,RLK
chr05,Bn19714,89865290,91986521,2121231,RLP
chr05,Bn19715,40629834,81688677,41058843,CN
chr05,Bn19716,14034161,35058820,21024659,RLP
chr05,Bn19717,57415552,97428257,40012705,CN
chr05,Bn19718,92852758,98836180,5983422,CNL
chr05,Bn19719,86252018,94758343,8506325,NBS
chr05,Bn19720,6379619,43040144,36660525,RLP
chr05,Bn19721,79322352,84842405,5520053,TNL
chr05,Bn19722,62634438,97453696,34819258,RLP
chr05,Bn19723,15885047,55179472,39294425,NBS
chr05,Bn19724,61821275,96256004,34434729,NBS
chr05,Bn19725,77029488,77162644,133156,TNL
chr05,Bn19726,38383823,73447809,35063986,NBS
chr05,Bn19727,68545357,97783925,29238568,RLK
chr05,Bn19728,77514724,80459968,2945244,RLP
chr05,Bn19729,35396793,90150073,54753280,RLK
chr05,Bn19730,3396922,19745368,16348446,CN
chr05,Bn19731,38916457,71085059,32168602,TNL
chr05,Bn19732,40488995,78361556,37872561,TN
chr05,Bn19733,91183454,96095268,4911814,RLK
chr05,Bn19734,14457821,96826994,82369173,TNL
chr05,Bn19735,44631214,50446421,5815207,CN
chr05,Bn19736,82647816,94680266,12032450,TNL
chr05,Bn19737,22071223,27804724,5733501,TN
chr05,Bn19738,31773216,70843948,39070732,NBS
chr05,Bn19739,94243834,96560684,2316850,NBS
chr05,Bn19740,80387047,91093729,10706682,CN
chr05,Bn19741,50299005,86084655,35785650,NBS
chr05,Bn19742,38621873,74489964,35868091,CNL
chr05,Bn19743,44945433,63259629,18314196,CN
chr05,Bn19744,73529397,74019217,489820,NBS
chr05,Bn19745,39468517,45179256,5710739,NBS
chr05,Bn19746,86109178,86982310,873132,RLP
chr05,Bn19747,21983476,25734162,3750686,CN
chr05,Bn19748,39816022,77398467,37582445,TNL
chr05,Bn19749,62337763,64903176,2565413,CNL
chr05,Bn19750,96060515,96665885,605370,CNL
chr05,Bn19751,75277000,89268363,13991363,TN
chr05,Bn19752,3765199,56305731,52540532,NBS
chr05,Bn19753,54041924,74608275,20566351,TN
chr05,Bn19754,67802896,76932739,9129843,NBS
chr05,Bn19755,15191314,91336779,76145465,TN
chr05,Bn19756,32180329,81671760,49491431,NBS
chr05,Bn19757,51498668,81479816,29981148,RLP
chr05,Bn19758,93906559,94405158,498599,NBS
chr05,Bn19759,84743315,85443017,699702,TNL
chr05,Bn19760,67318571,91877363,24558792,NBS
chr05,Bn19761,56882748,89391070,32508322,CN
chr05,Bn19762,72672443,99633533,26961090,TNL
chr05,Bn19763,1253313,38809462,37556149,RLK
chr05,Bn19764,43829523,52933835,9104312,TN
chr05,Bn19765,22173946,80998214,58824268,TN
chr05,Bn19766,93284536,98808717,5524181,RLP
chr05,Bn19767,76978468,94532356,17553888,RLP
chr05,Bn19768,70445138,98847190,28402052,CNL
chr05,Bn19769,38913822,65910207,26996385,RLK
chr05,Bn19770,46933130,51899268,4966138,CN
chr05,Bn19771,37745561,92961972,55216411,NBS
chr05,Bn19772,64950408,86941994,21991586,NBS
chr05,Bn19773,91665392,99724414,8059022,NBS
chr05,Bn19774,68712618,85810214,17097596,NBS
chr05,Bn19775,65133439,80952802,15819363,TN
chr05,Bn19776,79570695,82958496,3387801,CNL
chr05,Bn19777,75430566,75659234,228668,CNL
chr05,Bn19778,84638102,88293331,3655229,CN
chr05,Bn19779,18263214,24540909,6277695,TNL
chr05,Bn19780,67364560,85098291,17733731,CN
chr05,Bn19781,85525633,95745614,10219981,CN
chr05,Bn19782,36203476,72566540,36363064,RLK
chr05,Bn19783,76564311,76915161,350850,RLK
chr05,Bn19784,76595841,85525208,8929367,RLK
chr05,Bn19785,69310998,88439831,19128833,CN
chr05,Bn19786,43707109,51503444,7796335,RLP
chr05,Bn19787,68815058,85616627,16801569,NBS
chr05,Bn19788,72799202,88595396,15796194,RLP
chr05,Bn19789,49669018,68280130,18611112,TN
chr05,Bn19790,71615986,72236009,620023,CNL
chr05,Bn19791,65864157,67474492,1610335,NBS
chr05,Bn19792,11029012,84478440,73449428,RLK
chr05,Bn19793,2824251,16221914,13397663,CNL
chr05,Bn19794,31217620,87804814,56587194,CNL
chr05,Bn19795,26037848,57439566,31401718,TN
chr05,Bn19796,43050086,95334511,52284425,RLK
chr05,Bn19797,64689288,96726756,32037468,RLK
chr05,Bn19798,15380102,43644089,28263987,CN
chr05,Bn19799,68146779,85028263,16881484,CNL
chr05,Bn19800,26325185,43771750,17446565,NBS
chr05,Bn19801,14113958,93814240,79700282,CN
chr05,Bn19802,73234384,85985257,12750873,NBS
chr05,Bn19803,16039231,70189601,54150370,CN
chr05,Bn19804,71317133,99591041,28273908,RLP
chr05,Bn19805,34559809,84720369,50160560,CNL
chr05,Bn19806,83371671,88111952,4740281,CNL
chr05,Bn19807,92090105,98321064,6230959,TNL
chr05,Bn19808,28820650,88939844,60119194,NBS
chr05,Bn19809,17551106,21332902,3781796,TNL
chr05,Bn19810,48431958,85599668,37167710,CNL
chr05,Bn19811,38829315,55006291,16176976,TN
chr05,Bn19812,40164106,62797596,22633490,CNL
chr05,Bn19813,35935371,57380508,21445137,RLK
chr05,Bn19814,67377998,73045966,5667968,TN
chr05,Bn19815,40601822,95300317,54698495,RLP
chr05,Bn19816,27002554,70448352,43445798,TNL
chr05,Bn19817,66299658,74882653,8582995,RLK
chr05,Bn19818,57574019,72541161,14967142,CN
chr05,Bn19819,84504408,90389447,5885039,TNL
chr05,Bn19820,13027993,53083644,40055651,CN
chr05,Bn19821,26837024,88667845,61830821,RLK
chr05,Bn19822,17470515,57118659,39648144,RLK
chr05,Bn19823,55670383,77767414,22097031,RLP
chr05,Bn19824,86519205,95489146,8969941,TN
chr05,Bn19825,3569401,74673700,71104299,TN
chr05,Bn19826,66461953,73766517,7304564,TN
chr05,Bn19827,97751809,99105879,1354070,RLP
chr05,Bn19828,37526643,87612467,50085824,RLK
chr05,Bn19829,74953098,90409470,15456372,TN
chr05,Bn19830,88861558,99538529,10676971,TNL
chr05,Bn19831,87999764,91371613,3371849,RLP
chr05,Bn19832,7498388,73943648,66445260,TNL
chr05,Bn19833,72676872,80717718,8040846,RLK
chr05,Bn19834,29486516,35167697,5681181,CNL
chr05,Bn19835,52860618,62536679,9676061,NBS
chr05,Bn19836,76299727,85563207,9263480,TN
chr05,Bn19837,38659669,50534738,11875069,NBS
chr05,Bn19838,36190090,58854699,22664609,TNL
chr05,Bn19839,84628323,89357368,4729045,TN
chr05,Bn19840,7488233,69014318,61526085,NBS
chr05,Bn19841,62349900,63566722,1216822,TNL
chr05,Bn19842,49930497,60561028,10630531,RLK
chr05,Bn19843,98002979,99376752,1373773,RLP
chr05,Bn19844,57565853,79550809,21984956,RLP
chr05,Bn19845,57880752,69981715,12100963,RLK
chr05,Bn19846,73011759,89232866,16221107,TNL
chr05,Bn19847,51488720,78776993,27288273,CNL
chr05,Bn19848,65437706,71378140,5940434,TN
chr05,Bn19849,42217192,91995751,49778559,RLK
chr05,Bn19850,50782674,52528791,1746117,RLK
chr05,Bn19851,47283688,56046185,8762497,NBS
chr05,Bn19852,40688404,79666592,38978188,CNL
chr05,Bn19853,8431419,64960034,56528615,CNL
chr05,Bn19854,54783136,55816912,1033776,TNL
chr05,Bn19855,74559730,82806674,8246944,RLK
chr05,Bn19856,14965279,21586039,6620760,NBS
chr05,Bn19857,51706897,95244209,43537312,NBS
chr05,Bn19858,97233609,99407434,2173825,RLP
chr05,Bn19859,32266156,68758369,36492213,CN
chr05,Bn19860,94295484,96896612,2601128,TNL
chr05,Bn19861,27957383,33755251,5797868,RLP
chr05,Bn19862,65524229,92988331,27464102,TN
chr05,Bn19863,47954414,83963395,36008981,TN
chr05,Bn19864,42436660,68739203,26302543,CN
chr05,Bn19865,73403625,78433738,5030113,RLK
chr05,Bn19866,30887675,74909305,44021630,RLP
chr05,Bn19867,78527685,82971650,4443965,NBS
chr05,Bn19868,54668381,56077017,1408636,RLP
chr05,Bn19869,68157735,82465553,14307818,RLK
chr05,Bn19870,57431225,98968728,41537503,CN
chr05,Bn19871,58031344,61235727,3204383,TNL
chr05,Bn19872,11874865,22827236,10952371,RLP
chr05,Bn19873,25469409,28074917,2605508,NBS
chr05,Bn19874,7884029,32471291,24587262,CNL
chr05,Bn19875,62435024,72192448,9757424,TN
chr05,Bn19876,53958681,76851742,22893061,NBS
chr05,Bn19877,94915385,97629736,2714351,TNL
chr05,Bn19878,3352464,71773288,68420824,NBS
chr05,Bn19879,36007339,67334204,31326865,CNL
chr05,Bn19880,63337981,71076267,7738286,CN
chr05,Bn19881,64404532,70460175,6055643,TNL
chr05,Bn19882,9179270,31838424,22659154,CN
chr05,Bn19883,99012261,99511949,499688,RLK
chr05,Bn19884,18946924,69535555,50588631,CN
chr05,Bn19885,79030072,87322741,8292669,NBS
chr05,Bn19886,84677600,96059713,11382113,TNL
chr05,Bn19887,71736237,83825230,12088993,CNL
chr05,Bn19888,80533807,93177327,12643520,CNL
chr05,Bn19889,59729029,93051937,33322908,TN
chr05,Bn19890,99754152,99864287,110135,CNL
chr05,Bn19891,30038095,76718356,46680261,NBS
chr05,Bn19892,95229476,96764794,1535318,TNL
chr05,Bn19893,81670164,85293981,3623817,TN
chr05,Bn19894,51827234,77698656,25871422,RLP
chr05,Bn19895,11031794,83121757,72089963,CN
chr05,Bn19896,8098773,71919840,63821067,TN
chr05,Bn19897,1518827,38793917,37275090,RLP
chr05,Bn19898,19692310,42840843,23148533,TNL
chr05,Bn19899,17189169,42303935,25114766,CN
chr05,Bn19900,46344734,55116478,8771744,TN
chr05,Bn19901,98176456,98810689,634233,TN
chr05,Bn19902,19759851,50525849,30765998,TNL
chr05,Bn19903,17649569,22133036,4483467,TN
chr05,Bn19904,20968805,42843357,21874552,CNL
chr05,Bn19905,51446328,99454779,48008451,CN
chr05,Bn19906,98412717,99518659,1105942,CN
chr05,Bn19907,28537522,45455122,16917600,CNL
chr05,Bn19908,1756078,13443094,11687016,TNL
chr05,Bn19909,63114229,81444677,18330448,CNL
chr05,Bn19910,26661241,44770575,18109334,RLP
chr05,Bn19911,26333005,99667422,73334417,RLK
chr05,Bn19912,75667462,92191209,16523747,RLP
chr05,Bn19913,7187896,53102968,45915072,TN
chr05,Bn19914,64366832,88721381,24354549,TN
chr05,Bn19915,62781415,69774340,6992925,CNL
chr05,Bn19916,27161521,47316580,20155059,NBS
chr05,Bn19917,61109895,88981733,27871838,NBS
chr05,Bn19918,98369724,99164567,794843,CNL
chr05,Bn19919,68242500,97261844,29019344,TN
chr05,Bn19920,41703313,58281048,16577735,RLK
chr05,Bn19921,47401106,61727969,14326863,TNL
chr05,Bn19922,43727135,52694883,8967748,RLP
chr05,Bn19923,11687813,54897388,43209575,RLP
chr05,Bn19924,21386018,80405753,59019735,NBS
chr05,Bn19925,6869585,15992617,9123032,TNL
chr05,Bn19926,94878411,95001114,122703,CN
chr05,Bn19927,18897833,65734281,46836448,TNL
chr05,Bn19928,73096622,96066156,22969534,NBS
chr05,Bn19929,34055420,51040452,16985032,RLK
chr05,Bn19930,88188150,88900057,711907,CNL
chr05,Bn19931,9869473,24728772,14859299,TNL
chr05,Bn19932,59331231,75321522,15990291,CNL
chr05,Bn19933,97664355,98136400,472045,RLP
chr05,Bn19934,59329989,71819769,12489780,RLK
chr05,Bn19935,23290292,87846849,64556557,RLP
chr05,Bn19936,33649614,40717481,7067867,NBS
chr05,Bn19937,25950215,53842714,27892499,CNL
chr05,Bn19938,7665984,39672953,32006969,TN
chr05,Bn19939,3132889,12103257,8970368,RLK
chr05,Bn19940,20181482,54661512,34480030,CNL
chr05,Bn19941,43526514,65999505,22472991,TNL
chr05,Bn19942,30877644,86064563,55186919,TNL
chr05,Bn19943,3113678,14806038,11692360,TNL
chr05,Bn19944,76039049,88857107,12818058,NBS
chr05,Bn19945,26533541,32439827,5906286,NBS
chr05,Bn19946,42983920,92581509,49597589,NBS
chr05,Bn19947,83975358,87619180,3643822,TNL
chr05,Bn19948,89050960,95522589,6471629,CNL
chr05,Bn19949,51271477,77049286,25777809,TN
chr05,Bn19950,87214577,96557875,9343298,CNL
chr05,Bn19951,13886177,51113120,37226943,RLK
chr05,Bn19952,92696979,98185252,5488273,CNL
chr05,Bn19953,4416826,98092759,93675933,RLP
chr05,Bn19954,50336805,77947420,27610615,NBS
chr05,Bn19955,81627675,86708394,5080719,CNL
chr05,Bn19956,73888179,90979474,17091295,TNL
chr05,Bn19957,94905308,98232350,3327042,TN
chr05,Bn19958,85619588,88038615,2419027,TNL
chr05,Bn19959,2560307,32250081,29689774,RLP
chr05,Bn19960,27863542,76492991,48629449,RLK
chr05,Bn19961,33276162,92962052,59685890,TN
chr05,Bn19962,47199841,53829178,6629337,RLP
chr05,Bn19963,75709612,96421950,20712338,NBS
chr05,Bn19964,38263723,85682119,47418396,CNL
chr05,Bn19965,24646701,44335416,19688715,RLP
chr05,Bn19966,88711819,96826979,8115160,NBS
chr05,Bn19967,98258009,99285057,1027048,CN
chr05,Bn19968,71304286,84779095,13474809,TNL
chr05,Bn19969,88298954,99539632,11240678,NBS
chr05,Bn19970,38226394,56779378,18552984,CN
chr05,Bn19971,11586211,84258866,72672655,NBS
chr05,Bn19972,96715002,98216628,1501626,TNL
chr05,Bn19973,18683125,18929394,246269,CN
chr05,Bn19974,6248254,38124310,31876056,TNL
chr05,Bn19975,3110222,64097808,60987586,CN
chr05,Bn19976,9183038,64630011,55446973,RLP
chr05,Bn19977,52484803,57477640,4992837,RLP
chr05,Bn19978,79899138,97590675,17691537,RLK
chr05,Bn19979,79802975,93918565,14115590,RLP
chr05,Bn19980,82684892,90169778,7484886,TN
chr05,Bn19981,4593187,23464666,18871479,CN
chr05,Bn19982,12857604,80461015,67603411,CN
chr05,Bn19983,29371486,87603077,58231591,TNL
chr05,Bn19984,55197838,88734655,33536817,TNL
chr05,Bn19985,96054787,96631322,576535,CNL
chr05,Bn19986,78276184,88968094,10691910,CNL
chr05,Bn19987,60673165,80307448,19634283,CN
chr05,Bn19988,37992845,54314446,16321601,TNL
chr05,Bn19989,85242451,91853366,6610915,NBS
chr05,Bn19990,3906856,98235864,94329008,RLK
chr05,Bn19991,18567822,51986677,33418855,RLK
chr05,Bn19992,82429531,99384908,16955377,NBS
chr05,Bn19993,6539221,50640691,44101470,CNL
chr05,Bn19994,61586555,84247052,22660497,TN
chr05,Bn19995,72354536,87108163,14753627,RLK
chr05,Bn19996,17298113,60657977,43359864,CNL
chr05,Bn19997,20588602,61211762,40623160,NBS
chr05,Bn19998,84554054,99416007,14861953,NBS
chr05,Bn19999,86029740,92546483,6516743,RLP
chr05,Bn20000,59602732,70920085,11317353,CNL
chr05,Bn20001,37453580,69609698,32156118,RLK
chr05,Bn20002,46508687,66184341,19675654,NBS
chr05,Bn20003,22745282,93304133,70558851,CN
chr05,Bn20004,28070891,43235534,15164643,CNL
chr05,Bn20005,73086575,74565000,1478425,NBS
chr05,Bn20006,72111359,78281142,6169783,RLP
chr05,Bn20007,34182199,49902615,15720416,CN
chr05,Bn20008,15999927,53808097,37808170,CN
chr05,Bn20009,56868438,73924772,17056334,TNL
chr05,Bn20010,52882807,81877762,28994955,RLK
chr05,Bn20011,32440662,79569224,47128562,CNL
chr05,Bn20012,67338101,87114246,19776145,CNL
chr05,Bn20013,9103616,45142942,36039326,TNL
chr05,Bn20014,13104372,64468236,51363864,CNL
chr05,Bn20015,20837638,83076975,62239337,RLK
chr05,Bn20016,69672161,87672496,18000335,CN
chr05,Bn20017,22950559,76825550,53874991,RLK
chr05,Bn20018,82716072,96349653,13633581,TNL
chr05,Bn20019,74338874,92990158,18651284,CNL
chr05,Bn20020,5769234,6256482,487248,CN
chr05,Bn20021,34104468,54512186,20407718,CN
chr05,Bn20022,95881931,98837128,2955197,RLP
chr05,Bn20023,97866001,99174279,1308278,CN
chr05,Bn20024,38108221,51233685,13125464,CN
chr05,Bn20025,54144261,62862496,8718235,TNL
chr05,Bn20026,8435417,40680757,32245340,CN
chr05,Bn20027,48001809,63488988,15487179,TNL
chr05,Bn20028,29513827,76846566,47332739,RLP
chr05,Bn20029,24297090,38086343,13789253,CNL
chr05,Bn20030,88412354,93408906,4996552,TN
chr05,Bn20031,62526921,93962931,31436010,RLP
chr05,Bn20032,21783906,54572685,32788779,TN
chr05,Bn20033,80799732,91054078,10254346,NBS
chr05,Bn20034,73917576,86658606,12741030,CNL
chr05,Bn20035,85490432,91935009,6444577,TNL
chr05,Bn20036,59743286,75908330,16165044,CN
chr05,Bn20037,57248908,63764103,6515195,TN
chr05,Bn20038,12718024,15216295,2498271,TN
chr05,Bn20039,16139939,36471375,20331436,TN
chr05,Bn20040,24326502,63881483,39554981,RLK
chr05,Bn20041,1281567,10027081,8745514,CN
chr05,Bn20042,21044973,80627698,59582725,TNL
chr05,Bn20043,68947985,68950343,2358,RLP
chr05,Bn20044,53015803,83915893,30900090,TN
chr05,Bn20045,94390637,94861095,470458,TNL
chr05,Bn20046,96166883,98607526,2440643,RLP
chr05,Bn20047,87703465,89294575,1591110,RLP
chr05,Bn20048,77377430,81714813,4337383,CNL
chr05,Bn20049,53979604,71888102,17908498,RLK
chr05,Bn20050,90432087,98330268,7898181,CNL
chr05,Bn20051,21605274,39736313,18131039,CN
chr05,Bn20052,62027492,88512459,26484967,CN
chr05,Bn20053,77582299,83868398,6286099,CN
chr05,Bn20054,12763435,68333347,55569912,RLK
chr05,Bn20055,72016408,79854183,7837775,RLP
chr05,Bn20056,12717548,69734962,57017414,RLK
chr05,Bn20057,89741989,95080455,5338466,RLK
chr05,Bn20058,6859985,42203196,35343211,RLK
chr05,Bn20059,76708746,79414610,2705864,RLP
chr05,Bn20060,81275492,86492956,5217464,NBS
chr05,Bn20061,34188257,69519633,35331376,NBS
chr05,Bn20062,38931835,51448652,12516817,NBS
chr05,Bn20063,58300335,66715879,8415544,TNL
chr05,Bn20064,23301273,88445571,65144298,NBS
chr05,Bn20065,42537086,55325319,12788233,TN
chr05,Bn20066,43906849,96432925,52526076,TNL
chr05,Bn20067,65690140,70216981,4526841,TN
chr05,Bn20068,4845925,25370273,20524348,RLP
chr05,Bn20069,47716599,81572635,33856036,TNL
chr05,Bn20070,56964941,74126384,17161443,TN
chr05,Bn20071,75253004,81968326,6715322,TNL
chr05,Bn20072,36880941,72190514,35309573,NBS
chr05,Bn20073,52057890,53078453,1020563,RLP
chr05,Bn20074,54695436,61240421,6544985,CN
chr05,Bn20075,39930632,92806994,52876362,RLP
chr05,Bn20076,21623425,51171183,29547758,NBS
chr05,Bn20077,60262318,84924979,24662661,RLK
chr05,Bn20078,56876718,65639879,8763161,TN
chr05,Bn20079,39979168,90612665,50633497,CN
chr05,Bn20080,98981295,99566811,585516,RLP
chr05,Bn20081,44568641,84310571,39741930,RLP
chr05,Bn20082,56614835,72854147,16239312,NBS
chr05,Bn20083,36195258,79777291,43582033,CN
chr05,Bn20084,92652699,97863866,5211167,CNL
chr05,Bn20085,36045153,75183697,39138544,RLK
chr05,Bn20086,54885935,71486135,16600200,TN
chr05,Bn20087,20786407,98707323,77920916,CNL
chr05,Bn20088,58662567,84390988,25728421,NBS
chr05,Bn20089,58092466,65587157,7494691,TNL
chr05,Bn20090,64698894,70467960,5769066,CNL
chr05,Bn20091,63628646,70367630,6738984,TNL
chr05,Bn20092,97575276,98528853,953577,CNL
chr05,Bn20093,30143147,53371835,23228688,CN
chr05,Bn20094,93135379,93415057,279678,CNL
chr05,Bn20095,91432129,94301210,2869081,TN
chr05,Bn20096,8551511,76255865,67704354,NBS
chr05,Bn20097,53264123,61513085,8248962,TNL
chr05,Bn20098,2094562,35663226,33568664,CNL
chr05,Bn20099,70499700,70739582,239882,TNL
chr05,Bn20100,18034608,74069594,56034986,CNL
chr05,Bn20101,62662089,87938758,25276669,CN
chr05,Bn20102,21905010,74671714,52766704,RLP
chr05,Bn20103,99728783,99936485,207702,TNL
chr05,Bn20104,34807288,39031645,4224357,TN
chr05,Bn20105,90592910,92468288,1875378,CN
chr05,Bn20106,9025243,97671739,88646496,CNL
chr05,Bn20107,74032825,74399755,366930,RLK
chr05,Bn20108,25272070,39001619,13729549,TNL
chr05,Bn20109,90593147,94859602,4266455,RLK
chr05,Bn20110,17195296,25184213,7988917,RLK
chr05,Bn20111,30472718,41809068,11336350,CN
chr05,Bn20112,71336925,82177133,10840208,RLK
chr05,Bn20113,58228245,77496836,19268591,TNL
chr05,Bn20114,89791853,95567622,5775769,TNL
chr05,Bn20115,66510359,81112781,14602422,RLK
chr05,Bn20116,47170420,64850106,17679686,CN
chr05,Bn20117,54252098,89231387,34979289,TN
chr05,Bn20118,96909051,98855000,1945949,CNL
chr05,Bn20119,11843938,39921116,28077178,RLP
chr05,Bn20120,44965180,60599369,15634189,RLK
chr05,Bn20121,39057032,46246773,7189741,RLK
chr05,Bn20122,13585236,56783073,43197837,RLP
chr05,Bn20123,10594176,56752579,46158403,TNL
chr05,Bn20124,47931230,96569341,48638111,CN
chr05,Bn20125,65289590,77600407,12310817,CN
chr05,Bn20126,60536184,78208220,17672036,RLK
chr05,Bn20127,12052140,63271721,51219581,CNL
chr05,Bn20128,35196819,94485556,59288737,RLK
chr05,Bn20129,13494096,65391623,51897527,CN
chr05,Bn20130,50840705,87415015,36574310,TN
chr05,Bn20131,61425531,80003475,18577944,CNL
chr05,Bn20132,41522700,68806410,27283710,RLP
chr05,Bn20133,70845325,79633036,8787711,RLK
chr05,Bn20134,77369695,85655194,8285499,CNL
chr05,Bn20135,66258819,91316774,25057955,NBS
chr05,Bn20136,34904542,89122814,54218272,RLK
chr05,Bn20137,29448890,95879291,66430401,CN
chr05,Bn20138,40153268,59195091,19041823,TNL
chr05,Bn20139,9414033,23489798,14075765,CN
chr05,Bn20140,43087439,66784720,23697281,TNL
chr05,Bn20141,45458105,89558252,44100147,CN
chr05,Bn20142,57677903,82209121,24531218,TN
chr05,Bn20143,32343775,40991429,8647654,NBS
chr05,Bn20144,44479717,92527462,48047745,TNL
chr05,Bn20145,40230194,55062460,14832266,TN
chr05,Bn20146,2101016,70719692,68618676,RLK
chr05,Bn20147,94854212,99533428,4679216,NBS
chr05,Bn20148,10418945,62995588,52576643,TN
chr05,Bn20149,54382776,66272479,11889703,RLK
chr05,Bn20150,17688727,81439780,63751053,CN
chr05,Bn20151,60336099,78505838,18169739,CN
chr05,Bn20152,76795282,81059475,4264193,RLP
chr05,Bn20153,33007637,71866255,38858618,NBS
chr05,Bn20154,13727905,64564193,50836288,RLP
chr05,Bn20155,2565180,71401300,68836120,CN
chr05,Bn20156,38972182,50645426,11673244,NBS
chr05,Bn20157,21373715,52210451,30836736,RLK
chr05,Bn20158,7495476,66861021,59365545,RLP
chr05,Bn20159,66139483,82335336,16195853,NBS
chr05,Bn20160,18264093,26760903,8496810,TNL
chr05,Bn20161,35698595,69789910,34091315,RLP
chr05,Bn20162,78018630,91496869,13478239,TN
chr05,Bn20163,21982313,56748752,34766439,NBS
chr05,Bn20164,89113548,98727962,9614414,TNL
chr05,Bn20165,50317983,88774681,38456698,NBS
chr05,Bn20166,95110186,98009651,2899465,RLP
chr05,Bn20167,95475587,96783088,1307501,NBS
chr05,Bn20168,41624861,99543648,57918787,TNL
chr05,Bn20169,46542848,91363389,44820541,RLK
chr05,Bn20170,78346899,79994977,1648078,TNL
chr05,Bn20171,76836921,84913074,8076153,TNL
chr05,Bn20172,56759403,78566850,21807447,CN
chr05,Bn20173,89358504,96485509,7127005,CN
chr05,Bn20174,29929764,63970469,34040705,TNL
chr05,Bn20175,53788809,69414240,15625431,NBS
chr05,Bn20176,32299331,96704857,64405526,CNL
chr05,Bn20177,15036732,63829163,48792431,CNL
chr05,Bn20178,2471172,52977300,50506128,CN
chr05,Bn20179,91483198,93480984,1997786,TNL
chr05,Bn20180,41444083,80630051,39185968,NBS
chr05,Bn20181,49132276,65923220,16790944,TNL
chr05,Bn20182,69382846,71659897,2277051,RLP
chr05,Bn20183,87759818,89030218,1270400,NBS
chr05,Bn20184,95997235,99022785,3025550,RLP
chr05,Bn20185,32597033,66611451,34014418,TN
chr05,Bn20186,46405333,91115701,44710368,TN
chr05,Bn20187,43591938,79668772,36076834,TNL
chr05,Bn20188,20437712,73042974,52605262,TN
chr05,Bn20189,74609354,82181536,7572182,RLP
chr05,Bn20190,40684028,98890258,58206230,RLP
chr05,Bn20191,10601330,98172483,87571153,RLP
chr05,Bn20192,96565000,98627417,2062417,TNL
chr05,Bn20193,56251520,76134264,19882744,CNL
chr05,Bn20194,44206603,55318903,11112300,TNL
chr05,Bn20195,79900034,83736210,3836176,RLP
chr05,Bn20196,41888543,99959157,58070614,TN
chr05,Bn20197,32557595,57321779,24764184,CN
chr05,Bn20198,75619866,77560696,1940830,TN
chr05,Bn20199,73293471,88896434,15602963,CN
chr05,Bn20200,6713144,50224590,43511446,RLK
chr05,Bn20201,32842708,44908254,12065546,TNL
chr05,Bn20202,77934536,86122719,8188183,TN
chr05,Bn20203,20752490,98679044,77926554,CNL
chr05,Bn20204,41169641,98864001,57694360,NBS
chr05,Bn20205,87398476,92569893,5171417,NBS
chr05,Bn20206,95741427,98815440,3074013,NBS
chr05,Bn20207,49817707,78288098,28470391,RLK
chr05,Bn20208,71783705,81525089,9741384,TNL
chr05,Bn20209,48872932,67158994,18286062,CN
chr05,Bn20210,87413672,98453430,11039758,TNL
chr05,Bn20211,72171966,88793839,16621873,CNL
chr05,Bn20212,47484779,77966701,30481922,CN
chr05,Bn20213,76228864,85951928,9723064,CNL
chr05,Bn20214,48567719,90923144,42355425,TN
chr05,Bn20215,10721056,64989311,54268255,CN
chr05,Bn20216,7526847,49762934,42236087,NBS
chr05,Bn20217,41036593,93838308,52801715,TNL
chr05,Bn20218,86578843,89484263,2905420,RLP
chr05,Bn20219,61496659,66934474,5437815,CN
chr05,Bn20220,21218882,68693475,47474593,TN
chr05,Bn20221,33569162,80919134,47349972,TNL
chr05,Bn20222,45130214,54682591,9552377,CN
chr05,Bn20223,42089036,74436615,32347579,TN
chr05,Bn20224,94311757,99811776,5500019,NBS
chr05,Bn20225,17721519,32663536,14942017,RLK
chr05,Bn20226,58419675,73893786,15474111,RLK
chr05,Bn20227,2096494,63161326,61064832,TNL
chr05,Bn20228,44208159,48000980,3792821,NBS
chr05,Bn20229,40185287,89358828,49173541,RLP
chr05,Bn20230,51801555,55306739,3505184,CNL
chr05,Bn20231,10327743,47020474,36692731,NBS
chr05,Bn20232,37976488,84800510,46824022,TNL
chr05,Bn20233,9895406,52593825,42698419,RLK
chr05,Bn20234,29841914,88005246,58163332,TN
chr05,Bn20235,87847291,97128467,9281176,RLK
chr05,Bn20236,54891353,67029561,12138208,RLK
chr05,Bn20237,77826801,90877091,13050290,TNL
chr05,Bn20238,62575826,73183853,10608027,CN
chr05,Bn20239,36820146,92662554,55842408,CNL
chr05,Bn20240,69768008,89179864,19411856,TNL
chr05,Bn20241,83897512,88850946,4953434,NBS
chr05,Bn20242,57812168,91666419,33854251,RLP
chr05,Bn20243,94690078,99475843,4785765,RLP
chr05,Bn20244,93043136,98473816,5430680,RLK
chr05,Bn20245,68725806,89947852,21222046,TNL
chr05,Bn20246,5625054,73712431,68087377,CN
chr05,Bn20247,90267648,94511213,4243565,RLP
chr05,Bn20248,73938834,86873300,12934466,TN
chr05,Bn20249,34946216,51951322,17005106,RLK
chr05,Bn20250,62959930,66509149,3549219,RLP
chr05,Bn20251,10151225,12970009,2818784,NBS
chr05,Bn20252,75321915,87017436,11695521,TNL
chr05,Bn20253,88841362,96910305,8068943,CNL
chr05,Bn20254,71142298,74439504,3297206,NBS
chr05,Bn20255,16583969,35777563,19193594,TNL
chr05,Bn20256,20882698,83181709,62299011,RLK
chr05,Bn20257,62446734,82096873,19650139,CN
chr05,Bn20258,36840229,57114216,20273987,TNL
chr05,Bn20259,92858794,94655058,1796264,TNL
chr05,Bn20260,18931259,36002364,17071105,TNL
chr05,Bn20261,19535639,74305061,54769422,CN
chr05,Bn20262,21599273,61177176,39577903,TN
chr05,Bn20263,8517325,56863609,48346284,TNL
chr05,Bn20264,84039705,87423484,3383779,RLK
chr05,Bn20265,31143500,71382389,40238889,CN
chr05,Bn20266,27947138,70010053,42062915,CNL
chr05,Bn20267,18535315,36745720,18210405,RLK
chr05,Bn20268,70567031,82751576,12184545,RLP
chr05,Bn20269,41729186,93321624,51592438,RLP
chr05,Bn20270,5130067,95319384,90189317,TNL
chr05,Bn20271,71034851,97957621,26922770,RLK
chr05,Bn20272,66018604,72182247,6163643,CNL
chr05,Bn20273,42409188,68204252,25795064,CNL
chr05,Bn20274,82520099,88991483,6471384,RLP
chr05,Bn20275,2399219,20427426,18028207,TN
chr05,Bn20276,35118197,76446580,41328383,NBS
chr05,Bn20277,6189021,13406946,7217925,NBS
chr05,Bn20278,47708876,56497220,8788344,RLP
chr05,Bn20279,4201289,27822652,23621363,CNL
chr05,Bn20280,56512118,59980536,3468418,RLP
chr05,Bn20281,84035309,84948180,912871,RLP
chr05,Bn20282,98284564,98720176,435612,NBS
chr05,Bn20283,57221332,58161097,939765,CNL
chr05,Bn20284,7766100,60467942,52701842,NBS
chr05,Bn20285,34435536,74765787,40330251,CN
chr05,Bn20286,50119929,58994587,8874658,RLK
chr05,Bn20287,95184682,95321110,136428,TN
chr05,Bn20288,56086338,72621710,16535372,RLK
chr05,Bn20289,5536549,23801131,18264582,TNL
chr05,Bn20290,92233267,92619195,385928,TNL
chr05,Bn20291,23427583,59700168,36272585,RLK
chr05,Bn20292,18005199,57122577,39117378,TNL
chr05,Bn20293,92782803,96525966,3743163,RLP
chr05,Bn20294,88057720,94510340,6452620,RLP
chr05,Bn20295,76858956,92815267,15956311,NBS
chr05,Bn20296,31274663,77849792,46575129,TN
chr05,Bn20297,90922096,98450335,7528239,TN
chr05,Bn20298,64969653,78259884,13290231,CNL
chr05,Bn20299,55218187,76145811,20927624,RLK
chr05,Bn20300,64234535,70210503,5975968,RLP
chr05,Bn20301,30752907,92442527,61689620,CN
chr05,Bn20302,76182235,94671947,18489712,RLP
chr05,Bn20303,52836765,79729591,26892826,CN
chr05,Bn20304,96774345,97721580,947235,NBS
chr05,Bn20305,13602682,46397846,32795164,RLP
chr05,Bn20306,76512756,90570605,14057849,RLP
chr05,Bn20307,52538894,73885825,21346931,CNL
chr05,Bn20308,2100262,81822554,79722292,RLK
chr05,Bn20309,46652489,88755671,42103182,CNL
chr05,Bn20310,50233091,55064712,4831621,CN
chr05,Bn20311,72797523,87351626,14554103,NBS
chr05,Bn20312,12277346,78520761,66243415,NBS
chr05,Bn20313,94475811,98246289,3770478,CNL
chr05,Bn20314,97526363,97549828,23465,TN
chr05,Bn20315,72447241,72636557,189316,CN
chr05,Bn20316,28195294,46677946,18482652,RLP
chr05,Bn20317,82393945,89242278,6848333,CNL
chr05,Bn20318,95055363,95974389,919026,CNL
chr05,Bn20319,54022223,73945078,19922855,RLP
chr05,Bn20320,42465359,65019395,22554036,RLP
chr05,Bn20321,61111246,99559933,38448687,TNL
chr05,Bn20322,36498522,85223530,48725008,CN
chr05,Bn20323,86636443,91209273,4572830,TN
chr05,Bn20324,44704836,74496623,29791787,TN
chr05,Bn20325,96030668,97008706,978038,CN
chr05,Bn20326,72405838,97715463,25309625,NBS
chr05,Bn20327,18431263,86404996,67973733,CNL
chr05,Bn20328,49056899,77231340,28174441,TNL
chr05,Bn20329,71022987,83382721,12359734,RLK
chr05,Bn20330,3885668,56908094,53022426,TN
chr05,Bn20331,56980767,70450360,13469593,CN
chr05,Bn20332,13765494,95473209,81707715,CNL
chr05,Bn20333,89250391,97710159,8459768,TN
chr05,Bn20334,7895357,62523580,54628223,NBS
chr05,Bn20335,99978079,99999878,21799,RLK
chr05,Bn20336,25029358,87232136,62202778,TNL
chr05,Bn20337,99874733,99954020,79287,RLK
chr05,Bn20338,27371940,86010684,58638744,CNL
chr05,Bn20339,99657349,99833193,175844,NBS
chr05,Bn20340,3518140,93650727,90132587,TN
chr05,Bn20341,50021880,93791980,43770100,CNL
chr05,Bn20342,27240630,47803891,20563261,CNL
chr05,Bn20343,3417810,78928347,75510537,RLK
chr05,Bn20344,83057257,98725373,15668116,NBS
chr05,Bn20345,68215952,78737348,10521396,RLP
chr05,Bn20346,47484308,66317570,18833262,CNL
chr05,Bn20347,31507402,56226581,24719179,TNL
chr05,Bn20348,85199217,87715848,2516631,RLP
chr05,Bn20349,5766729,26342349,20575620,CNL
chr05,Bn20350,83177509,95075581,11898072,TNL
chr05,Bn20351,19235817,64782561,45546744,TNL
chr05,Bn20352,5596209,25155505,19559296,RLK
chr05,Bn20353,95616960,97150348,1533388,NBS
chr05,Bn20354,62982105,93385406,30403301,RLP
chr05,Bn20355,55963840,70394119,14430279,NBS
chr05,Bn20356,8704962,30929981,22225019,CN
chr05,Bn20357,77627303,86855700,9228397,NBS
chr05,Bn20358,16604254,92211708,75607454,TNL
chr05,Bn20359,45654287,56175798,10521511,NBS
chr05,Bn20360,92033419,95190346,3156927,CN
chr05,Bn20361,55903754,81486046,25582292,RLK
chr05,Bn20362,56603840,77813614,21209774,RLP
chr05,Bn20363,50841362,65933185,15091823,CNL
chr05,Bn20364,27570778,33945116,6374338,RLP
chr05,Bn20365,58520325,92240823,33720498,RLP
chr05,Bn20366,92213517,93135364,921847,CNL
chr05,Bn20367,64943538,70985917,6042379,TNL
chr05,Bn20368,33706644,38193194,4486550,RLP
chr05,Bn20369,61156391,73487201,12330810,CN
chr05,Bn20370,72958307,89448446,16490139,NBS
chr05,Bn20371,51183260,91032684,39849424,CNL
chr05,Bn20372,63778540,70770035,6991495,NBS
chr05,Bn20373,47086740,75857098,28770358,RLK
chr05,Bn20374,23190423,86135514,62945091,RLK
chr05,Bn20375,21068375,51854727,30786352,TN
chr05,Bn20376,58424842,89339453,30914611,RLP
chr05,Bn20377,95921702,97601450,1679748,NBS
chr05,Bn20378,40914725,65542774,24628049,TNL
chr05,Bn20379,71506037,96203887,24697850,CN
chr05,Bn20380,88750337,98845560,10095223,RLP
chr05,Bn20381,55875744,70771779,14896035,TN
chr05,Bn20382,67792332,77050399,9258067,CN
chr05,Bn20383,48559491,99354484,50794993,TNL
chr05,Bn20384,67701847,80733494,13031647,RLP
chr05,Bn20385,66842613,82916300,16073687,CNL
chr05,Bn20386,22167465,43539681,21372216,RLK
chr05,Bn20387,19881588,47809416,27927828,TN
chr05,Bn20388,47742554,93026409,45283855,TNL
chr05,Bn20389,69329732,91777767,22448035,NBS
chr05,Bn20390,5435168,56704897,51269729,RLK
chr05,Bn20391,94081432,96886878,2805446,TNL
chr05,Bn20392,78839175,87571956,8732781,NBS
chr05,Bn20393,64196435,78931670,14735235,RLK
chr05,Bn20394,52508990,95866731,43357741,CN
chr05,Bn20395,55597714,59429272,3831558,RLP
chr05,Bn20396,9906600,58146944,48240344,TN
chr05,Bn20397,38399953,46805109,8405156,RLK
chr05,Bn20398,72675126,96641342,23966216,TN
chr05,Bn20399,71496456,84564618,13068162,TN
chr05,Bn20400,40173206,49822625,9649419,CN
chr05,Bn20401,43925993,60695221,16769228,CNL
chr05,Bn20402,20782631,91520873,70738242,NBS
chr05,Bn20403,34508744,89695316,55186572,TN
chr05,Bn20404,92165477,92960547,795070,CN
chr05,Bn20405,49629305,78871687,29242382,TN
chr05,Bn20406,74739618,90982274,16242656,RLP
chr05,Bn20407,28715445,86956507,58241062,RLK
chr05,Bn20408,93064244,97656141,4591897,NBS
chr05,Bn20409,39794472,43768215,3973743,TN
chr05,Bn20410,83814023,91300080,7486057,CNL
chr05,Bn20411,95197248,99009601,3812353,RLP
chr05,Bn20412,95609388,96426821,817433,NBS
chr05,Bn20413,36172905,50467004,14294099,NBS
chr05,Bn20414,36297075,39504426,3207351,CNL
chr05,Bn20415,55481652,82666372,27184720,CNL
chr05,Bn20416,18336009,80046292,61710283,RLK
chr05,Bn20417,22742146,82020492,59278346,CN
chr05,Bn20418,87784203,89231543,1447340,RLK
chr05,Bn20419,86575025,89944294,3369269,NBS
chr05,Bn20420,43616982,89223667,45606685,RLK
chr05,Bn20421,25707876,55733924,30026048,RLP
chr05,Bn20422,91752600,98794950,7042350,TN
chr05,Bn20423,71625243,78905375,7280132,CNL
chr05,Bn20424,75094954,93193311,18098357,RLK
chr05,Bn20425,60652013,88001015,27349002,RLK
chr05,Bn20426,11173151,13002322,1829171,NBS
chr05,Bn20427,71549577,89905409,18355832,TNL
chr05,Bn20428,45821074,77721846,31900772,RLK
chr05,Bn20429,74684096,88760736,14076640,RLK
chr05,Bn20430,52164530,70361514,18196984,TN
chr05,Bn20431,99311650,99928550,616900,RLK
chr05,Bn20432,52023434,88906282,36882848,CNL
chr05,Bn20433,1846300,89201883,87355583,TN
chr05,Bn20434,35995814,45941715,9945901,RLP
chr05,Bn20435,16074179,81426806,65352627,TNL
chr05,Bn20436,56829512,84939044,28109532,TN
chr05,Bn20437,35318976,42270700,6951724,TNL
chr05,Bn20438,67480179,70183186,2703007,RLP
chr05,Bn20439,74659585,91397565,16737980,TN
chr05,Bn20440,5709382,37437737,31728355,CN
chr05,Bn20441,2214523,91889207,89674684,RLK
chr05,Bn20442,25668130,70337687,44669557,CN
chr05,Bn20443,64955722,81100370,16144648,TNL
chr05,Bn20444,14158155,41826265,27668110,RLK
chr05,Bn20445,51130309,98093608,46963299,RLP
chr05,Bn20446,12104313,59082730,46978417,RLP
chr05,Bn20447,44025583,57787776,13762193,TN
chr05,Bn20448,45470143,49554421,4084278,NBS
chr05,Bn20449,16706520,24578724,7872204,RLP
chr05,Bn20450,35635772,86665971,51030199,CN
chr05,Bn20451,87387761,90375657,2987896,CN
chr05,Bn20452,27141168,65022882,37881714,TN
chr05,Bn20453,72519889,93410577,20890688,CNL
chr05,Bn20454,12004467,23363593,11359126,TN
chr05,Bn20455,14132174,55154155,41021981,CNL
chr05,Bn20456,15961101,94081115,78120014,CN
chr05,Bn20457,5643293,29292208,23648915,TNL
chr05,Bn20458,51172397,99217032,48044635,RLP
chr05,Bn20459,81474661,85943564,4468903,RLK
chr05,Bn20460,19288256,53653530,34365274,TNL
chr05,Bn20461,2959634,21647317,18687683,RLK
chr05,Bn20462,86484119,88918025,2433906,TN
chr05,Bn20463,21679067,58456073,36777006,CNL
chr05,Bn20464,33958154,67206802,33248648,TN
chr05,Bn20465,93368014,99444551,6076537,RLK
chr05,Bn20466,72512805,92163352,19650547,CN
chr05,Bn20467,42210500,86829161,44618661,RLK
chr05,Bn20468,6593075,80636733,74043658,NBS
chr05,Bn20469,88001077,89738447,1737370,TNL
chr05,Bn20470,89960474,91032539,1072065,CN
chr05,Bn20471,5476844,94089484,88612640,TNL
chr05,Bn20472,6498656,29830786,23332130,RLK
chr05,Bn20473,94153375,99180071,5026696,RLK
chr05,Bn20474,7769395,14110718,6341323,CN
chr05,Bn20475,57245472,69158128,11912656,TN
chr05,Bn20476,11096629,54314724,43218095,CN
chr05,Bn20477,2085849,58498115,56412266,TNL
chr05,Bn20478,43453900,76583839,33129939,CN
chr05,Bn20479,32073911,59934167,27860256,CNL
chr05,Bn20480,42395536,48702956,6307420,RLP
chr05,Bn20481,73915740,97044423,23128683,TNL
chr05,Bn20482,54713409,80772289,26058880,TNL
chr05,Bn20483,46754097,51318033,4563936,CNL
chr05,Bn20484,98098951,98194488,95537,CNL
chr05,Bn20485,56753755,68025249,11271494,TN
chr05,Bn20486,13302232,82842434,69540202,TN
chr05,Bn20487,87502262,93027526,5525264,TN
chr05,Bn20488,32606942,36622940,4015998,CN
chr05,Bn20489,74095720,89686029,15590309,TNL
chr05,Bn20490,63921524,84789300,20867776,TN
chr05,Bn20491,45417271,99252988,53835717,NBS
chr05,Bn20492,72238292,97862809,25624517,RLP
chr05,Bn20493,46408330,96112511,49704181,RLP
chr05,Bn20494,2139404,32329542,30190138,TNL
chr05,Bn20495,18948735,56516381,37567646,CNL
chr05,Bn20496,99794643,99934250,139607,NBS
chr05,Bn20497,60895654,66442954,5547300,CN
chr05,Bn20498,31502093,84138565,52636472,TNL
chr05,Bn20499,59753144,74064955,14311811,CN
chr05,Bn20500,47784419,51216792,3432373,TNL
chr05,Bn20501,9428890,40233980,30805090,TN
chr05,Bn20502,91813493,94324886,2511393,NBS
chr05,Bn20503,3625806,62381924,58756118,RLK
chr05,Bn20504,20645276,43722275,23076999,RLK
chr05,Bn20505,50609315,63703006,13093691,CNL
chr05,Bn20506,6965913,24231223,17265310,CNL
chr05,Bn20507,87573669,98705911,11132242,RLP
chr05,Bn20508,88289504,90723892,2434388,CN
chr05,Bn20509,37469794,64542397,27072603,RLP
chr05,Bn20510,86247478,89589132,3341654,NBS
chr05,Bn20511,91258596,97568509,6309913,NBS
chr05,Bn20512,70789520,91175461,20385941,TNL
chr05,Bn20513,2732883,67627256,64894373,CNL
chr05,Bn20514,80021801,84961974,4940173,NBS
chr05,Bn20515,37716254,93114132,55397878,CNL
chr05,Bn20516,20673008,35840717,15167709,CN
chr05,Bn20517,58681061,93246317,34565256,NBS
chr05,Bn20518,76822149,87719066,10896917,RLK
chr05,Bn20519,69876134,99787988,29911854,CN
chr05,Bn20520,44054732,66802172,22747440,RLP
chr05,Bn20521,53064301,61073800,8009499,NBS
chr05,Bn20522,91044565,93897053,2852488,CNL
chr05,Bn20523,89383645,96129860,6746215,RLK
chr05,Bn20524,91158287,92223747,1065460,TNL
chr05,Bn20525,21128128,71861376,50733248,TN
chr05,Bn20526,82496441,97289581,14793140,RLP
chr05,Bn20527,91610954,98672726,7061772,TNL
chr05,Bn20528,74368367,85764985,11396618,CNL
chr05,Bn20529,14527419,83928963,69401544,RLK
chr05,Bn20530,52885327,82555410,29670083,TN
chr05,Bn20531,95885826,99728062,3842236,CNL
chr05,Bn20532,94378389,99485449,5107060,TN
chr05,Bn20533,41800460,96317832,54517372,TNL
chr05,Bn20534,97482285,99943809,2461524,TN
chr05,Bn20535,51955091,76572786,24617695,RLK
chr05,Bn20536,48013549,56065554,8052005,CN
chr05,Bn20537,40925342,59099943,18174601,RLP
chr05,Bn20538,23682711,87199534,63516823,NBS
chr05,Bn20539,75443260,96665850,21222590,CN
chr05,Bn20540,3415627,24937923,21522296,CNL
chr05,Bn20541,38001005,44219437,6218432,TNL
chr05,Bn20542,18565047,61095674,42530627,CNL
chr05,Bn20543,65364190,87023410,21659220,CNL
chr05,Bn20544,64857560,75475409,10617849,RLP
chr05,Bn20545,51017912,77770034,26752122,TN
chr05,Bn20546,46100044,82379011,36278967,NBS
chr05,Bn20547,76568910,96651700,20082790,TN
chr05,Bn20548,69967537,73993882,4026345,TN
chr05,Bn20549,29882247,74768279,44886032,CNL
chr05,Bn20550,95639885,96904810,1264925,CN
chr05,Bn20551,15465607,83263763,67798156,RLP
chr05,Bn20552,37728595,79066451,41337856,TNL
chr05,Bn20553,88679107,92053361,3374254,CN
chr05,Bn20554,41449785,45509125,4059340,TN
chr05,Bn20555,78813368,82666442,3853074,CNL
chr05,Bn20556,75165831,78945974,3780143,RLP
chr05,Bn20557,64674842,91115587,26440745,RLK
chr05,Bn20558,10303012,33067443,22764431,TNL
chr05,Bn20559,36137657,67643070,31505413,RLK
chr05,Bn20560,38467410,87006019,48538609,RLK
chr05,Bn20561,23562683,87103806,63541123,TN
chr05,Bn20562,36310136,65698958,29388822,CNL
chr05,Bn20563,90416325,99410798,8994473,RLP
chr05,Bn20564,74461607,87336424,12874817,TN
chr05,Bn20565,27500104,54001253,26501149,NBS
chr05,Bn20566,53788689,72509159,18720470,TNL
chr05,Bn20567,87128721,89389355,2260634,RLP
chr05,Bn20568,95357361,98558131,3200770,TN
chr05,Bn20569,71177970,84860305,13682335,NBS
chr05,Bn20570,79911548,85521259,5609711,RLP
chr05,Bn20571,37285261,57936248,20650987,CNL
chr05,Bn20572,90382582,97436813,7054231,TNL
chr05,Bn20573,81505472,95200545,13695073,NBS
chr05,Bn20574,5103566,46072234,40968668,TNL
chr05,Bn20575,37220505,95563405,58342900,RLK
chr05,Bn20576,62226023,99165497,36939474,RLK
chr05,Bn20577,41257158,56475500,15218342,TNL
chr05,Bn20578,77391810,99810051,22418241,RLP
chr05,Bn20579,20604632,76543910,55939278,CN
chr05,Bn20580,87152113,94890110,7737997,RLK
chr05,Bn20581,74955202,95177782,20222580,TN
chr05,Bn20582,27234652,52735328,25500676,RLP
chr05,Bn20583,45528537,75503426,29974889,CNL
chr05,Bn20584,84341305,84403798,62493,RLK
chr05,Bn20585,13548306,82469984,68921678,CN
chr05,Bn20586,71029014,77347764,6318750,NBS
chr05,Bn20587,16163231,54053386,37890155,RLP
chr05,Bn20588,82453217,96855614,14402397,CN
chr05,Bn20589,57977494,86679843,28702349,RLP
chr05,Bn20590,7995581,46627284,38631703,RLK
chr05,Bn20591,35382929,54328999,18946070,RLK
chr05,Bn20592,8458891,90886011,82427120,TN
chr05,Bn20593,74065107,77421023,3355916,CNL
chr05,Bn20594,47003576,61580792,14577216,CNL
chr05,Bn20595,97723091,98660951,937860,NBS
chr05,Bn20596,22977096,48721304,25744208,TNL
chr05,Bn20597,99240985,99268910,27925,TN
chr05,Bn20598,60867066,97268640,36401574,NBS
chr05,Bn20599,3695741,36627022,32931281,TN
chr05,Bn20600,26630396,51657803,25027407,NBS
chr05,Bn20601,47594496,91449336,43854840,TN
chr05,Bn20602,13747991,35983271,22235280,TN
chr05,Bn20603,15738296,31069191,15330895,RLP
chr05,Bn20604,58529982,85533779,27003797,RLK
chr05,Bn20605,25265371,55802391,30537020,CNL
chr05,Bn20606,65547746,91463152,25915406,RLP
chr05,Bn20607,87375653,91493431,4117778,NBS
chr05,Bn20608,81648128,83492142,1844014,CNL
chr05,Bn20609,96146613,96455485,308872,RLK
chr05,Bn20610,74167817,78591521,4423704,TN
chr05,Bn20611,75115158,89735938,14620780,TN
chr05,Bn20612,32085426,50288086,18202660,CNL
chr05,Bn20613,75576889,78300707,2723818,CNL
chr05,Bn20614,58847084,59163306,316222,RLK
chr05,Bn20615,55486743,62468660,6981917,TN
chr05,Bn20616,3414107,27098420,23684313,TN
chr05,Bn20617,84835933,98923710,14087777,NBS
chr05,Bn20618,37865798,75179566,37313768,CNL
chr05,Bn20619,4170866,44940693,40769827,RLK
chr05,Bn20620,90265024,99905411,9640387,TN
chr05,Bn20621,26760617,40459942,13699325,CNL
chr05,Bn20622,66083484,80451118,14367634,CNL
chr05,Bn20623,91786582,92909551,1122969,CNL
chr05,Bn20624,5179740,21276363,16096623,RLP
chr05,Bn20625,75662844,98737154,23074310,TNL
chr05,Bn20626,49217456,90037709,40820253,RLP
chr05,Bn20627,26712309,76674569,49962260,TNL
chr05,Bn20628,49469845,85105419,35635574,RLP
chr05,Bn20629,4691661,28407268,23715607,RLP
chr05,Bn20630,93727189,93943804,216615,CNL
chr05,Bn20631,88420746,99381391,10960645,TN
chr05,Bn20632,36327146,52072925,15745779,TN
chr05,Bn20633,12896455,16329565,3433110,CNL
chr05,Bn20634,66694164,93255814,26561650,RLP
chr05,Bn20635,15704516,93223787,77519271,CN
chr05,Bn20636,82838912,89136868,6297956,CN
chr05,Bn20637,31104461,53337377,22232916,TNL
chr05,Bn20638,37843316,82452213,44608897,NBS
chr05,Bn20639,75509352,92186652,16677300,NBS
chr05,Bn20640,58236241,64528080,6291839,TNL
chr05,Bn20641,93471456,93492680,21224,RLP
chr05,Bn20642,53064207,72195733,19131526,RLK
chr05,Bn20643,9140082,37305770,28165688,NBS
chr05,Bn20644,13661972,66298826,52636854,NBS
chr05,Bn20645,55776190,91205853,35429663,CN
chr05,Bn20646,34311174,56857296,22546122,NBS
chr05,Bn20647,83199323,93194302,9994979,CN
chr05,Bn20648,9132963,20095464,10962501,CN
chr05,Bn20649,6403800,57936760,51532960,RLK
chr05,Bn20650,75299437,77566023,2266586,RLP
chr05,Bn20651,9854555,64361864,54507309,RLK
chr05,Bn20652,89252417,89679902,427485,RLP
chr05,Bn20653,84374047,86300371,1926324,RLP
chr05,Bn20654,55271754,84962322,29690568,TNL
chr05,Bn20655,12288101,65287201,52999100,CNL
chr05,Bn20656,51852792,81277026,29424234,CNL
chr05,Bn20657,29449761,77178327,47728566,RLP
chr05,Bn20658,34623217,53100178,18476961,CN
chr05,Bn20659,74224185,90363927,16139742,RLK
chr05,Bn20660,2338715,87105506,84766791,CN
chr05,Bn20661,93112471,95269479,2157008,TN
chr05,Bn20662,63873670,76316349,12442679,TN
chr05,Bn20663,60166529,76082412,15915883,RLP
chr05,Bn20664,9888669,81233282,71344613,TN
chr05,Bn20665,8198860,93582687,85383827,CN
chr05,Bn20666,58368764,99016123,40647359,TNL
chr05,Bn20667,32667765,68266914,35599149,TN
chr05,Bn20668,91110121,99583059,8472938,NBS
chr05,Bn20669,71997397,89740721,17743324,NBS
chr05,Bn20670,97890651,99309860,1419209,RLP
chr05,Bn20671,12291529,61722786,49431257,TNL
chr05,Bn20672,78997341,89062726,10065385,TN
chr05,Bn20673,72073132,97778190,25705058,RLK
chr05,Bn20674,92164891,95634213,3469322,TN
chr05,Bn20675,44284646,58763079,14478433,CNL
chr05,Bn20676,62782714,74204661,11421947,CNL
chr05,Bn20677,89113401,92303217,3189816,NBS
chr05,Bn20678,21266013,98149391,76883378,TNL
chr05,Bn20679,44408696,90220565,45811869,RLP
chr05,Bn20680,98829288,98951076,121788,RLK
chr05,Bn20681,56745205,85015350,28270145,CN
chr05,Bn20682,22703962,67632359,44928397,RLK
chr05,Bn20683,34284302,40492604,6208302,RLK
chr05,Bn20684,92367468,96276393,3908925,NBS
chr05,Bn20685,15858408,61779666,45921258,TN
chr05,Bn20686,13028964,35126060,22097096,RLP
chr05,Bn20687,56775941,81035342,24259401,RLP
chr05,Bn20688,16239027,83008435,66769408,TN
chr05,Bn20689,40240081,77843786,37603705,CN
chr05,Bn20690,19111729,95708293,76596564,TNL
chr05,Bn20691,21370832,61195050,39824218,RLP
chr05,Bn20692,53316556,56471622,3155066,CN
chr05,Bn20693,46500433,67401344,20900911,RLK
chr05,Bn20694,20836592,43873322,23036730,RLK
chr05,Bn20695,42035848,42317885,282037,CNL
chr05,Bn20696,89518401,96158497,6640096,CNL
chr05,Bn20697,86817057,98708623,11891566,NBS
chr05,Bn20698,62772047,96664999,33892952,CNL
chr05,Bn20699,49160457,82902475,33742018,RLK
chr05,Bn20700,48599287,76538175,27938888,RLK
chr05,Bn20701,53619233,56931626,3312393,RLP
chr05,Bn20702,63241949,68608492,5366543,RLP
chr05,Bn20703,42049679,45796485,3746806,CN
chr05,Bn20704,78621630,84383100,5761470,TN
chr05,Bn20705,90876125,99209309,8333184,TN
chr05,Bn20706,78571776,80528826,1957050,CN
chr05,Bn20707,68970368,90762111,21791743,TN
chr05,Bn20708,80405610,88241411,7835801,CN
chr05,Bn20709,11436477,96618491,85182014,TN
chr05,Bn20710,47689289,55246543,7557254,CNL
chr05,Bn20711,66150681,96460020,30309339,NBS
chr05,Bn20712,36840322,44829921,7989599,NBS
chr05,Bn20713,3568777,94013449,90444672,TNL
chr05,Bn20714,88579685,98939478,10359793,TNL
chr05,Bn20715,88103545,95132529,7028984,CNL
chr05,Bn20716,52911205,89946078,37034873,RLK
chr05,Bn20717,82571821,94904209,12332388,NBS
chr05,Bn20718,93337919,98919839,5581920,RLP
chr05,Bn20719,92078863,92756527,677664,NBS
chr05,Bn20720,40816268,65454708,24638440,TN
chr05,Bn20721,12636795,91145684,78508889,CNL
chr05,Bn20722,8345990,78029838,69683848,NBS
chr05,Bn20723,54327643,92732178,38404535,NBS
chr05,Bn20724,18687957,48564727,29876770,RLP
chr05,Bn20725,28133414,37617064,9483650,TN
chr05,Bn20726,34114309,39797609,5683300,NBS
chr05,Bn20727,53018102,67348383,14330281,TNL
chr05,Bn20728,34154424,87055748,52901324,TNL
chr05,Bn20729,63443336,72645126,9201790,TN
chr05,Bn20730,54190393,66986483,12796090,TN
chr05,Bn20731,30600872,48875922,18275050,TNL
chr05,Bn20732,3917293,18751416,14834123,TN
chr05,Bn20733,51594908,76090530,24495622,NBS
chr05,Bn20734,98194831,99274423,1079592,CN
chr05,Bn20735,40247341,42289081,2041740,TN
chr05,Bn20736,98137396,99571285,1433889,CNL
chr05,Bn20737,64104968,92506631,28401663,TN
chr05,Bn20738,21742646,22361251,618605,CN
chr05,Bn20739,20749740,89089856,68340116,NBS
chr05,Bn20740,27915509,87419501,59503992,TN
chr05,Bn20741,54208869,74564646,20355777,TN
chr05,Bn20742,97037575,97714046,676471,TNL
chr05,Bn20743,70084195,72501271,2417076,RLK
chr05,Bn20744,88521850,98213591,9691741,NBS
chr05,Bn20745,32230582,43004132,10773550,NBS
chr05,Bn20746,53914367,60383040,6468673,NBS
chr05,Bn20747,42785568,75770196,32984628,RLP
chr05,Bn20748,25357799,96553093,71195294,CN
chr05,Bn20749,61497416,85551485,24054069,NBS
chr05,Bn20750,29423697,42499608,13075911,RLK
chr05,Bn20751,84623390,88322720,3699330,RLP
chr05,Bn20752,77896516,78749648,853132,NBS
chr05,Bn20753,73067252,80948395,7881143,CN
chr05,Bn20754,39052940,76800416,37747476,RLP
chr05,Bn20755,72210962,82750659,10539697,CNL
chr05,Bn20756,22601160,28046648,5445488,TNL
chr05,Bn20757,22425926,40291793,17865867,TNL
chr05,Bn20758,62186094,83515296,21329202,TN
chr05,Bn20759,12622680,46359119,33736439,RLP
chr05,Bn20760,7552569,60563094,53010525,CNL
chr05,Bn20761,80670995,92830979,12159984,NBS
chr05,Bn20762,91874436,94643221,2768785,TN
chr05,Bn20763,13553031,89320217,75767186,CNL
chr05,Bn20764,86694251,91217915,4523664,RLK
chr05,Bn20765,83455855,94851668,11395813,TNL
chr05,Bn20766,40807197,44968855,4161658,TNL
chr05,Bn20767,90918503,93908108,2989605,TN
chr05,Bn20768,98455820,99077639,621819,RLK
chr05,Bn20769,40150786,87256791,47106005,NBS
chr05,Bn20770,6341720,14935819,8594099,RLP
chr05,Bn20771,88069657,90371287,2301630,RLK
chr05,Bn20772,92557634,98550918,5993284,RLK
chr05,Bn20773,72313787,97923281,25609494,CNL
chr05,Bn20774,92057616,97690650,5633034,NBS
chr05,Bn20775,34266987,99100643,64833656,TNL
chr05,Bn20776,86248399,93269322,7020923,CNL
chr05,Bn20777,3518441,40431454,36913013,RLK
chr05,Bn20778,48181988,67456723,19274735,NBS
chr05,Bn20779,97348575,99823597,2475022,TNL
chr05,Bn20780,8590511,98986875,90396364,TNL
chr05,Bn20781,92353301,96300903,3947602,RLK
chr05,Bn20782,3831386,91667744,87836358,RLK
chr05,Bn20783,75470539,81267072,5796533,TN
chr05,Bn20784,77374398,89469015,12094617,CN
chr05,Bn20785,42499317,78998526,36499209,TN
chr05,Bn20786,89310368,93812144,4501776,RLK
chr05,Bn20787,41080747,80557493,39476746,RLP
chr05,Bn20788,50904109,81434774,30530665,TN
chr05,Bn20789,13894374,53897449,40003075,CNL
chr05,Bn20790,46761480,85724849,38963369,TN
chr05,Bn20791,5820855,72727441,66906586,NBS
chr05,Bn20792,40034886,55511631,15476745,TNL
chr05,Bn20793,33611205,72971392,39360187,CNL
chr05,Bn20794,31835184,82470538,50635354,CN
chr05,Bn20795,51027094,83684826,32657732,NBS
chr05,Bn20796,59842107,92077110,32235003,TNL
chr05,Bn20797,53828021,97867477,44039456,CNL
chr05,Bn20798,22383556,92691661,70308105,CN
chr05,Bn20799,80595849,85022705,4426856,TNL
chr05,Bn20800,39216326,91934195,52717869,TN
chr05,Bn20801,74159028,77996125,3837097,NBS
chr05,Bn20802,61357934,86467345,25109411,CNL
chr05,Bn20803,98088110,98672971,584861,NBS
chr05,Bn20804,73772292,90449216,16676924,RLK
chr05,Bn20805,62026176,71231622,9205446,CNL
chr05,Bn20806,80665687,98335371,17669684,RLK
chr05,Bn20807,97412046,97995354,583308,CN
chr05,Bn20808,78068001,99914035,21846034,TN
chr05,Bn20809,21736298,30788800,9052502,CN
chr05,Bn20810,83723590,99250612,15527022,CN
chr05,Bn20811,19866922,53582846,33715924,CNL
chr05,Bn20812,34296385,96508606,62212221,CNL
chr05,Bn20813,79829467,87403761,7574294,RLK
chr05,Bn20814,94109716,99436282,5326566,RLK
chr05,Bn20815,81682406,97337457,15655051,CNL
chr05,Bn20816,73909313,81667969,7758656,TNL
chr05,Bn20817,56329037,66807826,10478789,RLP
chr05,Bn20818,46277389,71550415,25273026,NBS
chr05,Bn20819,30490652,83018106,52527454,CN
chr05,Bn20820,45719765,75049863,29330098,TN
chr05,Bn20821,14009855,90702222,76692367,TN
chr05,Bn20822,74928366,92820872,17892506,NBS
chr05,Bn20823,29991967,57096566,27104599,TN
chr05,Bn20824,87323743,98950495,11626752,RLP
chr05,Bn20825,56130115,92161554,36031439,TNL
chr05,Bn20826,16223735,66968306,50744571,RLP
chr05,Bn20827,70602222,97046578,26444356,TN
chr05,Bn20828,44674491,79925825,35251334,CN
chr05,Bn20829,37682920,69540562,31857642,RLP
chr05,Bn20830,21053426,42197217,21143791,RLP
chr05,Bn20831,89404123,90692790,1288667,RLK
chr05,Bn20832,45046462,60930609,15884147,TN
chr05,Bn20833,67991231,73505255,5514024,CN
chr05,Bn20834,47530515,61017320,13486805,TN
chr05,Bn20835,55878050,67027287,11149237,CN
chr05,Bn20836,66192414,91735206,25542792,RLK
chr05,Bn20837,30966655,86913295,55946640,CNL
chr05,Bn20838,8106632,63227407,55120775,CNL
chr05,Bn20839,52502466,63473216,10970750,TNL
chr05,Bn20840,48094174,78768443,30674269,TNL
chr05,Bn20841,68425616,98160894,29735278,RLK
chr05,Bn20842,78851783,98586320,19734537,RLP
chr05,Bn20843,69892639,95631388,25738749,TNL
chr05,Bn20844,20411061,86606821,66195760,RLK
chr05,Bn20845,76295546,83760913,7465367,RLP
chr05,Bn20846,89563354,94162939,4599585,TNL
chr05,Bn20847,13549728,76099843,62550115,TN
chr05,Bn20848,90239902,92802747,2562845,RLP
chr05,Bn20849,7494411,90002308,82507897,TN
chr05,Bn20850,80298173,95963766,15665593,TNL
chr05,Bn20851,39992438,81448956,41456518,NBS
chr05,Bn20852,3141146,72001393,68860247,NBS
chr05,Bn20853,54475157,79979162,25504005,RLP
chr05,Bn20854,57110354,99603466,42493112,TNL
chr05,Bn20855,39651047,52705872,13054825,TNL
chr05,Bn20856,75235852,97106776,21870924,TNL
chr05,Bn20857,77081146,94679487,17598341,TNL
chr05,Bn20858,60916235,68143085,7226850,CN
chr05,Bn20859,6892332,21891243,14998911,RLP
chr05,Bn20860,58185211,81339959,23154748,CNL
chr05,Bn20861,74755081,79271154,4516073,RLP
chr05,Bn20862,63342496,98654206,35311710,CN
chr05,Bn20863,71023361,94671293,23647932,TN
chr05,Bn20864,52070291,57117111,5046820,NBS
chr05,Bn20865,34966399,35805368,838969,RLK
chr05,Bn20866,38279963,44827571,6547608,RLP
chr05,Bn20867,4524409,86996997,82472588,TN
chr05,Bn20868,89356902,94429931,5073029,TN
chr05,Bn20869,29285892,33130258,3844366,NBS
chr05,Bn20870,66846015,88452817,21606802,RLP
chr05,Bn20871,52831165,68751371,15920206,TN
chr05,Bn20872,88263152,98079176,9816024,TNL
chr05,Bn20873,82853778,93577620,10723842,RLP
chr05,Bn20874,39499883,57813088,18313205,CN
chr05,Bn20875,70016066,77800703,7784637,NBS
chr05,Bn20876,38095019,67230164,29135145,TNL
chr05,Bn20877,88375156,99680144,11304988,RLP
chr05,Bn20878,11255385,13017192,1761807,RLK
chr05,Bn20879,24549448,49764804,25215356,TN
chr05,Bn20880,81912326,87914909,6002583,RLP
chr05,Bn20881,2456427,96708080,94251653,TNL
chr05,Bn20882,53549134,53758830,209696,RLK
chr05,Bn20883,52501547,84161852,31660305,RLK
chr05,Bn20884,35167259,75176447,40009188,TN
chr05,Bn20885,5637261,32287559,26650298,TNL
chr05,Bn20886,53459836,85929094,32469258,CN
chr05,Bn20887,36431738,36810363,378625,RLK
chr05,Bn20888,61676968,74208221,12531253,RLP
chr05,Bn20889,74410903,91798882,17387979,RLK
chr05,Bn20890,23880780,43512359,19631579,TNL
chr05,Bn20891,91391007,98395309,7004302,TN
chr05,Bn20892,31045381,79425750,48380369,RLP
chr05,Bn20893,47460617,53199607,5738990,CN
chr05,Bn20894,44282390,69811577,25529187,CN
chr05,Bn20895,70661949,87568603,16906654,TN
chr05,Bn20896,72245236,84882061,12636825,RLK
chr05,Bn20897,43335374,90886045,47550671,CN
chr05,Bn20898,41245250,73466524,32221274,TNL
chr05,Bn20899,59265935,87144708,27878773,CN
chr05,Bn20900,15774925,35252935,19478010,NBS
chr05,Bn20901,63742949,95766704,32023755,CNL
chr05,Bn20902,98958570,99675579,717009,NBS
chr05,Bn20903,52287903,97682619,45394716,NBS
chr05,Bn20904,4521840,74461560,69939720,RLK
chr05,Bn20905,30900453,34954634,4054181,TN
chr05,Bn20906,75799104,86329213,10530109,CN
chr05,Bn20907,31383705,64419751,33036046,NBS
chr05,Bn20908,69697561,85532653,15835092,NBS
chr05,Bn20909,64163986,86772107,22608121,NBS
chr05,Bn20910,50681534,99733123,49051589,NBS
chr05,Bn20911,61285211,68313504,7028293,RLK
chr05,Bn20912,73172898,75236829,2063931,TN
chr05,Bn20913,77641140,84460286,6819146,RLP
chr05,Bn20914,76758992,83215516,6456524,CNL
chr05,Bn20915,2958045,79221904,76263859,TN
chr05,Bn20916,54550899,54774597,223698,NBS
chr05,Bn20917,32644192,67915330,35271138,RLP
chr05,Bn20918,80916060,84278526,3362466,RLK
chr05,Bn20919,79822458,82936072,3113614,RLP
chr05,Bn20920,21820188,41040683,19220495,RLK
chr05,Bn20921,81741822,88021803,6279981,CNL
chr05,Bn20922,89713532,92140408,2426876,RLP
chr05,Bn20923,60381663,90195352,29813689,CN
chr05,Bn20924,8391869,53564206,45172337,TNL
chr05,Bn20925,15918198,95898377,79980179,CNL
chr05,Bn20926,6131963,86887564,80755601,TN
chr05,Bn20927,50560489,86117948,35557459,CN
chr05,Bn20928,69281106,85860957,16579851,RLK
chr05,Bn20929,16084120,67915057,51830937,RLP
chr05,Bn20930,86207063,91872292,5665229,NBS
chr05,Bn20931,99127255,99929092,801837,TN
chr05,Bn20932,30975796,68378755,37402959,TNL
chr05,Bn20933,76096752,98454614,22357862,CN
chr05,Bn20934,25798714,83226933,57428219,NBS
chr05,Bn20935,12981075,26284651,13303576,NBS
chr05,Bn20936,43272979,99671387,56398408,RLK
chr05,Bn20937,37213301,88738173,51524872,CNL
chr05,Bn20938,82015047,98542292,16527245,RLP
chr05,Bn20939,35928181,70226139,34297958,NBS
chr05,Bn20940,17840635,30795925,12955290,RLP
chr05,Bn20941,85212418,85464261,251843,CN
chr05,Bn20942,4303117,90307315,86004198,TNL
chr05,Bn20943,74797394,93654101,18856707,CN
chr05,Bn20944,16188680,30839507,14650827,CNL
chr05,Bn20945,96316270,97224248,907978,CNL
chr05,Bn20946,23512901,54719016,31206115,RLK
chr05,Bn20947,70511524,81425243,10913719,CNL
chr05,Bn20948,4964523,52106308,47141785,TN
chr05,Bn20949,74283618,99217495,24933877,RLP
chr05,Bn20950,89374828,95880079,6505251,TNL
chr05,Bn20951,58518786,59463210,944424,CNL
chr05,Bn20952,66305079,86287935,19982856,CN
chr05,Bn20953,27414454,32081699,4667245,TN
chr05,Bn20954,32291682,80621842,48330160,TN
chr05,Bn20955,45225814,93093826,47868012,CNL
chr05,Bn20956,47609478,74542772,26933294,TNL
chr05,Bn20957,96404742,99803219,3398477,CNL
chr05,Bn20958,90502772,91759275,1256503,TNL
chr05,Bn20959,81516010,91620206,10104196,RLK
chr05,Bn20960,71871160,73799889,1928729,CNL
chr05,Bn20961,5770447,79803616,74033169,CN
chr05,Bn20962,65967869,82781200,16813331,TN
chr05,Bn20963,99352755,99482376,129621,RLP
chr05,Bn20964,92670536,99372862,6702326,CN
chr05,Bn20965,57951304,90798649,32847345,NBS
chr05,Bn20966,32513235,33479438,966203,RLP
chr05,Bn20967,87064223,98045367,10981144,NBS
chr05,Bn20968,17352887,70845125,53492238,RLK
chr05,Bn20969,52141811,67737817,15596006,TN
chr05,Bn20970,18872822,31541675,12668853,TN
chr05,Bn20971,95474319,95652908,178589,RLK
chr05,Bn20972,76447255,93553063,17105808,TN
chr05,Bn20973,36408066,71558735,35150669,CN
chr05,Bn20974,84764016,90614060,5850044,NBS
chr05,Bn20975,13723109,77542245,63819136,RLP
chr05,Bn20976,76646004,81094568,4448564,CN
chr05,Bn20977,60942216,62877321,1935105,TN
chr05,Bn20978,57184168,65014170,7830002,CN
chr05,Bn20979,49682628,90261094,40578466,RLP
chr05,Bn20980,11107788,27109003,16001215,NBS
chr05,Bn20981,12159058,16563024,4403966,RLK
chr05,Bn20982,73205306,87926736,14721430,NBS
chr05,Bn20983,4760346,32759160,27998814,CNL
chr05,Bn20984,33852224,66114331,32262107,CNL
chr05,Bn20985,58003778,67407765,9403987,RLP
chr05,Bn20986,15050233,23041042,7990809,CNL
chr05,Bn20987,1842557,88357426,86514869,RLK
chr05,Bn20988,85323133,97340552,12017419,CN
chr05,Bn20989,71503195,96813189,25309994,RLP
chr05,Bn20990,63288685,86930104,23641419,RLK
chr05,Bn20991,19032331,84759406,65727075,RLP
chr05,Bn20992,65330989,92608427,27277438,TNL
chr05,Bn20993,10935610,56964934,46029324,CN
chr05,Bn20994,2782266,32733389,29951123,TNL
chr05,Bn20995,4776600,56589756,51813156,RLP
chr05,Bn20996,20035275,26223508,6188233,CN
chr05,Bn20997,81116360,97767512,16651152,CNL
chr05,Bn20998,52733624,85778525,33044901,RLK
chr05,Bn20999,32104117,77768360,45664243,RLP
chr05,Bn21000,81854084,97133606,15279522,RLP
chr05,Bn21001,78294958,82854192,4559234,TNL
chr05,Bn21002,17783016,85522933,67739917,TNL
chr05,Bn21003,6365466,99348206,92982740,CN
chr05,Bn21004,29497188,66689019,37191831,TNL
chr05,Bn21005,71057429,82509370,11451941,TNL
chr05,Bn21006,12387470,55398681,43011211,CNL
chr05,Bn21007,1787162,37855887,36068725,RLK
chr05,Bn21008,18866818,70524895,51658077,TN
chr05,Bn21009,98873411,99102143,228732,RLP
chr05,Bn21010,21229409,58775370,37545961,TNL
chr05,Bn21011,46537729,78719314,32181585,CN
chr05,Bn21012,81925247,96838189,14912942,CNL
chr05,Bn21013,45243436,56964961,11721525,NBS
chr05,Bn21014,8529307,67453475,58924168,CN
chr05,Bn21015,16790362,63744215,46953853,TN
chr05,Bn21016,25550854,86600162,61049308,NBS
chr05,Bn21017,53289608,93173876,39884268,RLP
chr05,Bn21018,51581569,85161895,33580326,TN
chr05,Bn21019,66438244,68295686,1857442,CN
chr05,Bn21020,85814377,99472612,13658235,RLP
chr05,Bn21021,88374437,93166025,4791588,NBS
chr05,Bn21022,41353281,61112248,19758967,NBS
chr05,Bn21023,57289313,62872264,5582951,TNL
chr05,Bn21024,9662748,87517307,77854559,CNL
chr05,Bn21025,30182368,64450934,34268566,TN
chr05,Bn21026,94213789,99572078,5358289,CNL
chr05,Bn21027,51293413,81965897,30672484,NBS
chr05,Bn21028,26549653,62535051,35985398,TNL
chr05,Bn21029,53197760,96321411,43123651,CN
chr05,Bn21030,90869236,95719898,4850662,RLK
chr05,Bn21031,33894587,93631265,59736678,TN
chr05,Bn21032,54129174,92620436,38491262,NBS
chr05,Bn21033,40412050,65797733,25385683,RLP
chr05,Bn21034,1297157,87763215,86466058,TN
chr05,Bn21035,6239772,89418468,83178696,TN
chr05,Bn21036,5193212,96388350,91195138,CN
chr05,Bn21037,85681637,86493596,811959,TNL
chr05,Bn21038,62811886,99940493,37128607,RLK
chr05,Bn21039,76867137,80218832,3351695,NBS
chr05,Bn21040,14509825,21871840,7362015,CN
chr05,Bn21041,50251530,91438883,41187353,TN
chr05,Bn21042,5483178,56813901,51330723,CN
chr05,Bn21043,25248936,31530277,6281341,CN
chr05,Bn21044,37725431,45981179,8255748,RLP
chr05,Bn21045,92234831,95756949,3522118,CN
chr05,Bn21046,8345155,35983713,27638558,TNL
chr05,Bn21047,9710225,67682657,57972432,NBS
chr05,Bn21048,29475287,69302878,39827591,CN
chr05,Bn21049,25039236,61596298,36557062,RLP
chr05,Bn21050,60955473,68436195,7480722,TN
chr05,Bn21051,27281227,82192990,54911763,NBS
chr05,Bn21052,92133108,92648067,514959,NBS
chr05,Bn21053,93480512,95352260,1871748,NBS
chr05,Bn21054,86976859,88683788,1706929,CNL
chr05,Bn21055,13879879,30697819,16817940,CN
chr05,Bn21056,77072398,81290803,4218405,CN
chr05,Bn21057,49986458,63689447,13702989,RLK
chr05,Bn21058,52265236,94966381,42701145,CNL
chr05,Bn21059,7007188,69380201,62373013,TN
chr05,Bn21060,66944892,73227786,6282894,RLK
chr05,Bn21061,8975359,66827498,57852139,TNL
chr05,Bn21062,41665158,57617134,15951976,RLK
chr05,Bn21063,85342424,97521889,12179465,TNL
chr05,Bn21064,46500769,62068528,15567759,NBS
chr05,Bn21065,38223192,86206616,47983424,TN
chr05,Bn21066,1538503,92048044,90509541,TNL
chr05,Bn21067,72706008,98101331,25395323,CNL
chr05,Bn21068,28895432,78965771,50070339,TN
chr05,Bn21069,69673466,82917531,13244065,RLP
chr05,Bn21070,31811312,57069680,25258368,NBS
chr05,Bn21071,68111530,80929063,12817533,TNL
chr05,Bn21072,48279734,78808877,30529143,CNL
chr05,Bn21073,25908457,64629468,38721011,CN
chr05,Bn21074,15658199,33050892,17392693,CN
chr05,Bn21075,67507028,91818293,24311265,TNL
chr05,Bn21076,53101926,91314731,38212805,RLK
chr05,Bn21077,55525300,74844909,19319609,RLK
chr05,Bn21078,33727422,81156227,47428805,RLP
chr05,Bn21079,60534485,92511565,31977080,RLK
chr05,Bn21080,25333210,47557105,22223895,TN
chr05,Bn21081,65185134,99826060,34640926,CNL
chr05,Bn21082,94437278,96332797,1895519,TN
chr05,Bn21083,6970335,79322271,72351936,TN
chr05,Bn21084,44335206,62711865,18376659,RLK
chr05,Bn21085,44385078,76093429,31708351,TN
chr05,Bn21086,45318284,73269944,27951660,CN
chr05,Bn21087,20972613,73246862,52274249,RLP
chr05,Bn21088,3973477,28931386,24957909,RLK
chr05,Bn21089,68138868,84778409,16639541,RLK
chr05,Bn21090,54624916,70141871,15516955,CNL
chr05,Bn21091,51639321,75946590,24307269,CNL
chr05,Bn21092,94250654,95343075,1092421,NBS
chr05,Bn21093,94249078,97450916,3201838,CN
chr05,Bn21094,35871292,80846189,44974897,RLP
chr05,Bn21095,13012092,83214082,70201990,TNL
chr05,Bn21096,7195218,44002134,36806916,CNL
chr05,Bn21097,29783978,71688239,41904261,NBS
chr05,Bn21098,1248602,70872813,69624211,CN
chr05,Bn21099,61347170,95083856,33736686,RLP
chr05,Bn21100,15213707,82109522,66895815,CNL
chr05,Bn21101,42098135,42174056,75921,NBS
chr05,Bn21102,5348075,8317650,2969575,RLK
chr05,Bn21103,71305727,78746056,7440329,CN
chr05,Bn21104,39884800,79499437,39614637,RLP
chr05,Bn21105,98448140,99417201,969061,CNL
chr05,Bn21106,31518635,60580747,29062112,NBS
chr05,Bn21107,77493005,81421643,3928638,TN
chr05,Bn21108,97579866,98512289,932423,TNL
chr05,Bn21109,83527397,87356720,3829323,CN
chr05,Bn21110,23779371,81643102,57863731,RLK
chr05,Bn21111,9135819,25556299,16420480,CNL
chr05,Bn21112,78829902,90198843,11368941,RLK
chr05,Bn21113,15238215,24937564,9699349,NBS
chr05,Bn21114,39201596,63117119,23915523,RLP
chr05,Bn21115,24491510,35197054,10705544,RLP
chr05,Bn21116,36462162,62537264,26075102,TNL
chr05,Bn21117,14947696,61334480,46386784,NBS
chr05,Bn21118,68801633,81255797,12454164,TNL
chr05,Bn21119,91184058,93590016,2405958,TN
chr05,Bn21120,55732503,82930490,27197987,CNL
chr05,Bn21121,86090737,97159424,11068687,TN
chr05,Bn21122,70800076,89524096,18724020,NBS
chr05,Bn21123,48231716,78805356,30573640,CN
chr05,Bn21124,88860214,91482370,2622156,TN
chr05,Bn21125,5308357,89317212,84008855,RLK
chr05,Bn21126,53590030,98010975,44420945,TNL
chr05,Bn21127,40581286,84008581,43427295,CNL
chr05,Bn21128,25092358,50904060,25811702,CN
chr05,Bn21129,87600229,94080901,6480672,CN
chr05,Bn21130,88111743,97602502,9490759,RLK
chr05,Bn21131,63189877,93007472,29817595,RLP
chr05,Bn21132,39210010,63019810,23809800,CN
chr05,Bn21133,58815590,76406761,17591171,TN
chr05,Bn21134,53649998,59105469,5455471,TN
chr05,Bn21135,50839979,81032174,30192195,NBS
chr05,Bn21136,32688385,38117677,5429292,CN
chr05,Bn21137,99162550,99794450,631900,CN
chr05,Bn21138,22610955,31008489,8397534,TN
chr05,Bn21139,9392056,64251106,54859050,RLK
chr05,Bn21140,52448095,66724470,14276375,TN
chr05,Bn21141,15123821,86153776,71029955,CNL
chr05,Bn21142,80211214,91640806,11429592,TNL
chr05,Bn21143,2077082,74700211,72623129,CNL
chr05,Bn21144,11596401,73458195,61861794,TN
chr05,Bn21145,50474018,81685752,31211734,CNL
chr05,Bn21146,19619698,39202989,19583291,TN
chr05,Bn21147,11105195,11541264,436069,NBS
chr05,Bn21148,9909590,13227680,3318090,TNL
chr05,Bn21149,74838152,96175049,21336897,TN
chr05,Bn21150,68142241,82283407,14141166,CNL
chr05,Bn21151,92340752,95790554,3449802,RLP
chr05,Bn21152,33386454,49405101,16018647,RLP
chr05,Bn21153,98189546,98624510,434964,NBS
chr05,Bn21154,62556640,90119058,27562418,CN
chr05,Bn21155,36616777,42667151,6050374,CN
chr05,Bn21156,8035189,21747457,13712268,CNL
chr05,Bn21157,56336123,81807962,25471839,RLK
chr05,Bn21158,30140344,95885254,65744910,CNL
chr05,Bn21159,6319047,53339468,47020421,CN
chr05,Bn21160,33418010,43039580,9621570,RLP
chr05,Bn21161,33947569,41915053,7967484,TNL
chr05,Bn21162,21134626,66797665,45663039,TNL
chr05,Bn21163,72275365,80427511,8152146,NBS
chr05,Bn21164,28924296,42418817,13494521,TN
chr05,Bn21165,35695256,70508494,34813238,CNL
chr05,Bn21166,90550444,92165738,1615294,RLP
chr05,Bn21167,10266571,96720119,86453548,NBS
chr05,Bn21168,56316103,76064166,19748063,RLP
chr05,Bn21169,44824544,97923925,53099381,TN
chr05,Bn21170,92476503,96254731,3778228,TN
chr05,Bn21171,7917095,48695373,40778278,RLK
chr05,Bn21172,95634295,96423762,789467,RLK
chr05,Bn21173,61513034,66931423,5418389,CN
chr05,Bn21174,93943452,98939341,4995889,CN
chr05,Bn21175,17848305,31108751,13260446,RLP
chr05,Bn21176,98874421,99773791,899370,RLK
chr05,Bn21177,86562274,93322911,6760637,RLK
chr05,Bn21178,81039955,87017555,5977600,TNL
chr05,Bn21179,42313422,81264449,38951027,NBS
chr05,Bn21180,16340687,26521732,10181045,TN
chr05,Bn21181,64558566,85695471,21136905,RLK
chr05,Bn21182,47302301,74772102,27469801,CN
chr05,Bn21183,16215201,79546466,63331265,CNL
chr05,Bn21184,52647249,55012402,2365153,RLP
chr05,Bn21185,36404871,81239998,44835127,RLK
chr05,Bn21186,42482452,56649182,14166730,CNL
chr05,Bn21187,36584885,93806093,57221208,TN
chr05,Bn21188,68136705,73388688,5251983,TN
chr05,Bn21189,3624099,37261725,33637626,NBS
chr05,Bn21190,51306278,83683170,32376892,RLK
chr05,Bn21191,68262372,94769111,26506739,RLP
chr05,Bn21192,36761552,39737679,2976127,CN
chr05,Bn21193,60441686,90582414,30140728,RLP
chr05,Bn21194,47021733,47687733,666000,CN
chr05,Bn21195,87498389,99876539,12378150,TNL
chr05,Bn21196,78207081,97409122,19202041,RLK
chr05,Bn21197,70705964,93836897,23130933,TN
chr05,Bn21198,54415904,98854192,44438288,CNL
chr05,Bn21199,25645163,71709217,46064054,NBS
chr05,Bn21200,12463366,42644469,30181103,TNL
chr05,Bn21201,55483913,98898414,43414501,CN
chr05,Bn21202,53838373,79405566,25567193,RLK
chr05,Bn21203,77278237,80485027,3206790,RLK
chr05,Bn21204,96758681,97734844,976163,TNL
chr05,Bn21205,69849609,93750848,23901239,CN
chr05,Bn21206,80152667,95867544,15714877,RLP
chr05,Bn21207,97670961,98312064,641103,RLP
chr05,Bn21208,4832034,15444986,10612952,RLK
chr05,Bn21209,80743078,98116925,17373847,TN
chr05,Bn21210,37091079,73269777,36178698,CN
chr05,Bn21211,71338186,75700368,4362182,TN
chr05,Bn21212,43702704,71815622,28112918,NBS
chr05,Bn21213,68778129,69024839,246710,TNL
chr05,Bn21214,9239746,76063243,66823497,CNL
chr05,Bn21215,29453564,67553979,38100415,NBS
chr05,Bn21216,24964692,61463480,36498788,RLK
chr05,Bn21217,87000448,99574678,12574230,CN
chr05,Bn21218,74435872,99761555,25325683,CN
chr05,Bn21219,95450126,96095387,645261,TN
chr05,Bn21220,95783157,97567369,1784212,TN
chr05,Bn21221,45821315,96459538,50638223,CN
chr05,Bn21222,9897467,89677450,79779983,TNL
chr05,Bn21223,47253138,70652018,23398880,TN
chr05,Bn21224,12037675,47775951,35738276,CN
chr05,Bn21225,84168089,88420093,4252004,CN
chr05,Bn21226,9323019,24474936,15151917,NBS
chr05,Bn21227,53216907,99934708,46717801,RLK
chr05,Bn21228,72349524,89261924,16912400,CN
chr05,Bn21229,71980985,84719889,12738904,RLP
chr05,Bn21230,4315538,46030591,41715053,CNL
chr05,Bn21231,73650842,97902291,24251449,TNL
chr05,Bn21232,63028764,87221015,24192251,CN
chr05,Bn21233,59212966,75145407,15932441,TNL
chr05,Bn21234,88354611,98674179,10319568,RLK
chr05,Bn21235,41069868,46416791,5346923,TN
chr05,Bn21236,97777270,98771134,993864,CN
chr05,Bn21237,98952114,99906396,954282,RLP
chr05,Bn21238,27505680,79599052,52093372,RLP
chr05,Bn21239,79315438,89493805,10178367,RLK
chr05,Bn21240,71233183,76239283,5006100,CNL
chr05,Bn21241,60641741,82481898,21840157,NBS
chr05,Bn21242,16646931,20533809,3886878,TNL
chr05,Bn21243,29658187,42343841,12685654,RLK
chr05,Bn21244,28247622,37816001,9568379,TNL
chr05,Bn21245,72511106,97140804,24629698,CNL
chr05,Bn21246,81973541,96843921,14870380,RLP
chr05,Bn21247,31512887,74186239,42673352,RLK
chr05,Bn21248,96283824,99290545,3006721,RLK
chr05,Bn21249,24996382,88998216,64001834,CNL
chr05,Bn21250,83202258,98171840,14969582,RLK
chr05,Bn21251,57516127,63536460,6020333,RLK
chr05,Bn21252,49745852,58921171,9175319,CNL
chr05,Bn21253,88677608,95621620,6944012,NBS
chr05,Bn21254,19028264,48443692,29415428,RLP
chr05,Bn21255,76095391,94211711,18116320,TN
chr05,Bn21256,68394331,97670834,29276503,NBS
chr05,Bn21257,13784292,75105188,61320896,CN
chr05,Bn21258,53293823,84552062,31258239,NBS
chr05,Bn21259,61180266,73456625,12276359,RLK
chr05,Bn21260,54430382,98716789,44286407,RLP
chr05,Bn21261,35464463,98527855,63063392,TNL
chr05,Bn21262,82343953,85358995,3015042,TNL
chr05,Bn21263,90198476,91500603,1302127,RLP
chr05,Bn21264,70494530,72475103,1980573,NBS
chr05,Bn21265,59402081,95021093,35619012,RLP
chr05,Bn21266,5933423,92828592,86895169,CNL
chr05,Bn21267,20090553,35941390,15850837,CN
chr05,Bn21268,63575526,67792603,4217077,TN
chr05,Bn21269,6945549,83010526,76064977,RLK
chr05,Bn21270,16838205,75115874,58277669,CNL
chr05,Bn21271,24494807,71618865,47124058,CN
chr05,Bn21272,86861422,87094872,233450,TNL
chr05,Bn21273,59720045,73465776,13745731,NBS
chr05,Bn21274,54016622,55172585,1155963,RLK
chr05,Bn21275,30558182,43832429,13274247,CNL
chr05,Bn21276,84249002,91143131,6894129,TN
chr05,Bn21277,8054510,99173684,91119174,TNL
chr05,Bn21278,92310503,95785190,3474687,NBS
chr05,Bn21279,33545951,74112230,40566279,TN
chr05,Bn21280,59472564,97893157,38420593,CN
chr05,Bn21281,31917749,43464145,11546396,RLP
chr05,Bn21282,98418311,98444885,26574,RLK
chr05,Bn21283,22937234,91056028,68118794,CNL
chr05,Bn21284,37768167,97728320,59960153,RLK
chr05,Bn21285,36797474,78384683,41587209,RLP
chr05,Bn21286,35411178,66378121,30966943,TNL
chr05,Bn21287,10317035,90317787,80000752,TN
chr05,Bn21288,62788095,92991281,30203186,TN
chr05,Bn21289,82701521,85658146,2956625,RLK
chr05,Bn21290,34315000,42305713,7990713,CNL
chr05,Bn21291,54856187,69643706,14787519,CNL
chr05,Bn21292,68013011,98833982,30820971,RLP
chr05,Bn21293,43989069,81381159,37392090,CNL
chr05,Bn21294,96130201,97756256,1626055,TN
chr05,Bn21295,46954582,81078739,34124157,TN
chr05,Bn21296,40214328,70404157,30189829,CNL
chr05,Bn21297,44274573,79741814,35467241,CNL
chr05,Bn21298,27588179,45076482,17488303,CNL
chr05,Bn21299,77077355,87378020,10300665,CNL
chr05,Bn21300,23519848,74906011,51386163,TNL
chr05,Bn21301,42332460,65290464,22958004,RLP
chr05,Bn21302,56639403,69191710,12552307,RLP
chr05,Bn21303,44606578,70025088,25418510,RLP
chr05,Bn21304,91744462,98709086,6964624,CNL
chr05,Bn21305,62194989,98669873,36474884,TNL
chr05,Bn21306,28733948,80609218,51875270,RLP
chr05,Bn21307,12170353,91843875,79673522,CN
chr05,Bn21308,81770872,86058491,4287619,RLK
chr05,Bn21309,75052267,87967256,12914989,TNL
chr05,Bn21310,33026938,83503941,50477003,CNL
chr05,Bn21311,57705623,89336392,31630769,CNL
chr05,Bn21312,34339587,82929295,48589708,RLP
chr05,Bn21313,1206305,32176306,30970001,CNL
chr05,Bn21314,40237816,51247666,11009850,TN
chr05,Bn21315,11713543,54027465,42313922,TN
chr05,Bn21316,89233291,97226830,7993539,RLP
chr05,Bn21317,96255386,97784334,1528948,RLK
chr05,Bn21318,68104984,92880482,24775498,TNL
chr05,Bn21319,59264472,97290553,38026081,CN
chr05,Bn21320,91923624,95508934,3585310,RLP
chr05,Bn21321,59155028,69458435,10303407,CN
chr05,Bn21322,4165029,55269528,51104499,RLK
chr05,Bn21323,20104604,62021036,41916432,RLK
chr05,Bn21324,85383387,87498186,2114799,RLK
chr05,Bn21325,65452073,83129872,17677799,CNL
chr05,Bn21326,55697681,67692475,11994794,RLK
chr05,Bn21327,70348350,73888943,3540593,CN
chr05,Bn21328,28045438,68054917,40009479,TNL
chr05,Bn21329,9311250,76845168,67533918,RLK
chr05,Bn21330,42716472,72691142,29974670,TN
chr05,Bn21331,49899528,65361928,15462400,CN
chr05,Bn21332,99003888,99596941,593053,NBS
chr05,Bn21333,45106647,82620771,37514124,TNL
chr05,Bn21334,99416376,99781882,365506,NBS
chr05,Bn21335,21335914,39105931,17770017,RLK
chr05,Bn21336,22894185,84587020,61692835,CNL
chr05,Bn21337,7882957,84093361,76210404,TNL
chr05,Bn21338,6078976,80430288,74351312,TN
chr05,Bn21339,7988116,57040150,49052034,CNL
chr05,Bn21340,58463877,71250389,12786512,CN
chr05,Bn21341,75717001,92711809,16994808,CNL
chr05,Bn21342,64889096,94668061,29778965,CNL
chr05,Bn21343,10357902,49709385,39351483,CNL
chr05,Bn21344,65821379,96677428,30856049,CN
chr05,Bn21345,75446393,97532451,22086058,TNL
chr05,Bn21346,49450026,60925225,11475199,TNL
chr05,Bn21347,64752471,99277450,34524979,TN
chr05,Bn21348,69875078,86553057,16677979,CNL
chr05,Bn21349,29184671,80543457,51358786,RLP
chr05,Bn21350,15545673,55105591,39559918,RLP
chr05,Bn21351,21987736,70253454,48265718,TN
chr05,Bn21352,96956710,97471780,515070,TN
chr05,Bn21353,89022174,89507464,485290,TNL
chr05,Bn21354,17676719,82954989,65278270,CN
chr05,Bn21355,30426494,76832536,46406042,RLP
chr05,Bn21356,29145574,75903361,46757787,RLP
chr05,Bn21357,77712828,93361399,15648571,NBS
chr05,Bn21358,74069480,91418770,17349290,NBS
chr05,Bn21359,89114419,89861717,747298,TN
chr05,Bn21360,65874142,78449518,12575376,CNL
chr05,Bn21361,13812785,69876209,56063424,TN
chr05,Bn21362,19070798,27238954,8168156,TN
chr05,Bn21363,65887572,88990738,23103166,TN
chr05,Bn21364,76476750,93488635,17011885,TNL
chr05,Bn21365,80108514,84148387,4039873,CN
chr05,Bn21366,41737010,83649845,41912835,CN
chr05,Bn21367,73789182,87941266,14152084,RLP
chr05,Bn21368,28466027,75368639,46902612,TNL
chr05,Bn21369,42887077,67286067,24398990,TNL
chr05,Bn21370,13960673,74218926,60258253,NBS
chr05,Bn21371,81480941,96952499,15471558,RLK
chr05,Bn21372,74196324,95924536,21728212,RLK
chr05,Bn21373,37818947,71747224,33928277,TNL
chr05,Bn21374,82025929,94464063,12438134,RLP
chr05,Bn21375,6902941,26188620,19285679,CN
chr05,Bn21376,73108001,82460774,9352773,TN
chr05,Bn21377,18749477,88366618,69617141,NBS
chr05,Bn21378,92361178,99115502,6754324,TNL
chr05,Bn21379,69668766,78721904,9053138,CNL
chr05,Bn21380,22815423,35524429,12709006,TNL
chr05,Bn21381,96075923,96554557,478634,TNL
chr05,Bn21382,83078816,83426605,347789,NBS
chr05,Bn21383,63568372,75264260,11695888,RLP
chr05,Bn21384,39428145,42121060,2692915,TNL
chr05,Bn21385,23187385,50614232,27426847,CN
chr05,Bn21386,87048906,88515257,1466351,TN
chr05,Bn21387,81636012,97314329,15678317,CNL
chr05,Bn21388,64716494,79254038,14537544,TNL
chr05,Bn21389,44139981,67620646,23480665,CNL
chr05,Bn21390,14709174,82710011,68000837,CNL
chr05,Bn21391,86651029,99322182,12671153,RLP
chr05,Bn21392,94731597,96809407,2077810,TNL
chr05,Bn21393,53546339,83592316,30045977,RLK
chr05,Bn21394,28679809,39322496,10642687,RLP
chr05,Bn21395,72611839,86399604,13787765,NBS
chr05,Bn21396,5002212,39965105,34962893,NBS
chr05,Bn21397,57406651,85400826,27994175,TNL
chr05,Bn21398,82488317,93068432,10580115,TNL
chr05,Bn21399,61536777,81157404,19620627,CN
chr05,Bn21400,8947380,68439749,59492369,RLP
chr05,Bn21401,84546260,86311734,1765474,TN
chr05,Bn21402,53956252,73696262,19740010,RLP
chr05,Bn21403,35063002,43385388,8322386,TNL
chr05,Bn21404,43425147,60615197,17190050,CN
chr05,Bn21405,36011443,72640319,36628876,TNL
chr05,Bn21406,94532109,95687399,1155290,RLP
chr05,Bn21407,89163253,96944930,7781677,RLK
chr05,Bn21408,56724194,63627381,6903187,TN
chr05,Bn21409,46670632,73206719,26536087,TN
chr05,Bn21410,34764219,89384279,54620060,CN
chr05,Bn21411,40870796,47487751,6616955,TN
chr05,Bn21412,38364009,59789221,21425212,TNL
chr05,Bn21413,10082848,96490868,86408020,NBS
chr05,Bn21414,57816051,65178478,7362427,RLP
chr05,Bn21415,50246526,94398918,44152392,TN
chr05,Bn21416,56200202,56706753,506551,TN
chr05,Bn21417,19506707,38620202,19113495,RLK
chr05,Bn21418,29292782,41088977,11796195,RLP
chr05,Bn21419,7041005,33447618,26406613,RLP
chr05,Bn21420,30754167,63468963,32714796,CN
chr05,Bn21421,89949767,92271149,2321382,RLP
chr05,Bn21422,59066106,99708380,40642274,CNL
chr05,Bn21423,46514111,88337904,41823793,NBS
chr05,Bn21424,63925160,99951291,36026131,NBS
chr05,Bn21425,72788975,90077727,17288752,CNL
chr05,Bn21426,13714127,57220794,43506667,CNL
chr05,Bn21427,55929271,64682945,8753674,RLK
chr05,Bn21428,43100620,59108618,16007998,RLP
chr05,Bn21429,65875800,74020807,8145007,TN
chr05,Bn21430,67160865,99320020,32159155,CNL
chr05,Bn21431,73149145,87603036,14453891,CNL
chr05,Bn21432,14122362,58310973,44188611,TNL
chr05,Bn21433,11337611,84134756,72797145,NBS
chr05,Bn21434,34135681,42106984,7971303,TN
chr05,Bn21435,36145191,99458666,63313475,RLP
chr05,Bn21436,64625248,84539924,19914676,TNL
chr05,Bn21437,50913065,76858251,25945186,RLP
chr05,Bn21438,45140918,87583611,42442693,TN
chr05,Bn21439,62862558,77142032,14279474,NBS
chr05,Bn21440,88975672,92034713,3059041,RLK
chr05,Bn21441,92122690,93268302,1145612,CN
chr05,Bn21442,5248296,8431026,3182730,TNL
chr05,Bn21443,90843624,95971379,5127755,TN
chr05,Bn21444,61858540,91677034,29818494,RLP
chr05,Bn21445,49638618,60123583,10484965,NBS
chr05,Bn21446,89332538,97791504,8458966,TN
chr05,Bn21447,54407180,56030664,1623484,RLK
chr05,Bn21448,59732398,95568720,35836322,TN
chr05,Bn21449,7682918,73369694,65686776,NBS
chr05,Bn21450,71635497,82558123,10922626,CNL
chr05,Bn21451,75598166,97865232,22267066,RLK
chr05,Bn21452,53038444,95872234,42833790,TN
chr05,Bn21453,58721119,66893068,8171949,RLK
chr05,Bn21454,78385736,79265913,880177,TN
chr05,Bn21455,29109695,62194317,33084622,CN
chr05,Bn21456,74107479,75959006,1851527,CNL
chr05,Bn21457,24131350,71366493,47235143,NBS
chr05,Bn21458,6552809,39145906,32593097,RLP
chr05,Bn21459,53987317,63687290,9699973,NBS
chr05,Bn21460,11395677,57850281,46454604,TN
chr05,Bn21461,48390331,73386595,24996264,TNL
chr05,Bn21462,35983602,73700311,37716709,RLP
chr05,Bn21463,42331409,68068821,25737412,TN
chr05,Bn21464,82192856,98621023,16428167,RLP
chr05,Bn21465,19146580,40798884,21652304,NBS
chr05,Bn21466,9930647,92124832,82194185,RLK
chr05,Bn21467,8304062,60011454,51707392,TN
chr05,Bn21468,61928229,69843584,7915355,CNL
chr05,Bn21469,75306697,90772787,15466090,RLK
chr05,Bn21470,87887748,90582016,2694268,RLK
chr05,Bn21471,26981089,68269614,41288525,TNL
chr05,Bn21472,98168029,98475883,307854,CNL
chr05,Bn21473,37806633,94750031,56943398,CN
chr05,Bn21474,83649654,99331291,15681637,CN
chr05,Bn21475,80138345,85140147,5001802,TN
chr05,Bn21476,50260549,68447465,18186916,CN
chr05,Bn21477,99147640,99365371,217731,CNL
chr05,Bn21478,54014214,59229653,5215439,CN
chr05,Bn21479,42100629,46126612,4025983,TNL
chr05,Bn21480,11438526,30919637,19481111,RLP
chr05,Bn21481,49431159,99685314,50254155,RLP
chr05,Bn21482,99752256,99836069,83813,NBS
chr05,Bn21483,76319740,98086710,21766970,CN
chr05,Bn21484,77533201,84280667,6747466,RLP
chr05,Bn21485,92342328,92687508,345180,CNL
chr05,Bn21486,56158038,79838219,23680181,RLK
chr05,Bn21487,91334097,99674272,8340175,RLP
chr05,Bn21488,77627257,95889068,18261811,TNL
chr05,Bn21489,14939749,53527721,38587972,CN
chr05,Bn21490,97535586,99879655,2344069,TN
chr05,Bn21491,68928839,97539182,28610343,RLP
chr05,Bn21492,92544383,97810572,5266189,TNL
chr05,Bn21493,79216063,84751760,5535697,RLP
chr05,Bn21494,62949826,72197895,9248069,TN
chr05,Bn21495,21208559,76675928,55467369,TNL
chr05,Bn21496,31291958,63674892,32382934,TNL
chr05,Bn21497,29101632,75299922,46198290,CN
chr05,Bn21498,22603270,35174357,12571087,CNL
chr05,Bn21499,32137160,56435427,24298267,NBS
chr05,Bn21500,11013340,25580404,14567064,TNL
chr05,Bn21501,29506706,95925310,66418604,NBS
chr05,Bn21502,4171995,90876273,86704278,CN
chr05,Bn21503,50400635,98252312,47851677,RLP
chr05,Bn21504,82089675,89073034,6983359,TNL
chr05,Bn21505,3669030,97230792,93561762,RLK
chr05,Bn21506,69713632,77731774,8018142,CN
chr05,Bn21507,74514490,85729453,11214963,CN
chr05,Bn21508,10483056,97716777,87233721,RLK
chr05,Bn21509,30467886,54559811,24091925,CN
chr05,Bn21510,27108032,65578680,38470648,RLP
chr05,Bn21511,36068736,66123542,30054806,CNL
chr05,Bn21512,82885777,83414174,528397,NBS
chr05,Bn21513,34754562,41483820,6729258,TN
chr05,Bn21514,64940765,89645903,24705138,NBS
chr05,Bn21515,48969129,87058203,38089074,TN
chr05,Bn21516,60798497,68022406,7223909,RLP
chr05,Bn21517,39868146,75506561,35638415,NBS
chr05,Bn21518,44605504,71835061,27229557,CN
chr05,Bn21519,40491672,80067083,39575411,TNL
chr05,Bn21520,52127810,82087411,29959601,CN
chr05,Bn21521,10757680,32902549,22144869,CN
chr05,Bn21522,31712237,91183205,59470968,RLP
chr05,Bn21523,41703932,57234841,15530909,TN
chr05,Bn21524,71752570,79034369,7281799,RLK
chr05,Bn21525,72112866,73246690,1133824,TN
chr05,Bn21526,57627621,67868480,10240859,CNL
chr05,Bn21527,73548876,94295046,20746170,TNL
chr05,Bn21528,19935237,43084395,23149158,RLK
chr05,Bn21529,74796344,90952241,16155897,CN
chr05,Bn21530,96265583,98576143,2310560,RLK
chr05,Bn21531,61437349,96920145,35482796,NBS
chr05,Bn21532,2256504,38305652,36049148,TNL
chr05,Bn21533,47690906,48673955,983049,TN
chr05,Bn21534,62361093,98555515,36194422,CN
chr05,Bn21535,91877885,99377631,7499746,RLP
chr05,Bn21536,40917312,56453449,15536137,TNL
chr05,Bn21537,31657471,92046438,60388967,CN
chr05,Bn21538,55194026,83311144,28117118,RLK
chr05,Bn21539,98878618,99244751,366133,TN
chr05,Bn21540,77152955,82169044,5016089,NBS
chr05,Bn21541,51616820,56165508,4548688,CNL
chr05,Bn21542,21386830,98045225,76658395,TN
chr05,Bn21543,36865724,72753173,35887449,CNL
chr05,Bn21544,57343048,90960201,33617153,CNL
chr05,Bn21545,43232259,59837152,16604893,RLP
chr05,Bn21546,6503341,12047758,5544417,RLK
chr05,Bn21547,24021021,98698696,74677675,NBS
chr05,Bn21548,94264882,96513090,2248208,CNL
chr05,Bn21549,43384053,45528920,2144867,TN
chr05,Bn21550,32159910,47494706,15334796,CN
chr05,Bn21551,85373623,94485745,9112122,RLP
chr05,Bn21552,99694528,99993307,298779,CN
chr05,Bn21553,81679408,97405417,15726009,CNL
chr05,Bn21554,81085322,82637701,1552379,TN
chr05,Bn21555,85128394,98126726,12998332,CN
chr05,Bn21556,22235477,25437525,3202048,TNL
chr05,Bn21557,96275072,96897559,622487,NBS
chr05,Bn21558,4414849,80759636,76344787,NBS
chr05,Bn21559,57454661,81580870,24126209,CN
chr05,Bn21560,53267367,98276651,45009284,CN
chr05,Bn21561,66952422,68544292,1591870,RLP
chr05,Bn21562,22643953,53511481,30867528,RLP
chr05,Bn21563,39004040,79094467,40090427,CNL
chr05,Bn21564,10545395,33347823,22802428,TN
chr05,Bn21565,54458129,76864232,22406103,TN
chr05,Bn21566,98448648,99592878,1144230,CNL
chr05,Bn21567,55872248,56137595,265347,CN
chr05,Bn21568,99953686,99995717,42031,NBS
chr05,Bn21569,37129505,85142220,48012715,CNL
chr05,Bn21570,98846450,98934358,87908,CN
chr05,Bn21571,26178020,54101744,27923724,NBS
chr05,Bn21572,63099533,72317812,9218279,TNL
chr05,Bn21573,19991745,76407006,56415261,CN
chr05,Bn21574,35480643,76096628,40615985,CN
chr05,Bn21575,7520284,46072252,38551968,NBS
chr05,Bn21576,95062782,98502449,3439667,RLP
chr05,Bn21577,62636672,99095147,36458475,NBS
chr05,Bn21578,96382619,98160474,1777855,CNL
chr05,Bn21579,9865902,33408529,23542627,TNL
chr05,Bn21580,47183713,75679126,28495413,TNL
chr05,Bn21581,3497158,75631438,72134280,RLP
chr05,Bn21582,34386877,73713061,39326184,CN
chr05,Bn21583,85253556,89585856,4332300,RLP
chr05,Bn21584,76075232,93200335,17125103,TNL
chr05,Bn21585,93463104,96709514,3246410,RLK
chr05,Bn21586,61539122,68317708,6778586,TNL
chr05,Bn21587,72478689,88051754,15573065,CN
chr05,Bn21588,75251015,79215122,3964107,CN
chr05,Bn21589,17655527,77088954,59433427,CNL
chr05,Bn21590,37732268,38649079,916811,TN
chr05,Bn21591,21275662,72817409,51541747,NBS
chr05,Bn21592,73273637,91361126,18087489,RLP
chr05,Bn21593,15076402,88177445,73101043,CNL
chr05,Bn21594,3728148,17670869,13942721,TNL
chr05,Bn21595,74207022,82963939,8756917,CN
chr05,Bn21596,92416316,93414217,997901,TN
chr05,Bn21597,46819748,58280527,11460779,RLK
chr05,Bn21598,65568164,90245698,24677534,CNL
chr05,Bn21599,43292183,70075623,26783440,CNL
chr05,Bn21600,92897915,95519281,2621366,CNL
chr05,Bn21601,93665999,96027977,2361978,NBS
chr05,Bn21602,2280018,11920672,9640654,RLK
chr05,Bn21603,38050788,96095186,58044398,RLP
chr05,Bn21604,61881387,91296649,29415262,CNL
chr05,Bn21605,70821495,95660557,24839062,CNL
chr05,Bn21606,46188340,89848875,43660535,RLK
chr05,Bn21607,15637569,67314498,51676929,RLP
chr05,Bn21608,45953481,71529022,25575541,TN
chr05,Bn21609,26671930,31200300,4528370,TNL
chr05,Bn21610,49540920,87301825,37760905,CNL
chr05,Bn21611,91347317,91634901,287584,RLK
chr05,Bn21612,43487938,80490580,37002642,RLK
chr05,Bn21613,35742183,60763601,25021418,RLK
chr05,Bn21614,97493450,97587967,94517,RLP
chr05,Bn21615,25744328,79868380,54124052,RLK
chr05,Bn21616,76773662,88770678,11997016,RLP
chr05,Bn21617,22727515,98459677,75732162,CNL
chr05,Bn21618,98651190,98761046,109856,NBS
chr05,Bn21619,37804806,72561353,34756547,CN
chr05,Bn21620,21834012,90522293,68688281,CN
chr05,Bn21621,56011132,65543309,9532177,NBS
chr05,Bn21622,60576217,69567335,8991118,CN
chr05,Bn21623,82414369,83710344,1295975,CNL
chr05,Bn21624,71050053,96673759,25623706,RLP
chr05,Bn21625,50220539,73114420,22893881,CNL
chr05,Bn21626,8223331,84557215,76333884,TN
chr05,Bn21627,55026615,77302165,22275550,CN
chr05,Bn21628,4286226,57004153,52717927,CNL
chr05,Bn21629,77908620,85085974,7177354,CNL
chr05,Bn21630,68288751,82511789,14223038,TN
chr05,Bn21631,75539009,80316971,4777962,TNL
chr05,Bn21632,26962136,93776885,66814749,RLP
chr05,Bn21633,39099883,79548165,40448282,TN
chr05,Bn21634,34724947,46544876,11819929,TN
chr05,Bn21635,71722017,76539189,4817172,CNL
chr05,Bn21636,14795504,63409028,48613524,TNL
chr05,Bn21637,36005641,46088112,10082471,TNL
chr05,Bn21638,73180393,81740804,8560411,RLK
chr05,Bn21639,37029889,81236588,44206699,RLK
chr05,Bn21640,3678624,11911868,8233244,RLK
chr05,Bn21641,79876881,95494614,15617733,TNL
chr05,Bn21642,91727273,95035691,3308418,TN
chr05,Bn21643,8908378,10996853,2088475,TNL
chr05,Bn21644,6928986,36462276,29533290,RLP
chr05,Bn21645,86844178,93240263,6396085,NBS
chr05,Bn21646,93139348,99705538,6566190,RLK
chr05,Bn21647,94476791,97759689,3282898,CNL
chr05,Bn21648,87524181,98543523,11019342,CN
chr05,Bn21649,77142332,99943303,22800971,NBS
chr05,Bn21650,32840684,82822909,49982225,CNL
chr05,Bn21651,70550591,71400073,849482,RLK
chr05,Bn21652,40762864,62353649,21590785,RLK
chr05,Bn21653,30854916,45681609,14826693,CNL
chr05,Bn21654,84129447,93310633,9181186,CN
chr05,Bn21655,37761342,83633221,45871879,TNL
chr05,Bn21656,85540223,87401741,1861518,TNL
chr05,Bn21657,39572031,91324958,51752927,CN
chr05,Bn21658,87301719,89839153,2537434,CN
chr05,Bn21659,50525202,95337885,44812683,CNL
chr05,Bn21660,2759874,52101266,49341392,RLK
chr05,Bn21661,34613813,66212517,31598704,RLP
chr05,Bn21662,25124259,89780041,64655782,TN
chr05,Bn21663,2093662,69853911,67760249,TN
chr05,Bn21664,30900899,70835923,39935024,TNL
chr05,Bn21665,66389556,71304382,4914826,TNL
chr05,Bn21666,74162664,76403829,2241165,NBS
chr05,Bn21667,98784280,98957941,173661,RLK
chr05,Bn21668,44040978,48715490,4674512,TNL
chr05,Bn21669,52702643,60095665,7393022,NBS
chr05,Bn21670,13323581,60530001,47206420,NBS
chr05,Bn21671,11020920,67814589,56793669,RLK
chr05,Bn21672,16321887,32781483,16459596,TNL
chr05,Bn21673,23167960,43338265,20170305,NBS
chr05,Bn21674,49946063,78896166,28950103,TNL
chr05,Bn21675,41958725,48414610,6455885,CNL
chr05,Bn21676,89082497,92471471,3388974,TNL
chr05,Bn21677,3786459,20587288,16800829,TNL
chr05,Bn21678,13064993,84643867,71578874,RLK
chr05,Bn21679,98354103,98955621,601518,RLP
chr05,Bn21680,33196213,54462470,21266257,RLK
chr05,Bn21681,76866529,95828239,18961710,RLK
chr05,Bn21682,7056680,59390401,52333721,RLP
chr05,Bn21683,50470116,87997476,37527360,TN
chr05,Bn21684,31921747,33358750,1437003,TN
chr05,Bn21685,55358934,72028409,16669475,TN
chr05,Bn21686,82560583,98534165,15973582,CN
chr05,Bn21687,92571315,92833915,262600,TNL
chr05,Bn21688,46962615,87234935,40272320,CNL
chr05,Bn21689,13231790,47091469,33859679,RLK
chr05,Bn21690,51314468,52703005,1388537,TNL
chr05,Bn21691,66359904,80684854,14324950,TN
chr05,Bn21692,6485391,55434059,48948668,RLP
chr05,Bn21693,36758123,97965730,61207607,NBS
chr05,Bn21694,87644942,92824319,5179377,CNL
chr05,Bn21695,56631623,63991449,7359826,RLK
chr05,Bn21696,90923903,98578259,7654356,RLK
chr05,Bn21697,27649641,41610920,13961279,RLP
chr05,Bn21698,9576467,70697680,61121213,TNL
chr05,Bn21699,69523742,98403925,28880183,RLP
chr05,Bn21700,12872852,41480820,28607968,NBS
chr05,Bn21701,53780490,88480657,34700167,CNL
chr05,Bn21702,80061902,99105088,19043186,NBS
chr05,Bn21703,51420534,66282290,14861756,RLP
chr05,Bn21704,47666792,84499691,36832899,RLK
chr05,Bn21705,25797262,71434166,45636904,RLK
chr05,Bn21706,4005402,10150129,6144727,TNL
chr05,Bn21707,47830696,57399074,9568378,CNL
chr05,Bn21708,2820057,45259833,42439776,TNL
chr05,Bn21709,73362794,77052597,3689803,RLK
chr05,Bn21710,73790899,78534141,4743242,CNL
chr05,Bn21711,32295404,60167624,27872220,TN
chr05,Bn21712,60716158,81253051,20536893,TN
chr05,Bn21713,96953785,98028510,1074725,RLK
chr05,Bn21714,91776869,95246238,3469369,CNL
chr05,Bn21715,36798258,44104768,7306510,RLK
chr05,Bn21716,92241570,97023317,4781747,CN
chr05,Bn21717,12899577,73584393,60684816,TNL
chr05,Bn21718,53719013,94557654,40838641,CN
chr05,Bn21719,25412394,98358837,72946443,CNL
chr05,Bn21720,36271843,53925493,17653650,TN
chr05,Bn21721,36241078,41577101,5336023,RLK
chr05,Bn21722,60859676,65549534,4689858,TN
chr05,Bn21723,14178139,50769345,36591206,TNL
chr05,Bn21724,11357349,77375031,66017682,TN
chr05,Bn21725,28078129,61087121,33008992,CN
chr05,Bn21726,15350456,66638757,51288301,CN
chr05,Bn21727,33426195,93031167,59604972,CN
chr05,Bn21728,75183017,85057651,9874634,CN
chr05,Bn21729,10426076,96704485,86278409,RLP
chr05,Bn21730,24675408,25621798,946390,RLP
chr05,Bn21731,98756652,98984293,227641,CN
chr05,Bn21732,30943465,74996058,44052593,CN
chr05,Bn21733,63709889,99470893,35761004,TN
chr05,Bn21734,23193786,97333735,74139949,NBS
chr05,Bn21735,55767307,94755112,38987805,RLP
chr05,Bn21736,34952088,92635900,57683812,NBS
chr05,Bn21737,25305841,75765367,50459526,CNL
chr05,Bn21738,31862923,80547232,48684309,NBS
chr05,Bn21739,21804150,83857207,62053057,TNL
chr05,Bn21740,53044480,91086371,38041891,NBS
chr05,Bn21741,17488401,27854374,10365973,CN
chr05,Bn21742,53248765,80452030,27203265,RLK
chr05,Bn21743,82410690,85321170,2910480,CN
chr05,Bn21744,43733261,66713336,22980075,CNL
chr05,Bn21745,28586487,34645482,6058995,RLP
chr05,Bn21746,95746309,97358365,1612056,RLK
chr05,Bn21747,83163279,83532422,369143,TN
chr05,Bn21748,4305953,72881582,68575629,NBS
chr05,Bn21749,95492695,99187072,3694377,CNL
chr05,Bn21750,56009835,84430281,28420446,RLP
chr05,Bn21751,49805310,80216383,30411073,TNL
chr05,Bn21752,98869605,99249380,379775,TN
chr05,Bn21753,59628542,88102523,28473981,CNL
chr05,Bn21754,39116932,73023685,33906753,TN
chr05,Bn21755,4455231,22428032,17972801,TNL
chr05,Bn21756,45575731,57061176,11485445,TNL
chr05,Bn21757,95703765,95725188,21423,RLP
chr05,Bn21758,4087163,64961996,60874833,TNL
chr05,Bn21759,95014514,98645827,3631313,CNL
chr05,Bn21760,64834411,72968580,8134169,RLK
chr05,Bn21761,92540897,94521409,1980512,CN
chr05,Bn21762,51500949,71071101,19570152,CNL
chr05,Bn21763,37862081,62428768,24566687,NBS
chr05,Bn21764,25435039,83597079,58162040,CN
chr05,Bn21765,34696089,61542205,26846116,TNL
chr05,Bn21766,73672372,85759475,12087103,CNL
chr05,Bn21767,93176722,94330653,1153931,CN
chr05,Bn21768,60941817,76853499,15911682,CNL
chr05,Bn21769,10181865,72154163,61972298,RLK
chr05,Bn21770,52929261,81252646,28323385,NBS
chr05,Bn21771,77466535,82770525,5303990,TNL
chr05,Bn21772,16529414,46269547,29740133,RLK
chr05,Bn21773,5512153,38257065,32744912,CNL
chr05,Bn21774,58135764,89698749,31562985,RLP
chr05,Bn21775,67681284,72626240,4944956,RLK
chr05,Bn21776,96665535,99349623,2684088,TNL
chr05,Bn21777,2302658,10643139,8340481,CNL
chr05,Bn21778,55215261,89973748,34758487,RLP
chr05,Bn21779,98444823,99276037,831214,RLP
chr05,Bn21780,88714015,91811113,3097098,RLK
chr05,Bn21781,28049969,37211228,9161259,CNL
chr05,Bn21782,19597353,76046150,56448797,NBS
chr05,Bn21783,12256464,55120872,42864408,TN
chr05,Bn21784,43217705,86255575,43037870,RLK
chr05,Bn21785,61146331,73319006,12172675,RLK
chr05,Bn21786,53288111,93912353,40624242,TNL
chr05,Bn21787,98057246,98168980,111734,CNL
chr05,Bn21788,37035073,87770330,50735257,RLK
chr05,Bn21789,96134625,98168870,2034245,CNL
chr05,Bn21790,7591251,67310396,59719145,RLK
chr05,Bn21791,25388104,95470200,70082096,CN
chr05,Bn21792,10793938,48525304,37731366,RLP
chr05,Bn21793,89970306,91407855,1437549,TNL
chr05,Bn21794,34324934,43624203,9299269,CN
chr05,Bn21795,80267253,90037653,9770400,TN
chr05,Bn21796,16294141,20577850,4283709,CNL
chr05,Bn21797,15735239,55174562,39439323,CN
chr05,Bn21798,73199606,77377562,4177956,CNL
chr05,Bn21799,78936765,89178217,10241452,TN
chr05,Bn21800,86753938,98655771,11901833,CNL
chr05,Bn21801,46237381,97798555,51561174,TN
chr05,Bn21802,35452794,60803309,25350515,NBS
chr05,Bn21803,77069278,95877254,18807976,RLP
chr05,Bn21804,60826674,95424930,34598256,TNL
chr05,Bn21805,38105911,76986531,38880620,RLK
chr05,Bn21806,50102548,55002380,4899832,NBS
chr05,Bn21807,49476938,60646567,11169629,CNL
chr05,Bn21808,60423339,91630528,31207189,NBS
chr05,Bn21809,62919198,80537009,17617811,CN
chr05,Bn21810,20885018,25040056,4155038,NBS
chr05,Bn21811,58416351,76919188,18502837,TN
chr05,Bn21812,39874793,61229122,21354329,TNL
chr05,Bn21813,97290160,99075752,1785592,TN
chr05,Bn21814,15204649,49517624,34312975,RLK
chr05,Bn21815,88942036,89600388,658352,CN
chr05,Bn21816,73430466,86207152,12776686,RLK
chr05,Bn21817,7632331,81895578,74263247,TNL
chr05,Bn21818,3028531,81552940,78524409,RLK
chr05,Bn21819,66196780,85590280,19393500,RLK
chr05,Bn21820,39720912,50689340,10968428,RLP
chr05,Bn21821,77486304,86294554,8808250,TNL
chr05,Bn21822,62089329,80087061,17997732,RLP
chr05,Bn21823,29573229,81515809,51942580,RLP
chr05,Bn21824,76026662,89512102,13485440,RLK
chr05,Bn21825,80244959,80708247,463288,RLP
chr05,Bn21826,8212794,54152400,45939606,NBS
chr05,Bn21827,26293011,67760772,41467761,RLK
chr05,Bn21828,91427984,95182305,3754321,RLK
chr05,Bn21829,90459357,96355942,5896585,CNL
chr05,Bn21830,20467350,63840863,43373513,NBS
chr05,Bn21831,20795908,95832628,75036720,CNL
chr05,Bn21832,57674087,63056161,5382074,CN
chr05,Bn21833,74496434,88210682,13714248,TN
chr05,Bn21834,78425241,93588148,15162907,CNL
chr05,Bn21835,16353690,63918717,47565027,CNL
chr05,Bn21836,70152873,85663286,15510413,CN
chr05,Bn21837,61195508,67851309,6655801,CN
chr05,Bn21838,63686953,72872316,9185363,TNL
chr05,Bn21839,48804796,55862255,7057459,RLP
chr05,Bn21840,36678756,98263983,61585227,TN
chr05,Bn21841,4514051,20150731,15636680,TNL
chr05,Bn21842,32683493,69293472,36609979,TNL
chr05,Bn21843,59237740,60410856,1173116,TN
chr05,Bn21844,1512748,39468873,37956125,TN
chr05,Bn21845,80953623,86966037,6012414,RLK
chr05,Bn21846,84008451,91425137,7416686,NBS
chr05,Bn21847,26846019,98551691,71705672,NBS
chr05,Bn21848,88470642,92482749,4012107,RLK
chr05,Bn21849,50899368,52831304,1931936,CNL
chr05,Bn21850,69358132,71271869,1913737,CNL
chr05,Bn21851,50218648,80193181,29974533,CNL
chr05,Bn21852,62916040,62974007,57967,CN
chr05,Bn21853,89666994,94444949,4777955,NBS
chr05,Bn21854,99458299,99965808,507509,TN
chr05,Bn21855,89406891,95198653,5791762,CN
chr05,Bn21856,14023185,22662512,8639327,NBS
chr05,Bn21857,70700539,82729732,12029193,RLK
chr05,Bn21858,35344657,57182522,21837865,CN
chr05,Bn21859,35557574,93865854,58308280,CN
chr05,Bn21860,68451314,90351530,21900216,TNL
chr05,Bn21861,80320286,83507445,3187159,NBS
chr05,Bn21862,31495579,59494898,27999319,TN
chr05,Bn21863,69073530,84777145,15703615,TN
chr05,Bn21864,81579460,94482808,12903348,NBS
chr05,Bn21865,1513559,4334357,2820798,RLK
chr05,Bn21866,11847580,85735402,73887822,TNL
chr05,Bn21867,87790688,99810637,12019949,TN
chr05,Bn21868,3318730,60523034,57204304,TNL
chr05,Bn21869,97667701,97907148,239447,TNL
chr05,Bn21870,51364572,97420735,46056163,TN
chr05,Bn21871,43027316,84554205,41526889,NBS
chr05,Bn21872,81957965,88989151,7031186,RLP
chr05,Bn21873,30689475,52992543,22303068,RLK
chr05,Bn21874,95019750,97551960,2532210,RLK
chr05,Bn21875,79845350,96396533,16551183,NBS
chr05,Bn21876,44730759,83313124,38582365,TNL
chr05,Bn21877,19541420,19742318,200898,RLP
chr05,Bn21878,21306315,93563661,72257346,RLP
chr05,Bn21879,71692347,71881751,189404,NBS
chr05,Bn21880,47668690,66592368,18923678,TNL
chr05,Bn21881,13927344,91718228,77790884,TNL
chr05,Bn21882,68499250,80075801,11576551,TNL
chr05,Bn21883,56738606,58166973,1428367,CNL
chr05,Bn21884,85732573,94126824,8394251,TNL
chr05,Bn21885,19488332,50601911,31113579,RLP
chr05,Bn21886,86631025,90423015,3791990,RLK
chr05,Bn21887,60920136,83840574,22920438,NBS
chr05,Bn21888,34848630,38756553,3907923,RLP
chr05,Bn21889,90527539,97973528,7445989,TNL
chr05,Bn21890,20681838,69150365,48468527,TN
chr05,Bn21891,84800912,85177983,377071,RLP
chr05,Bn21892,70190758,72672313,2481555,TN
chr05,Bn21893,60491820,69747489,9255669,TN
chr05,Bn21894,28715093,76065473,47350380,CNL
chr05,Bn21895,39489756,66095339,26605583,CN
chr05,Bn21896,89853742,97548314,7694572,CNL
chr05,Bn21897,28825870,29363980,538110,CN
chr05,Bn21898,28029952,33689040,5659088,TNL
chr05,Bn21899,47980816,61164180,13183364,NBS
chr05,Bn21900,16363463,30999528,14636065,TNL
chr05,Bn21901,63888575,93975108,30086533,NBS
chr05,Bn21902,87051300,89398430,2347130,CNL
chr05,Bn21903,2487672,86409975,83922303,RLK
chr05,Bn21904,91625346,92616783,991437,TNL
chr05,Bn21905,66475869,94238586,27762717,NBS
chr05,Bn21906,4098937,13993331,9894394,TN
chr05,Bn21907,69747085,72113469,2366384,TN
chr05,Bn21908,81844351,99079663,17235312,RLP
chr05,Bn21909,98229759,98540039,310280,CN
chr05,Bn21910,36811775,92475114,55663339,NBS
chr05,Bn21911,92307144,98551842,6244698,RLK
chr05,Bn21912,11921738,34030525,22108787,TN
chr05,Bn21913,38167008,70811233,32644225,RLK
chr05,Bn21914,78818699,86969120,8150421,CNL
chr05,Bn21915,73852796,95836015,21983219,RLP
chr05,Bn21916,11494046,32283178,20789132,RLP
chr05,Bn21917,2939543,53493337,50553794,CNL
chr05,Bn21918,81703925,82456168,752243,CNL
chr05,Bn21919,32319728,73830384,41510656,TN
chr05,Bn21920,6429524,79675474,73245950,TNL
chr05,Bn21921,84194051,91157706,6963655,TNL
chr05,Bn21922,55207746,73201043,17993297,RLK
chr05,Bn21923,25258662,80204891,54946229,RLK
chr05,Bn21924,35385815,45818630,10432815,NBS
chr05,Bn21925,95989152,97685240,1696088,RLP
chr05,Bn21926,36386542,65324752,28938210,TNL
chr05,Bn21927,56784400,80634614,23850214,RLP
chr05,Bn21928,23254583,70072844,46818261,CNL
chr05,Bn21929,79848302,94875570,15027268,TN
chr05,Bn21930,16581737,87185987,70604250,RLP
chr05,Bn21931,47672917,60672543,12999626,RLP
chr05,Bn21932,92533939,97499155,4965216,CN
chr05,Bn21933,82926209,98284645,15358436,RLK
chr05,Bn21934,19592129,54471079,34878950,NBS
chr05,Bn21935,79186797,80667874,1481077,RLP
chr05,Bn21936,3697127,25970063,22272936,TN
chr05,Bn21937,58439859,89853950,31414091,CN
chr05,Bn21938,79284884,96867123,17582239,TNL
chr05,Bn21939,39670698,51923453,12252755,TN
chr05,Bn21940,26489123,66491010,40001887,RLP
chr05,Bn21941,52012587,60861101,8848514,CNL
chr05,Bn21942,57160141,69834972,12674831,RLP
chr05,Bn21943,1561051,62351567,60790516,TN
chr05,Bn21944,29063414,36289063,7225649,TNL
chr05,Bn21945,48208000,49003760,795760,RLP
chr05,Bn21946,57870121,98752830,40882709,NBS
chr05,Bn21947,95300024,96423573,1123549,CN
chr05,Bn21948,39009637,90042454,51032817,CNL
chr05,Bn21949,21945443,70730158,48784715,TNL
chr05,Bn21950,17818907,93807128,75988221,TN
chr05,Bn21951,37161878,74114348,36952470,TNL
chr05,Bn21952,23452847,76983943,53531096,RLP
chr05,Bn21953,42564448,43783888,1219440,TNL
chr05,Bn21954,94286833,98298133,4011300,CN
chr05,Bn21955,75036906,75253385,216479,NBS
chr05,Bn21956,92312385,99183790,6871405,TNL
chr05,Bn21957,58387000,85141454,26754454,TN
chr05,Bn21958,84526475,94840958,10314483,TNL
chr05,Bn21959,20797762,79582198,58784436,TN
chr05,Bn21960,47106665,71261579,24154914,RLK
chr05,Bn21961,45294981,92720377,47425396,TN
chr05,Bn21962,34158659,74204379,40045720,RLK
chr05,Bn21963,27111093,65905451,38794358,NBS
chr05,Bn21964,74500360,85049031,10548671,CNL
chr05,Bn21965,94128507,95685235,1556728,NBS
chr05,Bn21966,65121018,94435197,29314179,RLK
chr05,Bn21967,98093534,99063786,970252,RLK
chr05,Bn21968,7287301,49368001,42080700,CNL
chr05,Bn21969,76006417,91276415,15269998,CN
chr05,Bn21970,39320374,76286243,36965869,NBS
chr05,Bn21971,72849869,92238803,19388934,CNL
chr05,Bn21972,19903390,33535365,13631975,CNL
chr05,Bn21973,82267501,88447279,6179778,TN
chr05,Bn21974,35133777,74467613,39333836,RLP
chr05,Bn21975,47960199,78937282,30977083,CNL
chr05,Bn21976,90346942,94517314,4170372,RLP
chr05,Bn21977,69859007,78681934,8822927,NBS
chr05,Bn21978,18837521,55224996,36387475,RLK
chr05,Bn21979,26184374,83057574,56873200,RLK
chr05,Bn21980,42255281,94887944,52632663,TN
chr05,Bn21981,46213665,90240172,44026507,RLP
chr05,Bn21982,94228810,99996148,5767338,CN
chr05,Bn21983,85292782,92064169,6771387,RLP
chr05,Bn21984,41575663,73173496,31597833,RLP
chr05,Bn21985,65314010,80578371,15264361,NBS
chr05,Bn21986,8974944,91642696,82667752,RLP
chr05,Bn21987,64578165,91064959,26486794,TNL
chr05,Bn21988,68413463,75911570,7498107,RLK
chr05,Bn21989,64253455,77077971,12824516,RLK
chr05,Bn21990,74528292,79178322,4650030,CN
chr05,Bn21991,2391612,48280103,45888491,RLP
chr05,Bn21992,20856538,34154882,13298344,CNL
chr05,Bn21993,3720207,36582403,32862196,CNL
chr05,Bn21994,75501751,92694937,17193186,TN
chr05,Bn21995,58136243,96134186,37997943,TN
chr05,Bn21996,8257671,15276656,7018985,NBS
chr05,Bn21997,19073260,78097960,59024700,RLK
chr05,Bn21998,13969735,65313265,51343530,CNL
chr05,Bn21999,68078574,81821875,13743301,CNL
chr05,Bn22000,76747377,97393919,20646542,CNL
chr05,Bn22001,24709563,69524030,44814467,CN
chr05,Bn22002,5669260,98422063,92752803,RLK
chr05,Bn22003,44004926,98938754,54933828,TN
chr05,Bn22004,73537231,76230426,2693195,RLK
chr05,Bn22005,14948031,63771351,48823320,CN
chr05,Bn22006,28764370,68210069,39445699,TN
chr05,Bn22007,63730352,84113578,20383226,CN
chr05,Bn22008,41028335,63129809,22101474,RLP
chr05,Bn22009,69701407,95252850,25551443,RLK
chr05,Bn22010,9711004,92147290,82436286,RLP
chr05,Bn22011,55440754,79226971,23786217,RLP
chr05,Bn22012,29139883,55595088,26455205,NBS
chr05,Bn22013,67469341,97296812,29827471,CN
chr05,Bn22014,94718052,99457648,4739596,TN
chr05,Bn22015,25907353,39444133,13536780,TN
chr05,Bn22016,98711795,99728764,1016969,RLK
chr05,Bn22017,2752311,49616458,46864147,TNL
chr05,Bn22018,41543846,48865598,7321752,RLP
chr05,Bn22019,66825125,79821252,12996127,RLP
chr05,Bn22020,97590773,98882003,1291230,TNL
chr05,Bn22021,75726643,92268615,16541972,TNL
chr05,Bn22022,62513435,71491639,8978204,CN
chr05,Bn22023,35299663,81764871,46465208,TN
chr05,Bn22024,75107765,75252474,144709,RLK
chr05,Bn22025,78398863,81357864,2959001,TNL
chr05,Bn22026,75331265,77754176,2422911,CN
chr05,Bn22027,12605701,35501700,22895999,TNL
chr05,Bn22028,34683564,55614533,20930969,TN
chr05,Bn22029,7996839,13897722,5900883,CNL
chr05,Bn22030,73889213,93362833,19473620,TN
chr05,Bn22031,70365772,72779484,2413712,NBS
chr05,Bn22032,84858462,92001963,7143501,TNL
chr05,Bn22033,21844289,61553850,39709561,CNL
chr05,Bn22034,53745685,94639519,40893834,RLP
chr05,Bn22035,77909777,98237110,20327333,NBS
chr05,Bn22036,37122635,53109381,15986746,CN
chr05,Bn22037,79244485,96833758,17589273,NBS
chr05,Bn22038,19758349,46618429,26860080,CN
chr05,Bn22039,83913579,85601376,1687797,TN
chr05,Bn22040,39914200,64180780,24266580,CN
chr05,Bn22041,37308553,69342010,32033457,RLK
chr05,Bn22042,49345897,99886174,50540277,RLP
chr05,Bn22043,59454973,68031095,8576122,NBS
chr05,Bn22044,45716378,79757077,34040699,RLP
chr05,Bn22045,54031582,62406084,8374502,CN
chr05,Bn22046,65837236,86949495,21112259,NBS
chr05,Bn22047,33199729,36236303,3036574,NBS
chr05,Bn22048,45229230,61262386,16033156,CN
chr05,Bn22049,93342191,98735556,5393365,TNL
chr05,Bn22050,26753276,88234711,61481435,RLK
chr05,Bn22051,58590479,86731818,28141339,RLK
chr05,Bn22052,58454332,75421407,16967075,RLK
chr05,Bn22053,39928082,67557823,27629741,TN
chr05,Bn22054,69054828,74227754,5172926,NBS
chr05,Bn22055,84830034,87955451,3125417,RLK
chr05,Bn22056,65757390,96683580,30926190,RLP
chr05,Bn22057,29303255,32336743,3033488,NBS
chr05,Bn22058,81065354,82112489,1047135,TNL
chr05,Bn22059,53649892,59539567,5889675,CN
chr05,Bn22060,5775904,72866711,67090807,CNL
chr05,Bn22061,36695916,73280175,36584259,RLP
chr05,Bn22062,50118565,55066391,4947826,TNL
chr05,Bn22063,73997991,85474690,11476699,CN
chr05,Bn22064,15278551,23515640,8237089,NBS
chr05,Bn22065,66235154,96236538,30001384,RLK
chr05,Bn22066,14998783,23787739,8788956,NBS
chr05,Bn22067,59077539,61260014,2182475,TNL
chr05,Bn22068,43809667,81523953,37714286,RLK
chr05,Bn22069,5879390,68778986,62899596,CN
chr05,Bn22070,6107710,13732267,7624557,TNL
chr05,Bn22071,79106088,85806207,6700119,NBS
chr05,Bn22072,46298388,70084301,23785913,TNL
chr05,Bn22073,57094421,85426651,28332230,RLP
chr05,Bn22074,11572481,61393839,49821358,TN
chr05,Bn22075,8949895,80298838,71348943,NBS
chr05,Bn22076,88717013,98963526,10246513,RLK
chr05,Bn22077,30928306,52613370,21685064,CN
chr05,Bn22078,52404841,81180532,28775691,RLK
chr05,Bn22079,51329189,95584056,44254867,NBS
chr05,Bn22080,60621332,67400408,6779076,CNL
chr05,Bn22081,42905128,92204030,49298902,CNL
chr05,Bn22082,51167138,89424196,38257058,TNL
chr05,Bn22083,14609525,70504422,55894897,CNL
chr05,Bn22084,84214436,92148046,7933610,NBS
chr05,Bn22085,49232206,63621585,14389379,CNL
chr05,Bn22086,99382185,99493106,110921,RLK
chr05,Bn22087,78759093,92196704,13437611,TN
chr05,Bn22088,75607857,87874154,12266297,NBS
chr05,Bn22089,61823917,95316452,33492535,TNL
chr05,Bn22090,64199488,79575600,15376112,TNL
chr05,Bn22091,59217532,95650558,36433026,RLK
chr05,Bn22092,53671795,94777357,41105562,TNL
chr05,Bn22093,85591157,86926417,1335260,TNL
chr05,Bn22094,21073075,47066978,25993903,TN
chr05,Bn22095,22716018,81563961,58847943,CN
chr05,Bn22096,67469871,81589306,14119435,CN
chr05,Bn22097,52372723,59350923,6978200,RLK
chr05,Bn22098,18364967,60001188,41636221,CN
chr05,Bn22099,18033303,73141339,55108036,TN
chr05,Bn22100,90311191,94508871,4197680,RLP
chr05,Bn22101,5088018,53672903,48584885,TNL
chr05,Bn22102,26509866,76329875,49820009,TN
chr05,Bn22103,37722925,40970753,3247828,CN
chr05,Bn22104,1405949,97928073,96522124,TNL
chr05,Bn22105,21632084,43758581,22126497,RLP
chr05,Bn22106,70647055,74778361,4131306,RLP
chr05,Bn22107,55266089,57601877,2335788,NBS
chr05,Bn22108,53072261,75019531,21947270,CNL
chr05,Bn22109,64992890,77563503,12570613,CN
chr05,Bn22110,82557030,98931267,16374237,CNL
chr05,Bn22111,45237788,84973639,39735851,TN
chr05,Bn22112,51672060,69001658,17329598,NBS
chr05,Bn22113,9981721,55977975,45996254,RLK
chr05,Bn22114,50254938,69251454,18996516,RLP
chr05,Bn22115,92492708,98488475,5995767,RLK
chr05,Bn22116,88826488,90816185,1989697,CNL
chr05,Bn22117,94311170,98183054,3871884,CNL
chr05,Bn22118,16483052,38561048,22077996,CNL
chr05,Bn22119,98506585,99515118,1008533,NBS
chr05,Bn22120,68626898,91601704,22974806,RLK
chr05,Bn22121,74866229,95181730,20315501,RLK
chr05,Bn22122,67058426,98377516,31319090,NBS
chr05,Bn22123,9217654,31734820,22517166,RLK
chr05,Bn22124,35088713,54520146,19431433,RLP
chr05,Bn22125,49847261,60907070,11059809,TNL
chr05,Bn22126,25249311,85690324,60441013,RLK
chr05,Bn22127,53632303,81487978,27855675,CN
chr05,Bn22128,2800194,56690888,53890694,NBS
chr05,Bn22129,47125235,68927996,21802761,CNL
chr05,Bn22130,75707427,88286278,12578851,RLP
chr05,Bn22131,22269317,40064604,17795287,TNL
chr05,Bn22132,27970435,68729520,40759085,CN
chr05,Bn22133,54193676,71710854,17517178,NBS
chr05,Bn22134,98762857,99194947,432090,CN
chr05,Bn22135,65181678,72820402,7638724,NBS
chr05,Bn22136,29824808,30600684,775876,CN
chr05,Bn22137,31151029,63422131,32271102,TN
chr05,Bn22138,33627330,79218467,45591137,CNL
chr05,Bn22139,37196485,52549557,15353072,CN
chr05,Bn22140,23412594,76892394,53479800,RLK
chr05,Bn22141,7973072,47540077,39567005,TNL
chr05,Bn22142,2269024,48227195,45958171,CN
chr05,Bn22143,45989365,93893837,47904472,TNL
chr05,Bn22144,36789446,80523663,43734217,NBS
chr05,Bn22145,7882422,63640160,55757738,RLP
chr05,Bn22146,43052396,57932197,14879801,TNL
chr05,Bn22147,8066777,84934272,76867495,CN
chr05,Bn22148,23875192,29626444,5751252,RLK
chr05,Bn22149,43681937,78398776,34716839,RLK
chr05,Bn22150,72539569,77683727,5144158,TNL
chr05,Bn22151,41383649,70339364,28955715,TNL
chr05,Bn22152,81696155,94015047,12318892,CN
chr05,Bn22153,35323772,56935723,21611951,NBS
chr05,Bn22154,74834330,89980619,15146289,CNL
chr05,Bn22155,45334422,94045144,48710722,TN
chr05,Bn22156,79515456,97790912,18275456,TN
chr05,Bn22157,4988098,51894381,46906283,CN
chr05,Bn22158,49604180,57020734,7416554,RLP
chr05,Bn22159,93920281,97382190,3461909,CN
chr05,Bn22160,16621373,33567520,16946147,TNL
chr05,Bn22161,32308596,43769746,11461150,RLK
chr05,Bn22162,57214662,79422546,22207884,TNL
chr05,Bn22163,95782549,98017366,2234817,TNL
chr05,Bn22164,64925838,72349462,7423624,RLP
chr05,Bn22165,47662506,90005993,42343487,RLP
chr05,Bn22166,35645475,59662867,24017392,TN
chr05,Bn22167,78906010,99689772,20783762,TNL
chr05,Bn22168,28568121,57589113,29020992,RLK
chr05,Bn22169,87178733,92155771,4977038,NBS
chr05,Bn22170,88930573,94863171,5932598,CNL
chr05,Bn22171,70253141,89926824,19673683,TN
chr05,Bn22172,83759373,90036908,6277535,CN
chr05,Bn22173,89687631,94680290,4992659,RLP
chr05,Bn22174,14827371,48552448,33725077,NBS
chr05,Bn22175,52451103,56573937,4122834,TNL
chr05,Bn22176,36401602,81291017,44889415,NBS
chr05,Bn22177,74058050,79729848,5671798,CNL
chr05,Bn22178,10337888,86517417,76179529,CN
chr05,Bn22179,2818783,21167199,18348416,RLK
chr05,Bn22180,85610529,87127234,1516705,RLP
chr05,Bn22181,36694863,38435709,1740846,RLP
chr05,Bn22182,18134824,28005694,9870870,TNL
chr05,Bn22183,19454790,73087719,53632929,TN
chr05,Bn22184,14046420,83102171,69055751,TNL
chr05,Bn22185,55707126,66259295,10552169,TN
chr05,Bn22186,75962155,96475364,20513209,TN
chr05,Bn22187,66404652,85405993,19001341,CNL
chr05,Bn22188,84048064,97024985,12976921,RLK
chr05,Bn22189,14893993,91923787,77029794,CNL
chr05,Bn22190,88598506,98293029,9694523,CNL
chr05,Bn22191,91603883,98726191,7122308,RLP
chr05,Bn22192,80472911,96752708,16279797,CNL
chr05,Bn22193,42416566,60054996,17638430,RLK
chr05,Bn22194,51268887,99520477,48251590,CN
chr05,Bn22195,84279629,91547833,7268204,CNL
chr05,Bn22196,47882870,88854084,40971214,NBS
chr05,Bn22197,48975257,95334914,46359657,TN
chr05,Bn22198,56187851,75947583,19759732,CN
chr05,Bn22199,86680648,95951454,9270806,TN
chr05,Bn22200,77617509,80008770,2391261,NBS
chr05,Bn22201,21797189,51609973,29812784,NBS
chr05,Bn22202,83266581,89790089,6523508,NBS
chr05,Bn22203,81338111,93480600,12142489,NBS
chr05,Bn22204,19222408,54376291,35153883,RLP
chr05,Bn22205,91575416,93301360,1725944,CNL
chr05,Bn22206,46925067,48654176,1729109,NBS
chr05,Bn22207,71508812,99249543,27740731,TN
chr05,Bn22208,32337967,98622763,66284796,RLK
chr05,Bn22209,21833238,76514362,54681124,TN
chr05,Bn22210,47027969,53092784,6064815,CNL
chr05,Bn22211,12939507,28517693,15578186,RLK
chr05,Bn22212,48850006,99561364,50711358,CNL
chr05,Bn22213,69188455,79384657,10196202,CNL
chr05,Bn22214,96290666,99004620,2713954,TN
chr05,Bn22215,44073965,65219309,21145344,NBS
chr05,Bn22216,12936140,29894922,16958782,CN
chr05,Bn22217,39653394,64551907,24898513,TNL
chr05,Bn22218,9735231,20262368,10527137,NBS
chr05,Bn22219,68217025,76495167,8278142,TNL
chr05,Bn22220,34890039,84746445,49856406,TN
chr05,Bn22221,17664345,39461905,21797560,TN
chr05,Bn22222,87209279,90040161,2830882,RLP
chr05,Bn22223,27164338,52777046,25612708,CNL
chr05,Bn22224,89830362,96188014,6357652,CN
chr05,Bn22225,64749669,90038696,25289027,TN
chr05,Bn22226,50906893,96401196,45494303,CN
chr05,Bn22227,28034262,72778042,44743780,TNL
chr05,Bn22228,44314995,69391597,25076602,TN
chr05,Bn22229,81090016,88993022,7903006,RLK
chr05,Bn22230,77936844,83700841,5763997,RLK
chr05,Bn22231,60256025,94417206,34161181,NBS
chr05,Bn22232,70082124,99792269,29710145,CNL
chr05,Bn22233,60847202,93344985,32497783,TNL
chr05,Bn22234,93055753,99278105,6222352,NBS
chr05,Bn22235,7787612,64695658,56908046,CN
chr05,Bn22236,5204974,46394940,41189966,TN
chr05,Bn22237,92082979,99357911,7274932,TN
chr05,Bn22238,20903351,60973930,40070579,CNL
chr05,Bn22239,19790958,69771369,49980411,TNL
chr05,Bn22240,70948980,93582221,22633241,RLP
chr05,Bn22241,94678155,95634742,956587,CNL
chr05,Bn22242,65844771,86129970,20285199,CNL
chr05,Bn22243,16843569,65573345,48729776,RLK
chr05,Bn22244,69685220,86252858,16567638,CN
chr05,Bn22245,5025524,10496865,5471341,NBS
chr05,Bn22246,10142875,93927423,83784548,RLP
chr05,Bn22247,56020414,86979670,30959256,TN
chr05,Bn22248,82433204,99057440,16624236,RLK
chr05,Bn22249,49654891,87641034,37986143,TN
chr05,Bn22250,14310637,23096933,8786296,TN
chr05,Bn22251,96572561,98275467,1702906,RLK
chr05,Bn22252,31088942,34842208,3753266,RLP
chr05,Bn22253,72821459,82102141,9280682,CN
chr05,Bn22254,67273299,91675444,24402145,TNL
chr05,Bn22255,56499391,86009483,29510092,NBS
chr05,Bn22256,35155360,42908539,7753179,RLP
chr05,Bn22257,21892252,53516100,31623848,RLK
chr05,Bn22258,85514665,98104404,12589739,NBS
chr05,Bn22259,30027596,55057461,25029865,RLK
chr05,Bn22260,71285330,71616653,331323,RLP
chr05,Bn22261,7942494,61194198,53251704,NBS
chr05,Bn22262,26977017,97541116,70564099,RLK
chr05,Bn22263,56559682,68171194,11611512,NBS
chr05,Bn22264,27461352,87950755,60489403,NBS
chr05,Bn22265,92563584,96581538,4017954,RLP
chr05,Bn22266,55628486,85807420,30178934,TN
chr05,Bn22267,43396604,68129451,24732847,RLP
chr05,Bn22268,41466079,87471339,46005260,RLP
chr05,Bn22269,56484039,57965634,1481595,NBS
chr05,Bn22270,1842877,3434160,1591283,RLP
chr05,Bn22271,60485261,77040138,16554877,TN
chr05,Bn22272,77975797,79484800,1509003,NBS
chr05,Bn22273,18848094,30237252,11389158,CN
chr05,Bn22274,98429836,99935844,1506008,TN
chr05,Bn22275,93073130,99166917,6093787,RLP
chr05,Bn22276,54761385,83287138,28525753,NBS
chr05,Bn22277,93890982,97471379,3580397,CN
chr05,Bn22278,86880129,94101268,7221139,TNL
chr05,Bn22279,81120339,90110475,8990136,CNL
chr05,Bn22280,52414742,84569503,32154761,CN
chr05,Bn22281,32591108,87908085,55316977,RLK
chr05,Bn22282,65850539,73918125,8067586,RLK
chr05,Bn22283,6392685,90295781,83903096,TNL
chr05,Bn22284,62231208,96786063,34554855,RLK
chr05,Bn22285,71584491,73132735,1548244,CNL
chr05,Bn22286,46407665,62210587,15802922,NBS
chr05,Bn22287,4359223,26757221,22397998,TN
chr05,Bn22288,57260440,61337037,4076597,CN
chr05,Bn22289,47750872,86077447,38326575,CN
chr05,Bn22290,73767685,96275341,22507656,CN
chr05,Bn22291,64866885,65974156,1107271,TNL
chr05,Bn22292,75369138,77521289,2152151,TNL
chr05,Bn22293,45592218,86496667,40904449,CNL
chr05,Bn22294,93157280,98886170,5728890,CNL
chr05,Bn22295,22058793,62971769,40912976,RLP
chr05,Bn22296,87223002,95098676,7875674,RLP
chr05,Bn22297,31348263,74619226,43270963,TN
chr05,Bn22298,78637509,83565107,4927598,RLP
chr05,Bn22299,22242492,24510314,2267822,TNL
chr05,Bn22300,57785870,68501236,10715366,NBS
chr05,Bn22301,54747300,70423253,15675953,RLK
chr05,Bn22302,55709354,58060045,2350691,TN
chr05,Bn22303,60558309,87094312,26536003,TNL
chr05,Bn22304,61226507,79673266,18446759,NBS
chr05,Bn22305,33744345,65008439,31264094,NBS
chr05,Bn22306,67732375,83228169,15495794,RLK
chr05,Bn22307,57558533,94702862,37144329,RLP
chr05,Bn22308,75644591,80026582,4381991,CN
chr05,Bn22309,69988299,94063451,24075152,RLP
chr05,Bn22310,79454250,94261644,14807394,RLP
chr05,Bn22311,8350282,44551765,36201483,TN
chr05,Bn22312,53759571,65742222,11982651,RLK
chr05,Bn22313,76963445,77223875,260430,CN
chr05,Bn22314,90274264,93784311,3510047,RLP
chr05,Bn22315,55630935,94522653,38891718,RLP
chr05,Bn22316,16861595,34189208,17327613,RLP
chr05,Bn22317,37338872,64761110,27422238,RLP
chr05,Bn22318,47271144,91869873,44598729,RLK
chr05,Bn22319,33449184,57413709,23964525,TNL
chr05,Bn22320,70196924,96442574,26245650,CN
chr05,Bn22321,34374718,40648782,6274064,RLK
chr05,Bn22322,38591339,67434041,28842702,NBS
chr05,Bn22323,3697823,95022832,91325009,TN
chr05,Bn22324,50739573,69558700,18819127,CN
chr05,Bn22325,78842929,85516905,6673976,CN
chr05,Bn22326,83033962,94174455,11140493,NBS
chr05,Bn22327,71574386,97582645,26008259,RLP
chr05,Bn22328,97330141,99043850,1713709,NBS
chr05,Bn22329,13701090,31128767,17427677,CN
chr05,Bn22330,13034730,31113669,18078939,CN
chr05,Bn22331,5671515,77407215,71735700,TN
chr05,Bn22332,18761538,25670434,6908896,CN
chr05,Bn22333,23994678,75510051,51515373,TNL
chr05,Bn22334,25737607,40887929,15150322,CN
chr05,Bn22335,52251475,56240368,3988893,RLP
chr05,Bn22336,59932869,88884231,28951362,RLP
chr05,Bn22337,37612065,78146044,40533979,TNL
chr05,Bn22338,83639911,95609617,11969706,TN
chr05,Bn22339,95142859,99120725,3977866,RLK
chr05,Bn22340,51734210,79177282,27443072,CN
chr05,Bn22341,45176264,65157365,19981101,CNL
chr05,Bn22342,5129935,31671724,26541789,RLP
chr05,Bn22343,44884968,98409197,53524229,TNL
chr05,Bn22344,68565725,81759587,13193862,NBS
chr05,Bn22345,8944726,43063184,34118458,NBS
chr05,Bn22346,50162938,85682581,35519643,TN
chr05,Bn22347,95851417,98223992,2372575,TN
chr05,Bn22348,38116021,87035811,48919790,RLP
chr05,Bn22349,30784989,66949020,36164031,TNL
chr05,Bn22350,28775242,83590732,54815490,NBS
chr05,Bn22351,71493992,77319517,5825525,TN
chr05,Bn22352,21896163,46904668,25008505,TN
chr05,Bn22353,94827440,95919962,1092522,CNL
chr05,Bn22354,15232115,32742454,17510339,TN
chr05,Bn22355,94488322,99990017,5501695,CN
chr05,Bn22356,22023567,59942671,37919104,RLP
chr05,Bn22357,78295176,97021254,18726078,RLK
chr05,Bn22358,77403264,78895330,1492066,TNL
chr05,Bn22359,58984961,85197491,26212530,RLP
chr05,Bn22360,7417533,20279148,12861615,TN
chr05,Bn22361,1475756,47717696,46241940,RLK
chr05,Bn22362,46113823,66326237,20212414,NBS
chr05,Bn22363,40586592,45078465,4491873,NBS
chr05,Bn22364,1822224,69865774,68043550,NBS
chr05,Bn22365,76162879,96143451,19980572,NBS
chr05,Bn22366,52040278,67874567,15834289,CN
chr05,Bn22367,96977976,99169062,2191086,CNL
chr05,Bn22368,52710877,99016459,46305582,TN
chr05,Bn22369,69533885,76588392,7054507,RLP
chr05,Bn22370,32248128,40921203,8673075,CNL
chr05,Bn22371,54796660,76983789,22187129,TN
chr05,Bn22372,13598665,94620526,81021861,TN
chr05,Bn22373,50742902,89718989,38976087,TN
chr05,Bn22374,75156595,77168867,2012272,CNL
chr05,Bn22375,71212165,84932201,13720036,NBS
chr05,Bn22376,26285910,49826988,23541078,RLK
chr05,Bn22377,2725900,55996039,53270139,CN
chr05,Bn22378,29289178,86200686,56911508,TNL
chr05,Bn22379,77261664,97708655,20446991,CNL
chr05,Bn22380,83197685,89648874,6451189,CN
chr05,Bn22381,85706089,91750799,6044710,CN
chr05,Bn22382,59977797,78805710,18827913,RLP
chr05,Bn22383,59453918,78435203,18981285,NBS
chr05,Bn22384,75939909,96306229,20366320,TN
chr05,Bn22385,1291462,51494638,50203176,CN
chr05,Bn22386,17725282,97305073,79579791,TN
chr05,Bn22387,98518532,99111202,592670,RLK
chr05,Bn22388,2092082,53480986,51388904,NBS
chr05,Bn22389,32442238,90546814,58104576,CNL
chr05,Bn22390,12760806,43735861,30975055,CNL
chr05,Bn22391,46008791,71583972,25575181,NBS
chr05,Bn22392,10764877,33907399,23142522,RLK
chr05,Bn22393,51917520,72965731,21048211,CNL
chr05,Bn22394,57149263,88288796,31139533,CNL
chr05,Bn22395,38596772,63771460,25174688,TNL
chr05,Bn22396,69076302,76969861,7893559,NBS
chr05,Bn22397,81325074,92798583,11473509,RLK
chr05,Bn22398,77180134,85785999,8605865,TN
chr05,Bn22399,44931780,92186030,47254250,TN
chr05,Bn22400,6149043,98775562,92626519,CNL
chr05,Bn22401,97730262,98139680,409418,CN
chr05,Bn22402,65915031,77345235,11430204,TNL
chr05,Bn22403,42386308,88308608,45922300,CNL
chr05,Bn22404,73748300,88280760,14532460,NBS
chr05,Bn22405,52017479,78489851,26472372,NBS
chr05,Bn22406,20024086,61548134,41524048,CN
chr05,Bn22407,84677315,93683129,9005814,TN
chr05,Bn22408,67517007,82124912,14607905,RLP
chr05,Bn22409,18808568,44905113,26096545,NBS
chr05,Bn22410,25771773,96981045,71209272,CNL
chr05,Bn22411,8355282,66937268,58581986,CN
chr05,Bn22412,17578390,35625387,18046997,TNL
chr05,Bn22413,32432828,90079152,57646324,NBS
chr05,Bn22414,70399520,81462102,11062582,CNL
chr05,Bn22415,13663920,53292497,39628577,CN
chr05,Bn22416,70156624,85060023,14903399,RLK
chr05,Bn22417,50999163,80475600,29476437,TN
chr05,Bn22418,58194682,87633803,29439121,TN
chr05,Bn22419,91485659,99794875,8309216,RLP
chr05,Bn22420,26685770,70505638,43819868,NBS
chr05,Bn22421,63487905,81484031,17996126,RLP
chr05,Bn22422,71889050,87576832,15687782,CNL
chr05,Bn22423,62091250,74920919,12829669,CN
chr05,Bn22424,55564604,78455726,22891122,RLK
chr05,Bn22425,66863539,74179150,7315611,CNL
chr05,Bn22426,21389195,85909172,64519977,NBS
chr05,Bn22427,83696158,92495766,8799608,RLK
chr05,Bn22428,13029212,89101533,76072321,RLK
chr05,Bn22429,61952958,98716203,36763245,RLK
chr05,Bn22430,36552945,45688768,9135823,RLP
chr05,Bn22431,52841501,89378409,36536908,TNL
chr05,Bn22432,28766233,38836041,10069808,CNL
chr05,Bn22433,67382991,77582086,10199095,CNL
chr05,Bn22434,27188267,55496645,28308378,RLK
chr05,Bn22435,87125318,98169662,11044344,RLP
chr05,Bn22436,85464578,87467027,2002449,TN
chr05,Bn22437,11647891,52705256,41057365,CNL
chr05,Bn22438,33104502,69778511,36674009,NBS
chr05,Bn22439,45729923,77957290,32227367,CN
chr05,Bn22440,26785153,64701667,37916514,RLK
chr05,Bn22441,89709843,98108520,8398677,RLP
chr05,Bn22442,60810379,81525900,20715521,TNL
chr05,Bn22443,65136140,81173808,16037668,CN
chr05,Bn22444,66264836,94167869,27903033,RLK
chr05,Bn22445,94870479,97737508,2867029,CN
chr05,Bn22446,62507103,87228148,24721045,TN
chr05,Bn22447,90318140,91190947,872807,TNL
chr05,Bn22448,79159317,96836849,17677532,CNL
chr05,Bn22449,12821419,17769086,4947667,RLK
chr05,Bn22450,34651320,61772151,27120831,TN
chr05,Bn22451,26951814,59178340,32226526,CNL
chr05,Bn22452,50613362,96199261,45585899,CN
chr05,Bn22453,16746205,86395236,69649031,TNL
chr05,Bn22454,66801945,74564568,7762623,RLP
chr05,Bn22455,33774619,57753085,23978466,TNL
chr05,Bn22456,55550354,95281196,39730842,CNL
chr05,Bn22457,97115020,99245824,2130804,TNL
chr05,Bn22458,32626393,75438936,42812543,CNL
chr05,Bn22459,66292722,79274123,12981401,NBS
chr05,Bn22460,69571108,81574416,12003308,NBS
chr05,Bn22461,18633529,52058914,33425385,NBS
chr05,Bn22462,29736832,94500792,64763960,RLK
chr05,Bn22463,4266905,13675847,9408942,NBS
chr05,Bn22464,21749256,26097512,4348256,TNL
chr05,Bn22465,19534625,29935009,10400384,RLP
chr05,Bn22466,60109177,87579682,27470505,NBS
chr05,Bn22467,93086096,97111183,4025087,TNL
chr05,Bn22468,77230615,85860053,8629438,TN
chr05,Bn22469,46147917,47383829,1235912,CNL
chr05,Bn22470,11543371,99527542,87984171,TN
chr05,Bn22471,83484750,93813772,10329022,NBS
chr05,Bn22472,59102097,96710247,37608150,TNL
chr05,Bn22473,27334887,43520015,16185128,NBS
chr05,Bn22474,6732762,39221507,32488745,RLK
chr05,Bn22475,53829692,94817490,40987798,RLK
chr05,Bn22476,84735294,99065351,14330057,NBS
chr05,Bn22477,21461909,90627709,69165800,NBS
chr05,Bn22478,63181402,78947526,15766124,CN
chr05,Bn22479,42157494,78883169,36725675,TN
chr05,Bn22480,71923772,96186355,24262583,RLK
chr05,Bn22481,43682926,85601034,41918108,NBS
chr05,Bn22482,3847625,7813765,3966140,CN
chr05,Bn22483,54479662,58586397,4106735,CNL
chr05,Bn22484,95825512,98050349,2224837,RLP
chr05,Bn22485,42696281,43210346,514065,NBS
chr05,Bn22486,89582200,99514269,9932069,RLP
chr05,Bn22487,97260625,98033563,772938,CNL
chr05,Bn22488,78544765,84250994,5706229,RLK
chr05,Bn22489,35787211,84345136,48557925,NBS
chr05,Bn22490,20669511,83451426,62781915,CNL
chr05,Bn22491,48381558,65713371,17331813,CN
chr05,Bn22492,30282419,31576129,1293710,RLK
chr05,Bn22493,59450425,61838218,2387793,RLK
chr05,Bn22494,58567044,81422431,22855387,TN
chr05,Bn22495,24188865,25617604,1428739,CN
chr05,Bn22496,19874787,59335398,39460611,CN
chr05,Bn22497,21305608,91417099,70111491,CN
chr05,Bn22498,43873977,58985337,15111360,RLK
chr05,Bn22499,58050284,62097536,4047252,CNL
chr05,Bn22500,94149629,97004415,2854786,CN
chr05,Bn22501,8518586,9066906,548320,TNL
chr05,Bn22502,74443342,89609706,15166364,CNL
chr05,Bn22503,39154603,79702950,40548347,CN
chr05,Bn22504,70083192,82139410,12056218,RLK
chr05,Bn22505,53807687,93605246,39797559,CNL
chr05,Bn22506,83041721,89554470,6512749,TN
chr05,Bn22507,92094412,96814952,4720540,CNL
chr05,Bn22508,27743730,93182142,65438412,RLK
chr05,Bn22509,48309000,88737036,40428036,CNL
chr05,Bn22510,60790896,90877930,30087034,TN
chr05,Bn22511,84584276,93871827,9287551,CNL
chr05,Bn22512,8547556,59978607,51431051,RLP
chr05,Bn22513,39712261,86376633,46664372,CNL
chr05,Bn22514,94017649,97079400,3061751,CNL
chr05,Bn22515,48290253,64621901,16331648,TN
chr05,Bn22516,50779913,61422881,10642968,CNL
chr05,Bn22517,71388792,81469560,10080768,NBS
chr05,Bn22518,24984553,32878374,7893821,RLP
chr05,Bn22519,45505832,75699345,30193513,CNL
chr05,Bn22520,60018555,94330854,34312299,RLK
chr05,Bn22521,19261057,55640735,36379678,RLP
chr05,Bn22522,4411614,29980534,25568920,TNL
chr05,Bn22523,63309653,94073401,30763748,TN
chr05,Bn22524,47729579,64397701,16668122,RLP
chr05,Bn22525,49739214,70501868,20762654,NBS
chr05,Bn22526,41495781,73880387,32384606,TN
chr05,Bn22527,63835160,93776376,29941216,CNL
chr05,Bn22528,40415351,84467592,44052241,TN
chr05,Bn22529,71091731,95605906,24514175,CN
chr05,Bn22530,26292303,29973328,3681025,CNL
chr05,Bn22531,74013924,79304432,5290508,RLK
chr05,Bn22532,97686714,97927834,241120,RLK
chr05,Bn22533,19792272,37089608,17297336,CNL
chr05,Bn22534,64172462,86457938,22285476,CN
chr05,Bn22535,47846570,76736886,28890316,TNL
chr05,Bn22536,31741747,56803283,25061536,CNL
chr05,Bn22537,49589914,55910658,6320744,TNL
chr05,Bn22538,63372988,77813902,14440914,RLK
chr05,Bn22539,21187662,62206980,41019318,NBS
chr05,Bn22540,13426376,48205257,34778881,NBS
chr05,Bn22541,82660769,85745647,3084878,RLK
chr05,Bn22542,10236674,24241156,14004482,TNL
chr05,Bn22543,41067365,89224189,48156824,TNL
chr05,Bn22544,11883975,67036851,55152876,NBS
chr05,Bn22545,42307961,62920696,20612735,RLP
chr05,Bn22546,99547446,99587330,39884,NBS
chr05,Bn22547,23474455,81574421,58099966,CN
chr05,Bn22548,19639445,52941315,33301870,CN
chr05,Bn22549,78924874,93083789,14158915,NBS
chr05,Bn22550,93311907,95884378,2572471,RLP
chr05,Bn22551,89399140,90411768,1012628,TNL
chr05,Bn22552,99818801,99868395,49594,NBS
chr05,Bn22553,47144378,50901294,3756916,RLP
chr05,Bn22554,46592065,88206942,41614877,RLK
chr05,Bn22555,26578598,68249393,41670795,CNL
chr05,Bn22556,7118839,27695418,20576579,TNL
chr05,Bn22557,98722115,98887773,165658,TNL
chr05,Bn22558,35482331,64918439,29436108,CN
chr05,Bn22559,44704099,50668647,5964548,RLK
chr05,Bn22560,27816285,89232064,61415779,TNL
chr05,Bn22561,91867789,96127757,4259968,CNL
chr05,Bn22562,53691372,62980174,9288802,CNL
chr05,Bn22563,78508150,96093564,17585414,TNL
chr05,Bn22564,70242554,90856653,20614099,TNL
chr05,Bn22565,46966144,76187542,29221398,NBS
chr05,Bn22566,63036165,88029206,24993041,CN
chr05,Bn22567,58461409,81273977,22812568,TNL
chr05,Bn22568,35556357,90096565,54540208,RLP
chr05,Bn22569,69155373,69603569,448196,TN
chr05,Bn22570,59326844,74419423,15092579,CN
chr05,Bn22571,12782159,31127203,18345044,NBS
chr05,Bn22572,45523737,85776197,40252460,CN
chr05,Bn22573,71810435,89166118,17355683,NBS
chr05,Bn22574,3930127,45760848,41830721,RLP
chr05,Bn22575,74594203,79319735,4725532,CNL
chr05,Bn22576,96345143,98391609,2046466,CNL
chr05,Bn22577,83083049,96208210,13125161,TN
chr05,Bn22578,18021980,90233847,72211867,RLP
chr05,Bn22579,8725296,78839530,70114234,TNL
chr05,Bn22580,50989410,60384002,9394592,CN
chr05,Bn22581,55866535,82952460,27085925,NBS
chr05,Bn22582,25966223,87231814,61265591,TNL
chr05,Bn22583,81230976,87965415,6734439,TNL
chr05,Bn22584,84747379,90559081,5811702,TN
chr05,Bn22585,90319618,99969480,9649862,RLP
chr05,Bn22586,46231277,49068294,2837017,RLP
chr05,Bn22587,84910252,92538427,7628175,NBS
chr05,Bn22588,69997279,84684866,14687587,CN
chr05,Bn22589,21182800,34697575,13514775,CNL
chr05,Bn22590,90664368,94064173,3399805,CNL
chr05,Bn22591,14222404,67963198,53740794,CNL
chr05,Bn22592,92287675,98285357,5997682,RLP
chr05,Bn22593,97986477,98606415,619938,CNL
chr05,Bn22594,95099202,98480544,3381342,RLK
chr05,Bn22595,15832339,17508182,1675843,NBS
chr05,Bn22596,96033772,96987628,953856,NBS
chr05,Bn22597,97642053,97859498,217445,NBS
chr05,Bn22598,87012174,95783531,8771357,NBS
chr05,Bn22599,8155967,38906886,30750919,CN
chr05,Bn22600,30682683,83013210,52330527,CN
chr05,Bn22601,44245700,95227253,50981553,TNL
chr05,Bn22602,9118716,36860531,27741815,RLP
chr05,Bn22603,28473374,57755109,29281735,CNL
chr05,Bn22604,15102584,23936187,8833603,TNL
chr05,Bn22605,1089961,24469420,23379459,CNL
chr05,Bn22606,93960079,99073338,5113259,CNL
chr05,Bn22607,46616318,71405759,24789441,CN
chr05,Bn22608,70569805,94600286,24030481,TNL
chr05,Bn22609,69735131,77701299,7966168,NBS
chr05,Bn22610,44490806,90424607,45933801,TN
chr05,Bn22611,99048827,99758258,709431,CNL
chr05,Bn22612,10974525,42307338,31332813,RLK
chr05,Bn22613,13011122,96696901,83685779,TN
chr05,Bn22614,45963737,75284697,29320960,CNL
chr05,Bn22615,47115696,60587228,13471532,TN
chr05,Bn22616,85234976,96905807,11670831,TNL
chr05,Bn22617,45409853,86798852,41388999,RLK
chr05,Bn22618,53752858,93428738,39675880,RLP
chr05,Bn22619,40959384,56728115,15768731,NBS
chr05,Bn22620,36207987,77287299,41079312,CN
chr05,Bn22621,46328885,73974220,27645335,TNL
chr05,Bn22622,21581333,50321855,28740522,CN
chr05,Bn22623,36787229,63962752,27175523,CN
chr05,Bn22624,47481809,78356778,30874969,TNL
chr05,Bn22625,17464390,35142949,17678559,CN
chr05,Bn22626,99836388,99915867,79479,RLK
chr05,Bn22627,67599115,84643423,17044308,CNL
chr05,Bn22628,78390493,90732426,12341933,TN
chr05,Bn22629,61442995,89053829,27610834,NBS
chr05,Bn22630,17938884,45222476,27283592,RLP
chr05,Bn22631,80913749,83333247,2419498,TNL
chr05,Bn22632,38214002,53415313,15201311,CN
chr05,Bn22633,31670287,81777107,50106820,NBS
chr05,Bn22634,24541816,50621294,26079478,CN
chr05,Bn22635,81034414,90980115,9945701,TN
chr05,Bn22636,10962431,16120207,5157776,CNL
chr05,Bn22637,44823534,78372695,33549161,TN
chr05,Bn22638,48149489,80544571,32395082,RLP
chr05,Bn22639,18866371,64880902,46014531,NBS
chr05,Bn22640,27095987,31059502,3963515,CNL
chr05,Bn22641,1997677,54811994,52814317,TNL
chr05,Bn22642,47821308,51597406,3776098,CNL
chr05,Bn22643,41951002,75394358,33443356,RLK
chr05,Bn22644,18301649,83284117,64982468,RLK
chr05,Bn22645,49676879,49817342,140463,TN
chr05,Bn22646,72107746,74290505,2182759,RLK
chr05,Bn22647,81131312,89668170,8536858,RLP
chr05,Bn22648,46312353,82345819,36033466,NBS
chr05,Bn22649,62034645,91727157,29692512,NBS
chr05,Bn22650,51080744,52368687,1287943,TN
chr05,Bn22651,97899722,99310746,1411024,TNL
chr05,Bn22652,10470374,17511583,7041209,CNL
chr05,Bn22653,36826521,53035256,16208735,TNL
chr05,Bn22654,10499129,76071905,65572776,TN
chr05,Bn22655,84333707,99310549,14976842,TNL
chr05,Bn22656,47616720,95950604,48333884,CN
chr05,Bn22657,13532200,25683299,12151099,TNL
chr05,Bn22658,24404186,69534371,45130185,RLP
chr05,Bn22659,55032964,98390973,43358009,RLP
chr05,Bn22660,90619640,98957872,8338232,TNL
chr05,Bn22661,59283368,85960507,26677139,TN
chr05,Bn22662,93088980,98984813,5895833,CN
chr05,Bn22663,2853494,24981014,22127520,CN
chr05,Bn22664,42234304,79352329,37118025,RLP
chr05,Bn22665,49509455,70415301,20905846,TN
chr05,Bn22666,53820786,61819523,7998737,NBS
chr05,Bn22667,93031695,94201497,1169802,CNL
chr05,Bn22668,76000971,76446051,445080,RLK
chr05,Bn22669,97233505,97238788,5283,RLP
chr05,Bn22670,91557131,94433280,2876149,NBS
chr05,Bn22671,56408902,99858627,43449725,TN
chr05,Bn22672,68141612,88931711,20790099,RLK
chr05,Bn22673,41183273,95692414,54509141,RLK
chr05,Bn22674,76716390,84901363,8184973,TNL
chr05,Bn22675,1383857,21392351,20008494,RLP
chr05,Bn22676,88924065,92134702,3210637,RLP
chr05,Bn22677,45457204,60001129,14543925,TNL
chr05,Bn22678,48002286,67200869,19198583,RLP
chr05,Bn22679,30767798,31521302,753504,CNL
chr05,Bn22680,4094684,41665368,37570684,NBS
chr05,Bn22681,67598357,67935638,337281,NBS
chr05,Bn22682,77804269,88963968,11159699,RLK
chr05,Bn22683,77659628,86362360,8702732,RLK
chr05,Bn22684,30996124,57278965,26282841,RLK
chr05,Bn22685,89090405,96200555,7110150,NBS
chr05,Bn22686,47728528,55403137,7674609,NBS
chr05,Bn22687,64861869,78074656,13212787,NBS
chr05,Bn22688,37478949,81571224,44092275,RLK
chr05,Bn22689,25835966,43433651,17597685,CNL
chr05,Bn22690,39807536,47283745,7476209,RLP
chr05,Bn22691,21647698,84191184,62543486,RLP
chr05,Bn22692,13606582,62819392,49212810,CNL
chr05,Bn22693,90265813,94221278,3955465,TN
chr05,Bn22694,18291280,32420710,14129430,RLK
chr05,Bn22695,98294777,99611777,1317000,TN
chr05,Bn22696,89193785,92801047,3607262,RLP
chr05,Bn22697,92084008,92589075,505067,TNL
chr05,Bn22698,32100501,90881059,58780558,NBS
chr05,Bn22699,85604158,91663952,6059794,RLP
chr05,Bn22700,97806434,99086436,1280002,RLK
chr05,Bn22701,85437005,90505006,5068001,CNL
chr05,Bn22702,94988745,98147043,3158298,RLK
chr05,Bn22703,33730238,51546437,17816199,RLP
chr05,Bn22704,81989730,91965614,9975884,CNL
chr05,Bn22705,4468836,78324895,73856059,CNL
chr05,Bn22706,24225828,24382171,156343,NBS
chr05,Bn22707,91754313,97548331,5794018,CNL
chr05,Bn22708,86071443,89789979,3718536,RLP
chr05,Bn22709,17820625,54500968,36680343,RLK
chr05,Bn22710,11908916,54283298,42374382,NBS
chr05,Bn22711,55306560,79287897,23981337,RLP
chr05,Bn22712,93441900,97368600,3926700,RLP
chr05,Bn22713,27455388,89549834,62094446,TNL
chr05,Bn22714,95570240,97913637,2343397,RLP
chr05,Bn22715,25934751,68945065,43010314,CN
chr05,Bn22716,18145919,58972669,40826750,TN
chr05,Bn22717,79449449,92702599,13253150,RLK
chr05,Bn22718,41795868,90251318,48455450,CNL
chr05,Bn22719,9742408,97774689,88032281,CNL
chr05,Bn22720,37492736,73063470,35570734,TN
chr05,Bn22721,26150865,43583434,17432569,CN
chr05,Bn22722,10177944,40901589,30723645,NBS
chr05,Bn22723,9331054,77403190,68072136,CNL
chr05,Bn22724,20399184,38017745,17618561,RLP
chr05,Bn22725,81239794,85926166,4686372,CNL
chr05,Bn22726,13824563,51952332,38127769,TNL
chr05,Bn22727,42012073,87165612,45153539,TNL
chr05,Bn22728,62013312,80975841,18962529,CNL
chr05,Bn22729,99369596,99993393,623797,CNL
chr05,Bn22730,69318415,74636792,5318377,NBS
chr05,Bn22731,85719317,89342340,3623023,TNL
chr05,Bn22732,89818454,95811166,5992712,RLK
chr05,Bn22733,48132344,81277151,33144807,TNL
chr05,Bn22734,58477561,71017879,12540318,NBS
chr05,Bn22735,57566132,63816441,6250309,RLK
chr05,Bn22736,92004175,99051546,7047371,CN
chr05,Bn22737,74140007,89635502,15495495,TNL
chr05,Bn22738,63681042,66194408,2513366,NBS
chr05,Bn22739,94160588,98440241,4279653,RLP
chr05,Bn22740,36302141,62669220,26367079,NBS
chr05,Bn22741,59532029,90510860,30978831,RLK
chr05,Bn22742,28001446,91203158,63201712,TN
chr05,Bn22743,56706537,62081034,5374497,RLP
chr05,Bn22744,52873834,88733801,35859967,TNL
chr05,Bn22745,25332875,48549587,23216712,CNL
chr05,Bn22746,90033309,99701223,9667914,TN
chr05,Bn22747,94220787,99470725,5249938,TN
chr05,Bn22748,72954274,90745052,17790778,NBS
chr05,Bn22749,34209627,90372082,56162455,NBS
chr05,Bn22750,72465074,73996633,1531559,RLK
chr05,Bn22751,97942687,99990424,2047737,TNL
chr05,Bn22752,17042285,97554552,80512267,CN
chr05,Bn22753,74425163,75002230,577067,TNL
chr05,Bn22754,18191184,21375281,3184097,CN
chr05,Bn22755,82150910,88669462,6518552,CNL
chr05,Bn22756,33216598,53934888,20718290,CN
chr05,Bn22757,84287592,97350416,13062824,RLP
chr05,Bn22758,43120495,77106119,33985624,NBS
chr05,Bn22759,47559146,77157593,29598447,RLP
chr05,Bn22760,70852412,92561674,21709262,RLK
chr05,Bn22761,1627188,11134561,9507373,CN
chr05,Bn22762,80931344,90240465,9309121,TN
chr05,Bn22763,28561829,70473039,41911210,TNL
chr05,Bn22764,96668019,99103524,2435505,RLK
chr05,Bn22765,59151764,65764834,6613070,CN
chr05,Bn22766,90876039,98988042,8112003,TN
chr05,Bn22767,51679090,55739344,4060254,NBS
chr05,Bn22768,98185879,98426429,240550,TN
chr05,Bn22769,36091188,83809618,47718430,RLK
chr05,Bn22770,65572151,98182555,32610404,RLP
chr05,Bn22771,37775275,64973798,27198523,CNL
chr05,Bn22772,53187552,74621795,21434243,CN
chr05,Bn22773,20512746,92436286,71923540,CNL
chr05,Bn22774,57302107,67578323,10276216,RLK
chr05,Bn22775,27204028,77515651,50311623,RLK
chr05,Bn22776,28451492,70548447,42096955,TNL
chr05,Bn22777,23818366,98840702,75022336,CNL
chr05,Bn22778,65902010,82940934,17038924,RLK
chr05,Bn22779,33450557,93571063,60120506,CNL
chr05,Bn22780,68407995,83311135,14903140,RLK
chr05,Bn22781,20964631,74786121,53821490,RLP
chr05,Bn22782,83478908,86647901,3168993,CN
chr05,Bn22783,93775064,96433688,2658624,RLP
chr05,Bn22784,62685620,65523651,2838031,RLK
chr05,Bn22785,54749060,75770870,21021810,CN
chr05,Bn22786,49067649,63579024,14511375,RLK
chr05,Bn22787,74845694,96838899,21993205,RLP
chr05,Bn22788,65478075,97321018,31842943,RLP
chr05,Bn22789,75824117,77658939,1834822,NBS
chr05,Bn22790,6518200,88407961,81889761,NBS
chr05,Bn22791,45988853,54146579,8157726,CN
chr05,Bn22792,65245881,94189395,28943514,TNL
chr05,Bn22793,30252116,47469075,17216959,NBS
chr05,Bn22794,87765906,92334563,4568657,RLP
chr05,Bn22795,1596141,74788969,73192828,RLK
chr05,Bn22796,72597312,78506665,5909353,NBS
chr05,Bn22797,9805959,55815440,46009481,CNL
chr05,Bn22798,43485557,88461668,44976111,TNL
chr05,Bn22799,75156195,94311849,19155654,NBS
chr05,Bn22800,34689396,68935256,34245860,CN
chr05,Bn22801,7889839,57896369,50006530,RLK
chr05,Bn22802,85074295,97123323,12049028,TN
chr05,Bn22803,49279280,92746266,43466986,NBS
chr05,Bn22804,5213466,63268663,58055197,TNL
chr05,Bn22805,76756908,97723790,20966882,RLP
chr05,Bn22806,6530149,79413778,72883629,TN
chr05,Bn22807,23767167,58539776,34772609,RLK
chr05,Bn22808,6254113,11267743,5013630,NBS
chr05,Bn22809,12484364,95882166,83397802,RLK
chr05,Bn22810,99728982,99966153,237171,NBS
chr05,Bn22811,25680251,27542545,1862294,TN
chr05,Bn22812,54029195,91378515,37349320,TN
chr05,Bn22813,16612734,54910501,38297767,CNL
chr05,Bn22814,64747312,69121094,4373782,TN
chr05,Bn22815,81212030,93438671,12226641,CNL
chr05,Bn22816,92550685,98296180,5745495,RLK
chr05,Bn22817,21821237,72070999,50249762,CNL
chr05,Bn22818,30845459,55612269,24766810,TN
chr05,Bn22819,11488447,65480787,53992340,CN
chr05,Bn22820,67550198,70001724,2451526,TNL
chr05,Bn22821,57024852,63404477,6379625,RLP
chr05,Bn22822,16773734,23228143,6454409,TN
chr05,Bn22823,19378101,35103764,15725663,CN
chr05,Bn22824,72774236,98368495,25594259,TNL
chr05,Bn22825,52615678,94777649,42161971,RLP
chr05,Bn22826,71685610,92028592,20342982,RLK
chr05,Bn22827,20433852,98347022,77913170,TNL
chr05,Bn22828,29705368,67884605,38179237,CNL
chr05,Bn22829,23826924,62393907,38566983,TNL
chr05,Bn22830,77543991,80093998,2550007,RLP
chr05,Bn22831,10954383,96304694,85350311,TNL
chr05,Bn22832,31461774,51156764,19694990,CN
chr05,Bn22833,33985460,71899301,37913841,NBS
chr05,Bn22834,5848485,79922949,74074464,NBS
chr05,Bn22835,71153969,89413229,18259260,TN
chr05,Bn22836,72482605,78744048,6261443,TNL
chr05,Bn22837,52460312,89993944,37533632,NBS
chr05,Bn22838,27814701,77615787,49801086,RLP
chr05,Bn22839,83346637,98852071,15505434,TNL
chr05,Bn22840,91399577,97490452,6090875,RLK
chr05,Bn22841,80642480,88620037,7977557,RLP
chr05,Bn22842,75517481,87197177,11679696,RLK
chr05,Bn22843,23440585,71973525,48532940,CN
chr05,Bn22844,51073504,81815158,30741654,CNL
chr05,Bn22845,36533299,69499444,32966145,NBS
chr05,Bn22846,32129250,67613061,35483811,TNL
chr05,Bn22847,12967022,93341785,80374763,CNL
chr05,Bn22848,17695874,31496504,13800630,RLK
chr05,Bn22849,5521052,51719783,46198731,CNL
chr05,Bn22850,61646804,97236170,35589366,TN
chr05,Bn22851,6779501,27415753,20636252,CN
chr05,Bn22852,20539126,61514258,40975132,RLK
chr05,Bn22853,59614228,78420591,18806363,TNL
chr05,Bn22854,14376120,32513332,18137212,CNL
chr05,Bn22855,62328099,78109816,15781717,NBS
chr05,Bn22856,14721145,61828311,47107166,TNL
chr05,Bn22857,8980541,98409019,89428478,NBS
chr05,Bn22858,8906564,81326706,72420142,RLK
chr05,Bn22859,85721247,88815685,3094438,RLK
chr05,Bn22860,90216624,92340328,2123704,NBS
chr05,Bn22861,58971623,75107086,16135463,TNL
chr05,Bn22862,41950461,84400763,42450302,RLK
chr05,Bn22863,11137213,38114379,26977166,TN
chr05,Bn22864,35019178,69425572,34406394,TNL
chr05,Bn22865,99187945,99248620,60675,TNL
chr05,Bn22866,45817742,83413244,37595502,CNL
chr05,Bn22867,98729375,98738647,9272,RLK
chr05,Bn22868,1539568,77665008,76125440,RLP
chr05,Bn22869,40383821,79126925,38743104,RLP
chr05,Bn22870,85129862,98754308,13624446,CNL
chr05,Bn22871,59752734,97597323,37844589,RLP
chr05,Bn22872,29015791,37753062,8737271,TNL
chr05,Bn22873,50583155,99820821,49237666,CN
chr05,Bn22874,18192681,84245544,66052863,TNL
chr05,Bn22875,85649821,97636115,11986294,TNL
chr05,Bn22876,12318560,46190162,33871602,CN
chr05,Bn22877,81307318,82923135,1615817,RLP
chr05,Bn22878,83307223,83525984,218761,CN
chr05,Bn22879,82670186,99440724,16770538,TN
chr05,Bn22880,70486912,78364557,7877645,TN
chr05,Bn22881,62531108,66532213,4001105,TN
chr05,Bn22882,65826390,92227177,26400787,TN
chr05,Bn22883,79839654,93465475,13625821,RLK
chr05,Bn22884,77859245,98445185,20585940,CN
chr05,Bn22885,41598614,96348365,54749751,CNL
chr05,Bn22886,46506791,46690579,183788,NBS
chr05,Bn22887,57930891,95159782,37228891,TNL
chr05,Bn22888,95442875,96635391,1192516,CNL
chr05,Bn22889,19690984,97171897,77480913,CNL
chr05,Bn22890,18287436,45241715,26954279,TN
chr05,Bn22891,62030437,70540166,8509729,TN
chr05,Bn22892,24662924,58246719,33583795,CN
chr05,Bn22893,51783046,64198864,12415818,CNL
chr05,Bn22894,55092106,81936646,26844540,TNL
chr05,Bn22895,12888215,81320340,68432125,TN
chr05,Bn22896,44592180,96289379,51697199,CN
chr05,Bn22897,3440166,89543234,86103068,NBS
chr05,Bn22898,7691317,20782003,13090686,RLK
chr05,Bn22899,11295834,47642698,36346864,CN
chr05,Bn22900,43331584,68341425,25009841,TNL
chr05,Bn22901,78465876,95775060,17309184,TN
chr05,Bn22902,54077885,94280527,40202642,CN
chr05,Bn22903,25274557,42018423,16743866,RLP
chr05,Bn22904,19301573,55496749,36195176,RLK
chr05,Bn22905,14044761,93232454,79187693,RLP
chr05,Bn22906,2162772,54938420,52775648,CN
chr05,Bn22907,86467044,91148854,4681810,CNL
chr05,Bn22908,93913925,95018829,1104904,TN
chr05,Bn22909,40670947,62357960,21687013,TNL
chr05,Bn22910,12312788,34756865,22444077,NBS
chr05,Bn22911,32192676,39792801,7600125,TN
chr05,Bn22912,36413474,95569556,59156082,RLK
chr05,Bn22913,83114924,98252073,15137149,NBS
chr05,Bn22914,67125749,80440581,13314832,TN
chr05,Bn22915,80687954,81435553,747599,RLP
chr05,Bn22916,9686870,58597526,48910656,TN
chr05,Bn22917,69161358,90227119,21065761,NBS
chr05,Bn22918,72434239,88179822,15745583,RLK
chr05,Bn22919,69789781,91789707,21999926,CN
chr05,Bn22920,52633465,74793200,22159735,TNL
chr05,Bn22921,70489142,94886712,24397570,NBS
chr05,Bn22922,39862823,49290087,9427264,TNL
chr05,Bn22923,75085085,99587881,24502796,CNL
chr05,Bn22924,82598161,93729723,11131562,RLK
chr05,Bn22925,20858266,81770010,60911744,TN
chr05,Bn22926,91035696,94720460,3684764,RLK
chr05,Bn22927,26888958,75597382,48708424,CNL
chr05,Bn22928,50904713,59797726,8893013,TNL
chr05,Bn22929,52793081,64383952,11590871,CN
chr05,Bn22930,82176971,90820637,8643666,CNL
chr05,Bn22931,83670056,99888535,16218479,CN
chr05,Bn22932,6135342,71576255,65440913,NBS
chr05,Bn22933,54191394,59731571,5540177,NBS
chr05,Bn22934,56818324,65085119,8266795,TN
chr05,Bn22935,1971383,26597946,24626563,CNL
chr05,Bn22936,26321490,69650715,43329225,CNL
chr05,Bn22937,40384204,71981544,31597340,RLK
chr05,Bn22938,23628745,80864793,57236048,RLP
chr05,Bn22939,29717184,82973119,53255935,RLK
chr05,Bn22940,42359990,72240968,29880978,NBS
chr05,Bn22941,14431083,76563139,62132056,RLP
chr05,Bn22942,30733667,83337611,52603944,RLK
chr05,Bn22943,50044837,50811880,767043,TN
chr05,Bn22944,34518599,35604762,1086163,TN
chr05,Bn22945,12688619,68607087,55918468,TNL
chr05,Bn22946,13740188,76580014,62839826,RLP
chr05,Bn22947,64942449,97907832,32965383,TN
chr05,Bn22948,73516989,92034494,18517505,RLK
chr05,Bn22949,72896210,87273079,14376869,TNL
chr05,Bn22950,64946910,77094005,12147095,RLP
chr05,Bn22951,51876013,81436657,29560644,CNL
chr05,Bn22952,37687882,37843803,155921,NBS
chr05,Bn22953,37701091,91484277,53783186,NBS
chr05,Bn22954,19021702,71964436,52942734,CNL
chr05,Bn22955,18081380,19821210,1739830,TNL
chr05,Bn22956,26988403,31480150,4491747,RLP
chr05,Bn22957,60920897,99137988,38217091,RLK
chr05,Bn22958,82398917,87859449,5460532,CNL
chr05,Bn22959,31863729,98824278,66960549,NBS
chr05,Bn22960,50948207,86393079,35444872,TN
chr05,Bn22961,65003676,67048201,2044525,RLP
chr05,Bn22962,67609062,74518788,6909726,RLP
chr05,Bn22963,21586138,83661368,62075230,NBS
chr05,Bn22964,12750250,35563634,22813384,NBS
chr05,Bn22965,55638755,98238152,42599397,RLK
chr05,Bn22966,4140102,71004252,66864150,NBS
chr05,Bn22967,99186314,99499637,313323,TN
chr05,Bn22968,10052492,58256084,48203592,TN
chr05,Bn22969,34049623,72973410,38923787,CNL
chr05,Bn22970,22356714,64606062,42249348,RLP
chr05,Bn22971,41964373,45458547,3494174,NBS
chr05,Bn22972,97189535,97457914,268379,TN
chr05,Bn22973,52074431,74910797,22836366,RLK
chr05,Bn22974,99523853,99849334,325481,NBS
chr05,Bn22975,82469358,85902500,3433142,RLP
chr05,Bn22976,83906341,92123950,8217609,CNL
chr05,Bn22977,5139809,62709929,57570120,CN
chr05,Bn22978,13184456,25173453,11988997,TNL
chr05,Bn22979,87986240,95346011,7359771,RLK
chr05,Bn22980,86124300,99076108,12951808,CNL
chr05,Bn22981,91156135,91312457,156322,CN
chr05,Bn22982,78297140,92744665,14447525,TNL
chr05,Bn22983,52765367,55464762,2699395,CN
chr05,Bn22984,52686657,70392741,17706084,CN
chr05,Bn22985,18590369,36160360,17569991,TNL
chr05,Bn22986,39311446,73471338,34159892,TN
chr05,Bn22987,76485463,79941357,3455894,CN
chr05,Bn22988,24820804,74878041,50057237,CN
chr05,Bn22989,39416240,65733068,26316828,CN
chr05,Bn22990,5115292,6363378,1248086,NBS
chr05,Bn22991,66330352,77519307,11188955,CNL
chr05,Bn22992,42864701,94094121,51229420,TNL
chr05,Bn22993,37058276,96884247,59825971,TN
chr05,Bn22994,31065265,96169765,65104500,NBS
chr05,Bn22995,73608685,79034266,5425581,TN
chr05,Bn22996,71729676,94472843,22743167,CNL
chr05,Bn22997,55547502,91722157,36174655,TN
chr05,Bn22998,61893876,76026917,14133041,CNL
chr05,Bn22999,69587801,74773118,5185317,TNL
chr05,Bn23000,81263817,99728793,18464976,NBS
chr05,Bn23001,93256041,95846955,2590914,TN
chr05,Bn23002,85980936,90530418,4549482,TNL
chr05,Bn23003,77068704,79406452,2337748,TN
chr05,Bn23004,52789979,96063286,43273307,TNL
chr05,Bn23005,80957968,99866613,18908645,CN
chr05,Bn23006,31569746,78762167,47192421,TN
chr05,Bn23007,7291396,81388941,74097545,TN
chr05,Bn23008,62678184,95608854,32930670,CNL
chr05,Bn23009,25867105,45525660,19658555,TNL
chr05,Bn23010,40724429,58787474,18063045,CN
chr05,Bn23011,82953365,89891396,6938031,CNL
chr05,Bn23012,12143690,62089955,49946265,TN
chr05,Bn23013,51256007,70632818,19376811,RLK
chr05,Bn23014,8302369,81254657,72952288,NBS
chr05,Bn23015,17565488,58121423,40555935,RLP
chr05,Bn23016,53649549,79002567,25353018,NBS
chr05,Bn23017,2467692,38891548,36423856,RLK
chr05,Bn23018,82437868,83858555,1420687,CNL
chr05,Bn23019,19908533,71475128,51566595,RLK
chr05,Bn23020,59966189,72444126,12477937,RLP
chr05,Bn23021,51191406,71594150,20402744,CNL
chr05,Bn23022,17069240,82610567,65541327,NBS
chr05,Bn23023,85067331,91619901,6552570,TNL
chr05,Bn23024,10501277,22199209,11697932,RLP
chr05,Bn23025,2405993,79940040,77534047,RLK
chr05,Bn23026,57526668,70762351,13235683,NBS
chr05,Bn23027,61671384,98390367,36718983,TNL
chr05,Bn23028,38185572,81698697,43513125,RLK
chr05,Bn23029,51746298,99766369,48020071,RLK
chr05,Bn23030,55592700,93864963,38272263,NBS
chr05,Bn23031,40898350,55352884,14454534,TNL
chr05,Bn23032,21007539,59177747,38170208,TN
chr05,Bn23033,16731230,60554794,43823564,RLP
chr05,Bn23034,92011468,99063985,7052517,CN
chr05,Bn23035,14593812,77353355,62759543,NBS
chr05,Bn23036,97551198,99418003,1866805,CNL
chr05,Bn23037,28566334,92473518,63907184,TNL
chr05,Bn23038,1591491,34921544,33330053,CN
chr05,Bn23039,35907112,96338853,60431741,RLP
chr05,Bn23040,97952835,99096828,1143993,RLK
chr05,Bn23041,35209001,73689469,38480468,TNL
chr05,Bn23042,9978408,97235671,87257263,TNL
chr05,Bn23043,89605804,95153515,5547711,CN
chr05,Bn23044,66486740,76182226,9695486,CNL
chr05,Bn23045,60483613,83060222,22576609,CNL
chr05,Bn23046,69305036,81215658,11910622,RLP
chr05,Bn23047,51832425,66802571,14970146,CN
chr05,Bn23048,20153533,67971965,47818432,RLK
chr05,Bn23049,82834393,98383053,15548660,TNL
chr05,Bn23050,9965724,92090412,82124688,TN
chr05,Bn23051,46207746,46734704,526958,NBS
chr05,Bn23052,53597057,97523205,43926148,CN
chr05,Bn23053,32840601,94824631,61984030,CN
chr05,Bn23054,56839564,71132753,14293189,TNL
chr05,Bn23055,54409557,67030867,12621310,NBS
chr05,Bn23056,59139648,72379632,13239984,TNL
chr05,Bn23057,99661319,99705339,44020,CN
chr05,Bn23058,38399728,58145738,19746010,NBS
chr05,Bn23059,79564540,94259374,14694834,CN
chr05,Bn23060,47140257,88760898,41620641,RLK
chr05,Bn23061,2028388,97683997,95655609,RLP
chr05,Bn23062,33300964,53381557,20080593,RLK
chr05,Bn23063,59531810,74157145,14625335,CN
chr05,Bn23064,10640023,53876618,43236595,RLP
chr05,Bn23065,52535650,94484834,41949184,RLK
chr05,Bn23066,26985741,74035925,47050184,CNL
chr05,Bn23067,14306827,74118954,59812127,NBS
chr05,Bn23068,20516055,51645902,31129847,NBS
chr05,Bn23069,58170270,93420626,35250356,TN
chr05,Bn23070,80961699,88976177,8014478,RLP
chr05,Bn23071,26679369,83549040,56869671,CN
chr05,Bn23072,51130229,76673357,25543128,TN
chr05,Bn23073,89697874,96173002,6475128,TNL
chr05,Bn23074,49228840,74294108,25065268,CN
chr05,Bn23075,32059231,91719016,59659785,RLK
chr05,Bn23076,49994585,72300763,22306178,TNL
chr05,Bn23077,39059932,85634715,46574783,CNL
chr05,Bn23078,46342781,50477296,4134515,CNL
chr05,Bn23079,58760963,73287364,14526401,TNL
chr05,Bn23080,69815542,73836988,4021446,NBS
chr05,Bn23081,71242268,73706584,2464316,TNL
chr05,Bn23082,45177903,86955904,41778001,TNL
chr05,Bn23083,73333907,79324167,5990260,TN
chr05,Bn23084,4186949,74416986,70230037,CN
chr05,Bn23085,15214035,81577137,66363102,NBS
chr05,Bn23086,18597185,24806057,6208872,RLP
chr05,Bn23087,50481536,99787872,49306336,CNL
chr05,Bn23088,76816013,90012621,13196608,TNL
chr05,Bn23089,26439631,47557569,21117938,TN
chr05,Bn23090,88503317,99284016,10780699,TNL
chr05,Bn23091,49948510,55926088,5977578,TN
chr05,Bn23092,43294509,84023955,40729446,TNL
chr05,Bn23093,96221809,96408608,186799,CNL
chr05,Bn23094,65361755,90216993,24855238,RLK
chr05,Bn23095,31550571,66591816,35041245,NBS
chr05,Bn23096,10255368,47492761,37237393,NBS
chr05,Bn23097,73660100,95733673,22073573,NBS
chr05,Bn23098,76438439,90995259,14556820,RLP
chr05,Bn23099,40586064,96388942,55802878,NBS
chr05,Bn23100,26303450,60078512,33775062,TNL
chr05,Bn23101,45230055,60813677,15583622,CN
chr05,Bn23102,15830883,41405583,25574700,CN
chr05,Bn23103,15032573,35025588,19993015,RLP
chr05,Bn23104,14866346,20077508,5211162,TN
chr05,Bn23105,32884686,45649791,12765105,CNL
chr05,Bn23106,39168297,84678253,45509956,RLP
chr05,Bn23107,3417512,40235926,36818414,CN
chr05,Bn23108,10505479,98102295,87596816,NBS
chr05,Bn23109,70616787,80415775,9798988,CNL
chr05,Bn23110,10476338,51967122,41490784,TNL
chr05,Bn23111,5365856,45777469,40411613,CNL
chr05,Bn23112,90202075,94290325,4088250,NBS
chr05,Bn23113,58723841,85915068,27191227,TNL
chr05,Bn23114,32072433,84329011,52256578,TN
chr05,Bn23115,99408735,99848679,439944,CN
chr05,Bn23116,42146805,73675210,31528405,CNL
chr05,Bn23117,30727547,66485441,35757894,CNL
chr05,Bn23118,16961988,43368494,26406506,TN
chr05,Bn23119,70354918,97441499,27086581,RLK
chr05,Bn23120,56596372,81704393,25108021,NBS
chr05,Bn23121,54203604,91556414,37352810,CN
chr05,Bn23122,8337306,82711486,74374180,TN
chr05,Bn23123,57219458,94586540,37367082,RLP
chr05,Bn23124,4694386,76212325,71517939,TN
chr05,Bn23125,97999095,98660492,661397,RLK
chr05,Bn23126,63131983,80314235,17182252,TNL
chr05,Bn23127,24107805,80691213,56583408,CN
chr05,Bn23128,83800847,90705576,6904729,RLK
chr05,Bn23129,17257279,79007971,61750692,CNL
chr05,Bn23130,64173805,97290135,33116330,CN
chr05,Bn23131,38465327,82804108,44338781,RLP
chr05,Bn23132,85204915,94830306,9625391,CN
chr05,Bn23133,31503256,75843004,44339748,NBS
chr05,Bn23134,43469968,59085777,15615809,CN
chr06,Bn23135,83078768,95166960,12088192,CN
chr06,Bn23136,88037584,90180518,2142934,TNL
chr06,Bn23137,92903437,98048744,5145307,TNL
chr06,Bn23138,54242700,55090186,847486,RLK
chr06,Bn23139,86503060,99349292,12846232,CNL
chr06,Bn23140,43291560,75838033,32546473,CNL
chr06,Bn23141,85790577,86929990,1139413,RLP
chr06,Bn23142,9131010,42708998,33577988,TNL
chr06,Bn23143,51432715,88108684,36675969,RLK
chr06,Bn23144,90635827,92362778,1726951,RLP
chr06,Bn23145,13879601,54797287,40917686,RLP
chr06,Bn23146,64413301,70001536,5588235,RLK
chr06,Bn23147,23291701,42670951,19379250,TNL
chr06,Bn23148,10035844,18608424,8572580,RLK
chr06,Bn23149,81406374,94849212,13442838,CNL
chr06,Bn23150,11994854,83356784,71361930,RLP
chr06,Bn23151,53266564,83150258,29883694,TNL
chr06,Bn23152,6586958,56830085,50243127,TNL
chr06,Bn23153,75200208,82088504,6888296,RLP
chr06,Bn23154,74030321,85819079,11788758,TNL
chr06,Bn23155,39888543,46182082,6293539,TNL
chr06,Bn23156,19769780,32097389,12327609,NBS
chr06,Bn23157,76152565,77236049,1083484,RLK
chr06,Bn23158,17934742,82668273,64733531,CN
chr06,Bn23159,12482049,75841761,63359712,RLK
chr06,Bn23160,5315165,11208841,5893676,CNL
chr06,Bn23161,4449238,96624877,92175639,NBS
chr06,Bn23162,92914720,95771754,2857034,RLK
chr06,Bn23163,89246621,90882150,1635529,TN
chr06,Bn23164,39279774,48778515,9498741,RLP
chr06,Bn23165,2073549,33131328,31057779,TN
chr06,Bn23166,24978088,82240313,57262225,CNL
chr06,Bn23167,13581926,38632286,25050360,RLK
chr06,Bn23168,13520545,15645305,2124760,RLK
chr06,Bn23169,92880304,97773483,4893179,CNL
chr06,Bn23170,80627469,91453391,10825922,TN
chr06,Bn23171,20791425,80291525,59500100,CN
chr06,Bn23172,46151230,67355967,21204737,CNL
chr06,Bn23173,95025762,97293573,2267811,RLP
chr06,Bn23174,44163487,94711805,50548318,TNL
chr06,Bn23175,54023686,80784730,26761044,RLK
chr06,Bn23176,47823529,72244907,24421378,CN
chr06,Bn23177,76633410,77121073,487663,TNL
chr06,Bn23178,14813374,26608436,11795062,NBS
chr06,Bn23179,87336913,88533856,1196943,CN
chr06,Bn23180,48634740,52746563,4111823,TN
chr06,Bn23181,21037881,25121164,4083283,CN
chr06,Bn23182,19462762,20919799,1457037,RLK
chr06,Bn23183,15167740,57674152,42506412,NBS
chr06,Bn23184,51344443,92082192,40737749,CNL
chr06,Bn23185,9045720,11923342,2877622,CN
chr06,Bn23186,38077274,75821356,37744082,CN
chr06,Bn23187,52149042,82724039,30574997,RLK
chr06,Bn23188,83293593,99274214,15980621,RLK
chr06,Bn23189,75461710,98034357,22572647,CN
chr06,Bn23190,49004178,74610726,25606548,NBS
chr06,Bn23191,93509284,98331331,4822047,NBS
chr06,Bn23192,17137043,50149581,33012538,RLK
chr06,Bn23193,6280369,55044902,48764533,TNL
chr06,Bn23194,32051390,78826399,46775009,CNL
chr06,Bn23195,3413330,90718201,87304871,CN
chr06,Bn23196,71531919,86092334,14560415,NBS
chr06,Bn23197,98801563,99600119,798556,CNL
chr06,Bn23198,78360680,96171218,17810538,CN
chr06,Bn23199,79795385,81909071,2113686,NBS
chr06,Bn23200,13341486,74714129,61372643,RLK
chr06,Bn23201,40716311,57006737,16290426,TN
chr06,Bn23202,7120429,95855814,88735385,NBS
chr06,Bn23203,58279969,62019424,3739455,TNL
chr06,Bn23204,70406500,84441316,14034816,TN
chr06,Bn23205,96857518,99283861,2426343,CN
chr06,Bn23206,41202987,68129319,26926332,CNL
chr06,Bn23207,6230889,8654794,2423905,CNL
chr06,Bn23208,45353575,64598439,19244864,NBS
chr06,Bn23209,97550539,97932112,381573,TNL
chr06,Bn23210,38271944,69805749,31533805,CNL
chr06,Bn23211,80478102,91063546,10585444,RLP
chr06,Bn23212,4099030,62008223,57909193,RLK
chr06,Bn23213,27629670,83860045,56230375,CN
chr06,Bn23214,25039944,96133803,71093859,NBS
chr06,Bn23215,97734026,98470526,736500,RLK
chr06,Bn23216,62741469,88663130,25921661,CNL
chr06,Bn23217,76751271,91660158,14908887,NBS
chr06,Bn23218,3882652,65943139,62060487,NBS
chr06,Bn23219,50007004,90968705,40961701,CNL
chr06,Bn23220,19097769,89756731,70658962,TNL
chr06,Bn23221,15674210,60707689,45033479,CN
chr06,Bn23222,5549002,38501771,32952769,RLK
chr06,Bn23223,15971637,97286925,81315288,TNL
chr06,Bn23224,18320598,82237873,63917275,RLP
chr06,Bn23225,34688038,69030209,34342171,TN
chr06,Bn23226,23231266,76690835,53459569,CN
chr06,Bn23227,72301841,86450517,14148676,CNL
chr06,Bn23228,53847200,58937815,5090615,CN
chr06,Bn23229,35637645,47014280,11376635,CN
chr06,Bn23230,66497055,91522593,25025538,TNL
chr06,Bn23231,86971457,99837563,12866106,TN
chr06,Bn23232,14631941,73708149,59076208,RLK
chr06,Bn23233,76312487,98212375,21899888,TNL
chr06,Bn23234,91825580,92049272,223692,NBS
chr06,Bn23235,43112587,50539165,7426578,NBS
chr06,Bn23236,49592037,95688611,46096574,CN
chr06,Bn23237,58417341,91605530,33188189,RLK
chr06,Bn23238,77458628,96143502,18684874,TNL
chr06,Bn23239,49881538,84165265,34283727,CN
chr06,Bn23240,80620932,86352253,5731321,NBS
chr06,Bn23241,22721268,33420642,10699374,TN
chr06,Bn23242,26019502,37411283,11391781,TNL
chr06,Bn23243,8519526,74429702,65910176,RLP
chr06,Bn23244,9099610,87796540,78696930,CNL
chr06,Bn23245,96016040,97122915,1106875,NBS
chr06,Bn23246,39822177,71354852,31532675,CNL
chr06,Bn23247,55917837,60816085,4898248,TN
chr06,Bn23248,84703614,90205836,5502222,CNL
chr06,Bn23249,87323084,92857888,5534804,TNL
chr06,Bn23250,73942713,83205158,9262445,CNL
chr06,Bn23251,54590388,91213424,36623036,NBS
chr06,Bn23252,99372247,99472930,100683,CNL
chr06,Bn23253,76987875,78433442,1445567,TNL
chr06,Bn23254,78415755,92942438,14526683,RLK
chr06,Bn23255,80382837,91247816,10864979,TN
chr06,Bn23256,63907322,73096585,9189263,CN
chr06,Bn23257,1642586,91053699,89411113,RLK
chr06,Bn23258,5065807,67903169,62837362,TNL
chr06,Bn23259,71722515,79227849,7505334,NBS
chr06,Bn23260,21182064,78944262,57762198,TNL
chr06,Bn23261,26869132,88731510,61862378,TNL
chr06,Bn23262,6791134,74995795,68204661,CNL
chr06,Bn23263,58264661,88786404,30521743,TN
chr06,Bn23264,1833939,92632921,90798982,RLK
chr06,Bn23265,90282582,91691661,1409079,CN
chr06,Bn23266,5892712,20378403,14485691,RLK
chr06,Bn23267,32396565,52409095,20012530,RLK
chr06,Bn23268,41770842,82953428,41182586,RLP
chr06,Bn23269,38638742,56278151,17639409,RLK
chr06,Bn23270,22466610,42995958,20529348,RLK
chr06,Bn23271,11190954,73105204,61914250,CN
chr06,Bn23272,58093357,62604323,4510966,CN
chr06,Bn23273,27999015,76122584,48123569,NBS
chr06,Bn23274,45484979,47052844,1567865,TNL
chr06,Bn23275,11332256,80904788,69572532,NBS
chr06,Bn23276,5993602,24828415,18834813,CN
chr06,Bn23277,39511399,42475886,2964487,RLK
chr06,Bn23278,89275934,98849651,9573717,RLK
chr06,Bn23279,53245630,79493616,26247986,CN
chr06,Bn23280,84629491,93093965,8464474,NBS
chr06,Bn23281,77191298,95927906,18736608,TNL
chr06,Bn23282,71710969,97098226,25387257,CNL
chr06,Bn23283,47018547,81768521,34749974,CNL
chr06,Bn23284,91113843,97385665,6271822,RLP
chr06,Bn23285,8752113,17517931,8765818,CNL
chr06,Bn23286,14287688,23399524,9111836,CNL
chr06,Bn23287,5678526,96625686,90947160,TN
chr06,Bn23288,64275679,72456478,8180799,NBS
chr06,Bn23289,59503736,85239437,25735701,TN
chr06,Bn23290,93065494,98221809,5156315,CNL
chr06,Bn23291,37893735,86213554,48319819,CNL
chr06,Bn23292,38414161,61248826,22834665,RLP
chr06,Bn23293,18479376,89846837,71367461,TNL
chr06,Bn23294,95675235,99455339,3780104,RLK
chr06,Bn23295,91095446,96116326,5020880,CN
chr06,Bn23296,53403733,56472921,3069188,CN
chr06,Bn23297,68389796,84817919,16428123,NBS
chr06,Bn23298,97340985,99522833,2181848,TNL
chr06,Bn23299,1421696,38421689,36999993,TN
chr06,Bn23300,6464470,41813339,35348869,TNL
chr06,Bn23301,60232868,61044916,812048,CN
chr06,Bn23302,51486110,69819453,18333343,NBS
chr06,Bn23303,90755534,93873965,3118431,TN
chr06,Bn23304,45567802,53149698,7581896,RLP
chr06,Bn23305,21109519,98754556,77645037,NBS
chr06,Bn23306,56475745,65411528,8935783,TNL
chr06,Bn23307,12631675,95950609,83318934,TN
chr06,Bn23308,39120761,51776948,12656187,NBS
chr06,Bn23309,40025128,56367771,16342643,RLP
chr06,Bn23310,48824464,70540136,21715672,TNL
chr06,Bn23311,64703526,97515372,32811846,CNL
chr06,Bn23312,1216197,10461212,9245015,TNL
chr06,Bn23313,50027009,99887745,49860736,TNL
chr06,Bn23314,30580241,90622842,60042601,TN
chr06,Bn23315,33028001,47109012,14081011,RLP
chr06,Bn23316,20392406,81602859,61210453,RLK
chr06,Bn23317,17605326,92551537,74946211,TNL
chr06,Bn23318,92051779,92653271,601492,TNL
chr06,Bn23319,8577199,88228640,79651441,RLP
chr06,Bn23320,33303287,75757962,42454675,NBS
chr06,Bn23321,92009853,94759623,2749770,CN
chr06,Bn23322,95495032,96757476,1262444,NBS
chr06,Bn23323,23682512,38607297,14924785,TNL
chr06,Bn23324,60542990,79490863,18947873,CNL
chr06,Bn23325,86652566,98794059,12141493,RLK
chr06,Bn23326,70099875,95026824,24926949,TNL
chr06,Bn23327,77021473,90969391,13947918,NBS
chr06,Bn23328,2022421,95348319,93325898,TN
chr06,Bn23329,75673290,81650876,5977586,CN
chr06,Bn23330,37307438,69676697,32369259,RLP
chr06,Bn23331,69138729,75378793,6240064,NBS
chr06,Bn23332,53761663,74575093,20813430,TNL
chr06,Bn23333,80497944,92259190,11761246,NBS
chr06,Bn23334,29960889,62089289,32128400,TNL
chr06,Bn23335,57022851,58257858,1235007,NBS
chr06,Bn23336,79387644,87435179,8047535,TNL
chr06,Bn23337,14411329,96389904,81978575,TN
chr06,Bn23338,39499013,43605999,4106986,NBS
chr06,Bn23339,29418635,66694939,37276304,TN
chr06,Bn23340,28297076,47543124,19246048,TN
chr06,Bn23341,46027320,51145502,5118182,RLK
chr06,Bn23342,71299391,80977052,9677661,RLK
chr06,Bn23343,73599962,95292459,21692497,RLK
chr06,Bn23344,21431391,92670791,71239400,CN
chr06,Bn23345,15918994,29682679,13763685,RLP
chr06,Bn23346,34251283,38144535,3893252,TNL
chr06,Bn23347,79299971,88091328,8791357,TN
chr06,Bn23348,27787258,63616329,35829071,NBS
chr06,Bn23349,23791687,53773025,29981338,TN
chr06,Bn23350,82561069,82602753,41684,CN
chr06,Bn23351,84537513,96351028,11813515,CNL
chr06,Bn23352,29607991,97840478,68232487,CN
chr06,Bn23353,15196485,95215111,80018626,RLK
chr06,Bn23354,13276478,75821907,62545429,CNL
chr06,Bn23355,78619680,91914400,13294720,CN
chr06,Bn23356,99747909,99982971,235062,CN
chr06,Bn23357,98422855,98660237,237382,RLK
chr06,Bn23358,38640106,58416376,19776270,TNL
chr06,Bn23359,3864577,69175539,65310962,NBS
chr06,Bn23360,18324161,28325420,10001259,NBS
chr06,Bn23361,6371908,84495609,78123701,CNL
chr06,Bn23362,96539535,99365536,2826001,RLK
chr06,Bn23363,81127709,87377142,6249433,NBS
chr06,Bn23364,30369901,92772641,62402740,TNL
chr06,Bn23365,86661655,95625117,8963462,CNL
chr06,Bn23366,31851588,50822737,18971149,CNL
chr06,Bn23367,99076098,99844211,768113,CNL
chr06,Bn23368,18958626,19335528,376902,RLP
chr06,Bn23369,13520241,72382352,58862111,TNL
chr06,Bn23370,49084327,64954057,15869730,CNL
chr06,Bn23371,96141607,99015679,2874072,RLK
chr06,Bn23372,81829781,99499912,17670131,TN
chr06,Bn23373,29589203,71274921,41685718,NBS
chr06,Bn23374,87424000,90787977,3363977,TN
chr06,Bn23375,18079411,96781206,78701795,NBS
chr06,Bn23376,44278913,55562882,11283969,TNL
chr06,Bn23377,7063124,10477160,3414036,NBS
chr06,Bn23378,97191075,98914216,1723141,CN
chr06,Bn23379,54700411,91368507,36668096,NBS
chr06,Bn23380,42794950,91874892,49079942,CN
chr06,Bn23381,37300603,56542450,19241847,TN
chr06,Bn23382,4573902,20292951,15719049,CNL
chr06,Bn23383,2323528,52438217,50114689,RLK
chr06,Bn23384,80166249,93626638,13460389,RLP
chr06,Bn23385,43154121,74563719,31409598,TNL
chr06,Bn23386,26558249,73218321,46660072,CNL
chr06,Bn23387,87148262,91067591,3919329,TNL
chr06,Bn23388,78388288,87802323,9414035,CNL
chr06,Bn23389,86817425,94394581,7577156,CNL
chr06,Bn23390,1334191,42205357,40871166,CNL
chr06,Bn23391,65649282,71520601,5871319,RLK
chr06,Bn23392,59325975,85837800,26511825,CNL
chr06,Bn23393,25850906,55379631,29528725,CN
chr06,Bn23394,21946318,24524525,2578207,RLK
chr06,Bn23395,29720559,94054305,64333746,TNL
chr06,Bn23396,79175590,88643015,9467425,NBS
chr06,Bn23397,41345158,59532171,18187013,RLK
chr06,Bn23398,91885524,97386216,5500692,RLK
chr06,Bn23399,21483264,77509439,56026175,RLK
chr06,Bn23400,71348745,93442679,22093934,TNL
chr06,Bn23401,71545269,84087568,12542299,CNL
chr06,Bn23402,72817551,78756812,5939261,CNL
chr06,Bn23403,19485376,31064295,11578919,TNL
chr06,Bn23404,21262843,80699165,59436322,TN
chr06,Bn23405,35678001,52600588,16922587,CNL
chr06,Bn23406,21827340,71033295,49205955,CNL
chr06,Bn23407,53608734,72381748,18773014,CNL
chr06,Bn23408,68734747,68942793,208046,RLP
chr06,Bn23409,75511805,78768879,3257074,CN
chr06,Bn23410,72735389,88534387,15798998,NBS
chr06,Bn23411,81927968,84715209,2787241,NBS
chr06,Bn23412,63288920,80848099,17559179,CN
chr06,Bn23413,86428910,96680411,10251501,RLK
chr06,Bn23414,33512508,61607430,28094922,NBS
chr06,Bn23415,18184661,79038707,60854046,TNL
chr06,Bn23416,74724856,82133348,7408492,NBS
chr06,Bn23417,33770565,34077511,306946,TNL
chr06,Bn23418,19564257,45570157,26005900,TNL
chr06,Bn23419,89233374,89976906,743532,CN
chr06,Bn23420,9420587,40698578,31277991,CN
chr06,Bn23421,93962014,96863503,2901489,CNL
chr06,Bn23422,94346944,97766182,3419238,RLP
chr06,Bn23423,60211711,86838513,26626802,CNL
chr06,Bn23424,57070151,73715525,16645374,CN
chr06,Bn23425,37825425,76440968,38615543,RLP
chr06,Bn23426,79614016,81448693,1834677,RLP
chr06,Bn23427,65827297,71093611,5266314,NBS
chr06,Bn23428,39238401,86344202,47105801,CNL
chr06,Bn23429,71712929,99638519,27925590,CN
chr06,Bn23430,31816409,45214460,13398051,CN
chr06,Bn23431,85473922,88393676,2919754,RLK
chr06,Bn23432,26888305,53895903,27007598,TN
chr06,Bn23433,83343303,87887846,4544543,TNL
chr06,Bn23434,36518947,58457072,21938125,RLK
chr06,Bn23435,64803652,80398592,15594940,RLK
chr06,Bn23436,39356057,50089795,10733738,CN
chr06,Bn23437,54126465,65964037,11837572,NBS
chr06,Bn23438,1316654,28069239,26752585,TNL
chr06,Bn23439,24932594,90672879,65740285,RLP
chr06,Bn23440,74310254,93698356,19388102,NBS
chr06,Bn23441,41902882,51796872,9893990,TN
chr06,Bn23442,39953799,96029768,56075969,TNL
chr06,Bn23443,4877522,29250854,24373332,RLK
chr06,Bn23444,32057713,90381234,58323521,TNL
chr06,Bn23445,10825328,77279529,66454201,CNL
chr06,Bn23446,33479908,71794818,38314910,CNL
chr06,Bn23447,40977597,82858643,41881046,RLK
chr06,Bn23448,20376601,93391527,73014926,CNL
chr06,Bn23449,92557811,97365901,4808090,TNL
chr06,Bn23450,96928465,97680127,751662,NBS
chr06,Bn23451,10798757,40082813,29284056,TNL
chr06,Bn23452,51865809,63207218,11341409,NBS
chr06,Bn23453,32633221,72627597,39994376,CNL
chr06,Bn23454,4907968,24976528,20068560,TNL
chr06,Bn23455,56203561,90437151,34233590,NBS
chr06,Bn23456,62284303,70195680,7911377,RLK
chr06,Bn23457,82530647,83306891,776244,RLK
chr06,Bn23458,93238820,96188617,2949797,CN
chr06,Bn23459,17463981,66317811,48853830,TNL
chr06,Bn23460,11528335,95938575,84410240,CN
chr06,Bn23461,60767988,95374493,34606505,CNL
chr06,Bn23462,51144015,98833321,47689306,TN
chr06,Bn23463,59787541,65837620,6050079,TNL
chr06,Bn23464,34124705,80158351,46033646,NBS
chr06,Bn23465,39016031,58768105,19752074,CN
chr06,Bn23466,40775466,54418479,13643013,TNL
chr06,Bn23467,31284494,70440640,39156146,CNL
chr06,Bn23468,17474362,77562257,60087895,RLP
chr06,Bn23469,70483225,77473754,6990529,TN
chr06,Bn23470,84963772,88110838,3147066,CNL
chr06,Bn23471,12501174,24266428,11765254,NBS
chr06,Bn23472,22282912,93109930,70827018,CNL
chr06,Bn23473,84170849,96742898,12572049,CN
chr06,Bn23474,60195950,79884539,19688589,TNL
chr06,Bn23475,47946195,98164682,50218487,NBS
chr06,Bn23476,79828222,91180385,11352163,CNL
chr06,Bn23477,60798425,84820866,24022441,TN
chr06,Bn23478,38834992,74048167,35213175,TNL
chr06,Bn23479,99564075,99900129,336054,NBS
chr06,Bn23480,59423660,96640997,37217337,RLK
chr06,Bn23481,34677335,98105964,63428629,CN
chr06,Bn23482,49086914,64219966,15133052,TNL
chr06,Bn23483,77631428,91553967,13922539,CN
chr06,Bn23484,69309681,71965353,2655672,RLK
chr06,Bn23485,53201577,69245851,16044274,CNL
chr06,Bn23486,16583981,95706277,79122296,NBS
chr06,Bn23487,29629105,52740185,23111080,CNL
chr06,Bn23488,7573239,92670406,85097167,TNL
chr06,Bn23489,14055912,85810643,71754731,TN
chr06,Bn23490,14237215,68874944,54637729,RLK
chr06,Bn23491,36614186,45901063,9286877,TNL
chr06,Bn23492,82068992,95990175,13921183,CN
chr06,Bn23493,5071867,17719172,12647305,RLP
chr06,Bn23494,65282662,75029671,9747009,CN
chr06,Bn23495,34991312,40051446,5060134,TN
chr06,Bn23496,59893134,91616164,31723030,NBS
chr06,Bn23497,11966886,41079133,29112247,TN
chr06,Bn23498,62579986,85022864,22442878,CNL
chr06,Bn23499,88965177,90693179,1728002,RLP
chr06,Bn23500,37682630,38894243,1211613,TNL
chr06,Bn23501,12765920,43271201,30505281,TN
chr06,Bn23502,63782948,82194173,18411225,NBS
chr06,Bn23503,66683430,86228059,19544629,CNL
chr06,Bn23504,27590329,47731197,20140868,TNL
chr06,Bn23505,61006255,92198352,31192097,CNL
chr06,Bn23506,72986004,81997466,9011462,RLP
chr06,Bn23507,33245672,86024467,52778795,TNL
chr06,Bn23508,9282124,62790644,53508520,TN
chr06,Bn23509,85799727,87422366,1622639,TNL
chr06,Bn23510,8544078,86948106,78404028,RLP
chr06,Bn23511,14772156,19663825,4891669,NBS
chr06,Bn23512,18620976,95000160,76379184,NBS
chr06,Bn23513,20526751,64108723,43581972,RLK
chr06,Bn23514,68715789,81279003,12563214,TN
chr06,Bn23515,88223416,96322636,8099220,CN
chr06,Bn23516,82351124,86456965,4105841,RLK
chr06,Bn23517,85291569,93321034,8029465,NBS
chr06,Bn23518,63959958,66716208,2756250,RLK
chr06,Bn23519,18960339,28093794,9133455,TNL
chr06,Bn23520,71155162,80984183,9829021,TN
chr06,Bn23521,81583078,84622184,3039106,RLK
chr06,Bn23522,35121097,79145247,44024150,CN
chr06,Bn23523,71282546,79333266,8050720,TNL
chr06,Bn23524,74241217,90441148,16199931,CNL
chr06,Bn23525,6033782,75617729,69583947,NBS
chr06,Bn23526,39452210,72791980,33339770,RLP
chr06,Bn23527,75487727,85597210,10109483,TN
chr06,Bn23528,56335336,78442466,22107130,RLK
chr06,Bn23529,46535187,51974734,5439547,CNL
chr06,Bn23530,81893444,97906573,16013129,RLK
chr06,Bn23531,38129632,56201898,18072266,TNL
chr06,Bn23532,31772827,85136884,53364057,TNL
chr06,Bn23533,42537376,88067796,45530420,TN
chr06,Bn23534,50426324,53235807,2809483,RLP
chr06,Bn23535,79534367,83623102,4088735,RLK
chr06,Bn23536,93505412,99973696,6468284,CN
chr06,Bn23537,60734561,83598757,22864196,RLK
chr06,Bn23538,7803555,59889419,52085864,TN
chr06,Bn23539,15494222,89701554,74207332,NBS
chr06,Bn23540,89065664,97130316,8064652,RLK
chr06,Bn23541,39739399,78583696,38844297,TN
chr06,Bn23542,30390346,31660990,1270644,NBS
chr06,Bn23543,21808170,83807158,61998988,TNL
chr06,Bn23544,45990322,57528072,11537750,NBS
chr06,Bn23545,95541559,98975079,3433520,RLK
chr06,Bn23546,30610288,75216999,44606711,RLK
chr06,Bn23547,15732937,56459685,40726748,TN
chr06,Bn23548,40772471,81051093,40278622,TN
chr06,Bn23549,12102296,77851514,65749218,RLP
chr06,Bn23550,10332904,85694416,75361512,NBS
chr06,Bn23551,30573016,35462358,4889342,NBS
chr06,Bn23552,94938457,99865856,4927399,RLP
chr06,Bn23553,66834398,96270919,29436521,TN
chr06,Bn23554,16752746,89777442,73024696,RLK
chr06,Bn23555,65059322,85165609,20106287,CNL
chr06,Bn23556,95824994,95954024,129030,RLP
chr06,Bn23557,25693171,70547830,44854659,RLK
chr06,Bn23558,94428764,98998549,4569785,RLK
chr06,Bn23559,77866168,88135151,10268983,CNL
chr06,Bn23560,15117772,51147722,36029950,RLK
chr06,Bn23561,91462323,96721470,5259147,CNL
chr06,Bn23562,8733247,24188651,15455404,RLK
chr06,Bn23563,68934704,92037884,23103180,RLP
chr06,Bn23564,85894236,99502360,13608124,CN
chr06,Bn23565,62342977,79180683,16837706,CN
chr06,Bn23566,20841853,94504949,73663096,CNL
chr06,Bn23567,68654275,82428516,13774241,RLK
chr06,Bn23568,34405155,91985446,57580291,RLK
chr06,Bn23569,16002147,70614654,54612507,TN
chr06,Bn23570,53145787,78846812,25701025,TNL
chr06,Bn23571,40903477,58525668,17622191,TN
chr06,Bn23572,63066497,98247936,35181439,TNL
chr06,Bn23573,23694869,84661728,60966859,CNL
chr06,Bn23574,2731764,97049655,94317891,CNL
chr06,Bn23575,82025927,95816161,13790234,TN
chr06,Bn23576,63523281,65253274,1729993,CN
chr06,Bn23577,62455124,89918560,27463436,TNL
chr06,Bn23578,46677569,85032274,38354705,RLK
chr06,Bn23579,80775230,96664500,15889270,NBS
chr06,Bn23580,12612972,97651502,85038530,NBS
chr06,Bn23581,23398858,47136045,23737187,CNL
chr06,Bn23582,34600452,83224801,48624349,CNL
chr06,Bn23583,95495795,98003940,2508145,TNL
chr06,Bn23584,57478181,79322663,21844482,TN
chr06,Bn23585,47102384,88398064,41295680,CN
chr06,Bn23586,91548230,97833577,6285347,CN
chr06,Bn23587,92519100,96010737,3491637,TNL
chr06,Bn23588,79338782,91415553,12076771,TN
chr06,Bn23589,39159668,77004478,37844810,NBS
chr06,Bn23590,65839701,90025945,24186244,TNL
chr06,Bn23591,55931753,66232246,10300493,TNL
chr06,Bn23592,63929111,71791249,7862138,RLK
chr06,Bn23593,90053815,92407100,2353285,CN
chr06,Bn23594,80327372,96662010,16334638,TN
chr06,Bn23595,30249716,93107561,62857845,TN
chr06,Bn23596,53830785,81195473,27364688,RLP
chr06,Bn23597,55381176,64728791,9347615,RLP
chr06,Bn23598,29113774,35598664,6484890,NBS
chr06,Bn23599,60766665,68284127,7517462,RLP
chr06,Bn23600,30244587,47124228,16879641,CN
chr06,Bn23601,72282698,90872816,18590118,TN
chr06,Bn23602,92278682,96559815,4281133,TN
chr06,Bn23603,62221345,91455268,29233923,RLK
chr06,Bn23604,52252442,99592585,47340143,NBS
chr06,Bn23605,55754844,82607918,26853074,CN
chr06,Bn23606,97445264,99753755,2308491,RLP
chr06,Bn23607,7346055,15454629,8108574,CNL
chr06,Bn23608,92845791,93953296,1107505,TNL
chr06,Bn23609,79528322,92452456,12924134,TNL
chr06,Bn23610,64864534,93358623,28494089,RLP
chr06,Bn23611,95451773,95785334,333561,CN
chr06,Bn23612,73818012,77562135,3744123,TN
chr06,Bn23613,7476860,97985801,90508941,TN
chr06,Bn23614,33932710,88970985,55038275,TNL
chr06,Bn23615,93436893,93902579,465686,TN
chr06,Bn23616,25739091,34610252,8871161,TN
chr06,Bn23617,21525339,98447446,76922107,CNL
chr06,Bn23618,25122523,74775947,49653424,RLK
chr06,Bn23619,94595923,95345177,749254,TN
chr06,Bn23620,46189092,63240824,17051732,CNL
chr06,Bn23621,88507728,92739998,4232270,TN
chr06,Bn23622,5250326,35392990,30142664,RLK
chr06,Bn23623,65286281,99978649,34692368,NBS
chr06,Bn23624,42841494,52597497,9756003,TNL
chr06,Bn23625,61268418,70064313,8795895,RLP
chr06,Bn23626,45832873,90149174,44316301,RLP
chr06,Bn23627,48722001,50285836,1563835,RLK
chr06,Bn23628,96070008,96670132,600124,CNL
chr06,Bn23629,23114853,46782795,23667942,RLP
chr06,Bn23630,99116460,99502879,386419,CNL
chr06,Bn23631,73646687,93849962,20203275,TNL
chr06,Bn23632,3059700,3638876,579176,RLP
chr06,Bn23633,39026343,87075616,48049273,TN
chr06,Bn23634,12143074,28314832,16171758,CN
chr06,Bn23635,29766562,90391194,60624632,NBS
chr06,Bn23636,82893463,92019588,9126125,NBS
chr06,Bn23637,74338227,77256127,2917900,TNL
chr06,Bn23638,6931775,34407078,27475303,CN
chr06,Bn23639,75196690,76004451,807761,RLK
chr06,Bn23640,88678111,95351601,6673490,CN
chr06,Bn23641,58444990,97974645,39529655,RLK
chr06,Bn23642,3830457,52997056,49166599,CNL
chr06,Bn23643,11193327,25848232,14654905,NBS
chr06,Bn23644,37662350,49008088,11345738,CNL
chr06,Bn23645,61511490,97021767,35510277,NBS
chr06,Bn23646,95998505,98487371,2488866,TNL
chr06,Bn23647,19396390,69230271,49833881,RLK
chr06,Bn23648,26943371,90765263,63821892,CNL
chr06,Bn23649,54941444,90647661,35706217,TNL
chr06,Bn23650,19409691,85682615,66272924,TNL
chr06,Bn23651,80865755,89163726,8297971,CNL
chr06,Bn23652,34392433,89197429,54804996,CNL
chr06,Bn23653,45001448,87094229,42092781,CN
chr06,Bn23654,9027093,62504892,53477799,RLK
chr06,Bn23655,8629225,42622148,33992923,TNL
chr06,Bn23656,63798621,84064438,20265817,CN
chr06,Bn23657,41645550,42228979,583429,TN
chr06,Bn23658,18215017,63356120,45141103,TN
chr06,Bn23659,2099077,41528631,39429554,TN
chr06,Bn23660,93767976,98874809,5106833,CN
chr06,Bn23661,7199681,26002334,18802653,RLK
chr06,Bn23662,14388686,30912609,16523923,TNL
chr06,Bn23663,3687445,83875800,80188355,CN
chr06,Bn23664,90347354,98303564,7956210,TNL
chr06,Bn23665,15608315,35061085,19452770,CN
chr06,Bn23666,99418000,99483592,65592,CN
chr06,Bn23667,68471660,98737760,30266100,RLP
chr06,Bn23668,28351456,44954928,16603472,CN
chr06,Bn23669,99115702,99130943,15241,TN
chr06,Bn23670,34061331,34560207,498876,TN
chr06,Bn23671,96367501,98331542,1964041,RLP
chr06,Bn23672,96881916,97323486,441570,CNL
chr06,Bn23673,18877361,85373829,66496468,TNL
chr06,Bn23674,3682959,48973810,45290851,TN
chr06,Bn23675,65988900,88374725,22385825,TNL
chr06,Bn23676,83348335,87617101,4268766,NBS
chr06,Bn23677,93466690,98960696,5494006,RLP
chr06,Bn23678,24218765,34110368,9891603,RLP
chr06,Bn23679,28360985,58733250,30372265,NBS
chr06,Bn23680,55575554,94743458,39167904,TN
chr06,Bn23681,17282396,96192479,78910083,TN
chr06,Bn23682,11087741,96812148,85724407,TN
chr06,Bn23683,98452933,98546407,93474,TNL
chr06,Bn23684,89844678,98219722,8375044,RLP
chr06,Bn23685,14697906,62969497,48271591,TN
chr06,Bn23686,20017370,55078791,35061421,CNL
chr06,Bn23687,82475657,86128499,3652842,RLK
chr06,Bn23688,92912617,96808725,3896108,CNL
chr06,Bn23689,3164153,88817094,85652941,TN
chr06,Bn23690,75860708,95916373,20055665,RLK
chr06,Bn23691,22430969,69600557,47169588,CN
chr06,Bn23692,64166297,76147248,11980951,TNL
chr06,Bn23693,32100405,36561032,4460627,TN
chr06,Bn23694,11624243,80409864,68785621,TNL
chr06,Bn23695,31315275,66425004,35109729,RLP
chr06,Bn23696,93906789,96434280,2527491,CN
chr06,Bn23697,71616670,86575699,14959029,RLK
chr06,Bn23698,49582105,94378037,44795932,TN
chr06,Bn23699,47956353,99784034,51827681,RLK
chr06,Bn23700,84436023,84544028,108005,NBS
chr06,Bn23701,98773681,99366672,592991,RLP
chr06,Bn23702,47537544,81295175,33757631,RLK
chr06,Bn23703,63874378,84071909,20197531,NBS
chr06,Bn23704,16736299,45793016,29056717,TNL
chr06,Bn23705,86329266,90525659,4196393,TN
chr06,Bn23706,77782449,97244919,19462470,TN
chr06,Bn23707,18240203,38006214,19766011,TN
chr06,Bn23708,93345000,97358891,4013891,RLP
chr06,Bn23709,88932707,89585479,652772,RLK
chr06,Bn23710,77014789,89554628,12539839,NBS
chr06,Bn23711,95833155,98508372,2675217,TN
chr06,Bn23712,99491440,99902777,411337,CNL
chr06,Bn23713,99823302,99838351,15049,NBS
chr06,Bn23714,78050844,82839914,4789070,NBS
chr06,Bn23715,73364905,91696615,18331710,TN
chr06,Bn23716,16057305,69357330,53300025,TN
chr06,Bn23717,29903819,60960100,31056281,TNL
chr06,Bn23718,1519771,54875822,53356051,TN
chr06,Bn23719,39620160,52195659,12575499,TN
chr06,Bn23720,57784454,84794186,27009732,TNL
chr06,Bn23721,62216746,95305639,33088893,TN
chr06,Bn23722,79901832,86310607,6408775,CN
chr06,Bn23723,38675663,65451851,26776188,RLP
chr06,Bn23724,83757154,85607487,1850333,CNL
chr06,Bn23725,4072723,66543055,62470332,TN
chr06,Bn23726,41526238,74439680,32913442,TNL
chr06,Bn23727,34710726,75072560,40361834,TNL
chr06,Bn23728,12495905,66919233,54423328,RLP
chr06,Bn23729,88153057,95444384,7291327,RLK
chr06,Bn23730,70260684,99613681,29352997,RLK
chr06,Bn23731,65605271,69108385,3503114,RLK
chr06,Bn23732,99854507,99974276,119769,RLK
chr06,Bn23733,99524487,99763583,239096,CNL
chr06,Bn23734,21546983,73119536,51572553,RLK
chr06,Bn23735,38055035,50308785,12253750,CN
chr06,Bn23736,69499811,81203088,11703277,TNL
chr06,Bn23737,37691168,82828487,45137319,TN
chr06,Bn23738,20934056,79850297,58916241,TNL
chr06,Bn23739,23154055,52401597,29247542,CN
chr06,Bn23740,96325245,99846391,3521146,RLK
chr06,Bn23741,65411067,79652537,14241470,CN
chr06,Bn23742,37117776,43281354,6163578,NBS
chr06,Bn23743,33149245,61999068,28849823,TNL
chr06,Bn23744,95996417,99718593,3722176,TNL
chr06,Bn23745,5033755,73067769,68034014,CN
chr06,Bn23746,22573923,45113304,22539381,CN
chr06,Bn23747,77418602,98380989,20962387,CN
chr06,Bn23748,65464097,98278189,32814092,NBS
chr06,Bn23749,59576403,68502786,8926383,TN
chr06,Bn23750,4841269,16924319,12083050,RLP
chr06,Bn23751,68149210,98154497,30005287,CNL
chr06,Bn23752,87572111,89936558,2364447,NBS
chr06,Bn23753,44071475,45327149,1255674,NBS
chr06,Bn23754,33805345,35647103,1841758,TN
chr06,Bn23755,51261428,91947266,40685838,CNL
chr06,Bn23756,85915247,95425600,9510353,NBS
chr06,Bn23757,53591710,79930220,26338510,NBS
chr06,Bn23758,29809656,81681482,51871826,CNL
chr06,Bn23759,2403819,71311388,68907569,CNL
chr06,Bn23760,47098612,58491161,11392549,NBS
chr06,Bn23761,31239964,89784372,58544408,NBS
chr06,Bn23762,81698741,83705824,2007083,TN
chr06,Bn23763,24976493,87523287,62546794,NBS
chr06,Bn23764,83792876,92839087,9046211,TN
chr06,Bn23765,72195693,98637192,26441499,TN
chr06,Bn23766,45339343,66150044,20810701,RLK
chr06,Bn23767,76725711,87935482,11209771,TN
chr06,Bn23768,21532078,97008482,75476404,RLP
chr06,Bn23769,19816975,22217994,2401019,CNL
chr06,Bn23770,95261379,96973654,1712275,TNL
chr06,Bn23771,47185384,88486813,41301429,TNL
chr06,Bn23772,1461308,90224186,88762878,NBS
chr06,Bn23773,95576935,98220374,2643439,RLK
chr06,Bn23774,12153592,19835304,7681712,TNL
chr06,Bn23775,51272576,51779530,506954,CN
chr06,Bn23776,92248106,95534053,3285947,NBS
chr06,Bn23777,11071054,93197329,82126275,RLP
chr06,Bn23778,91641629,94745524,3103895,TNL
chr06,Bn23779,86797089,93412291,6615202,NBS
chr06,Bn23780,22640467,56550263,33909796,TNL
chr06,Bn23781,19071537,84888114,65816577,CN
chr06,Bn23782,91907772,96840207,4932435,CN
chr06,Bn23783,84293091,94228042,9934951,CN
chr06,Bn23784,58135632,72408878,14273246,RLP
chr06,Bn23785,82466060,97208949,14742889,TNL
chr06,Bn23786,42940876,95188819,52247943,CNL
chr06,Bn23787,41680355,60770742,19090387,RLK
chr06,Bn23788,98167208,99168176,1000968,CNL
chr06,Bn23789,74926251,95902630,20976379,TN
chr06,Bn23790,50227780,79278411,29050631,CN
chr06,Bn23791,95763833,99012922,3249089,TNL
chr06,Bn23792,90582792,95137117,4554325,CNL
chr06,Bn23793,92536598,96484644,3948046,TN
chr06,Bn23794,95747543,99645057,3897514,TNL
chr06,Bn23795,95619958,99214387,3594429,TN
chr06,Bn23796,79849349,90480760,10631411,CN
chr06,Bn23797,52262353,60779672,8517319,TNL
chr06,Bn23798,35402528,99812166,64409638,TN
chr06,Bn23799,16357907,81984952,65627045,RLP
chr06,Bn23800,46030140,88439861,42409721,TNL
chr06,Bn23801,26359070,58365685,32006615,CN
chr06,Bn23802,61362117,92571149,31209032,RLK
chr06,Bn23803,82052962,87663495,5610533,CN
chr06,Bn23804,52612898,56289475,3676577,RLK
chr06,Bn23805,47045236,66869119,19823883,CNL
chr06,Bn23806,43240402,89437072,46196670,RLP
chr06,Bn23807,65351585,90530590,25179005,CN
chr06,Bn23808,1855575,90592569,88736994,RLP
chr06,Bn23809,44389009,82881996,38492987,RLP
chr06,Bn23810,79384278,92088796,12704518,RLK
chr06,Bn23811,88056726,92576408,4519682,CN
chr06,Bn23812,42015631,52170039,10154408,TNL
chr06,Bn23813,51936177,67156702,15220525,NBS
chr06,Bn23814,95074004,99279374,4205370,TN
chr06,Bn23815,38642143,57489468,18847325,NBS
chr06,Bn23816,90902613,95981657,5079044,CNL
chr06,Bn23817,52487345,98973103,46485758,NBS
chr06,Bn23818,94557776,97064229,2506453,TNL
chr06,Bn23819,53017168,58108963,5091795,CN
chr06,Bn23820,61502408,63825069,2322661,TN
chr06,Bn23821,56611093,80496505,23885412,RLP
chr06,Bn23822,65937609,79686637,13749028,CNL
chr06,Bn23823,33829757,74891965,41062208,TNL
chr06,Bn23824,2210469,69628801,67418332,TNL
chr06,Bn23825,24415071,74381160,49966089,RLP
chr06,Bn23826,48576581,80585628,32009047,TN
chr06,Bn23827,70771824,92494220,21722396,CN
chr06,Bn23828,21521825,94349781,72827956,RLP
chr06,Bn23829,86183384,89271075,3087691,CN
chr06,Bn23830,33045142,42655065,9609923,CNL
chr06,Bn23831,94443332,95050752,607420,NBS
chr06,Bn23832,1440874,52373107,50932233,RLP
chr06,Bn23833,27205626,82652558,55446932,CN
chr06,Bn23834,97244337,99154057,1909720,NBS
chr06,Bn23835,28022536,45297896,17275360,CN
chr06,Bn23836,42143103,97467342,55324239,RLP
chr06,Bn23837,13239567,53504209,40264642,RLP
chr06,Bn23838,53518918,90257273,36738355,CN
chr06,Bn23839,51679331,90366998,38687667,RLP
chr06,Bn23840,46338100,89950422,43612322,RLP
chr06,Bn23841,4485484,93697299,89211815,TN
chr06,Bn23842,75268295,80413207,5144912,TNL
chr06,Bn23843,50877816,57755951,6878135,CNL
chr06,Bn23844,38719110,99267679,60548569,CNL
chr06,Bn23845,46793625,78326631,31533006,CNL
chr06,Bn23846,38837357,83708118,44870761,CNL
chr06,Bn23847,22879878,84104125,61224247,RLK
chr06,Bn23848,59702654,73740756,14038102,TNL
chr06,Bn23849,47007087,65274045,18266958,NBS
chr06,Bn23850,90097582,96477852,6380270,RLP
chr06,Bn23851,70847351,75754168,4906817,TN
chr06,Bn23852,88900625,88994447,93822,CN
chr06,Bn23853,57614980,81322616,23707636,TNL
chr06,Bn23854,73671382,89966247,16294865,NBS
chr06,Bn23855,12452699,46736320,34283621,CNL
chr06,Bn23856,3078993,16567453,13488460,NBS
chr06,Bn23857,10937134,88938836,78001702,TNL
chr06,Bn23858,40982219,47557238,6575019,RLK
chr06,Bn23859,91629122,94282791,2653669,CNL
chr06,Bn23860,21417908,85688940,64271032,CNL
chr06,Bn23861,61723109,81149441,19426332,NBS
chr06,Bn23862,5100218,84131131,79030913,TNL
chr06,Bn23863,4616137,76432491,71816354,CN
chr06,Bn23864,72692025,87698765,15006740,CN
chr06,Bn23865,65664103,85487524,19823421,RLP
chr06,Bn23866,78486875,91450585,12963710,RLP
chr06,Bn23867,35521435,60980905,25459470,RLK
chr06,Bn23868,21736681,89787127,68050446,RLK
chr06,Bn23869,47081335,57480332,10398997,CNL
chr06,Bn23870,93314032,95231299,1917267,CN
chr06,Bn23871,7469507,20517052,13047545,CNL
chr06,Bn23872,63316283,88677068,25360785,TNL
chr06,Bn23873,68665792,70773891,2108099,CN
chr06,Bn23874,7200646,59174672,51974026,RLK
chr06,Bn23875,70197264,70213073,15809,RLP
chr06,Bn23876,37072034,89939139,52867105,TNL
chr06,Bn23877,7699000,64091284,56392284,TNL
chr06,Bn23878,49559276,59164448,9605172,CN
chr06,Bn23879,42294377,90622184,48327807,TNL
chr06,Bn23880,72201448,86093643,13892195,CN
chr06,Bn23881,88850122,96442170,7592048,TN
chr06,Bn23882,35945534,38612728,2667194,TN
chr06,Bn23883,31784103,75540114,43756011,CNL
chr06,Bn23884,55529754,62437163,6907409,CNL
chr06,Bn23885,82905117,97860649,14955532,TNL
chr06,Bn23886,83371882,86051973,2680091,RLK
chr06,Bn23887,16295930,40054287,23758357,TN
chr06,Bn23888,97684203,99155390,1471187,TNL
chr06,Bn23889,96155389,97318575,1163186,TNL
chr06,Bn23890,80184174,92723014,12538840,CNL
chr06,Bn23891,8860682,97992877,89132195,RLP
chr06,Bn23892,39353640,66782624,27428984,RLP
chr06,Bn23893,14162667,99667739,85505072,NBS
chr06,Bn23894,52404895,80488468,28083573,CN
chr06,Bn23895,77180779,82862865,5682086,RLK
chr06,Bn23896,22425454,34501905,12076451,NBS
chr06,Bn23897,3069733,78510670,75440937,TN
chr06,Bn23898,56798226,60658216,3859990,RLP
chr06,Bn23899,62273479,79713756,17440277,CNL
chr06,Bn23900,85367459,89598884,4231425,NBS
chr06,Bn23901,75510471,87385826,11875355,RLK
chr06,Bn23902,34109536,43443048,9333512,CNL
chr06,Bn23903,7765778,31924509,24158731,RLK
chr06,Bn23904,65585427,74542989,8957562,TN
chr06,Bn23905,45183120,73773444,28590324,TN
chr06,Bn23906,30776786,67794480,37017694,CNL
chr06,Bn23907,46201379,97082764,50881385,TN
chr06,Bn23908,52742854,85033023,32290169,CNL
chr06,Bn23909,63872561,89954798,26082237,TNL
chr06,Bn23910,62783505,69630713,6847208,RLP
chr06,Bn23911,97846908,99400427,1553519,NBS
chr06,Bn23912,53481779,75716124,22234345,NBS
chr06,Bn23913,24740353,91504040,66763687,RLK
chr06,Bn23914,74262040,95602506,21340466,RLK
chr06,Bn23915,49489819,83009009,33519190,NBS
chr06,Bn23916,94345121,99056297,4711176,RLP
chr06,Bn23917,86218908,92432217,6213309,RLP
chr06,Bn23918,59392312,69143010,9750698,TNL
chr06,Bn23919,87290143,96141577,8851434,RLK
chr06,Bn23920,71759532,93461187,21701655,RLP
chr06,Bn23921,54885850,58573535,3687685,CN
chr06,Bn23922,9779826,31439428,21659602,CN
chr06,Bn23923,34132086,37302988,3170902,TN
chr06,Bn23924,43070898,79763918,36693020,TN
chr06,Bn23925,18945954,27301677,8355723,RLK
chr06,Bn23926,66680393,83969940,17289547,TNL
chr06,Bn23927,76176019,79545670,3369651,RLK
chr06,Bn23928,37349500,46983307,9633807,TNL
chr06,Bn23929,23721070,65182327,41461257,CNL
chr06,Bn23930,31104109,45142252,14038143,RLK
chr06,Bn23931,25205700,99241971,74036271,NBS
chr06,Bn23932,92492565,96580549,4087984,TN
chr06,Bn23933,2566207,33063482,30497275,RLK
chr06,Bn23934,52100693,58980662,6879969,CNL
chr06,Bn23935,39883185,95687990,55804805,TN
chr06,Bn23936,80535509,92521917,11986408,TNL
chr06,Bn23937,77293140,88209665,10916525,RLK
chr06,Bn23938,19302029,32557987,13255958,CNL
chr06,Bn23939,81625846,95765698,14139852,TN
chr06,Bn23940,25345310,82168505,56823195,CNL
chr06,Bn23941,32634832,68884416,36249584,RLK
chr06,Bn23942,23886175,59773337,35887162,NBS
chr06,Bn23943,11476489,20445893,8969404,TN
chr06,Bn23944,23776483,67314569,43538086,TNL
chr06,Bn23945,17528034,58934881,41406847,CNL
chr06,Bn23946,58438672,79089565,20650893,TNL
chr06,Bn23947,16116055,59809910,43693855,CNL
chr06,Bn23948,11962185,49400082,37437897,TNL
chr06,Bn23949,62290899,71799468,9508569,CNL
chr06,Bn23950,10608607,72951579,62342972,CN
chr06,Bn23951,75342139,77565965,2223826,CNL
chr06,Bn23952,30167495,64219998,34052503,NBS
chr06,Bn23953,6837496,61368331,54530835,TN
chr06,Bn23954,70733833,72624551,1890718,TNL
chr06,Bn23955,47934792,58500831,10566039,NBS
chr06,Bn23956,45018665,70385413,25366748,TN
chr06,Bn23957,12857926,69428902,56570976,CN
chr06,Bn23958,11864429,25822441,13958012,CNL
chr06,Bn23959,97047108,98374847,1327739,RLP
chr06,Bn23960,37303088,46143954,8840866,RLP
chr06,Bn23961,42118552,52373822,10255270,CN
chr06,Bn23962,40511449,63207528,22696079,CNL
chr06,Bn23963,6964722,80660662,73695940,CNL
chr06,Bn23964,36904569,73742729,36838160,CNL
chr06,Bn23965,3025743,40226088,37200345,RLP
chr06,Bn23966,46148897,68834579,22685682,TN
chr06,Bn23967,18506816,43813431,25306615,RLP
chr06,Bn23968,56633651,92879206,36245555,TN
chr06,Bn23969,39299373,74567682,35268309,RLK
chr06,Bn23970,21700860,52044598,30343738,TN
chr06,Bn23971,37688278,42521449,4833171,CNL
chr06,Bn23972,79488410,99261420,19773010,TN
chr06,Bn23973,90028518,95271981,5243463,TN
chr06,Bn23974,99155056,99831039,675983,RLP
chr06,Bn23975,8600683,51120374,42519691,TN
chr06,Bn23976,26683271,78561265,51877994,CNL
chr06,Bn23977,54213293,80807749,26594456,TN
chr06,Bn23978,1305442,71253836,69948394,RLK
chr06,Bn23979,65789957,82116547,16326590,RLP
chr06,Bn23980,52407975,95356261,42948286,CN
chr06,Bn23981,97323112,98777903,1454791,TN
chr06,Bn23982,67612069,97127426,29515357,CN
chr06,Bn23983,42203833,69015483,26811650,CNL
chr06,Bn23984,2114509,73597207,71482698,NBS
chr06,Bn23985,92381638,95786842,3405204,TN
chr06,Bn23986,95023944,98066912,3042968,TN
chr06,Bn23987,19045616,66996625,47951009,TNL
chr06,Bn23988,93035768,93529114,493346,CN
chr06,Bn23989,2060538,80610611,78550073,RLK
chr06,Bn23990,2664885,72088591,69423706,CNL
chr06,Bn23991,24972824,29190625,4217801,CNL
chr06,Bn23992,54638848,71784937,17146089,TN
chr06,Bn23993,50749894,87189037,36439143,CN
chr06,Bn23994,13088490,71468051,58379561,TN
chr06,Bn23995,69414314,97841853,28427539,CNL
chr06,Bn23996,28907050,34687603,5780553,TNL
chr06,Bn23997,26318944,52344377,26025433,RLK
chr06,Bn23998,65438646,72233703,6795057,TN
chr06,Bn23999,26884645,51771833,24887188,CN
chr06,Bn24000,43917192,78916053,34998861,TN
chr06,Bn24001,37585696,50053239,12467543,CN
chr06,Bn24002,44997596,70642709,25645113,TNL
chr06,Bn24003,63501272,87506448,24005176,TN
chr06,Bn24004,27520998,53066625,25545627,NBS
chr06,Bn24005,14996626,71336765,56340139,RLK
chr06,Bn24006,58372405,65984553,7612148,RLP
chr06,Bn24007,80634696,92894256,12259560,TNL
chr06,Bn24008,7698936,57464343,49765407,NBS
chr06,Bn24009,10374320,67910704,57536384,RLP
chr06,Bn24010,48121253,95809001,47687748,NBS
chr06,Bn24011,44554398,59968213,15413815,TN
chr06,Bn24012,42520076,74179455,31659379,RLK
chr06,Bn24013,79286680,90216315,10929635,CN
chr06,Bn24014,80665382,99969784,19304402,RLP
chr06,Bn24015,24844569,31760968,6916399,CN
chr06,Bn24016,57408100,67904645,10496545,NBS
chr06,Bn24017,28712582,52175252,23462670,CNL
chr06,Bn24018,83019961,89156353,6136392,NBS
chr06,Bn24019,18668573,49217879,30549306,NBS
chr06,Bn24020,1068757,85906280,84837523,RLK
chr06,Bn24021,70668334,77711318,7042984,CN
chr06,Bn24022,41240888,88726813,47485925,CNL
chr06,Bn24023,6417931,48434661,42016730,TNL
chr06,Bn24024,78512434,88592575,10080141,TN
chr06,Bn24025,67476168,88230958,20754790,NBS
chr06,Bn24026,39382849,62779492,23396643,CNL
chr06,Bn24027,84819036,84833793,14757,RLK
chr06,Bn24028,33524219,60457740,26933521,RLK
chr06,Bn24029,85325283,89129798,3804515,CNL
chr06,Bn24030,91709576,91734033,24457,CN
chr06,Bn24031,92675486,99729271,7053785,RLP
chr06,Bn24032,50386576,93019618,42633042,CNL
chr06,Bn24033,80194809,96738759,16543950,NBS
chr06,Bn24034,24196846,66561439,42364593,CNL
chr06,Bn24035,60496583,99689692,39193109,RLP
chr06,Bn24036,49612454,93770176,44157722,TNL
chr06,Bn24037,41054078,88764714,47710636,CN
chr06,Bn24038,40383001,46164579,5781578,RLP
chr06,Bn24039,65756131,99099625,33343494,TNL
chr06,Bn24040,38083544,66646219,28562675,CNL
chr06,Bn24041,54792402,89701809,34909407,TN
chr06,Bn24042,96780171,99578852,2798681,RLK
chr06,Bn24043,62312897,77216331,14903434,TNL
chr06,Bn24044,5994833,91122388,85127555,NBS
chr06,Bn24045,77328263,78691371,1363108,CN
chr06,Bn24046,22135839,26874942,4739103,CN
chr06,Bn24047,92611378,92761763,150385,CNL
chr06,Bn24048,93222409,95096110,1873701,NBS
chr06,Bn24049,6127074,20148695,14021621,RLK
chr06,Bn24050,45810636,76548636,30738000,TNL
chr06,Bn24051,66119304,85952622,19833318,CN
chr06,Bn24052,97667193,99963589,2296396,NBS
chr06,Bn24053,93275396,96051845,2776449,NBS
chr06,Bn24054,97457719,98321560,863841,CNL
chr06,Bn24055,82156004,83842564,1686560,NBS
chr06,Bn24056,72349880,89114323,16764443,RLP
chr06,Bn24057,41767747,66852035,25084288,TNL
chr06,Bn24058,63378311,92627855,29249544,CNL
chr06,Bn24059,82603017,83106221,503204,TN
chr06,Bn24060,25612498,87700785,62088287,RLP
chr06,Bn24061,99401396,99908860,507464,TN
chr06,Bn24062,86275180,93837426,7562246,RLP
chr06,Bn24063,59561342,89029113,29467771,TN
chr06,Bn24064,66930596,70642116,3711520,RLP
chr06,Bn24065,77439181,80698767,3259586,CNL
chr06,Bn24066,25546924,58549277,33002353,TN
chr06,Bn24067,14217600,76298234,62080634,TNL
chr06,Bn24068,98745258,99312797,567539,CNL
chr06,Bn24069,30649947,67522968,36873021,CN
chr06,Bn24070,41113437,62123556,21010119,TNL
chr06,Bn24071,35457686,80478472,45020786,RLK
chr06,Bn24072,70800567,75220865,4420298,TN
chr06,Bn24073,43971079,60448061,16476982,CN
chr06,Bn24074,21179876,34854326,13674450,CN
chr06,Bn24075,26794934,28450404,1655470,TN
chr06,Bn24076,63022007,94037288,31015281,TN
chr06,Bn24077,39978015,97644149,57666134,NBS
chr06,Bn24078,68115945,97885060,29769115,NBS
chr06,Bn24079,26607118,61893835,35286717,CNL
chr06,Bn24080,32896601,82216579,49319978,NBS
chr06,Bn24081,82217835,85109722,2891887,CN
chr06,Bn24082,21934232,41488332,19554100,TN
chr06,Bn24083,89894319,98936564,9042245,RLK
chr06,Bn24084,90200423,97441167,7240744,TN
chr06,Bn24085,18947300,63290159,44342859,TN
chr06,Bn24086,47239155,75869857,28630702,CNL
chr06,Bn24087,86104784,96639695,10534911,TN
chr06,Bn24088,37574513,79374985,41800472,TNL
chr06,Bn24089,89428363,97490031,8061668,TN
chr06,Bn24090,56517741,56587712,69971,RLP
chr06,Bn24091,10380815,51419880,41039065,CNL
chr06,Bn24092,44633790,97516971,52883181,CNL
chr06,Bn24093,29632747,92403597,62770850,RLK
chr06,Bn24094,74997273,85730020,10732747,NBS
chr06,Bn24095,74325212,87813274,13488062,CN
chr06,Bn24096,10582522,54184091,43601569,RLK
chr06,Bn24097,41141590,96608035,55466445,TN
chr06,Bn24098,41044140,49887813,8843673,RLK
chr06,Bn24099,89276509,89587903,311394,TNL
chr06,Bn24100,6878841,91208436,84329595,TNL
chr06,Bn24101,35335882,70326705,34990823,RLK
chr06,Bn24102,67182056,90122989,22940933,TN
chr06,Bn24103,29774019,90814879,61040860,RLK
chr06,Bn24104,33481894,91036998,57555104,TNL
chr06,Bn24105,54662795,75744657,21081862,RLK
chr06,Bn24106,63430828,94912982,31482154,CNL
chr06,Bn24107,47524726,89991017,42466291,RLP
chr06,Bn24108,75607456,78032869,2425413,CNL
chr06,Bn24109,57553534,80389682,22836148,RLK
chr06,Bn24110,9630511,41009158,31378647,CN
chr06,Bn24111,6840424,27912474,21072050,CN
chr06,Bn24112,29250487,34073430,4822943,CNL
chr06,Bn24113,59171188,83116644,23945456,NBS
chr06,Bn24114,90326760,92066131,1739371,CNL
chr06,Bn24115,46510762,76519470,30008708,CNL
chr06,Bn24116,22941001,71731358,48790357,TN
chr06,Bn24117,7680101,45565890,37885789,RLK
chr06,Bn24118,88556670,93075991,4519321,CN
chr06,Bn24119,7113746,97260594,90146848,RLK
chr06,Bn24120,81922210,94259826,12337616,TN
chr06,Bn24121,71691749,77333347,5641598,CNL
chr06,Bn24122,93982217,94289135,306918,TNL
chr06,Bn24123,52895992,96533566,43637574,RLP
chr06,Bn24124,35689819,57832017,22142198,RLK
chr06,Bn24125,1927245,99392034,97464789,TN
chr06,Bn24126,17463247,65949772,48486525,NBS
chr06,Bn24127,45430993,88608444,43177451,NBS
chr06,Bn24128,23463648,29980746,6517098,CNL
chr06,Bn24129,54672227,63989903,9317676,NBS
chr06,Bn24130,40502995,52846447,12343452,RLP
chr06,Bn24131,4596616,42045982,37449366,TNL
chr06,Bn24132,26151887,28138064,1986177,CNL
chr06,Bn24133,33167626,90932569,57764943,TN
chr06,Bn24134,83415455,90737106,7321651,TN
chr06,Bn24135,79404392,88675327,9270935,RLK
chr06,Bn24136,84911756,93659227,8747471,CNL
chr06,Bn24137,61688027,87186708,25498681,RLK
chr06,Bn24138,91857534,95607329,3749795,RLP
chr06,Bn24139,88932385,99738325,10805940,TN
chr06,Bn24140,1158538,91422697,90264159,TNL
chr06,Bn24141,69439403,76472139,7032736,RLP
chr06,Bn24142,15934635,91867904,75933269,TN
chr06,Bn24143,52589510,96883388,44293878,CN
chr06,Bn24144,8780678,12275567,3494889,CNL
chr06,Bn24145,97032641,99237535,2204894,CN
chr06,Bn24146,15400182,69292332,53892150,CN
chr06,Bn24147,87635771,89743265,2107494,NBS
chr06,Bn24148,57770248,68162461,10392213,NBS
chr06,Bn24149,46282723,72108254,25825531,NBS
chr06,Bn24150,4523785,19263816,14740031,RLP
chr06,Bn24151,24627866,82417196,57789330,CNL
chr06,Bn24152,94755624,95119493,363869,CNL
chr06,Bn24153,29471651,57788767,28317116,RLP
chr06,Bn24154,18216419,68108122,49891703,RLK
chr06,Bn24155,42338461,79340695,37002234,CN
chr06,Bn24156,48660155,96003173,47343018,RLP
chr06,Bn24157,38329518,97196756,58867238,CNL
chr06,Bn24158,78579391,90584898,12005507,TN
chr06,Bn24159,43025789,52080609,9054820,CN
chr06,Bn24160,23533383,44976634,21443251,RLK
chr06,Bn24161,78948812,93828423,14879611,TN
chr06,Bn24162,90317585,97873622,7556037,CNL
chr06,Bn24163,15774739,30703860,14929121,CN
chr06,Bn24164,37922877,64720902,26798025,NBS
chr06,Bn24165,20104355,46679039,26574684,RLK
chr06,Bn24166,81998758,98732301,16733543,RLK
chr06,Bn24167,20033593,50207871,30174278,RLK
chr06,Bn24168,66666258,83000595,16334337,TNL
chr06,Bn24169,89587482,95180364,5592882,NBS
chr06,Bn24170,93566548,98904286,5337738,CNL
chr06,Bn24171,6847440,73384311,66536871,CN
chr06,Bn24172,38270275,85828562,47558287,RLP
chr06,Bn24173,67776316,69458906,1682590,NBS
chr06,Bn24174,77681264,82410879,4729615,RLP
chr06,Bn24175,91022879,99349388,8326509,CNL
chr06,Bn24176,96678259,99452952,2774693,RLK
chr06,Bn24177,86687404,98633750,11946346,CN
chr06,Bn24178,55110399,55873315,762916,TNL
chr06,Bn24179,95306129,98641936,3335807,TN
chr06,Bn24180,30965384,62379402,31414018,CN
chr06,Bn24181,56621653,74136477,17514824,RLK
chr06,Bn24182,75244922,80198179,4953257,CNL
chr06,Bn24183,11855339,72944060,61088721,TNL
chr06,Bn24184,87190934,97620971,10430037,RLK
chr06,Bn24185,5684906,86658273,80973367,TN
chr06,Bn24186,10061127,46037553,35976426,RLP
chr06,Bn24187,90699446,97786380,7086934,CN
chr06,Bn24188,92451990,94668037,2216047,RLP
chr06,Bn24189,89828294,94652854,4824560,TN
chr06,Bn24190,66125380,97296780,31171400,TN
chr06,Bn24191,38544184,69230578,30686394,CNL
chr06,Bn24192,88809431,99313614,10504183,CNL
chr06,Bn24193,3853288,9928494,6075206,RLP
chr06,Bn24194,21224944,98135459,76910515,RLK
chr06,Bn24195,20387749,64386462,43998713,TNL
chr06,Bn24196,37402549,89621409,52218860,TN
chr06,Bn24197,76753988,81962930,5208942,NBS
chr06,Bn24198,72877773,99897545,27019772,TNL
chr06,Bn24199,24526609,43776179,19249570,RLP
chr06,Bn24200,51620321,94352387,42732066,TN
chr06,Bn24201,33733205,37456442,3723237,RLP
chr06,Bn24202,54953065,69628078,14675013,RLK
chr06,Bn24203,53848153,82187388,28339235,RLP
chr06,Bn24204,56458811,92571145,36112334,NBS
chr06,Bn24205,45838747,65844460,20005713,TNL
chr06,Bn24206,8823427,75530857,66707430,RLK
chr06,Bn24207,36986149,47197374,10211225,CN
chr06,Bn24208,92520074,92585255,65181,RLP
chr06,Bn24209,43380196,76761146,33380950,CNL
chr06,Bn24210,15893845,57138676,41244831,NBS
chr06,Bn24211,70834867,97881543,27046676,CNL
chr06,Bn24212,97404771,97489590,84819,NBS
chr06,Bn24213,24073263,78470643,54397380,RLP
chr06,Bn24214,96068695,99277470,3208775,NBS
chr06,Bn24215,35786835,36093417,306582,CN
chr06,Bn24216,64678059,81379643,16701584,TN
chr06,Bn24217,1600093,45362115,43762022,RLP
chr06,Bn24218,7612474,66318761,58706287,CN
chr06,Bn24219,89785341,92094937,2309596,RLK
chr06,Bn24220,21317720,48339570,27021850,NBS
chr06,Bn24221,71725585,88379446,16653861,TN
chr06,Bn24222,17422967,59452690,42029723,NBS
chr06,Bn24223,19583190,54101885,34518695,TN
chr06,Bn24224,64453353,93166328,28712975,TN
chr06,Bn24225,82770001,93756025,10986024,CNL
chr06,Bn24226,88222433,97648955,9426522,RLK
chr06,Bn24227,11677470,48983412,37305942,RLP
chr06,Bn24228,41819601,52060899,10241298,CN
chr06,Bn24229,66845793,76711627,9865834,RLP
chr06,Bn24230,23116182,77805779,54689597,RLK
chr06,Bn24231,40808274,97602231,56793957,CNL
chr06,Bn24232,93272614,97739154,4466540,RLK
chr06,Bn24233,74903657,99358820,24455163,TN
chr06,Bn24234,65013078,73272401,8259323,TN
chr06,Bn24235,53014812,63714076,10699264,TN
chr06,Bn24236,80513266,80893383,380117,TNL
chr06,Bn24237,68567512,74015604,5448092,TN
chr06,Bn24238,1726738,27975190,26248452,NBS
chr06,Bn24239,57970906,74138229,16167323,RLK
chr06,Bn24240,80405706,90268856,9863150,CNL
chr06,Bn24241,44664867,94540135,49875268,CNL
chr06,Bn24242,24605229,81200175,56594946,RLP
chr06,Bn24243,88495895,98782725,10286830,TNL
chr06,Bn24244,44739970,85150130,40410160,CNL
chr06,Bn24245,98864999,99995339,1130340,RLK
chr06,Bn24246,52925459,93500830,40575371,TNL
chr06,Bn24247,10679486,67314170,56634684,CN
chr06,Bn24248,92199091,96621146,4422055,TNL
chr06,Bn24249,49371586,70265139,20893553,RLP
chr06,Bn24250,43909545,92199495,48289950,NBS
chr06,Bn24251,14736918,83285663,68548745,NBS
chr06,Bn24252,59471792,98432601,38960809,RLP
chr06,Bn24253,50750689,72384672,21633983,CN
chr06,Bn24254,38575243,45940075,7364832,CNL
chr06,Bn24255,64662536,70326168,5663632,NBS
chr06,Bn24256,31057714,40565529,9507815,TNL
chr06,Bn24257,35632751,88339124,52706373,NBS
chr06,Bn24258,2035245,74619334,72584089,NBS
chr06,Bn24259,21735052,97978564,76243512,RLP
chr06,Bn24260,89853283,93786522,3933239,NBS
chr06,Bn24261,92274707,93795772,1521065,TNL
chr06,Bn24262,6755615,9173894,2418279,CN
chr06,Bn24263,61886537,64457211,2570674,NBS
chr06,Bn24264,35282080,74430046,39147966,CNL
chr06,Bn24265,98166238,98569878,403640,TN
chr06,Bn24266,86949111,88118087,1168976,CN
chr06,Bn24267,88942080,93863540,4921460,TN
chr06,Bn24268,69305812,89093628,19787816,RLK
chr06,Bn24269,67995008,90547012,22552004,RLK
chr06,Bn24270,21646564,91368401,69721837,CNL
chr06,Bn24271,16949578,18726911,1777333,CN
chr06,Bn24272,6804454,32937572,26133118,TN
chr06,Bn24273,3824421,8312833,4488412,CN
chr06,Bn24274,2575120,21606568,19031448,CN
chr06,Bn24275,30247442,72505740,42258298,RLK
chr06,Bn24276,18353112,87753797,69400685,RLP
chr06,Bn24277,56052213,69569402,13517189,TNL
chr06,Bn24278,5988356,10776693,4788337,RLK
chr06,Bn24279,27127577,40661980,13534403,RLK
chr06,Bn24280,5173700,82741054,77567354,TN
chr06,Bn24281,25673997,70972524,45298527,CNL
chr06,Bn24282,97558572,98824087,1265515,NBS
chr06,Bn24283,86421945,90512360,4090415,RLK
chr06,Bn24284,41136433,46029942,4893509,TN
chr06,Bn24285,17746325,27192480,9446155,CNL
chr06,Bn24286,70671191,74678157,4006966,RLK
chr06,Bn24287,43365194,94079010,50713816,TN
chr06,Bn24288,8326684,33901384,25574700,CN
chr06,Bn24289,62072903,70976254,8903351,TN
chr06,Bn24290,32998679,96450627,63451948,RLK
chr06,Bn24291,46335740,51328878,4993138,TN
chr06,Bn24292,51443282,85044289,33601007,RLP
chr06,Bn24293,6382387,38524097,32141710,RLP
chr06,Bn24294,59760742,71303542,11542800,TNL
chr06,Bn24295,45910896,74156810,28245914,NBS
chr06,Bn24296,86631351,90116061,3484710,NBS
chr06,Bn24297,10940799,42711990,31771191,RLP
chr06,Bn24298,10252662,58410081,48157419,CNL
chr06,Bn24299,42295635,96326762,54031127,TN
chr06,Bn24300,62528486,80476126,17947640,CNL
chr06,Bn24301,76457155,84151252,7694097,NBS
chr06,Bn24302,48604454,70169073,21564619,RLK
chr06,Bn24303,61964539,99897746,37933207,TN
chr06,Bn24304,85444221,88708174,3263953,RLK
chr06,Bn24305,12149907,63687668,51537761,RLP
chr06,Bn24306,12152488,54801413,42648925,NBS
chr06,Bn24307,16350000,82594148,66244148,RLK
chr06,Bn24308,98762962,99582465,819503,TN
chr06,Bn24309,61773749,62798837,1025088,RLK
chr06,Bn24310,20564935,49520728,28955793,TN
chr06,Bn24311,19816833,55631103,35814270,TNL
chr06,Bn24312,83985573,96918478,12932905,TN
chr06,Bn24313,68137911,71201808,3063897,TNL
chr06,Bn24314,67158053,97105285,29947232,TN
chr06,Bn24315,52473607,93455102,40981495,TNL
chr06,Bn24316,6137083,28213629,22076546,RLP
chr06,Bn24317,52095574,77436172,25340598,RLP
chr06,Bn24318,95897263,98595726,2698463,TNL
chr06,Bn24319,83282348,87446524,4164176,CN
chr06,Bn24320,72679983,87510471,14830488,RLP
chr06,Bn24321,14026045,59020474,44994429,RLP
chr06,Bn24322,89540641,91405939,1865298,CN
chr06,Bn24323,98263857,98902843,638986,NBS
chr06,Bn24324,30373360,41686460,11313100,RLP
chr06,Bn24325,11674574,32329110,20654536,TN
chr06,Bn24326,27699226,61366206,33666980,CNL
chr06,Bn24327,91860762,95275584,3414822,RLP
chr06,Bn24328,53737118,56711067,2973949,RLP
chr06,Bn24329,45804868,45960407,155539,RLP
chr06,Bn24330,28806714,99322571,70515857,CN
chr06,Bn24331,28836912,35851133,7014221,TN
chr06,Bn24332,63997343,97189302,33191959,CNL
chr06,Bn24333,83122099,85862923,2740824,TNL
chr06,Bn24334,83041635,91187878,8146243,TN
chr06,Bn24335,25861967,66303015,40441048,NBS
chr06,Bn24336,72745873,72999815,253942,NBS
chr06,Bn24337,9212516,96623339,87410823,NBS
chr06,Bn24338,57445454,80158657,22713203,RLP
chr06,Bn24339,70444744,93220287,22775543,NBS
chr06,Bn24340,63004634,89971857,26967223,CN
chr06,Bn24341,64368305,99862769,35494464,CNL
chr06,Bn24342,51054216,81496705,30442489,TN
chr06,Bn24343,46906979,49330689,2423710,TNL
chr06,Bn24344,33657285,83984184,50326899,RLP
chr06,Bn24345,75367547,85539455,10171908,CN
chr06,Bn24346,65480693,77219551,11738858,TNL
chr06,Bn24347,61168730,69906675,8737945,RLK
chr06,Bn24348,98600305,98902091,301786,CN
chr06,Bn24349,5803534,52505113,46701579,CN
chr06,Bn24350,11686637,73817071,62130434,RLK
chr06,Bn24351,81307165,87791310,6484145,CN
chr06,Bn24352,12465156,85027082,72561926,RLK
chr06,Bn24353,97579777,99817431,2237654,NBS
chr06,Bn24354,82918526,96297116,13378590,RLK
chr06,Bn24355,27394205,97112907,69718702,RLK
chr06,Bn24356,9699866,39703079,30003213,NBS
chr06,Bn24357,28714400,52342833,23628433,NBS
chr06,Bn24358,84881057,94018541,9137484,TNL
chr06,Bn24359,26470208,70438790,43968582,NBS
chr06,Bn24360,38015077,67543748,29528671,CNL
chr06,Bn24361,81944955,97853628,15908673,RLP
chr06,Bn24362,80908491,86309676,5401185,NBS
chr06,Bn24363,11413595,86649227,75235632,TNL
chr06,Bn24364,87175740,91029350,3853610,RLK
chr06,Bn24365,63297955,69651668,6353713,RLK
chr06,Bn24366,39366166,40156728,790562,TNL
chr06,Bn24367,45384131,79841838,34457707,RLK
chr06,Bn24368,2412456,54986539,52574083,RLP
chr06,Bn24369,77839268,78154706,315438,CN
chr06,Bn24370,15050465,80079308,65028843,TNL
chr06,Bn24371,61318203,75155853,13837650,RLK
chr06,Bn24372,55383761,67461025,12077264,NBS
chr06,Bn24373,23143715,27507562,4363847,TNL
chr06,Bn24374,63838449,87940091,24101642,RLK
chr06,Bn24375,37788908,38868282,1079374,CN
chr06,Bn24376,40246848,52266888,12020040,TNL
chr06,Bn24377,28831901,90014872,61182971,TNL
chr06,Bn24378,84563440,89651180,5087740,RLK
chr06,Bn24379,16410925,73884595,57473670,RLP
chr06,Bn24380,69519046,93594561,24075515,RLK
chr06,Bn24381,41406075,84902114,43496039,NBS
chr06,Bn24382,70275625,85655650,15380025,TNL
chr06,Bn24383,74491343,87286397,12795054,RLK
chr06,Bn24384,29986205,99318434,69332229,TNL
chr06,Bn24385,47128940,53021918,5892978,CN
chr06,Bn24386,52058737,98190223,46131486,CN
chr06,Bn24387,66551935,76131426,9579491,RLK
chr06,Bn24388,85353044,98547320,13194276,RLP
chr06,Bn24389,92357019,96868233,4511214,CN
chr06,Bn24390,97362897,99885365,2522468,RLP
chr06,Bn24391,55644320,82972944,27328624,CN
chr06,Bn24392,32958638,54694475,21735837,TN
chr06,Bn24393,26133094,34533615,8400521,TN
chr06,Bn24394,95928607,98533240,2604633,CNL
chr06,Bn24395,18616401,47918451,29302050,CN
chr06,Bn24396,27983644,79214600,51230956,CN
chr06,Bn24397,21814200,97022254,75208054,CN
chr06,Bn24398,27182048,58417475,31235427,CN
chr06,Bn24399,13965018,56368001,42402983,TN
chr06,Bn24400,62586821,72943436,10356615,TNL
chr06,Bn24401,9793720,82007515,72213795,RLK
chr06,Bn24402,53960734,99753067,45792333,RLP
chr06,Bn24403,92626869,99977754,7350885,TNL
chr06,Bn24404,3347164,19398743,16051579,TN
chr06,Bn24405,3342723,50882508,47539785,RLK
chr06,Bn24406,59998106,92205870,32207764,TNL
chr06,Bn24407,54408904,80357745,25948841,RLK
chr06,Bn24408,54968210,86571381,31603171,RLK
chr06,Bn24409,45019803,68782726,23762923,RLP
chr06,Bn24410,19240030,46660195,27420165,NBS
chr06,Bn24411,3346134,52244738,48898604,TNL
chr06,Bn24412,93856491,94825887,969396,CN
chr06,Bn24413,65361481,73240320,7878839,TNL
chr06,Bn24414,42801741,45685023,2883282,CNL
chr06,Bn24415,98145757,99822614,1676857,RLK
chr06,Bn24416,27575914,49139517,21563603,NBS
chr06,Bn24417,53036497,61747707,8711210,NBS
chr06,Bn24418,25398780,68659138,43260358,TNL
chr06,Bn24419,6204335,81605326,75400991,RLP
chr06,Bn24420,75309905,95610129,20300224,TN
chr06,Bn24421,87449292,92093264,4643972,RLK
chr06,Bn24422,94483820,96572330,2088510,TNL
chr06,Bn24423,2809301,44668442,41859141,TN
chr06,Bn24424,14250934,94798527,80547593,RLP
chr06,Bn24425,12278147,85299183,73021036,TN
chr06,Bn24426,44118571,48366653,4248082,CN
chr06,Bn24427,44262665,72622695,28360030,RLP
chr06,Bn24428,22663909,58096801,35432892,CNL
chr06,Bn24429,59993838,69626725,9632887,RLK
chr06,Bn24430,16438321,45578670,29140349,CN
chr06,Bn24431,50751374,85928780,35177406,RLK
chr06,Bn24432,29531836,46463786,16931950,RLP
chr06,Bn24433,1972827,23984194,22011367,CN
chr06,Bn24434,63333074,75659685,12326611,NBS
chr06,Bn24435,49272506,99673272,50400766,TN
chr06,Bn24436,52503002,94245778,41742776,NBS
chr06,Bn24437,2958388,43077046,40118658,RLK
chr06,Bn24438,87186180,98266784,11080604,NBS
chr06,Bn24439,14234008,56715394,42481386,CNL
chr06,Bn24440,2846867,26911467,24064600,TN
chr06,Bn24441,78571203,96546131,17974928,RLP
chr06,Bn24442,59058145,77978393,18920248,RLP
chr06,Bn24443,70630843,88812513,18181670,TNL
chr06,Bn24444,66288549,89708770,23420221,TN
chr06,Bn24445,91764141,96843346,5079205,RLK
chr06,Bn24446,65656056,68497629,2841573,TN
chr06,Bn24447,65657405,87961595,22304190,RLP
chr06,Bn24448,1677340,93549469,91872129,NBS
chr06,Bn24449,2913180,89622487,86709307,CNL
chr06,Bn24450,53698872,99779146,46080274,NBS
chr06,Bn24451,87409569,91414294,4004725,RLP
chr06,Bn24452,83053496,86197390,3143894,TN
chr06,Bn24453,35721629,82607383,46885754,RLK
chr06,Bn24454,43848176,46955311,3107135,RLP
chr06,Bn24455,30433666,37209529,6775863,TN
chr06,Bn24456,44908745,63169458,18260713,CNL
chr06,Bn24457,20285790,97177909,76892119,CNL
chr06,Bn24458,99251338,99663166,411828,RLK
chr06,Bn24459,44471954,80990289,36518335,CNL
chr06,Bn24460,48772905,49635438,862533,CNL
chr06,Bn24461,18695457,44169018,25473561,TNL
chr06,Bn24462,52158377,98375433,46217056,NBS
chr06,Bn24463,75224442,76372407,1147965,NBS
chr06,Bn24464,42330175,87507592,45177417,CN
chr06,Bn24465,14801350,73318060,58516710,TNL
chr06,Bn24466,53816203,84762460,30946257,TNL
chr06,Bn24467,89798136,99224358,9426222,NBS
chr06,Bn24468,17833355,87668261,69834906,TNL
chr06,Bn24469,22193940,89378318,67184378,NBS
chr06,Bn24470,55915540,65826269,9910729,RLK
chr06,Bn24471,8909379,48767125,39857746,RLP
chr06,Bn24472,34059444,49084792,15025348,RLP
chr06,Bn24473,50927025,60368939,9441914,NBS
chr06,Bn24474,81069636,95470285,14400649,TN
chr06,Bn24475,29293522,37919942,8626420,RLK
chr06,Bn24476,18363946,99409055,81045109,CNL
chr06,Bn24477,70323569,91668694,21345125,RLK
chr06,Bn24478,58236361,92301004,34064643,TNL
chr06,Bn24479,53042587,64271579,11228992,TNL
chr06,Bn24480,78160976,83953269,5792293,TNL
chr06,Bn24481,91406926,95940788,4533862,CNL
chr06,Bn24482,49549580,97037399,47487819,TN
chr06,Bn24483,7343299,58086733,50743434,CN
chr06,Bn24484,31329297,48072544,16743247,CNL
chr06,Bn24485,36372308,99827437,63455129,NBS
chr06,Bn24486,44645192,45967387,1322195,RLP
chr06,Bn24487,54072328,68478338,14406010,CNL
chr06,Bn24488,96856046,99501504,2645458,RLK
chr06,Bn24489,20260416,73359315,53098899,TN
chr06,Bn24490,52046721,58031881,5985160,TN
chr06,Bn24491,82382583,96937879,14555296,CNL
chr06,Bn24492,88682295,90220077,1537782,CN
chr06,Bn24493,62206959,99829969,37623010,TN
chr06,Bn24494,65380258,98296829,32916571,TNL
chr06,Bn24495,88141471,99617534,11476063,RLK
chr06,Bn24496,99530869,99694262,163393,RLP
chr06,Bn24497,28482172,63760546,35278374,TN
chr06,Bn24498,11294020,40225959,28931939,CNL
chr06,Bn24499,95809409,99333792,3524383,RLP
chr06,Bn24500,5828229,91628277,85800048,CNL
chr06,Bn24501,22526191,23976748,1450557,TNL
chr06,Bn24502,53944687,96599568,42654881,TNL
chr06,Bn24503,97078386,98848161,1769775,TN
chr06,Bn24504,50056991,84757204,34700213,TNL
chr06,Bn24505,64546137,75589159,11043022,RLP
chr06,Bn24506,73973750,81590772,7617022,RLK
chr06,Bn24507,65332206,69967760,4635554,RLK
chr06,Bn24508,21603070,51223751,29620681,NBS
chr06,Bn24509,80883653,82113583,1229930,NBS
chr06,Bn24510,1153416,88094803,86941387,TNL
chr06,Bn24511,24675499,90293486,65617987,TN
chr06,Bn24512,89405475,94965527,5560052,TN
chr06,Bn24513,52522335,93700464,41178129,RLP
chr06,Bn24514,38255060,96105498,57850438,RLK
chr06,Bn24515,67865003,79510922,11645919,RLK
chr06,Bn24516,38105533,94558848,56453315,RLP
chr06,Bn24517,66170260,79659709,13489449,RLP
chr06,Bn24518,61032927,72281896,11248969,TN
chr06,Bn24519,16096992,78728031,62631039,TN
chr06,Bn24520,75694487,86892058,11197571,NBS
chr06,Bn24521,22261712,89329344,67067632,RLK
chr06,Bn24522,79561996,85944058,6382062,RLP
chr06,Bn24523,71236878,87216040,15979162,TN
chr06,Bn24524,66456405,81195218,14738813,RLP
chr06,Bn24525,47898448,53496133,5597685,RLK
chr06,Bn24526,35623507,90688331,55064824,CNL
chr06,Bn24527,71325834,72392723,1066889,RLK
chr06,Bn24528,93755556,94048078,292522,RLK
chr06,Bn24529,99916339,99997216,80877,RLK
chr06,Bn24530,45989811,62160183,16170372,TNL
chr06,Bn24531,86282983,95041816,8758833,NBS
chr06,Bn24532,7766522,73373604,65607082,RLK
chr06,Bn24533,91497539,97728383,6230844,TNL
chr06,Bn24534,59561416,60246665,685249,TN
chr06,Bn24535,44899481,76468619,31569138,TNL
chr06,Bn24536,23846336,32923382,9077046,TN
chr06,Bn24537,47936776,50514115,2577339,RLP
chr06,Bn24538,14952091,35617046,20664955,RLK
chr06,Bn24539,94648202,99258626,4610424,CNL
chr06,Bn24540,76773418,79771373,2997955,TNL
chr06,Bn24541,4981278,97692995,92711717,TN
chr06,Bn24542,25847077,40276643,14429566,NBS
chr06,Bn24543,7689074,12342293,4653219,TNL
chr06,Bn24544,28293005,76722540,48429535,CNL
chr06,Bn24545,12339813,57537235,45197422,TNL
chr06,Bn24546,32242721,36729710,4486989,CNL
chr06,Bn24547,99235843,99294395,58552,CNL
chr06,Bn24548,12984432,45404722,32420290,RLP
chr06,Bn24549,51005373,63739482,12734109,RLK
chr06,Bn24550,77796566,86916955,9120389,RLK
chr06,Bn24551,3129390,10192774,7063384,RLP
chr06,Bn24552,97394699,99666792,2272093,NBS
chr06,Bn24553,65007244,94510794,29503550,CNL
chr06,Bn24554,87945590,97309451,9363861,RLK
chr06,Bn24555,47932316,66849593,18917277,CNL
chr06,Bn24556,52830974,97572956,44741982,TNL
chr06,Bn24557,97636172,98672475,1036303,TN
chr06,Bn24558,90962408,95635597,4673189,CNL
chr06,Bn24559,67316634,81918612,14601978,RLP
chr06,Bn24560,50288072,90043051,39754979,NBS
chr06,Bn24561,29350974,46343234,16992260,RLP
chr06,Bn24562,25608641,63396731,37788090,CNL
chr06,Bn24563,54155653,90689451,36533798,RLP
chr06,Bn24564,53863389,63821292,9957903,RLK
chr06,Bn24565,9326687,19399944,10073257,CN
chr06,Bn24566,17321294,17899728,578434,TN
chr06,Bn24567,3053795,46721313,43667518,RLK
chr06,Bn24568,27194545,48318114,21123569,RLP
chr06,Bn24569,25083073,32434160,7351087,RLK
chr06,Bn24570,76231382,80694302,4462920,TNL
chr06,Bn24571,98807756,99275618,467862,CNL
chr06,Bn24572,91808501,93443996,1635495,NBS
chr06,Bn24573,37700042,51296219,13596177,CNL
chr06,Bn24574,5455134,81595331,76140197,TNL
chr06,Bn24575,25167861,44042776,18874915,TN
chr06,Bn24576,58648260,82977388,24329128,RLP
chr06,Bn24577,35446085,52672290,17226205,NBS
chr06,Bn24578,50507958,57800141,7292183,NBS
chr06,Bn24579,50471989,56553304,6081315,RLK
chr06,Bn24580,69881647,91020175,21138528,RLP
chr06,Bn24581,78158576,82381502,4222926,CN
chr06,Bn24582,28676851,97791496,69114645,RLK
chr06,Bn24583,29387434,98103689,68716255,RLP
chr06,Bn24584,96404733,99891409,3486676,TN
chr06,Bn24585,26967827,67208338,40240511,RLK
chr06,Bn24586,93751212,95534912,1783700,RLP
chr06,Bn24587,86305401,91538125,5232724,RLK
chr06,Bn24588,55747651,70320299,14572648,NBS
chr06,Bn24589,13327392,47987311,34659919,TN
chr06,Bn24590,61868662,95753035,33884373,TNL
chr06,Bn24591,66287821,88344150,22056329,TNL
chr06,Bn24592,70703619,98713297,28009678,RLP
chr06,Bn24593,21448324,65425927,43977603,TNL
chr06,Bn24594,99814178,99871878,57700,NBS
chr06,Bn24595,4874723,46395939,41521216,TN
chr06,Bn24596,46299694,81470963,35171269,TN
chr06,Bn24597,84119929,89113260,4993331,CNL
chr06,Bn24598,34878844,57552381,22673537,RLK
chr06,Bn24599,14640610,73618680,58978070,NBS
chr06,Bn24600,39422751,99848832,60426081,TNL
chr06,Bn24601,79566975,96728279,17161304,NBS
chr06,Bn24602,89676690,95568381,5891691,RLK
chr06,Bn24603,47232797,49905637,2672840,TNL
chr06,Bn24604,17772394,19364089,1591695,TNL
chr06,Bn24605,86118622,94868105,8749483,TNL
chr06,Bn24606,39138464,95721341,56582877,NBS
chr06,Bn24607,24726687,74777227,50050540,CNL
chr06,Bn24608,92086556,95103345,3016789,RLK
chr06,Bn24609,83135059,92191622,9056563,NBS
chr06,Bn24610,4261730,83973359,79711629,CNL
chr06,Bn24611,57581352,88917107,31335755,RLP
chr06,Bn24612,66349793,67257360,907567,RLP
chr06,Bn24613,49296251,79340158,30043907,RLK
chr06,Bn24614,47667348,90990112,43322764,TN
chr06,Bn24615,24333890,47871308,23537418,CNL
chr06,Bn24616,38238293,42378090,4139797,TNL
chr06,Bn24617,12803003,40500319,27697316,CN
chr06,Bn24618,80225075,88902550,8677475,RLK
chr06,Bn24619,89196909,97540611,8343702,TNL
chr06,Bn24620,21441716,29189267,7747551,TN
chr06,Bn24621,70143048,86375530,16232482,RLK
chr06,Bn24622,24785389,71453261,46667872,RLK
chr06,Bn24623,81825602,85151555,3325953,TN
chr06,Bn24624,59677268,88927301,29250033,TNL
chr06,Bn24625,43912595,63122784,19210189,NBS
chr06,Bn24626,19545729,87212442,67666713,NBS
chr06,Bn24627,81624714,81706965,82251,TN
chr06,Bn24628,50446586,77547473,27100887,TN
chr06,Bn24629,70849022,85963958,15114936,TNL
chr06,Bn24630,82538399,96309689,13771290,RLP
chr06,Bn24631,91268666,93859594,2590928,NBS
chr06,Bn24632,44771090,44976932,205842,CNL
chr06,Bn24633,72232683,89150195,16917512,CN
chr06,Bn24634,43763553,61892765,18129212,RLP
chr06,Bn24635,78762420,80233325,1470905,RLK
chr06,Bn24636,35055574,94614277,59558703,CN
chr06,Bn24637,86453678,90038719,3585041,RLP
chr06,Bn24638,18524382,21106218,2581836,TNL
chr06,Bn24639,82305161,91527107,9221946,TN
chr06,Bn24640,67568102,78173877,10605775,RLP
chr06,Bn24641,70882910,71277803,394893,NBS
chr06,Bn24642,35538089,39096893,3558804,TN
chr06,Bn24643,67556667,71585641,4028974,RLK
chr06,Bn24644,98336078,98540040,203962,CNL
chr06,Bn24645,3269045,25207909,21938864,CNL
chr06,Bn24646,90862727,97300606,6437879,TN
chr06,Bn24647,85754129,94166097,8411968,NBS
chr06,Bn24648,97349795,98099922,750127,NBS
chr06,Bn24649,7223584,37984466,30760882,TN
chr06,Bn24650,29872096,49674964,19802868,RLK
chr06,Bn24651,48078610,74387792,26309182,TNL
chr06,Bn24652,23107350,93932746,70825396,CNL
chr06,Bn24653,11548433,86846617,75298184,TNL
chr06,Bn24654,67965677,74084733,6119056,NBS
chr06,Bn24655,49656886,93690829,44033943,NBS
chr06,Bn24656,43413401,60626007,17212606,RLP
chr06,Bn24657,38099047,65387246,27288199,RLP
chr06,Bn24658,78127625,87305623,9177998,TN
chr06,Bn24659,96789673,97843139,1053466,TN
chr06,Bn24660,9184309,14540193,5355884,CN
chr06,Bn24661,6344822,94656803,88311981,TN
chr06,Bn24662,91557566,97565783,6008217,RLP
chr06,Bn24663,4381275,85159237,80777962,NBS
chr06,Bn24664,81854733,92208176,10353443,RLP
chr06,Bn24665,97859416,97985207,125791,CNL
chr06,Bn24666,64675941,68933986,4258045,TN
chr06,Bn24667,27473460,63946927,36473467,TNL
chr06,Bn24668,81269342,85021588,3752246,RLP
chr06,Bn24669,86651586,89424858,2773272,CN
chr06,Bn24670,64917054,70302752,5385698,RLK
chr06,Bn24671,51136015,64865495,13729480,CNL
chr06,Bn24672,94568644,96609671,2041027,CNL
chr06,Bn24673,59097536,97409819,38312283,CNL
chr06,Bn24674,6070014,13168374,7098360,RLK
chr06,Bn24675,61396034,74666704,13270670,TNL
chr06,Bn24676,72165892,98911922,26746030,RLK
chr06,Bn24677,19280594,93013692,73733098,CN
chr06,Bn24678,64136419,76017566,11881147,CN
chr06,Bn24679,80138200,83994416,3856216,NBS
chr06,Bn24680,77975479,79601460,1625981,RLP
chr06,Bn24681,38028397,99846856,61818459,CNL
chr06,Bn24682,75787666,85113730,9326064,TNL
chr06,Bn24683,32397520,66975349,34577829,NBS
chr06,Bn24684,49763465,98687525,48924060,TNL
chr06,Bn24685,41022414,75549864,34527450,RLP
chr06,Bn24686,54761722,63098919,8337197,RLP
chr06,Bn24687,81270694,90033407,8762713,CN
chr06,Bn24688,72201569,84240960,12039391,TN
chr06,Bn24689,85286362,90847488,5561126,TN
chr06,Bn24690,35317572,76995784,41678212,TN
chr06,Bn24691,22749862,27858440,5108578,NBS
chr06,Bn24692,40555503,90671010,50115507,CNL
chr06,Bn24693,50636836,83207315,32570479,CNL
chr06,Bn24694,73138288,81722348,8584060,RLK
chr06,Bn24695,14449061,65322052,50872991,CN
chr06,Bn24696,5714665,66296395,60581730,CN
chr06,Bn24697,94356889,96939748,2582859,RLK
chr06,Bn24698,3908665,42614085,38705420,TN
chr06,Bn24699,28356034,36968891,8612857,TN
chr06,Bn24700,82374353,99855317,17480964,CNL
chr06,Bn24701,77782485,97559539,19777054,RLK
chr06,Bn24702,51964127,80794064,28829937,TN
chr06,Bn24703,65993225,93568765,27575540,TNL
chr06,Bn24704,24137826,89980260,65842434,NBS
chr06,Bn24705,38667304,86961654,48294350,RLP
chr06,Bn24706,73446615,90485035,17038420,RLP
chr06,Bn24707,3067101,27258670,24191569,CNL
chr06,Bn24708,15217214,28937088,13719874,TNL
chr06,Bn24709,28772755,66450319,37677564,TNL
chr06,Bn24710,56353904,91716136,35362232,TNL
chr06,Bn24711,61208809,70845051,9636242,CNL
chr06,Bn24712,21685584,60053606,38368022,TN
chr06,Bn24713,72594476,86558002,13963526,RLK
chr06,Bn24714,82934397,94852470,11918073,CNL
chr06,Bn24715,97384428,97861124,476696,CNL
chr06,Bn24716,18001718,64493340,46491622,RLK
chr06,Bn24717,84990617,99860358,14869741,CN
chr06,Bn24718,35295096,80803247,45508151,RLP
chr06,Bn24719,7273951,61286368,54012417,RLP
chr06,Bn24720,6080877,67206339,61125462,TNL
chr06,Bn24721,10222288,31644976,21422688,NBS
chr06,Bn24722,80998339,85415743,4417404,TNL
chr06,Bn24723,64694785,66429395,1734610,CNL
chr06,Bn24724,31438220,73248595,41810375,CNL
chr06,Bn24725,8029109,21278590,13249481,TNL
chr06,Bn24726,12071141,72175173,60104032,CNL
chr06,Bn24727,60894171,81754605,20860434,TNL
chr06,Bn24728,89748330,90562060,813730,RLK
chr06,Bn24729,1248448,56014929,54766481,CNL
chr06,Bn24730,32744645,80748342,48003697,NBS
chr06,Bn24731,85696911,93390929,7694018,TNL
chr06,Bn24732,34463922,61575916,27111994,CN
chr06,Bn24733,13373325,87133120,73759795,TN
chr06,Bn24734,61188133,75007819,13819686,TNL
chr06,Bn24735,55805738,81531451,25725713,NBS
chr06,Bn24736,70030173,98283155,28252982,RLK
chr06,Bn24737,46432570,79651222,33218652,NBS
chr06,Bn24738,67607314,97751604,30144290,CN
chr06,Bn24739,43017985,80842195,37824210,RLP
chr06,Bn24740,91863258,95211270,3348012,TNL
chr06,Bn24741,60364913,96526778,36161865,CN
chr06,Bn24742,93159438,96491536,3332098,RLP
chr06,Bn24743,25986759,64138886,38152127,TNL
chr06,Bn24744,38771669,43135540,4363871,TN
chr06,Bn24745,64611053,91589902,26978849,TN
chr06,Bn24746,73909013,78485426,4576413,NBS
chr06,Bn24747,78204525,92577203,14372678,TN
chr06,Bn24748,84330593,89241082,4910489,RLK
chr06,Bn24749,23527057,91561640,68034583,RLP
chr06,Bn24750,13463187,35736224,22273037,TN
chr06,Bn24751,62192979,86091758,23898779,TNL
chr06,Bn24752,46664071,79703909,33039838,NBS
chr06,Bn24753,63253164,95518555,32265391,TNL
chr06,Bn24754,66346548,95374452,29027904,RLP
chr06,Bn24755,31354337,46429736,15075399,TN
chr06,Bn24756,97425873,98950873,1525000,RLK
chr06,Bn24757,10706425,87438359,76731934,TN
chr06,Bn24758,44645771,79929446,35283675,NBS
chr06,Bn24759,43212818,80652555,37439737,RLP
chr06,Bn24760,87916267,97363099,9446832,RLP
chr06,Bn24761,93458742,96294017,2835275,RLK
chr06,Bn24762,39092937,93196332,54103395,NBS
chr06,Bn24763,8785140,55778988,46993848,CNL
chr06,Bn24764,28811818,96555812,67743994,RLK
chr06,Bn24765,65907882,88737551,22829669,NBS
chr06,Bn24766,63142752,63216012,73260,CNL
chr06,Bn24767,75710145,82916616,7206471,CNL
chr06,Bn24768,98302879,99232443,929564,TN
chr06,Bn24769,98569375,99627939,1058564,CN
chr06,Bn24770,22102507,57405491,35302984,RLP
chr06,Bn24771,18718903,21355206,2636303,RLP
chr06,Bn24772,70093046,80524905,10431859,RLP
chr06,Bn24773,95058137,99339324,4281187,RLK
chr06,Bn24774,67880447,82633811,14753364,NBS
chr06,Bn24775,47031971,78669208,31637237,CN
chr06,Bn24776,99541206,99971071,429865,RLK
chr06,Bn24777,17567294,73266157,55698863,RLK
chr06,Bn24778,37642162,70975795,33333633,RLK
chr06,Bn24779,24247716,89897088,65649372,TNL
chr06,Bn24780,5638406,18358219,12719813,NBS
chr06,Bn24781,14175737,81146012,66970275,NBS
chr06,Bn24782,56690793,98549547,41858754,CN
chr06,Bn24783,50780680,99908223,49127543,RLP
chr06,Bn24784,60197476,76856749,16659273,CNL
chr06,Bn24785,28816590,96703724,67887134,TNL
chr06,Bn24786,8360978,17157399,8796421,CNL
chr06,Bn24787,83250313,83568312,317999,TNL
chr06,Bn24788,22205494,59558706,37353212,RLP
chr06,Bn24789,96889601,97121197,231596,RLP
chr06,Bn24790,85106569,99061033,13954464,TNL
chr06,Bn24791,96075878,98160304,2084426,CN
chr06,Bn24792,71360252,78565949,7205697,TN
chr06,Bn24793,31107654,56214989,25107335,RLP
chr06,Bn24794,80086039,96674584,16588545,RLK
chr06,Bn24795,26719142,85356274,58637132,NBS
chr06,Bn24796,31666054,85513552,53847498,RLK
chr06,Bn24797,56430608,68577751,12147143,CN
chr06,Bn24798,77886884,98406934,20520050,TN
chr06,Bn24799,25367610,65359604,39991994,RLP
chr06,Bn24800,23334883,51302324,27967441,CN
chr06,Bn24801,75630169,83722593,8092424,TNL
chr06,Bn24802,96662488,96939899,277411,TN
chr06,Bn24803,84535528,87165897,2630369,RLP
chr06,Bn24804,73162883,77092173,3929290,RLK
chr06,Bn24805,38074901,51240370,13165469,CN
chr06,Bn24806,7383296,71411277,64027981,NBS
chr06,Bn24807,76847221,88205067,11357846,RLK
chr06,Bn24808,39163331,62803424,23640093,CNL
chr06,Bn24809,2550068,80235179,77685111,RLK
chr06,Bn24810,56913628,92906334,35992706,TNL
chr06,Bn24811,52331721,72573347,20241626,TNL
chr06,Bn24812,24303466,63093805,38790339,RLK
chr06,Bn24813,45990459,55557042,9566583,TNL
chr06,Bn24814,16105870,20943614,4837744,TNL
chr06,Bn24815,77770389,99696163,21925774,RLK
chr06,Bn24816,47734036,84638591,36904555,RLP
chr06,Bn24817,29704214,51025934,21321720,RLP
chr06,Bn24818,71113798,76483339,5369541,CNL
chr06,Bn24819,66383701,85681599,19297898,TNL
chr06,Bn24820,28667472,68300415,39632943,NBS
chr06,Bn24821,83675166,98650686,14975520,RLP
chr06,Bn24822,33457337,44441029,10983692,CNL
chr06,Bn24823,28001314,28234691,233377,TNL
chr06,Bn24824,58465454,77078890,18613436,RLK
chr06,Bn24825,55004184,63128696,8124512,RLK
chr06,Bn24826,8813551,94271897,85458346,TNL
chr06,Bn24827,24101777,52106465,28004688,TNL
chr06,Bn24828,65005411,78034304,13028893,CNL
chr06,Bn24829,64733470,74157525,9424055,TN
chr06,Bn24830,49758339,62092381,12334042,TN
chr06,Bn24831,73431185,74079203,648018,CNL
chr06,Bn24832,20589520,92312328,71722808,RLP
chr06,Bn24833,25195636,62411773,37216137,RLK
chr06,Bn24834,46884602,77077416,30192814,NBS
chr06,Bn24835,40899309,95524091,54624782,TN
chr06,Bn24836,17258838,25902011,8643173,TN
chr06,Bn24837,88644670,97772518,9127848,NBS
chr06,Bn24838,99456589,99814901,358312,NBS
chr06,Bn24839,53040739,83794183,30753444,RLP
chr06,Bn24840,66285894,79132469,12846575,RLP
chr06,Bn24841,55096505,85001698,29905193,TN
chr06,Bn24842,12327223,41975161,29647938,RLP
chr06,Bn24843,53324833,76338331,23013498,TN
chr06,Bn24844,23602919,63272995,39670076,CNL
chr06,Bn24845,73608393,81793869,8185476,NBS
chr06,Bn24846,78614945,78683797,68852,CNL
chr06,Bn24847,61931445,99179476,37248031,RLP
chr06,Bn24848,54497348,59103784,4606436,RLP
chr06,Bn24849,60518344,99062570,38544226,TN
chr06,Bn24850,81106030,85125855,4019825,CN
chr06,Bn24851,89569133,89843918,274785,RLP
chr06,Bn24852,92808700,98398259,5589559,RLP
chr06,Bn24853,37002269,68878457,31876188,CN
chr06,Bn24854,6279832,75095925,68816093,TN
chr06,Bn24855,45200786,69981778,24780992,RLP
chr06,Bn24856,33973094,35887660,1914566,RLK
chr06,Bn24857,8563333,42864612,34301279,TN
chr06,Bn24858,53472293,71915492,18443199,RLP
chr06,Bn24859,87272126,99589419,12317293,CNL
chr06,Bn24860,77728517,89748461,12019944,CNL
chr06,Bn24861,88170803,97284222,9113419,TNL
chr06,Bn24862,29312539,50365954,21053415,TNL
chr06,Bn24863,86651941,93344320,6692379,TN
chr06,Bn24864,32909424,56128692,23219268,TNL
chr06,Bn24865,32801472,57855317,25053845,RLP
chr06,Bn24866,91506018,95254661,3748643,RLK
chr06,Bn24867,90017227,92241827,2224600,RLK
chr06,Bn24868,8377556,38057817,29680261,RLK
chr06,Bn24869,93095378,99541861,6446483,NBS
chr06,Bn24870,44821472,75621017,30799545,TN
chr06,Bn24871,59091426,91012912,31921486,TNL
chr06,Bn24872,72517597,99385531,26867934,TN
chr06,Bn24873,1005761,88399289,87393528,RLP
chr06,Bn24874,51895780,89832858,37937078,RLK
chr06,Bn24875,32494042,53537396,21043354,RLK
chr06,Bn24876,45036880,79490088,34453208,RLP
chr06,Bn24877,79354470,91986441,12631971,TNL
chr06,Bn24878,24388276,92898212,68509936,CN
chr06,Bn24879,35552596,76491295,40938699,CN
chr06,Bn24880,98460996,99347203,886207,RLP
chr06,Bn24881,75127929,76802928,1674999,RLP
chr06,Bn24882,75019492,78743866,3724374,RLP
chr06,Bn24883,62676765,75583729,12906964,TN
chr06,Bn24884,16128958,64908614,48779656,RLP
chr06,Bn24885,56305370,69433517,13128147,TN
chr06,Bn24886,17803762,92602536,74798774,TN
chr06,Bn24887,72816853,95978979,23162126,TN
chr06,Bn24888,79248791,95280233,16031442,CN
chr06,Bn24889,15704775,19412606,3707831,TN
chr06,Bn24890,13166513,57229412,44062899,RLK
chr06,Bn24891,91882788,94155451,2272663,NBS
chr06,Bn24892,35853094,72494264,36641170,RLP
chr06,Bn24893,49093011,97874947,48781936,RLP
chr06,Bn24894,33046620,97972850,64926230,RLK
chr06,Bn24895,23736861,86452688,62715827,CNL
chr06,Bn24896,18284376,77571852,59287476,RLK
chr06,Bn24897,43627085,62603713,18976628,CNL
chr06,Bn24898,22519508,56547708,34028200,CN
chr06,Bn24899,54862050,65547785,10685735,TNL
chr06,Bn24900,61246868,99533020,38286152,RLP
chr06,Bn24901,94817778,97935698,3117920,TN
chr06,Bn24902,14792269,98339110,83546841,RLK
chr06,Bn24903,67628033,99606775,31978742,TN
chr06,Bn24904,65623582,70124437,4500855,TNL
chr06,Bn24905,55280081,66057198,10777117,RLK
chr06,Bn24906,64406242,79213744,14807502,CNL
chr06,Bn24907,59576661,71213357,11636696,CN
chr06,Bn24908,83353570,90456631,7103061,RLK
chr06,Bn24909,77955362,78307845,352483,RLK
chr06,Bn24910,60524897,63779374,3254477,NBS
chr06,Bn24911,77725783,81589148,3863365,CNL
chr06,Bn24912,22043233,24940197,2896964,TNL
chr06,Bn24913,92654020,93881355,1227335,TN
chr06,Bn24914,6297046,87180232,80883186,RLP
chr06,Bn24915,13148517,69280267,56131750,RLP
chr06,Bn24916,83321300,89237847,5916547,RLK
chr06,Bn24917,95454490,97379854,1925364,RLK
chr06,Bn24918,21704775,96614696,74909921,RLK
chr06,Bn24919,11306303,27756854,16450551,RLP
chr06,Bn24920,15013889,87277031,72263142,TNL
chr06,Bn24921,36134894,58498508,22363614,TNL
chr06,Bn24922,91644717,94061229,2416512,TNL
chr06,Bn24923,63851326,92294182,28442856,NBS
chr06,Bn24924,95610805,96137259,526454,NBS
chr06,Bn24925,26357038,88287686,61930648,TNL
chr06,Bn24926,10985808,76920604,65934796,NBS
chr06,Bn24927,40904866,68583459,27678593,RLP
chr06,Bn24928,12337355,27237384,14900029,RLP
chr06,Bn24929,49197002,77166862,27969860,TN
chr06,Bn24930,97559658,99853007,2293349,TNL
chr06,Bn24931,49046757,77689383,28642626,RLK
chr06,Bn24932,95467632,98369564,2901932,RLK
chr06,Bn24933,32053353,62405754,30352401,RLP
chr06,Bn24934,13773207,26918254,13145047,NBS
chr06,Bn24935,91010675,91797145,786470,CNL
chr06,Bn24936,21834693,98211229,76376536,RLP
chr06,Bn24937,22549025,35379760,12830735,TNL
chr06,Bn24938,6529761,36699070,30169309,TNL
chr06,Bn24939,52961022,59247930,6286908,CN
chr06,Bn24940,42964990,73973221,31008231,TN
chr06,Bn24941,62153448,90352093,28198645,TNL
chr06,Bn24942,65646291,86402301,20756010,TN
chr06,Bn24943,29058724,93571728,64513004,NBS
chr06,Bn24944,9654170,78798011,69143841,RLK
chr06,Bn24945,68180415,88647606,20467191,TNL
chr06,Bn24946,74267261,80978845,6711584,RLP
chr06,Bn24947,17182686,35066176,17883490,RLP
chr06,Bn24948,64024591,89987346,25962755,TNL
chr06,Bn24949,96871622,99501992,2630370,NBS
chr06,Bn24950,81572105,93180235,11608130,CNL
chr06,Bn24951,19640665,83576819,63936154,RLK
chr06,Bn24952,66093225,91665881,25572656,RLK
chr06,Bn24953,28588664,65162175,36573511,CN
chr06,Bn24954,65202250,88986966,23784716,CN
chr06,Bn24955,40189169,96873184,56684015,RLP
chr06,Bn24956,85871828,95529899,9658071,NBS
chr06,Bn24957,95037361,96444666,1407305,TN
chr06,Bn24958,52981948,79730468,26748520,RLK
chr06,Bn24959,37969239,78573906,40604667,CNL
chr06,Bn24960,25166434,35067730,9901296,TNL
chr06,Bn24961,56631853,76333081,19701228,RLP
chr06,Bn24962,38700457,71424287,32723830,CN
chr06,Bn24963,37906785,99126696,61219911,CN
chr06,Bn24964,31898168,91807574,59909406,RLK
chr06,Bn24965,37560921,50901912,13340991,TNL
chr06,Bn24966,47658211,92954410,45296199,TN
chr06,Bn24967,56910147,78594283,21684136,CNL
chr06,Bn24968,54659293,95236753,40577460,RLK
chr06,Bn24969,1923124,65096800,63173676,CNL
chr06,Bn24970,2479916,31757686,29277770,TNL
chr06,Bn24971,36417966,89229382,52811416,NBS
chr06,Bn24972,65845292,98842702,32997410,TNL
chr06,Bn24973,93420939,98208051,4787112,TN
chr06,Bn24974,61518553,67449644,5931091,RLP
chr06,Bn24975,46699723,60689756,13990033,RLK
chr06,Bn24976,39762635,99152001,59389366,CNL
chr06,Bn24977,3678757,92546830,88868073,CN
chr06,Bn24978,48053673,70681816,22628143,RLK
chr06,Bn24979,31539376,41210346,9670970,TN
chr06,Bn24980,17129862,32100958,14971096,TN
chr06,Bn24981,7402147,79472251,72070104,CNL
chr06,Bn24982,91426998,98653126,7226128,NBS
chr06,Bn24983,66641687,94452033,27810346,CN
chr06,Bn24984,72113541,83549213,11435672,NBS
chr06,Bn24985,22090090,44843135,22753045,CNL
chr06,Bn24986,9519713,91660655,82140942,TNL
chr06,Bn24987,69397882,97677198,28279316,NBS
chr06,Bn24988,3423122,16332548,12909426,NBS
chr06,Bn24989,99995157,99995184,27,CN
chr06,Bn24990,45230113,87766220,42536107,RLK
chr06,Bn24991,36855943,43108788,6252845,NBS
chr06,Bn24992,82846256,89886389,7040133,CNL
chr06,Bn24993,47207386,96894400,49687014,TN
chr06,Bn24994,18390859,76952673,58561814,RLK
chr06,Bn24995,88875262,91632161,2756899,RLK
chr06,Bn24996,30648540,87043314,56394774,TN
chr06,Bn24997,33967177,47889330,13922153,TN
chr06,Bn24998,50491262,73987405,23496143,RLK
chr06,Bn24999,15870027,41066945,25196918,TNL
chr06,Bn25000,32971740,40892097,7920357,CN
chr06,Bn25001,17705224,69902688,52197464,CNL
chr06,Bn25002,66164195,96580636,30416441,CNL
chr06,Bn25003,61729151,64172449,2443298,NBS
chr06,Bn25004,98671379,99561928,890549,CNL
chr06,Bn25005,14843937,27068574,12224637,CNL
chr06,Bn25006,5833307,55205120,49371813,RLP
chr06,Bn25007,70239721,89003479,18763758,RLP
chr06,Bn25008,34881356,59078157,24196801,TNL
chr06,Bn25009,70757689,81109389,10351700,NBS
chr06,Bn25010,83076409,96347199,13270790,NBS
chr06,Bn25011,12957205,93428871,80471666,TNL
chr06,Bn25012,49948099,66547654,16599555,TN
chr06,Bn25013,49303735,69479916,20176181,RLK
chr06,Bn25014,80892326,82983171,2090845,NBS
chr06,Bn25015,12789073,27408697,14619624,TN
chr06,Bn25016,80906059,85950421,5044362,RLK
chr06,Bn25017,24207157,44765379,20558222,CN
chr06,Bn25018,77637628,97385998,19748370,RLK
chr06,Bn25019,23679849,53145870,29466021,RLP
chr06,Bn25020,55468616,95680472,40211856,CN
chr06,Bn25021,29310118,87002440,57692322,TNL
chr06,Bn25022,70623979,76934971,6310992,CNL
chr06,Bn25023,95549517,96473310,923793,RLP
chr06,Bn25024,57232269,74060425,16828156,RLK
chr06,Bn25025,54267523,78717880,24450357,RLP
chr06,Bn25026,8340352,64374519,56034167,CN
chr06,Bn25027,54972460,69133098,14160638,CNL
chr06,Bn25028,84959239,91702420,6743181,TN
chr06,Bn25029,77936204,87634658,9698454,TN
chr06,Bn25030,46791689,81618686,34826997,RLP
chr06,Bn25031,13198594,76003238,62804644,RLP
chr06,Bn25032,92240861,99024389,6783528,TNL
chr06,Bn25033,70031617,78087666,8056049,NBS
chr06,Bn25034,76723420,97177437,20454017,TN
chr06,Bn25035,9275357,32832358,23557001,RLK
chr06,Bn25036,90090922,98521483,8430561,RLK
chr06,Bn25037,84117126,93839483,9722357,RLK
chr06,Bn25038,35832593,83925504,48092911,RLK
chr06,Bn25039,50664913,94878080,44213167,TN
chr06,Bn25040,54692077,65484856,10792779,TNL
chr06,Bn25041,47190929,75515858,28324929,RLK
chr06,Bn25042,30667330,66985402,36318072,TN
chr06,Bn25043,17444669,80977144,63532475,RLK
chr06,Bn25044,47415654,98114228,50698574,TNL
chr06,Bn25045,49145667,63999482,14853815,RLP
chr06,Bn25046,8097925,23114571,15016646,CNL
chr06,Bn25047,99309072,99873834,564762,CN
chr06,Bn25048,46861766,89616861,42755095,CN
chr06,Bn25049,54598153,74354776,19756623,RLK
chr06,Bn25050,70485034,90155200,19670166,TNL
chr06,Bn25051,95466022,96337237,871215,NBS
chr06,Bn25052,56920401,99830847,42910446,NBS
chr06,Bn25053,61112608,71871163,10758555,NBS
chr06,Bn25054,31557531,76090005,44532474,NBS
chr06,Bn25055,29927709,39604890,9677181,RLP
chr06,Bn25056,23293012,52092053,28799041,RLK
chr06,Bn25057,45210364,88638502,43428138,RLP
chr06,Bn25058,10406657,72891325,62484668,CN
chr06,Bn25059,96593046,99381869,2788823,CNL
chr06,Bn25060,30715124,80633713,49918589,CN
chr06,Bn25061,84326970,97267932,12940962,CN
chr06,Bn25062,93552147,95529192,1977045,NBS
chr06,Bn25063,55652336,64645711,8993375,RLP
chr06,Bn25064,65726072,96679277,30953205,CN
chr06,Bn25065,92066362,94634149,2567787,CNL
chr06,Bn25066,80854095,99284719,18430624,TNL
chr06,Bn25067,34801985,76009738,41207753,CNL
chr06,Bn25068,49646774,93584756,43937982,CNL
chr06,Bn25069,55794912,96281967,40487055,CNL
chr06,Bn25070,8642675,99055579,90412904,CNL
chr06,Bn25071,86515052,98888693,12373641,RLP
chr06,Bn25072,70574499,92326890,21752391,CNL
chr06,Bn25073,80973217,92229723,11256506,TNL
chr06,Bn25074,33792699,79544494,45751795,CN
chr06,Bn25075,54988840,69807367,14818527,CN
chr06,Bn25076,87568566,90368535,2799969,NBS
chr06,Bn25077,1522602,75407970,73885368,CNL
chr06,Bn25078,73841026,96009959,22168933,RLK
chr06,Bn25079,19666782,26376726,6709944,RLP
chr06,Bn25080,67190507,69579736,2389229,TNL
chr06,Bn25081,28578673,45707982,17129309,RLP
chr06,Bn25082,38597338,92564988,53967650,NBS
chr06,Bn25083,41584873,85933782,44348909,CN
chr06,Bn25084,80053691,82667713,2614022,CN
chr06,Bn25085,28177524,93996356,65818832,RLP
chr06,Bn25086,22049422,50990565,28941143,CN
chr06,Bn25087,72455459,96357706,23902247,TNL
chr06,Bn25088,72468647,79360656,6892009,CNL
chr06,Bn25089,17002014,85586624,68584610,RLP
chr06,Bn25090,79406683,89299083,9892400,CN
chr06,Bn25091,86527138,97356147,10829009,RLK
chr06,Bn25092,33130727,83672267,50541540,RLK
chr06,Bn25093,5103986,63540396,58436410,TN
chr06,Bn25094,82502093,86764435,4262342,CN
chr06,Bn25095,59850354,86685354,26835000,TNL
chr06,Bn25096,22047372,35748794,13701422,TN
chr06,Bn25097,55066996,65314330,10247334,CN
chr06,Bn25098,17736278,58055955,40319677,RLP
chr06,Bn25099,24104491,47693093,23588602,CNL
chr06,Bn25100,44186712,54933029,10746317,RLK
chr06,Bn25101,61648645,72099327,10450682,RLK
chr06,Bn25102,27776556,40955256,13178700,TN
chr06,Bn25103,14661184,41556796,26895612,CNL
chr06,Bn25104,12003113,39635231,27632118,TNL
chr06,Bn25105,3636336,9058326,5421990,NBS
chr06,Bn25106,48264114,96080620,47816506,RLP
chr06,Bn25107,13267232,67114382,53847150,TN
chr06,Bn25108,29338664,74186541,44847877,NBS
chr06,Bn25109,17345232,51222115,33876883,CN
chr06,Bn25110,63650639,66096728,2446089,TN
chr06,Bn25111,8166085,32697198,24531113,CNL
chr06,Bn25112,50477885,52380751,1902866,CNL
chr06,Bn25113,70943921,97947038,27003117,CNL
chr06,Bn25114,7545255,96634148,89088893,RLK
chr06,Bn25115,89402383,94367010,4964627,TN
chr06,Bn25116,40911275,55313184,14401909,CN
chr06,Bn25117,13841986,57285556,43443570,TNL
chr06,Bn25118,70739665,75702797,4963132,NBS
chr06,Bn25119,89438504,94495977,5057473,RLK
chr06,Bn25120,45506233,92189165,46682932,RLP
chr06,Bn25121,83074865,86475750,3400885,TN
chr06,Bn25122,12514931,67323824,54808893,NBS
chr06,Bn25123,61555251,95523402,33968151,NBS
chr06,Bn25124,59123228,97290247,38167019,RLK
chr06,Bn25125,24088027,29682487,5594460,NBS
chr06,Bn25126,14305032,24703350,10398318,RLK
chr06,Bn25127,52275565,58828473,6552908,NBS
chr06,Bn25128,33551307,92324037,58772730,CNL
chr06,Bn25129,58549819,69001269,10451450,TNL
chr06,Bn25130,25315220,33894222,8579002,CN
chr06,Bn25131,52287873,87866096,35578223,TNL
chr06,Bn25132,88714786,93603319,4888533,TN
chr06,Bn25133,15388184,33959148,18570964,NBS
chr06,Bn25134,6057095,81872085,75814990,CN
chr06,Bn25135,7971177,59779713,51808536,TN
chr06,Bn25136,29061800,85989966,56928166,NBS
chr06,Bn25137,42787174,48650551,5863377,TNL
chr06,Bn25138,1668280,86226552,84558272,RLP
chr06,Bn25139,19522435,87402804,67880369,RLP
chr06,Bn25140,14827608,84152740,69325132,CNL
chr06,Bn25141,99738713,99905322,166609,TNL
chr06,Bn25142,69730106,85351120,15621014,TN
chr06,Bn25143,91284832,99171422,7886590,CN
chr06,Bn25144,81742610,83805559,2062949,TN
chr06,Bn25145,51250238,56003544,4753306,TNL
chr06,Bn25146,47082858,49430359,2347501,TN
chr06,Bn25147,34658412,94027291,59368879,CN
chr06,Bn25148,62797006,98349752,35552746,TNL
chr06,Bn25149,38081037,83138087,45057050,CN
chr06,Bn25150,82272275,82319365,47090,TNL
chr06,Bn25151,71142173,92440094,21297921,NBS
chr06,Bn25152,74857309,93247424,18390115,RLP
chr06,Bn25153,88657636,94435839,5778203,CN
chr06,Bn25154,6527582,44741116,38213534,RLK
chr06,Bn25155,27228464,78475166,51246702,CNL
chr06,Bn25156,35754364,54661482,18907118,TNL
chr06,Bn25157,16944606,57071869,40127263,CN
chr06,Bn25158,80003485,89077690,9074205,RLK
chr06,Bn25159,99603407,99993920,390513,CNL
chr06,Bn25160,31167203,66157725,34990522,RLP
chr06,Bn25161,26498419,54180043,27681624,RLP
chr06,Bn25162,48946907,72145926,23199019,NBS
chr06,Bn25163,10289101,66505626,56216525,CNL
chr06,Bn25164,33574776,83713614,50138838,TNL
chr06,Bn25165,8749995,99436799,90686804,CN
chr06,Bn25166,80597361,92368244,11770883,TNL
chr06,Bn25167,56617034,67483313,10866279,TN
chr06,Bn25168,13547598,76972957,63425359,CNL
chr06,Bn25169,62471354,66023409,3552055,RLK
chr06,Bn25170,6770623,22494057,15723434,RLK
chr06,Bn25171,59570332,68128539,8558207,RLK
chr06,Bn25172,42965812,96632781,53666969,TNL
chr06,Bn25173,32079274,77046454,44967180,CNL
chr06,Bn25174,55459432,73909283,18449851,NBS
chr06,Bn25175,68431299,75845121,7413822,TN
chr06,Bn25176,27404629,64365974,36961345,TN
chr06,Bn25177,19728290,54605132,34876842,TNL
chr06,Bn25178,47690103,73155355,25465252,RLK
chr06,Bn25179,43779300,93954977,50175677,RLP
chr06,Bn25180,26866868,69114682,42247814,NBS
chr06,Bn25181,33539458,49459228,15919770,TNL
chr06,Bn25182,86180165,92698056,6517891,RLK
chr06,Bn25183,64307196,99093194,34785998,RLK
chr06,Bn25184,23570118,87208112,63637994,RLP
chr06,Bn25185,89652631,95145449,5492818,TNL
chr06,Bn25186,62659100,62863405,204305,CN
chr06,Bn25187,7711708,28281837,20570129,CNL
chr06,Bn25188,8388167,89612459,81224292,RLP
chr06,Bn25189,57777788,64284465,6506677,CN
chr06,Bn25190,84855842,86628366,1772524,NBS
chr06,Bn25191,90897087,91055396,158309,NBS
chr06,Bn25192,51376324,66921955,15545631,RLP
chr06,Bn25193,61503383,94822148,33318765,CN
chr06,Bn25194,52124627,94763228,42638601,NBS
chr06,Bn25195,67754528,92084021,24329493,NBS
chr06,Bn25196,27166117,64061635,36895518,RLK
chr06,Bn25197,69478017,86617195,17139178,RLP
chr06,Bn25198,46863785,77478187,30614402,CN
chr06,Bn25199,34850784,75850850,41000066,TNL
chr06,Bn25200,49758994,84174112,34415118,RLP
chr06,Bn25201,4283463,20404394,16120931,RLP
chr06,Bn25202,10282756,34104736,23821980,NBS
chr06,Bn25203,50700742,85908491,35207749,TNL
chr06,Bn25204,21120720,61047327,39926607,TNL
chr06,Bn25205,52189815,58635970,6446155,TNL
chr06,Bn25206,49285177,57363379,8078202,TN
chr06,Bn25207,46091996,54420886,8328890,NBS
chr06,Bn25208,65676189,70632063,4955874,RLK
chr06,Bn25209,22174241,58565177,36390936,NBS
chr06,Bn25210,44555373,61874075,17318702,TNL
chr06,Bn25211,81349822,94894309,13544487,CNL
chr06,Bn25212,24663818,96399177,71735359,RLK
chr06,Bn25213,90436939,94259027,3822088,TN
chr06,Bn25214,61677554,95777857,34100303,RLK
chr06,Bn25215,12593219,86962932,74369713,RLP
chr06,Bn25216,47668989,83667520,35998531,RLK
chr06,Bn25217,50997748,79908049,28910301,CNL
chr06,Bn25218,98940407,99917058,976651,NBS
chr06,Bn25219,30702031,42398757,11696726,CNL
chr06,Bn25220,35101627,42027632,6926005,TNL
chr06,Bn25221,5717532,78371428,72653896,NBS
chr06,Bn25222,99895671,99901008,5337,TN
chr06,Bn25223,31701797,77002180,45300383,TNL
chr06,Bn25224,50329948,72936787,22606839,CNL
chr06,Bn25225,54968980,56797717,1828737,CN
chr06,Bn25226,80630923,99755407,19124484,CN
chr06,Bn25227,95773297,96538318,765021,RLP
chr06,Bn25228,17703391,96969771,79266380,CN
chr06,Bn25229,36900751,91305081,54404330,NBS
chr06,Bn25230,56649922,85207104,28557182,TN
chr06,Bn25231,2094027,49581026,47486999,CN
chr06,Bn25232,65702736,80079649,14376913,RLP
chr06,Bn25233,96029323,98482308,2452985,NBS
chr06,Bn25234,90901398,92229813,1328415,NBS
chr06,Bn25235,64045020,85292322,21247302,RLP
chr06,Bn25236,33452338,70590723,37138385,CN
chr06,Bn25237,68682784,90771868,22089084,TN
chr06,Bn25238,52638895,64005162,11366267,NBS
chr06,Bn25239,96830831,99509190,2678359,CNL
chr06,Bn25240,63592834,80132086,16539252,CNL
chr06,Bn25241,94610323,96673402,2063079,CNL
chr06,Bn25242,71661966,98068491,26406525,TNL
chr06,Bn25243,19775432,75396528,55621096,NBS
chr06,Bn25244,38045634,41024827,2979193,RLP
chr06,Bn25245,13842814,67362511,53519697,RLP
chr06,Bn25246,84641491,85775796,1134305,TN
chr06,Bn25247,70639626,99690882,29051256,RLK
chr06,Bn25248,78464523,86850841,8386318,TNL
chr06,Bn25249,64091896,85098686,21006790,CNL
chr06,Bn25250,78276386,99192607,20916221,TNL
chr06,Bn25251,59411635,70719980,11308345,TN
chr06,Bn25252,49331633,74697129,25365496,RLP
chr06,Bn25253,56611383,75250941,18639558,NBS
chr06,Bn25254,71938299,79181546,7243247,TNL
chr06,Bn25255,10588436,15993904,5405468,NBS
chr06,Bn25256,82584854,96356133,13771279,RLK
chr06,Bn25257,1223026,55902784,54679758,TN
chr06,Bn25258,84812945,87656407,2843462,CN
chr06,Bn25259,82280950,89153098,6872148,NBS
chr06,Bn25260,48525503,88171775,39646272,TNL
chr06,Bn25261,91518876,98141639,6622763,RLK
chr06,Bn25262,26460903,32170978,5710075,CNL
chr06,Bn25263,6065925,88059766,81993841,NBS
chr06,Bn25264,5497334,18979879,13482545,NBS
chr06,Bn25265,43041857,46681213,3639356,CNL
chr06,Bn25266,21824932,92751188,70926256,RLP
chr06,Bn25267,57811860,62589497,4777637,NBS
chr06,Bn25268,31467252,32292675,825423,TN
chr06,Bn25269,81580030,82995923,1415893,RLP
chr06,Bn25270,97329403,98626812,1297409,CN
chr06,Bn25271,97378215,99336350,1958135,CNL
chr06,Bn25272,1957875,91089012,89131137,NBS
chr06,Bn25273,21013925,57917616,36903691,CNL
chr06,Bn25274,59521600,71981942,12460342,NBS
chr06,Bn25275,65108937,89076096,23967159,TN
chr06,Bn25276,76090854,79764236,3673382,RLP
chr06,Bn25277,34756946,66549584,31792638,CN
chr06,Bn25278,28733035,56208566,27475531,RLK
chr06,Bn25279,43082954,81743492,38660538,NBS
chr06,Bn25280,97046217,98835458,1789241,CN
chr06,Bn25281,30295142,55234542,24939400,CN
chr06,Bn25282,7853785,86109211,78255426,RLP
chr06,Bn25283,52389287,65340772,12951485,RLP
chr06,Bn25284,56986155,98884351,41898196,CNL
chr06,Bn25285,26140435,89950454,63810019,TNL
chr06,Bn25286,8826661,39393028,30566367,CN
chr06,Bn25287,99845555,99890031,44476,TN
chr06,Bn25288,4691211,46754114,42062903,RLK
chr06,Bn25289,18203789,32770780,14566991,RLP
chr06,Bn25290,49941053,70445597,20504544,TNL
chr06,Bn25291,29994193,75195229,45201036,TN
chr06,Bn25292,43502730,76181599,32678869,CNL
chr06,Bn25293,83921109,86764273,2843164,CNL
chr06,Bn25294,6224919,37958013,31733094,RLK
chr06,Bn25295,63372631,98174390,34801759,TN
chr06,Bn25296,23881772,60702224,36820452,RLK
chr06,Bn25297,53772707,99061305,45288598,RLK
chr06,Bn25298,5234801,33190312,27955511,NBS
chr06,Bn25299,90356124,91583093,1226969,TNL
chr06,Bn25300,97150790,98334551,1183761,RLP
chr06,Bn25301,47065150,72254429,25189279,RLK
chr06,Bn25302,62402170,70775209,8373039,NBS
chr06,Bn25303,70272396,71449391,1176995,CN
chr06,Bn25304,56493816,87479519,30985703,CNL
chr06,Bn25305,66796109,96050722,29254613,CNL
chr06,Bn25306,31810213,63515819,31705606,CN
chr06,Bn25307,6096995,90507552,84410557,NBS
chr06,Bn25308,95057955,99695246,4637291,RLP
chr06,Bn25309,82131788,93817597,11685809,CNL
chr06,Bn25310,94012187,95018200,1006013,RLK
chr06,Bn25311,17606236,17671453,65217,CNL
chr06,Bn25312,34490563,75157046,40666483,NBS
chr06,Bn25313,12803390,19550164,6746774,NBS
chr06,Bn25314,98421327,99242405,821078,CNL
chr06,Bn25315,41398330,51579382,10181052,TN
chr06,Bn25316,21455645,37332434,15876789,TN
chr06,Bn25317,30497261,84688747,54191486,TN
chr06,Bn25318,27537962,75032237,47494275,RLP
chr06,Bn25319,60788418,81822180,21033762,CN
chr06,Bn25320,78284142,90525233,12241091,CN
chr06,Bn25321,49567539,91399628,41832089,CN
chr06,Bn25322,99059341,99962374,903033,TNL
chr06,Bn25323,72174599,87413045,15238446,TN
chr06,Bn25324,33716817,40783969,7067152,NBS
chr06,Bn25325,12835972,61850760,49014788,TN
chr06,Bn25326,39397188,70917549,31520361,RLK
chr06,Bn25327,88633712,88733146,99434,TN
chr06,Bn25328,35308456,41051932,5743476,RLP
chr06,Bn25329,27751785,71979146,44227361,TNL
chr06,Bn25330,62928907,95194116,32265209,TNL
chr06,Bn25331,23487204,71591004,48103800,NBS
chr06,Bn25332,58785348,66256888,7471540,RLP
chr06,Bn25333,3233466,84426910,81193444,CNL
chr06,Bn25334,13656062,54981877,41325815,CN
chr06,Bn25335,58852963,92826082,33973119,TNL
chr06,Bn25336,24812632,85438082,60625450,TNL
chr06,Bn25337,54476558,66508282,12031724,RLP
chr06,Bn25338,26155293,88685628,62530335,CN
chr06,Bn25339,10148128,42508788,32360660,TN
chr06,Bn25340,33631844,90430040,56798196,TNL
chr06,Bn25341,28606341,49263632,20657291,TNL
chr06,Bn25342,38157080,44320569,6163489,CN
chr06,Bn25343,31281952,88362402,57080450,TNL
chr06,Bn25344,10640360,49166574,38526214,RLP
chr06,Bn25345,13053037,31066505,18013468,NBS
chr06,Bn25346,71553197,85734271,14181074,CNL
chr06,Bn25347,19696898,23203711,3506813,CNL
chr06,Bn25348,73409569,98343806,24934237,RLK
chr06,Bn25349,24439401,82305770,57866369,CNL
chr06,Bn25350,45062118,82696871,37634753,TNL
chr06,Bn25351,63219049,72515756,9296707,CN
chr06,Bn25352,63397759,73086544,9688785,NBS
chr06,Bn25353,48443452,87726515,39283063,TNL
chr06,Bn25354,45333313,89071703,43738390,TN
chr06,Bn25355,16392021,90355466,73963445,TNL
chr06,Bn25356,64275279,81822733,17547454,RLP
chr06,Bn25357,4284462,6851123,2566661,RLK
chr06,Bn25358,5438790,26808107,21369317,TN
chr06,Bn25359,6910083,68740542,61830459,RLK
chr06,Bn25360,96981767,97564400,582633,TN
chr06,Bn25361,5667208,89215998,83548790,NBS
chr06,Bn25362,45836399,58994604,13158205,CN
chr06,Bn25363,2130788,76390744,74259956,NBS
chr06,Bn25364,79762287,85088457,5326170,RLK
chr06,Bn25365,72827885,83428632,10600747,TNL
chr06,Bn25366,71490632,85007427,13516795,RLK
chr06,Bn25367,16891645,34125752,17234107,TNL
chr06,Bn25368,64969101,86566798,21597697,RLP
chr06,Bn25369,16079307,49066580,32987273,TN
chr06,Bn25370,91226980,98342155,7115175,RLK
chr06,Bn25371,64617560,83891711,19274151,NBS
chr06,Bn25372,20394322,56595113,36200791,CNL
chr06,Bn25373,69152951,98553805,29400854,NBS
chr06,Bn25374,17939528,86454911,68515383,TNL
chr06,Bn25375,13343746,61650409,48306663,NBS
chr06,Bn25376,62125838,72685218,10559380,CN
chr06,Bn25377,44826085,64521149,19695064,TN
chr06,Bn25378,83422891,95161527,11738636,TNL
chr06,Bn25379,64899064,72753185,7854121,NBS
chr06,Bn25380,59183487,85897937,26714450,CN
chr06,Bn25381,90435474,91732059,1296585,RLP
chr06,Bn25382,17153253,27288837,10135584,RLP
chr06,Bn25383,79320985,90951070,11630085,TN
chr06,Bn25384,37347117,64348594,27001477,RLP
chr06,Bn25385,25281998,55983947,30701949,NBS
chr06,Bn25386,74103611,81584329,7480718,CNL
chr06,Bn25387,54089544,54673696,584152,RLP
chr06,Bn25388,78754169,90580830,11826661,RLK
chr06,Bn25389,20153921,87543296,67389375,TNL
chr06,Bn25390,4540397,23294387,18753990,RLK
chr06,Bn25391,94780668,95530755,750087,RLP
chr06,Bn25392,84688360,98463756,13775396,RLP
chr06,Bn25393,38509559,59221678,20712119,RLP
chr06,Bn25394,13039917,21723815,8683898,TN
chr06,Bn25395,94595960,98090364,3494404,NBS
chr06,Bn25396,89594494,94881361,5286867,NBS
chr06,Bn25397,78943429,86037241,7093812,TN
chr06,Bn25398,52674952,84582557,31907605,RLK
chr06,Bn25399,58596471,88797451,30200980,TN
chr06,Bn25400,99587393,99606595,19202,RLK
chr06,Bn25401,24379214,40310770,15931556,NBS
chr06,Bn25402,95437593,97702758,2265165,RLP
chr06,Bn25403,20125913,37489369,17363456,NBS
chr06,Bn25404,27612320,48783210,21170890,TN
chr06,Bn25405,31871459,77875519,46004060,RLK
chr06,Bn25406,11660221,59209300,47549079,TN
chr06,Bn25407,78865500,82647564,3782064,TNL
chr06,Bn25408,24273144,29767816,5494672,RLK
chr06,Bn25409,12472693,24630543,12157850,RLP
chr06,Bn25410,10374055,41198163,30824108,TN
chr06,Bn25411,91001121,99339870,8338749,CN
chr06,Bn25412,64860225,77509781,12649556,TNL
chr06,Bn25413,30459957,71633828,41173871,TNL
chr06,Bn25414,12882612,59239200,46356588,CN
chr06,Bn25415,85313803,97136944,11823141,NBS
chr06,Bn25416,67644832,70677968,3033136,NBS
chr06,Bn25417,91921141,99607668,7686527,TNL
chr06,Bn25418,95323189,98549749,3226560,TNL
chr06,Bn25419,47370356,68884184,21513828,TNL
chr06,Bn25420,43192565,48117864,4925299,NBS
chr06,Bn25421,72916367,96462104,23545737,TN
chr06,Bn25422,62965938,88084450,25118512,TNL
chr06,Bn25423,57775423,62471433,4696010,TNL
chr06,Bn25424,73071186,92540778,19469592,TN
chr06,Bn25425,62912715,76857499,13944784,CN
chr06,Bn25426,57684234,73742328,16058094,NBS
chr06,Bn25427,76127969,96845549,20717580,CN
chr06,Bn25428,49626666,64405023,14778357,CNL
chr06,Bn25429,90741326,91523631,782305,TNL
chr06,Bn25430,20318972,22976950,2657978,RLK
chr06,Bn25431,88004088,99703593,11699505,NBS
chr06,Bn25432,5657784,44761428,39103644,TN
chr06,Bn25433,76612923,82208027,5595104,NBS
chr06,Bn25434,5629087,47937419,42308332,TN
chr06,Bn25435,50128389,50252246,123857,CN
chr06,Bn25436,59552053,81140557,21588504,RLP
chr06,Bn25437,52266624,73570158,21303534,CN
chr06,Bn25438,87058987,88005751,946764,CN
chr06,Bn25439,75317660,77375202,2057542,TNL
chr06,Bn25440,30560860,74534873,43974013,NBS
chr06,Bn25441,55691423,68545918,12854495,CNL
chr06,Bn25442,37043117,59600646,22557529,RLK
chr06,Bn25443,13154236,58341901,45187665,CNL
chr06,Bn25444,80224537,99977872,19753335,CNL
chr06,Bn25445,79290372,99691314,20400942,CN
chr06,Bn25446,18632929,92932659,74299730,TN
chr06,Bn25447,23975654,48893240,24917586,TNL
chr06,Bn25448,67874669,97773340,29898671,RLP
chr06,Bn25449,81770499,91009480,9238981,RLP
chr06,Bn25450,52468238,91067538,38599300,CNL
chr06,Bn25451,13174932,15861994,2687062,NBS
chr06,Bn25452,70816611,88544119,17727508,NBS
chr06,Bn25453,49218996,80936079,31717083,TN
chr06,Bn25454,95024430,98103117,3078687,CNL
chr06,Bn25455,70170802,75848234,5677432,TNL
chr06,Bn25456,56408315,62064248,5655933,TN
chr06,Bn25457,6050283,44292644,38242361,CNL
chr06,Bn25458,72393557,78077199,5683642,TN
chr06,Bn25459,88867948,94191346,5323398,TN
chr06,Bn25460,40650256,58160958,17510702,CNL
chr06,Bn25461,90942620,96281869,5339249,TN
chr06,Bn25462,54359679,55572558,1212879,TNL
chr06,Bn25463,65342638,87877815,22535177,RLP
chr06,Bn25464,70309398,95605922,25296524,RLP
chr06,Bn25465,95710829,98886561,3175732,RLK
chr06,Bn25466,7810835,90687335,82876500,NBS
chr06,Bn25467,49297503,73368648,24071145,RLP
chr06,Bn25468,72161353,91473832,19312479,TNL
chr06,Bn25469,65274289,75727956,10453667,TNL
chr06,Bn25470,47329969,51584110,4254141,RLP
chr06,Bn25471,79535896,89406603,9870707,RLP
chr06,Bn25472,98136235,98662141,525906,RLK
chr06,Bn25473,13390938,72768243,59377305,RLK
chr06,Bn25474,85181003,94205053,9024050,NBS
chr06,Bn25475,79553920,96883546,17329626,RLP
chr06,Bn25476,1766555,30496149,28729594,CN
chr06,Bn25477,89067252,95964420,6897168,TN
chr06,Bn25478,40042869,96136557,56093688,RLK
chr06,Bn25479,54133132,57854450,3721318,TNL
chr06,Bn25480,12585110,71871119,59286009,RLK
chr06,Bn25481,71219334,87692729,16473395,RLP
chr06,Bn25482,16846390,54361567,37515177,RLK
chr06,Bn25483,30307461,81180515,50873054,TN
chr06,Bn25484,45427202,50227102,4799900,CNL
chr06,Bn25485,64771691,71483617,6711926,RLK
chr06,Bn25486,37116493,44235534,7119041,TN
chr06,Bn25487,62849630,90385821,27536191,TN
chr06,Bn25488,71652928,75574347,3921419,TNL
chr06,Bn25489,71561688,99578024,28016336,CNL
chr06,Bn25490,80503893,84551665,4047772,CNL
chr06,Bn25491,67993291,99937803,31944512,TN
chr06,Bn25492,69991724,82206544,12214820,RLP
chr06,Bn25493,63266218,82368524,19102306,RLP
chr06,Bn25494,76992694,90495952,13503258,NBS
chr06,Bn25495,89447315,90082418,635103,RLK
chr06,Bn25496,44142757,92045126,47902369,RLP
chr06,Bn25497,55860225,80974383,25114158,RLK
chr06,Bn25498,24077496,27909573,3832077,RLK
chr06,Bn25499,55133906,91827969,36694063,TNL
chr06,Bn25500,5514459,86249126,80734667,RLK
chr06,Bn25501,8598155,58773375,50175220,RLK
chr06,Bn25502,6038130,79994172,73956042,RLP
chr06,Bn25503,73218420,86522086,13303666,CNL
chr06,Bn25504,5683611,97501675,91818064,RLK
chr06,Bn25505,90957003,93610136,2653133,CNL
chr06,Bn25506,31581790,82035085,50453295,RLP
chr06,Bn25507,65019944,78978011,13958067,CN
chr06,Bn25508,25026611,39695904,14669293,RLK
chr06,Bn25509,98715927,99551154,835227,TNL
chr06,Bn25510,97230837,99515611,2284774,TN
chr06,Bn25511,35863038,54018227,18155189,RLP
chr06,Bn25512,30231230,57787765,27556535,RLK
chr06,Bn25513,1571324,84035170,82463846,TNL
chr06,Bn25514,73640639,81159649,7519010,TN
chr06,Bn25515,38531889,40289020,1757131,CN
chr06,Bn25516,26496029,55797557,29301528,CNL
chr06,Bn25517,49724293,76142477,26418184,RLP
chr06,Bn25518,54424004,69169879,14745875,TN
chr06,Bn25519,93646761,95019754,1372993,CNL
chr06,Bn25520,95147039,97256428,2109389,CNL
chr06,Bn25521,47082480,69761646,22679166,CNL
chr06,Bn25522,47119599,99593138,52473539,CN
chr06,Bn25523,45378566,53346915,7968349,NBS
chr06,Bn25524,69403401,89701960,20298559,NBS
chr06,Bn25525,60656585,64718472,4061887,TNL
chr06,Bn25526,64640129,88560750,23920621,TN
chr06,Bn25527,14047019,26557201,12510182,RLP
chr06,Bn25528,31569543,71568779,39999236,RLP
chr06,Bn25529,88380884,88883257,502373,TNL
chr06,Bn25530,93832294,99319825,5487531,TNL
chr06,Bn25531,88806006,95540442,6734436,CN
chr06,Bn25532,49335526,55471334,6135808,RLP
chr06,Bn25533,41334162,72786101,31451939,CN
chr06,Bn25534,56458278,64953508,8495230,RLP
chr06,Bn25535,45123879,73765157,28641278,NBS
chr06,Bn25536,63774264,64480059,705795,CNL
chr06,Bn25537,70260565,71291709,1031144,NBS
chr06,Bn25538,68308327,71731071,3422744,NBS
chr06,Bn25539,8383261,18580584,10197323,TNL
chr06,Bn25540,57363377,71243083,13879706,CN
chr06,Bn25541,18321921,64870718,46548797,TNL
chr06,Bn25542,16298865,40844914,24546049,CNL
chr06,Bn25543,45395835,61809394,16413559,NBS
chr06,Bn25544,43997101,81852182,37855081,TNL
chr06,Bn25545,28653401,67105697,38452296,NBS
chr06,Bn25546,27326123,73693725,46367602,TN
chr06,Bn25547,12147426,53922725,41775299,RLK
chr06,Bn25548,34146122,67452785,33306663,TN
chr06,Bn25549,5763421,61822853,56059432,TNL
chr06,Bn25550,62453660,69233921,6780261,RLK
chr06,Bn25551,80992599,81404561,411962,CN
chr06,Bn25552,17927211,37611955,19684744,NBS
chr06,Bn25553,16378279,83454397,67076118,CN
chr06,Bn25554,96340568,98184823,1844255,NBS
chr06,Bn25555,67519360,71914460,4395100,CNL
chr06,Bn25556,27506877,83207578,55700701,TNL
chr06,Bn25557,75522431,80623006,5100575,RLP
chr06,Bn25558,91748991,96568239,4819248,TN
chr06,Bn25559,22457445,93852917,71395472,CNL
chr06,Bn25560,72239950,75508106,3268156,TN
chr06,Bn25561,42735850,67239094,24503244,TNL
chr06,Bn25562,50011070,91706246,41695176,RLP
chr06,Bn25563,8852101,45964204,37112103,NBS
chr06,Bn25564,51857148,60060873,8203725,NBS
chr06,Bn25565,50855419,95954456,45099037,CNL
chr06,Bn25566,18808033,53733347,34925314,NBS
chr06,Bn25567,98175957,99599338,1423381,NBS
chr06,Bn25568,46929453,68384434,21454981,TN
chr06,Bn25569,13121496,88024961,74903465,TN
chr06,Bn25570,99990088,99996987,6899,NBS
chr06,Bn25571,11553075,11815111,262036,RLP
chr06,Bn25572,58322567,64039874,5717307,RLK
chr06,Bn25573,19339544,80659165,61319621,RLK
chr06,Bn25574,58138236,87844109,29705873,CN
chr06,Bn25575,26060361,91100086,65039725,TN
chr06,Bn25576,82780556,97852481,15071925,TN
chr06,Bn25577,90349045,93304501,2955456,TNL
chr06,Bn25578,25958317,96871072,70912755,TN
chr06,Bn25579,21420267,85450108,64029841,RLP
chr06,Bn25580,97138614,98950217,1811603,TNL
chr06,Bn25581,16006747,16856134,849387,TNL
chr06,Bn25582,11883076,88890368,77007292,CNL
chr06,Bn25583,14275003,82812420,68537417,RLK
chr06,Bn25584,35419170,73931239,38512069,RLK
chr06,Bn25585,63503523,98286831,34783308,RLP
chr06,Bn25586,1639321,96331386,94692065,CNL
chr06,Bn25587,46517751,87168919,40651168,CNL
chr06,Bn25588,94579510,99162331,4582821,TNL
chr06,Bn25589,57941533,96476053,38534520,NBS
chr06,Bn25590,92353502,98586438,6232936,RLP
chr06,Bn25591,92187688,96592719,4405031,TN
chr06,Bn25592,58024367,98130846,40106479,NBS
chr06,Bn25593,90318885,91427731,1108846,NBS
chr06,Bn25594,74386401,83812808,9426407,NBS
chr06,Bn25595,82904953,98700833,15795880,RLP
chr06,Bn25596,28904599,48112226,19207627,CN
chr06,Bn25597,65037287,66520200,1482913,TNL
chr06,Bn25598,84102242,99734301,15632059,TNL
chr06,Bn25599,95870081,96520139,650058,CNL
chr06,Bn25600,51639555,86369255,34729700,RLP
chr06,Bn25601,73533673,78153431,4619758,CN
chr06,Bn25602,88758943,93815002,5056059,RLP
chr06,Bn25603,65805365,82416908,16611543,CN
chr06,Bn25604,28347541,29099983,752442,TNL
chr06,Bn25605,22185447,91650235,69464788,NBS
chr06,Bn25606,15858150,92526270,76668120,NBS
chr06,Bn25607,65456931,66900506,1443575,TNL
chr06,Bn25608,12251037,50486638,38235601,TN
chr06,Bn25609,21127058,56131399,35004341,RLP
chr06,Bn25610,95481269,96718524,1237255,TN
chr06,Bn25611,96354620,97004066,649446,CNL
chr06,Bn25612,9717994,11937270,2219276,RLP
chr06,Bn25613,35739375,86373224,50633849,RLK
chr06,Bn25614,7660167,19749379,12089212,NBS
chr06,Bn25615,79950829,88532550,8581721,CNL
chr06,Bn25616,97949579,98011308,61729,TN
chr06,Bn25617,61958483,82127240,20168757,RLP
chr06,Bn25618,56351563,58772561,2420998,CNL
chr06,Bn25619,33630732,57851350,24220618,NBS
chr06,Bn25620,76988618,91092113,14103495,NBS
chr06,Bn25621,12656995,31201673,18544678,NBS
chr06,Bn25622,93397233,93834703,437470,NBS
chr06,Bn25623,53290142,77242323,23952181,TN
chr06,Bn25624,54746420,60211271,5464851,TNL
chr06,Bn25625,82386158,83302997,916839,RLK
chr06,Bn25626,5522187,22658066,17135879,CNL
chr06,Bn25627,97492791,97620351,127560,RLK
chr06,Bn25628,81867863,90096558,8228695,NBS
chr06,Bn25629,41179502,61728158,20548656,RLP
chr06,Bn25630,32073516,46298758,14225242,RLP
chr06,Bn25631,43644573,52568016,8923443,NBS
chr06,Bn25632,2405681,60473167,58067486,CNL
chr06,Bn25633,44475500,55841979,11366479,RLP
chr06,Bn25634,94195588,99552525,5356937,TNL
chr06,Bn25635,76850958,84973187,8122229,TNL
chr06,Bn25636,40287519,44413061,4125542,CNL
chr06,Bn25637,73039853,76610725,3570872,NBS
chr06,Bn25638,51529994,94894985,43364991,TNL
chr06,Bn25639,79565210,82889415,3324205,CNL
chr06,Bn25640,7899282,45611940,37712658,RLK
chr06,Bn25641,1949456,9402565,7453109,CN
chr06,Bn25642,69203380,82016385,12813005,CN
chr06,Bn25643,5909026,39594162,33685136,TN
chr06,Bn25644,50373341,71519137,21145796,CN
chr06,Bn25645,69921580,75288963,5367383,TN
chr06,Bn25646,91633626,96651766,5018140,NBS
chr06,Bn25647,2417592,84244131,81826539,CNL
chr06,Bn25648,60346886,62820357,2473471,TNL
chr06,Bn25649,57910544,83756931,25846387,TNL
chr06,Bn25650,46263355,77730850,31467495,CN
chr06,Bn25651,6657510,12972902,6315392,RLP
chr06,Bn25652,83686675,94524709,10838034,RLP
chr06,Bn25653,14562033,54394282,39832249,RLP
chr06,Bn25654,91536646,94978966,3442320,CN
chr06,Bn25655,46322516,49968548,3646032,RLP
chr06,Bn25656,80337333,86159964,5822631,CNL
chr06,Bn25657,41890105,81498177,39608072,RLP
chr06,Bn25658,6431088,99690458,93259370,NBS
chr06,Bn25659,22466890,66527650,44060760,TNL
chr06,Bn25660,35919226,45476898,9557672,TNL
chr06,Bn25661,53131296,68292490,15161194,TN
chr06,Bn25662,62353233,87450991,25097758,TN
chr06,Bn25663,37266590,71116391,33849801,NBS
chr06,Bn25664,44096372,85079044,40982672,RLK
chr06,Bn25665,66177196,81234038,15056842,RLK
chr06,Bn25666,35065599,50335912,15270313,TN
chr06,Bn25667,98449211,99144772,695561,CNL
chr06,Bn25668,12252043,41665852,29413809,RLP
chr06,Bn25669,4727936,64978082,60250146,RLK
chr06,Bn25670,43524755,53548629,10023874,TN
chr06,Bn25671,26834475,55478427,28643952,TN
chr06,Bn25672,45926458,84592687,38666229,TNL
chr06,Bn25673,99929252,99978694,49442,RLK
chr06,Bn25674,46293355,77859437,31566082,TN
chr06,Bn25675,87376972,92601892,5224920,RLP
chr06,Bn25676,33877909,62179876,28301967,TN
chr06,Bn25677,95531318,96918612,1387294,CN
chr06,Bn25678,87094736,91585297,4490561,TN
chr06,Bn25679,45513473,70745601,25232128,TN
chr06,Bn25680,73172228,98207563,25035335,NBS
chr06,Bn25681,18825320,74463423,55638103,CN
chr06,Bn25682,33423497,34686888,1263391,TNL
chr06,Bn25683,29189158,51275931,22086773,TN
chr06,Bn25684,97492200,99000383,1508183,NBS
chr06,Bn25685,86946479,90053811,3107332,RLP
chr06,Bn25686,7743379,8891491,1148112,CN
chr06,Bn25687,70390848,94857543,24466695,CN
chr06,Bn25688,27010642,74998968,47988326,RLK
chr06,Bn25689,99867399,99973405,106006,CNL
chr06,Bn25690,12654662,66432661,53777999,TNL
chr06,Bn25691,42901718,48528815,5627097,CN
chr06,Bn25692,27407643,56142053,28734410,CN
chr06,Bn25693,26847283,44969941,18122658,RLP
chr06,Bn25694,39578176,44212217,4634041,TN
chr06,Bn25695,78183461,95945203,17761742,RLK
chr06,Bn25696,6411239,27384400,20973161,TNL
chr06,Bn25697,19069195,77848940,58779745,RLK
chr06,Bn25698,39527470,54580632,15053162,CN
chr06,Bn25699,91182632,93726659,2544027,NBS
chr06,Bn25700,26897120,75555589,48658469,NBS
chr06,Bn25701,74168790,96750592,22581802,RLK
chr06,Bn25702,74618880,97913085,23294205,RLK
chr06,Bn25703,86902788,88768284,1865496,NBS
chr06,Bn25704,23855543,65246649,41391106,RLP
chr06,Bn25705,37808519,70321041,32512522,CN
chr06,Bn25706,30052209,74339306,44287097,CNL
chr06,Bn25707,54757901,82358976,27601075,CNL
chr06,Bn25708,22931341,81398762,58467421,CN
chr06,Bn25709,41359028,64899296,23540268,NBS
chr06,Bn25710,22323633,52475843,30152210,TN
chr06,Bn25711,89866154,92913748,3047594,CN
chr06,Bn25712,74913769,75758942,845173,CN
chr06,Bn25713,83989326,92722569,8733243,CNL
chr06,Bn25714,55422944,70144103,14721159,RLK
chr06,Bn25715,58834360,96080636,37246276,NBS
chr06,Bn25716,6273447,52980955,46707508,NBS
chr06,Bn25717,47048497,62173420,15124923,NBS
chr06,Bn25718,35732412,61410621,25678209,NBS
chr06,Bn25719,16392825,81455354,65062529,RLP
chr06,Bn25720,77579113,81841367,4262254,RLK
chr06,Bn25721,98891458,99060480,169022,TN
chr06,Bn25722,30158649,89933218,59774569,NBS
chr06,Bn25723,56943236,89401493,32458257,TNL
chr06,Bn25724,60707595,95197516,34489921,TN
chr06,Bn25725,52453878,78163094,25709216,TNL
chr06,Bn25726,70275202,88690124,18414922,NBS
chr06,Bn25727,50886042,68602001,17715959,TN
chr06,Bn25728,80003243,88231692,8228449,NBS
chr06,Bn25729,38624233,57814486,19190253,CN
chr06,Bn25730,89833281,95544082,5710801,CN
chr06,Bn25731,49594599,57204389,7609790,TNL
chr06,Bn25732,35603680,73794375,38190695,TN
chr06,Bn25733,16949705,65191261,48241556,CN
chr06,Bn25734,96794975,98223758,1428783,NBS
chr06,Bn25735,15680812,34982790,19301978,RLP
chr06,Bn25736,76365073,95029725,18664652,RLP
chr06,Bn25737,73920881,76200494,2279613,RLK
chr06,Bn25738,44419629,65642855,21223226,CNL
chr06,Bn25739,45427460,79613242,34185782,TNL
chr06,Bn25740,93064235,99318400,6254165,TN
chr06,Bn25741,27800953,71689438,43888485,TN
chr06,Bn25742,92104352,98523355,6419003,NBS
chr06,Bn25743,31311758,95701208,64389450,CNL
chr06,Bn25744,90556218,98784586,8228368,CN
chr06,Bn25745,39658245,44639384,4981139,RLP
chr06,Bn25746,70850885,85312631,14461746,TN
chr06,Bn25747,62196825,90286493,28089668,RLP
chr06,Bn25748,96320629,96360910,40281,NBS
chr06,Bn25749,71358259,74218222,2859963,CN
chr06,Bn25750,76121787,84713808,8592021,TNL
chr06,Bn25751,10921658,40035321,29113663,CNL
chr06,Bn25752,16864064,55900768,39036704,TNL
chr06,Bn25753,51563839,76985265,25421426,CNL
chr06,Bn25754,72506406,91714988,19208582,TNL
chr06,Bn25755,1220822,56245649,55024827,NBS
chr06,Bn25756,37739339,71411554,33672215,CNL
chr06,Bn25757,47350286,86598703,39248417,TNL
chr06,Bn25758,60846189,96667125,35820936,RLP
chr06,Bn25759,88915871,89977532,1061661,TNL
chr06,Bn25760,30987806,49741520,18753714,CN
chr06,Bn25761,4381146,84035834,79654688,CN
chr06,Bn25762,36643878,89086567,52442689,TN
chr06,Bn25763,87212887,97336916,10124029,RLK
chr06,Bn25764,89144480,99912537,10768057,TN
chr06,Bn25765,64036810,93195859,29159049,TN
chr06,Bn25766,56086159,76196802,20110643,RLP
chr06,Bn25767,19982005,75742706,55760701,RLP
chr06,Bn25768,63630662,74632267,11001605,TNL
chr06,Bn25769,99112148,99719736,607588,NBS
chr06,Bn25770,39997352,57214403,17217051,CN
chr06,Bn25771,22790321,64336397,41546076,TNL
chr06,Bn25772,5581717,82638805,77057088,NBS
chr06,Bn25773,58736426,96396468,37660042,CN
chr06,Bn25774,58611596,86529581,27917985,TNL
chr06,Bn25775,83425790,84680083,1254293,CNL
chr06,Bn25776,92482088,95788526,3306438,CNL
chr06,Bn25777,68190919,93222865,25031946,TN
chr06,Bn25778,40862696,96108064,55245368,TNL
chr06,Bn25779,34612539,90212063,55599524,CNL
chr06,Bn25780,98438490,98481774,43284,RLK
chr06,Bn25781,5123401,42427256,37303855,CNL
chr06,Bn25782,13394595,95528299,82133704,TNL
chr06,Bn25783,55280912,80763031,25482119,CNL
chr06,Bn25784,82170567,89475989,7305422,TNL
chr06,Bn25785,33711406,50520012,16808606,TN
chr06,Bn25786,32490038,71027801,38537763,CN
chr06,Bn25787,89718134,91489612,1771478,CNL
chr06,Bn25788,24916890,89922112,65005222,NBS
chr06,Bn25789,46022043,65912951,19890908,RLP
chr06,Bn25790,93885852,96087296,2201444,NBS
chr06,Bn25791,65884355,83628096,17743741,RLK
chr06,Bn25792,73677562,91528283,17850721,RLP
chr06,Bn25793,9007658,56440535,47432877,CNL
chr06,Bn25794,96473978,98182009,1708031,RLK
chr06,Bn25795,51106972,54397794,3290822,CNL
chr06,Bn25796,62681302,76419162,13737860,TN
chr06,Bn25797,92002402,94848605,2846203,TN
chr06,Bn25798,51487282,74482579,22995297,TNL
chr06,Bn25799,55348390,72701058,17352668,NBS
chr06,Bn25800,58562057,92815005,34252948,TNL
chr06,Bn25801,97539103,99249544,1710441,RLP
chr06,Bn25802,51475836,67837348,16361512,NBS
chr06,Bn25803,20345515,74108255,53762740,RLK
chr06,Bn25804,16380178,91897447,75517269,RLP
chr06,Bn25805,21454015,72768880,51314865,CN
chr06,Bn25806,57833212,81949922,24116710,NBS
chr06,Bn25807,73453363,93388534,19935171,NBS
chr06,Bn25808,60697486,85412927,24715441,NBS
chr06,Bn25809,74756914,87248733,12491819,NBS
chr06,Bn25810,45411983,79330135,33918152,TN
chr06,Bn25811,88344655,91065332,2720677,CNL
chr06,Bn25812,25130110,63391332,38261222,CN
chr06,Bn25813,37204360,55110148,17905788,RLK
chr06,Bn25814,61022095,66679793,5657698,TN
chr06,Bn25815,77179773,82819208,5639435,TNL
chr06,Bn25816,74100925,90281440,16180515,RLK
chr06,Bn25817,65264510,70670881,5406371,TN
chr06,Bn25818,33226311,62826594,29600283,TN
chr06,Bn25819,23121728,42277281,19155553,TN
chr06,Bn25820,85000435,92525234,7524799,CNL
chr06,Bn25821,34300204,84896296,50596092,RLK
chr06,Bn25822,55869936,59355396,3485460,CN
chr06,Bn25823,67539656,95797067,28257411,NBS
chr06,Bn25824,97946954,98734912,787958,CNL
chr06,Bn25825,8138253,57105190,48966937,CNL
chr06,Bn25826,54251717,83602237,29350520,RLP
chr06,Bn25827,46207493,79024853,32817360,RLP
chr06,Bn25828,35129494,88167419,53037925,CNL
chr06,Bn25829,16893343,86033248,69139905,RLK
chr06,Bn25830,33698991,90283994,56585003,RLP
chr06,Bn25831,50112067,59527983,9415916,CN
chr06,Bn25832,50558618,78689492,28130874,RLP
chr06,Bn25833,75662262,98975993,23313731,RLK
chr06,Bn25834,43895496,73267648,29372152,CNL
chr06,Bn25835,72046748,73262599,1215851,RLP
chr06,Bn25836,19975393,47502795,27527402,RLK
chr06,Bn25837,82097887,82856001,758114,CNL
chr06,Bn25838,78888277,97866780,18978503,NBS
chr06,Bn25839,22578686,82897101,60318415,NBS
chr06,Bn25840,80270782,90063270,9792488,CN
chr06,Bn25841,13586282,18978763,5392481,RLK
chr06,Bn25842,44229407,84840051,40610644,CN
chr06,Bn25843,33984038,67883392,33899354,TN
chr06,Bn25844,61802854,70634506,8831652,TNL
chr06,Bn25845,55473650,70840133,15366483,TNL
chr06,Bn25846,40462160,76777736,36315576,RLP
chr06,Bn25847,13784542,71183076,57398534,CNL
chr06,Bn25848,67479685,90879934,23400249,CNL
chr06,Bn25849,26560459,55453855,28893396,CNL
chr06,Bn25850,15314703,17895246,2580543,RLK
chr06,Bn25851,43564302,91814665,48250363,TN
chr06,Bn25852,41855299,75085263,33229964,TN
chr06,Bn25853,14623970,44865787,30241817,RLP
chr06,Bn25854,40816018,91210638,50394620,RLK
chr06,Bn25855,45578523,90300210,44721687,TN
chr06,Bn25856,94259267,98450237,4190970,TNL
chr06,Bn25857,66843682,96207101,29363419,CNL
chr06,Bn25858,50198738,68124630,17925892,CNL
chr06,Bn25859,21887536,87654311,65766775,CN
chr06,Bn25860,80472103,88447694,7975591,CN
chr06,Bn25861,66321045,88191405,21870360,RLP
chr06,Bn25862,41165017,48966876,7801859,RLP
chr06,Bn25863,50704965,80950423,30245458,NBS
chr06,Bn25864,73819462,99053453,25233991,RLK
chr06,Bn25865,74867991,91316113,16448122,CN
chr06,Bn25866,81311335,89355835,8044500,RLP
chr06,Bn25867,93797851,99861995,6064144,TNL
chr06,Bn25868,27672056,54131640,26459584,RLK
chr06,Bn25869,76600614,91428179,14827565,RLP
chr06,Bn25870,77357860,95115426,17757566,RLK
chr06,Bn25871,39227266,59980053,20752787,TNL
chr06,Bn25872,48556473,87324964,38768491,TN
chr06,Bn25873,17067896,38880754,21812858,CNL
chr06,Bn25874,92746169,93049158,302989,RLP
chr06,Bn25875,94851348,95350744,499396,CNL
chr06,Bn25876,69753728,91008656,21254928,TN
chr06,Bn25877,15199436,53085576,37886140,CNL
chr06,Bn25878,96345054,96565781,220727,RLK
chr06,Bn25879,13126806,48898948,35772142,RLK
chr06,Bn25880,59870830,99090146,39219316,CN
chr06,Bn25881,15793830,91168270,75374440,CNL
chr06,Bn25882,41216780,83719570,42502790,TN
chr06,Bn25883,24711301,98658429,73947128,TN
chr06,Bn25884,93856955,98542508,4685553,NBS
chr06,Bn25885,34348181,99349745,65001564,CN
chr06,Bn25886,27540754,90806541,63265787,TN
chr06,Bn25887,21255128,44731839,23476711,RLP
chr06,Bn25888,11830253,83109116,71278863,NBS
chr06,Bn25889,18904659,88138491,69233832,CNL
chr06,Bn25890,87150069,89175580,2025511,CN
chr06,Bn25891,93330677,97712209,4381532,NBS
chr06,Bn25892,99789984,99816255,26271,RLP
chr06,Bn25893,66829167,94052652,27223485,CN
chr06,Bn25894,37916221,54713138,16796917,NBS
chr06,Bn25895,84815970,85912221,1096251,TNL
chr06,Bn25896,78478472,87712182,9233710,NBS
chr06,Bn25897,52123407,74658478,22535071,CN
chr06,Bn25898,13430156,85082628,71652472,TNL
chr06,Bn25899,42587491,71216420,28628929,RLP
chr06,Bn25900,65187314,99679635,34492321,TN
chr06,Bn25901,8191520,33268661,25077141,NBS
chr06,Bn25902,58772047,67326165,8554118,CNL
chr06,Bn25903,49460473,60527048,11066575,TN
chr06,Bn25904,19132715,58942259,39809544,TN
chr06,Bn25905,85766809,96456877,10690068,CN
chr06,Bn25906,5563738,24451093,18887355,NBS
chr06,Bn25907,60836615,90848206,30011591,NBS
chr06,Bn25908,93569576,94807087,1237511,RLK
chr06,Bn25909,2520428,79831271,77310843,TN
chr06,Bn25910,74272830,87719394,13446564,NBS
chr06,Bn25911,40362327,73628455,33266128,RLK
chr06,Bn25912,20540750,96503820,75963070,NBS
chr06,Bn25913,32373470,84215049,51841579,NBS
chr06,Bn25914,92098107,96214232,4116125,RLK
chr06,Bn25915,3771630,31857386,28085756,TN
chr06,Bn25916,21168194,97226040,76057846,RLK
chr06,Bn25917,82901988,86622990,3721002,CN
chr06,Bn25918,8544213,21079362,12535149,TN
chr06,Bn25919,56488142,83641835,27153693,CNL
chr06,Bn25920,28924316,52706841,23782525,RLK
chr06,Bn25921,45559388,56677342,11117954,RLK
chr06,Bn25922,72069377,87456124,15386747,CNL
chr06,Bn25923,87902667,96145234,8242567,TN
chr06,Bn25924,50052248,80290134,30237886,NBS
chr06,Bn25925,63388617,71598898,8210281,NBS
chr06,Bn25926,89312172,91128230,1816058,CNL
chr06,Bn25927,84143439,98725225,14581786,CN
chr06,Bn25928,27360441,95837262,68476821,CN
chr06,Bn25929,57982052,65078981,7096929,CNL
chr06,Bn25930,3798650,10448548,6649898,RLK
chr06,Bn25931,36537449,60355274,23817825,RLP
chr06,Bn25932,34844493,57952512,23108019,RLK
chr06,Bn25933,83534470,94413195,10878725,CNL
chr06,Bn25934,12695854,25037537,12341683,RLP
chr06,Bn25935,88949687,99732740,10783053,CN
chr06,Bn25936,7684632,60304090,52619458,TN
chr06,Bn25937,69874368,84933355,15058987,TNL
chr06,Bn25938,50920003,64238080,13318077,TNL
chr06,Bn25939,34345641,61567351,27221710,NBS
chr06,Bn25940,87847431,94216237,6368806,CNL
chr06,Bn25941,73451621,74603768,1152147,RLP
chr06,Bn25942,43373826,51139950,7766124,TNL
chr06,Bn25943,81273174,85950000,4676826,TNL
chr06,Bn25944,22907688,49448091,26540403,CN
chr06,Bn25945,23955138,77157153,53202015,RLP
chr06,Bn25946,56718767,81442735,24723968,NBS
chr06,Bn25947,18587571,91296699,72709128,CNL
chr06,Bn25948,71708412,86271762,14563350,TN
chr06,Bn25949,56355365,70237167,13881802,CNL
chr06,Bn25950,65049908,94704069,29654161,RLP
chr06,Bn25951,27695724,56028527,28332803,NBS
chr06,Bn25952,36350499,38539076,2188577,RLK
chr06,Bn25953,65061923,84925352,19863429,RLP
chr06,Bn25954,21834146,96020000,74185854,RLP
chr06,Bn25955,95918274,99567926,3649652,TN
chr06,Bn25956,66463109,71159061,4695952,CNL
chr06,Bn25957,25906551,75279937,49373386,TN
chr06,Bn25958,28758970,62831403,34072433,RLK
chr06,Bn25959,80046737,82538023,2491286,TNL
chr06,Bn25960,58902703,60945897,2043194,TNL
chr06,Bn25961,37278132,98419307,61141175,NBS
chr06,Bn25962,80658616,94056578,13397962,RLK
chr06,Bn25963,99910301,99943845,33544,TN
chr06,Bn25964,80262533,92145551,11883018,TNL
chr06,Bn25965,72971547,83113110,10141563,CNL
chr06,Bn25966,58518812,61803549,3284737,CNL
chr06,Bn25967,9934409,62866125,52931716,CNL
chr06,Bn25968,98859771,99651818,792047,CNL
chr06,Bn25969,73557296,89692063,16134767,RLP
chr06,Bn25970,19224820,54686928,35462108,RLP
chr06,Bn25971,76938262,84500180,7561918,TNL
chr06,Bn25972,75507062,82262371,6755309,CNL
chr06,Bn25973,75919502,89565264,13645762,CNL
chr06,Bn25974,48321164,57956013,9634849,CNL
chr06,Bn25975,4487429,56522888,52035459,CNL
chr06,Bn25976,81277434,85182150,3904716,TN
chr06,Bn25977,6124645,86827369,80702724,TNL
chr06,Bn25978,81801723,92414055,10612332,NBS
chr06,Bn25979,70543592,72812579,2268987,CN
chr06,Bn25980,35907392,55153398,19246006,CN
chr06,Bn25981,34330791,79612266,45281475,CNL
chr06,Bn25982,43613814,56180786,12566972,CNL
chr06,Bn25983,57988734,95789699,37800965,TN
chr06,Bn25984,30816806,57616435,26799629,RLK
chr06,Bn25985,44597322,62270981,17673659,NBS
chr06,Bn25986,91635860,91820232,184372,NBS
chr06,Bn25987,26755977,52525344,25769367,RLP
chr06,Bn25988,98064194,98215336,151142,CN
chr06,Bn25989,95142180,99393749,4251569,CN
chr06,Bn25990,46646913,80554460,33907547,RLK
chr06,Bn25991,75456746,89499482,14042736,CN
chr06,Bn25992,12999216,27099834,14100618,TN
chr06,Bn25993,74381432,89564241,15182809,NBS
chr06,Bn25994,97336588,98684051,1347463,RLK
chr06,Bn25995,82922590,92140599,9218009,NBS
chr06,Bn25996,52048563,58035795,5987232,TN
chr06,Bn25997,25262932,52271822,27008890,RLP
chr06,Bn25998,64007581,84649993,20642412,CN
chr06,Bn25999,80678069,83566686,2888617,CNL
chr06,Bn26000,41220730,79390824,38170094,TNL
chr06,Bn26001,47383112,82105459,34722347,RLP
chr06,Bn26002,80440165,95902133,15461968,TN
chr06,Bn26003,18597066,25963504,7366438,CN
chr06,Bn26004,15481972,52338160,36856188,CN
chr06,Bn26005,9368446,62543793,53175347,CN
chr06,Bn26006,48441372,53884427,5443055,NBS
chr06,Bn26007,94540257,95812017,1271760,RLP
chr06,Bn26008,33568280,52990679,19422399,RLP
chr06,Bn26009,10316912,25415737,15098825,TN
chr06,Bn26010,39501932,84106737,44604805,NBS
chr06,Bn26011,43787661,85116286,41328625,RLP
chr06,Bn26012,77979996,92962464,14982468,NBS
chr06,Bn26013,45953809,81589122,35635313,CNL
chr06,Bn26014,17412532,24980231,7567699,NBS
chr06,Bn26015,6343016,16571751,10228735,CNL
chr06,Bn26016,59132740,76382421,17249681,RLP
chr06,Bn26017,18283654,73596893,55313239,CNL
chr06,Bn26018,49777617,70075547,20297930,CNL
chr06,Bn26019,80792067,91293846,10501779,TN
chr06,Bn26020,17240818,62440559,45199741,CNL
chr06,Bn26021,7822617,82960962,75138345,RLP
chr06,Bn26022,39027885,87690636,48662751,CN
chr06,Bn26023,56032493,72070468,16037975,TNL
chr06,Bn26024,34796835,66804623,32007788,TN
chr06,Bn26025,14254999,15049475,794476,NBS
chr06,Bn26026,47600713,86140409,38539696,RLP
chr06,Bn26027,31049304,44042111,12992807,RLP
chr06,Bn26028,70131771,77096924,6965153,RLP
chr06,Bn26029,66883796,92040557,25156761,RLK
chr06,Bn26030,85167543,95571082,10403539,RLP
chr06,Bn26031,67388963,85598728,18209765,CN
chr06,Bn26032,19283803,83757843,64474040,TNL
chr06,Bn26033,77949255,96953626,19004371,RLP
chr06,Bn26034,83071447,94226529,11155082,TN
chr06,Bn26035,27778530,48516223,20737693,RLK
chr06,Bn26036,79494798,92903177,13408379,CN
chr06,Bn26037,32434432,47041753,14607321,CN
chr06,Bn26038,28380947,36170425,7789478,CN
chr06,Bn26039,5797822,10547250,4749428,NBS
chr06,Bn26040,21604896,26310888,4705992,RLK
chr06,Bn26041,48918317,82673464,33755147,RLK
chr06,Bn26042,27037089,46936805,19899716,RLP
chr06,Bn26043,44016936,79656151,35639215,RLK
chr06,Bn26044,22824324,88758528,65934204,RLK
chr06,Bn26045,87263241,99582432,12319191,CNL
chr06,Bn26046,29528240,74225373,44697133,TNL
chr06,Bn26047,63048552,68829193,5780641,CN
chr06,Bn26048,67981465,76109910,8128445,RLK
chr06,Bn26049,48973012,57483391,8510379,CNL
chr06,Bn26050,12059484,94426487,82367003,NBS
chr06,Bn26051,62263503,87171339,24907836,CN
chr06,Bn26052,96267066,99225343,2958277,TN
chr06,Bn26053,47690892,86664618,38973726,TNL
chr06,Bn26054,41722312,67220544,25498232,TNL
chr06,Bn26055,31846963,35937542,4090579,RLK
chr06,Bn26056,48523207,98391106,49867899,RLK
chr06,Bn26057,90942852,99265252,8322400,TN
chr06,Bn26058,59437712,74464440,15026728,CN
chr06,Bn26059,63337267,83483323,20146056,TN
chr06,Bn26060,44971059,69421239,24450180,TNL
chr06,Bn26061,16230399,88979905,72749506,TNL
chr06,Bn26062,2894673,70571254,67676581,TN
chr06,Bn26063,45194988,82287037,37092049,TN
chr06,Bn26064,29148226,98072018,68923792,RLK
chr06,Bn26065,97531521,99763335,2231814,RLK
chr06,Bn26066,67676127,88802036,21125909,CN
chr06,Bn26067,86150623,89407056,3256433,NBS
chr06,Bn26068,51225364,92328807,41103443,TN
chr06,Bn26069,71557172,96054537,24497365,RLK
chr06,Bn26070,68368305,99674420,31306115,RLP
chr06,Bn26071,84626157,85524153,897996,RLP
chr06,Bn26072,56054898,59665868,3610970,RLP
chr06,Bn26073,28901668,33660142,4758474,NBS
chr06,Bn26074,53611861,79232111,25620250,CN
chr06,Bn26075,58307688,65865379,7557691,NBS
chr06,Bn26076,45678688,84485690,38807002,RLK
chr06,Bn26077,76859958,88857856,11997898,NBS
chr06,Bn26078,43749246,66172741,22423495,TNL
chr06,Bn26079,77618174,82986695,5368521,TNL
chr06,Bn26080,43980621,48272200,4291579,TN
chr06,Bn26081,83345720,93949853,10604133,TNL
chr06,Bn26082,59533481,77882711,18349230,CNL
chr06,Bn26083,85605305,90641271,5035966,NBS
chr06,Bn26084,94265844,94647695,381851,RLK
chr06,Bn26085,7596248,66162173,58565925,RLP
chr06,Bn26086,77086664,87961849,10875185,TNL
chr06,Bn26087,47310764,68456851,21146087,RLP
chr06,Bn26088,15147963,65181744,50033781,CN
chr06,Bn26089,38195099,74138475,35943376,RLP
chr06,Bn26090,61075344,74702327,13626983,TNL
chr06,Bn26091,83542864,85281463,1738599,CN
chr06,Bn26092,17441871,64146364,46704493,NBS
chr06,Bn26093,88995268,90034917,1039649,CNL
chr06,Bn26094,26903166,64716595,37813429,RLP
chr06,Bn26095,62545851,84234782,21688931,TNL
chr06,Bn26096,91557967,96746975,5189008,RLP
chr06,Bn26097,21122533,28338408,7215875,RLK
chr06,Bn26098,79939183,87658682,7719499,NBS
chr06,Bn26099,66614489,71025797,4411308,TN
chr06,Bn26100,10510328,74285852,63775524,CNL
chr06,Bn26101,25123825,59644015,34520190,TN
chr06,Bn26102,90350392,93536729,3186337,RLK
chr06,Bn26103,45842539,96735798,50893259,NBS
chr06,Bn26104,52616579,80487390,27870811,TNL
chr06,Bn26105,49169369,83911124,34741755,CN
chr06,Bn26106,32677775,47193019,14515244,CN
chr06,Bn26107,66904329,67853241,948912,NBS
chr06,Bn26108,71498169,82799291,11301122,TN
chr06,Bn26109,67223105,85950449,18727344,RLK
chr06,Bn26110,51420103,98391304,46971201,NBS
chr06,Bn26111,15602840,86433098,70830258,TN
chr06,Bn26112,20385569,54832927,34447358,CNL
chr06,Bn26113,27132430,51456657,24324227,CN
chr06,Bn26114,83721879,86157054,2435175,RLK
chr06,Bn26115,30227267,83032933,52805666,TN
chr06,Bn26116,21759886,94490276,72730390,TN
chr06,Bn26117,50121328,57163029,7041701,RLP
chr06,Bn26118,56830560,98384125,41553565,RLP
chr06,Bn26119,70422912,88937890,18514978,RLP
chr06,Bn26120,90595574,97413885,6818311,CN
chr06,Bn26121,38707805,51885216,13177411,NBS
chr06,Bn26122,73142730,94114465,20971735,TNL
chr06,Bn26123,72350931,85331650,12980719,NBS
chr06,Bn26124,19403688,83013116,63609428,TN
chr06,Bn26125,23465022,90310315,66845293,RLP
chr06,Bn26126,41681913,56265699,14583786,TNL
chr06,Bn26127,61862560,99262006,37399446,TN
chr06,Bn26128,97332859,97784025,451166,RLP
chr06,Bn26129,87111825,99511362,12399537,CNL
chr06,Bn26130,46353042,49779941,3426899,TNL
chr06,Bn26131,41337201,74878493,33541292,RLK
chr06,Bn26132,36880914,42816250,5935336,TNL
chr06,Bn26133,29653055,74324284,44671229,TNL
chr06,Bn26134,72357271,82812834,10455563,TNL
chr06,Bn26135,60458990,75872003,15413013,CNL
chr06,Bn26136,25975242,54425393,28450151,CNL
chr06,Bn26137,97225388,99685981,2460593,NBS
chr06,Bn26138,32682270,84639284,51957014,TN
chr06,Bn26139,84535259,97012386,12477127,CNL
chr06,Bn26140,54869990,59871147,5001157,NBS
chr06,Bn26141,64117334,92559442,28442108,CN
chr06,Bn26142,90898829,93997625,3098796,CNL
chr06,Bn26143,81727350,99408049,17680699,TNL
chr06,Bn26144,44532732,84492033,39959301,CNL
chr06,Bn26145,14582794,18401691,3818897,RLP
chr06,Bn26146,12523193,47517428,34994235,RLP
chr06,Bn26147,65633209,84048392,18415183,TN
chr06,Bn26148,79972842,92608318,12635476,CNL
chr06,Bn26149,61234407,91136465,29902058,CNL
chr06,Bn26150,40767737,52849955,12082218,CNL
chr06,Bn26151,48975258,81320038,32344780,RLK
chr06,Bn26152,3231126,7204574,3973448,CNL
chr06,Bn26153,64375202,81347395,16972193,RLK
chr06,Bn26154,71352865,89168404,17815539,TNL
chr06,Bn26155,27751631,75601784,47850153,TNL
chr06,Bn26156,68615643,81676664,13061021,CN
chr06,Bn26157,95931125,99691956,3760831,RLP
chr06,Bn26158,5512594,56092021,50579427,CNL
chr06,Bn26159,43342250,56276484,12934234,CN
chr06,Bn26160,66748559,76117504,9368945,RLK
chr06,Bn26161,68207300,80053971,11846671,CN
chr06,Bn26162,17063145,72583128,55519983,CN
chr06,Bn26163,36853887,99486562,62632675,RLK
chr06,Bn26164,68701130,70412271,1711141,RLP
chr06,Bn26165,66702439,89005852,22303413,RLP
chr06,Bn26166,76330693,97352250,21021557,CNL
chr06,Bn26167,33558588,53839433,20280845,CNL
chr06,Bn26168,83751044,99005548,15254504,TNL
chr06,Bn26169,44471669,52362126,7890457,CN
chr06,Bn26170,62679714,84196786,21517072,CN
chr06,Bn26171,59214593,77044509,17829916,RLK
chr06,Bn26172,82482420,94548556,12066136,CN
chr06,Bn26173,92988823,95556484,2567661,TNL
chr06,Bn26174,24963932,75679545,50715613,TNL
chr06,Bn26175,34505490,80760383,46254893,RLK
chr06,Bn26176,92116790,94603811,2487021,RLK
chr06,Bn26177,54344890,85681710,31336820,CNL
chr06,Bn26178,95794202,96417216,623014,RLP
chr06,Bn26179,88408069,98395019,9986950,CNL
chr06,Bn26180,29839083,36447593,6608510,CN
chr06,Bn26181,77918942,93669481,15750539,TN
chr06,Bn26182,82910685,84119640,1208955,NBS
chr06,Bn26183,76334643,89544245,13209602,RLP
chr06,Bn26184,64028214,77701289,13673075,RLK
chr06,Bn26185,19062660,38251005,19188345,CN
chr06,Bn26186,35796740,62920288,27123548,CN
chr06,Bn26187,92595572,96682629,4087057,NBS
chr06,Bn26188,20710231,44275869,23565638,CNL
chr06,Bn26189,13343739,71887671,58543932,RLP
chr06,Bn26190,15049210,35363708,20314498,TN
chr06,Bn26191,30757006,95431128,64674122,RLK
chr06,Bn26192,91154998,93567671,2412673,CN
chr06,Bn26193,39470569,90741735,51271166,CNL
chr06,Bn26194,34040418,77112415,43071997,CN
chr06,Bn26195,94035822,96966123,2930301,CNL
chr06,Bn26196,60366891,78550469,18183578,NBS
chr06,Bn26197,87721770,93727523,6005753,CNL
chr06,Bn26198,50855372,99167669,48312297,CNL
chr06,Bn26199,37197097,52699236,15502139,NBS
chr06,Bn26200,92373292,94983241,2609949,RLP
chr06,Bn26201,40333256,49192938,8859682,NBS
chr06,Bn26202,74696559,83467604,8771045,TN
chr06,Bn26203,77618586,85138840,7520254,RLP
chr06,Bn26204,90956525,97788036,6831511,TNL
chr06,Bn26205,34678939,94278139,59599200,NBS
chr06,Bn26206,24645529,77225105,52579576,NBS
chr06,Bn26207,49139012,74149891,25010879,TN
chr06,Bn26208,18972622,43110117,24137495,TNL
chr06,Bn26209,42182351,84485943,42303592,TNL
chr06,Bn26210,62382524,84637746,22255222,TN
chr06,Bn26211,29913957,79498423,49584466,NBS
chr06,Bn26212,81794603,94078352,12283749,TNL
chr06,Bn26213,35480274,36344031,863757,NBS
chr06,Bn26214,64374041,84812551,20438510,RLK
chr06,Bn26215,10132648,83460715,73328067,NBS
chr06,Bn26216,57612452,94757281,37144829,NBS
chr06,Bn26217,17753736,33551850,15798114,RLK
chr06,Bn26218,94557227,96987397,2430170,CN
chr06,Bn26219,93365846,96514268,3148422,RLP
chr06,Bn26220,10786312,39658918,28872606,CN
chr06,Bn26221,80937911,86284661,5346750,RLK
chr06,Bn26222,18526587,41665449,23138862,RLK
chr06,Bn26223,78357977,98068211,19710234,RLK
chr06,Bn26224,75371014,86058503,10687489,TNL
chr06,Bn26225,28324856,68955533,40630677,TNL
chr06,Bn26226,73806934,90680164,16873230,CNL
chr06,Bn26227,69418668,93578452,24159784,TN
chr06,Bn26228,61293264,62057706,764442,CN
chr06,Bn26229,50143196,87385915,37242719,RLP
chr06,Bn26230,41227506,57855509,16628003,CN
chr06,Bn26231,80602629,96621874,16019245,RLP
chr06,Bn26232,57766205,91375146,33608941,NBS
chr06,Bn26233,89133499,90486668,1353169,RLP
chr06,Bn26234,96354626,97225173,870547,TN
chr06,Bn26235,22745695,40369326,17623631,RLP
chr06,Bn26236,54931915,97728653,42796738,RLP
chr06,Bn26237,12196712,41625298,29428586,TN
chr06,Bn26238,87741109,94418063,6676954,NBS
chr06,Bn26239,5439733,89212563,83772830,CNL
chr06,Bn26240,88852331,97751549,8899218,CNL
chr06,Bn26241,31426007,57049092,25623085,TN
chr06,Bn26242,48870853,92782665,43911812,TN
chr06,Bn26243,47880813,55910883,8030070,RLP
chr06,Bn26244,88201334,90142914,1941580,TN
chr06,Bn26245,18541421,71226347,52684926,RLP
chr06,Bn26246,22573230,95569780,72996550,RLP
chr06,Bn26247,20751265,51503402,30752137,CN
chr06,Bn26248,49004946,95955274,46950328,CN
chr06,Bn26249,65926255,85196486,19270231,TN
chr06,Bn26250,34170105,77920512,43750407,RLK
chr06,Bn26251,18832964,64422987,45590023,TN
chr06,Bn26252,39783061,86938418,47155357,CNL
chr06,Bn26253,17842072,96297173,78455101,TN
chr06,Bn26254,66497385,79536451,13039066,RLP
chr06,Bn26255,15024954,30816856,15791902,NBS
chr06,Bn26256,56938526,60124501,3185975,CN
chr06,Bn26257,19594884,61161246,41566362,TNL
chr06,Bn26258,26949473,92085620,65136147,CNL
chr06,Bn26259,12469733,48815592,36345859,TN
chr06,Bn26260,8665200,26798250,18133050,RLP
chr06,Bn26261,95136514,99093923,3957409,RLP
chr06,Bn26262,76156565,80543988,4387423,NBS
chr06,Bn26263,43970133,62324116,18353983,RLP
chr06,Bn26264,2340870,29482267,27141397,CNL
chr06,Bn26265,31296970,87909218,56612248,RLP
chr06,Bn26266,72861888,86136885,13274997,CNL
chr06,Bn26267,45521413,70944791,25423378,TN
chr06,Bn26268,50150853,66545646,16394793,TN
chr06,Bn26269,75854053,89030650,13176597,TN
chr06,Bn26270,47804166,74236372,26432206,TNL
chr06,Bn26271,73084171,83806915,10722744,CNL
chr06,Bn26272,46711664,68947243,22235579,CNL
chr06,Bn26273,96089728,96185184,95456,CNL
chr06,Bn26274,88239773,93901891,5662118,RLP
chr06,Bn26275,40572972,51596707,11023735,CN
chr06,Bn26276,86173195,88481439,2308244,NBS
chr06,Bn26277,84183615,94090180,9906565,TNL
chr06,Bn26278,81028096,82673829,1645733,RLK
chr06,Bn26279,27821899,99788920,71967021,NBS
chr06,Bn26280,9396380,35934538,26538158,CN
chr06,Bn26281,80597158,97080699,16483541,CNL
chr06,Bn26282,97784229,98956596,1172367,RLK
chr06,Bn26283,87274435,94980405,7705970,TN
chr06,Bn26284,11972657,91110508,79137851,RLK
chr06,Bn26285,56753308,89069547,32316239,NBS
chr06,Bn26286,76237060,89676225,13439165,NBS
chr06,Bn26287,43967615,75231005,31263390,NBS
chr06,Bn26288,84990071,90122281,5132210,CN
chr06,Bn26289,49024846,82760334,33735488,RLK
chr06,Bn26290,17044235,33040949,15996714,RLP
chr06,Bn26291,13897098,58541636,44644538,RLK
chr06,Bn26292,86976284,92054291,5078007,CNL
chr06,Bn26293,27433134,64424248,36991114,TNL
chr06,Bn26294,2138439,41438000,39299561,CN
chr06,Bn26295,7625954,60741198,53115244,RLK
chr06,Bn26296,42345959,88211742,45865783,CNL
chr06,Bn26297,70361795,81520568,11158773,NBS
chr06,Bn26298,78179593,95421734,17242141,RLP
chr06,Bn26299,60269505,72200184,11930679,CNL
chr06,Bn26300,47432512,67434713,20002201,NBS
chr06,Bn26301,55678739,92911487,37232748,RLP
chr06,Bn26302,45064081,77443464,32379383,RLK
chr06,Bn26303,82905957,96480338,13574381,TN
chr06,Bn26304,50178176,82119917,31941741,CN
chr06,Bn26305,80554949,91400282,10845333,CN
chr06,Bn26306,34641692,36836492,2194800,RLP
chr06,Bn26307,19759891,88695764,68935873,CN
chr06,Bn26308,74217183,85177696,10960513,TN
chr06,Bn26309,64861408,73472569,8611161,RLK
chr06,Bn26310,1442053,1615286,173233,RLP
chr06,Bn26311,31194502,57410034,26215532,RLK
chr06,Bn26312,97390968,97577861,186893,TNL
chr06,Bn26313,96847214,98609704,1762490,TN
chr06,Bn26314,62602168,68662658,6060490,TN
chr06,Bn26315,94242892,98872829,4629937,RLP
chr06,Bn26316,97789269,99625485,1836216,CN
chr06,Bn26317,93071767,95212297,2140530,TNL
chr06,Bn26318,21057134,55133112,34075978,RLP
chr06,Bn26319,48433052,69017192,20584140,CN
chr06,Bn26320,66340756,83729779,17389023,RLK
chr06,Bn26321,25779256,86671662,60892406,CN
chr06,Bn26322,42894932,89035833,46140901,TN
chr06,Bn26323,77225681,78176295,950614,CNL
chr06,Bn26324,3841308,18989851,15148543,TNL
chr06,Bn26325,41191820,86833958,45642138,TNL
chr06,Bn26326,98131121,99604012,1472891,TN
chr06,Bn26327,56409206,85133114,28723908,NBS
chr06,Bn26328,2264856,53097927,50833071,CNL
chr06,Bn26329,73253563,82351617,9098054,NBS
chr06,Bn26330,55990037,92936228,36946191,NBS
chr06,Bn26331,3588547,58786351,55197804,TN
chr06,Bn26332,54996117,70883258,15887141,TN
chr06,Bn26333,67287037,71716475,4429438,TN
chr06,Bn26334,55288179,98967352,43679173,TN
chr06,Bn26335,58250408,85091800,26841392,RLP
chr06,Bn26336,40933997,43200556,2266559,RLP
chr06,Bn26337,82560977,87081297,4520320,CNL
chr06,Bn26338,10380378,89868331,79487953,RLK
chr06,Bn26339,80743067,87727905,6984838,CN
chr06,Bn26340,28614099,57537198,28923099,RLP
chr06,Bn26341,18848266,72092871,53244605,CNL
chr06,Bn26342,46831425,55259483,8428058,NBS
chr06,Bn26343,83343370,91792803,8449433,RLP
chr06,Bn26344,63691196,80319499,16628303,CNL
chr06,Bn26345,44771232,88864583,44093351,TN
chr06,Bn26346,3782268,28723801,24941533,TNL
chr06,Bn26347,7707162,83889613,76182451,TNL
chr06,Bn26348,75744280,80025450,4281170,CN
chr06,Bn26349,48702739,57340998,8638259,CNL
chr06,Bn26350,89316626,99475091,10158465,RLK
chr06,Bn26351,8014928,48042088,40027160,TNL
chr06,Bn26352,32165303,80512612,48347309,TN
chr06,Bn26353,80200562,85216397,5015835,TNL
chr06,Bn26354,81398290,96339611,14941321,TNL
chr06,Bn26355,51817625,98415745,46598120,RLP
chr06,Bn26356,45036582,90889657,45853075,RLK
chr06,Bn26357,68496329,90977568,22481239,RLP
chr06,Bn26358,25310325,69348379,44038054,TNL
chr06,Bn26359,55301800,93054443,37752643,RLK
chr06,Bn26360,91754709,92469447,714738,RLK
chr06,Bn26361,38002865,75786041,37783176,RLK
chr06,Bn26362,95436059,95635952,199893,RLK
chr06,Bn26363,97005337,98155368,1150031,TN
chr06,Bn26364,87190749,88030772,840023,CNL
chr06,Bn26365,32548151,45263201,12715050,TN
chr06,Bn26366,11544804,35373323,23828519,TN
chr06,Bn26367,58093414,73119482,15026068,CNL
chr06,Bn26368,62834892,72638900,9804008,CNL
chr06,Bn26369,55003732,86148108,31144376,CNL
chr06,Bn26370,77092882,84808366,7715484,CN
chr06,Bn26371,56502681,79361974,22859293,TNL
chr06,Bn26372,15501862,25177000,9675138,CN
chr06,Bn26373,99950787,99982354,31567,RLP
chr06,Bn26374,69820507,98995914,29175407,CN
chr06,Bn26375,77263653,80583188,3319535,RLP
chr06,Bn26376,1313364,7460228,6146864,TN
chr06,Bn26377,74224561,77979465,3754904,RLK
chr06,Bn26378,50541726,89829829,39288103,CNL
chr06,Bn26379,86435314,95621020,9185706,CNL
chr06,Bn26380,96219461,97807654,1588193,CN
chr06,Bn26381,71133722,77075470,5941748,TN
chr06,Bn26382,70240411,82237497,11997086,CN
chr06,Bn26383,54571016,81522270,26951254,RLK
chr06,Bn26384,17979179,77687287,59708108,CNL
chr06,Bn26385,77887963,99899310,22011347,RLP
chr06,Bn26386,45952633,59759416,13806783,TN
chr06,Bn26387,82436775,94762383,12325608,TNL
chr06,Bn26388,94924115,99020876,4096761,RLP
chr06,Bn26389,41189864,52367647,11177783,CNL
chr06,Bn26390,55011547,91342005,36330458,TN
chr06,Bn26391,72160958,79510998,7350040,CNL
chr06,Bn26392,96309259,98902227,2592968,CNL
chr06,Bn26393,56519444,70631871,14112427,CN
chr06,Bn26394,19981083,88598725,68617642,CN
chr06,Bn26395,12272693,82673359,70400666,TN
chr06,Bn26396,55820006,97132510,41312504,NBS
chr06,Bn26397,47366516,53191349,5824833,NBS
chr06,Bn26398,24187781,78779082,54591301,CN
chr06,Bn26399,90920020,97778688,6858668,CNL
chr06,Bn26400,40792574,84497772,43705198,RLK
chr06,Bn26401,21246988,55850526,34603538,CNL
chr06,Bn26402,22579937,63789068,41209131,CNL
chr06,Bn26403,9450041,70156607,60706566,RLK
chr06,Bn26404,23834293,84838297,61004004,TN
chr06,Bn26405,72585790,96551378,23965588,CNL
chr06,Bn26406,36499926,79213086,42713160,NBS
chr06,Bn26407,98195703,99595191,1399488,CNL
chr06,Bn26408,24518159,29003368,4485209,CNL
chr06,Bn26409,97411415,99946936,2535521,NBS
chr06,Bn26410,76652241,82028360,5376119,TNL
chr06,Bn26411,45585146,96533908,50948762,NBS
chr06,Bn26412,56460276,89898710,33438434,TNL
chr06,Bn26413,76359128,81763828,5404700,RLP
chr06,Bn26414,70071081,77141189,7070108,NBS
chr06,Bn26415,53503047,92866935,39363888,TN
chr06,Bn26416,80577702,85844023,5266321,RLK
chr06,Bn26417,46989793,52174797,5185004,CNL
chr06,Bn26418,53928664,84661343,30732679,RLP
chr06,Bn26419,50415884,88761623,38345739,RLP
chr06,Bn26420,53004251,72243378,19239127,RLK
chr06,Bn26421,16342569,36562241,20219672,RLP
chr06,Bn26422,32600613,63122158,30521545,TN
chr06,Bn26423,46930933,54801784,7870851,CNL
chr06,Bn26424,33584942,80294964,46710022,RLP
chr06,Bn26425,43500819,86417806,42916987,TN
chr06,Bn26426,88406169,88415761,9592,TNL
chr06,Bn26427,58057964,91039655,32981691,RLP
chr06,Bn26428,76894931,94904022,18009091,CNL
chr06,Bn26429,85356116,97782973,12426857,CNL
chr06,Bn26430,91297883,98044240,6746357,RLK
chr06,Bn26431,19516177,81783500,62267323,RLK
chr06,Bn26432,37261086,60490758,23229672,CN
chr06,Bn26433,95063252,97243634,2180382,RLP
chr06,Bn26434,24392406,65734376,41341970,CN
chr06,Bn26435,31917948,94184383,62266435,RLK
chr06,Bn26436,55413978,61164130,5750152,TNL
chr06,Bn26437,38532304,44690737,6158433,NBS
chr06,Bn26438,97163268,99989767,2826499,CNL
chr06,Bn26439,48905722,58165252,9259530,RLP
chr06,Bn26440,27376108,85062913,57686805,TN
chr06,Bn26441,55601226,60304686,4703460,TNL
chr06,Bn26442,19807716,95352936,75545220,TNL
chr06,Bn26443,36631938,47534834,10902896,NBS
chr06,Bn26444,69571710,86080585,16508875,CNL
chr06,Bn26445,30060272,84361975,54301703,TNL
chr06,Bn26446,65770407,69950688,4180281,CN
chr06,Bn26447,4604480,25500494,20896014,TN
chr06,Bn26448,21036086,32980459,11944373,RLP
chr06,Bn26449,35259741,79200618,43940877,CNL
chr06,Bn26450,71369877,88286678,16916801,TN
chr06,Bn26451,21161042,76807337,55646295,CN
chr06,Bn26452,96961893,96984671,22778,TNL
chr06,Bn26453,76685180,99262357,22577177,CN
chr06,Bn26454,34131215,85181567,51050352,NBS
chr06,Bn26455,25241407,95796355,70554948,RLK
chr06,Bn26456,63495291,89736074,26240783,NBS
chr06,Bn26457,74390285,96390409,22000124,CN
chr06,Bn26458,54187518,81990885,27803367,TN
chr06,Bn26459,94120534,95833510,1712976,RLP
chr06,Bn26460,95309626,95417140,107514,RLP
chr06,Bn26461,32997528,66624239,33626711,TNL
chr06,Bn26462,47618466,73585978,25967512,RLP
chr06,Bn26463,26560980,94174002,67613022,RLK
chr06,Bn26464,6806662,60962338,54155676,RLP
chr06,Bn26465,6810774,28393780,21583006,CNL
chr06,Bn26466,25457317,54894157,29436840,RLP
chr06,Bn26467,61698430,63199478,1501048,NBS
chr06,Bn26468,39256509,76037404,36780895,CNL
chr06,Bn26469,64524656,95033205,30508549,NBS
chr06,Bn26470,78112588,82743405,4630817,RLK
chr06,Bn26471,28673586,57029293,28355707,CNL
chr06,Bn26472,32220787,80158008,47937221,NBS
chr06,Bn26473,64744511,89724802,24980291,CN
chr06,Bn26474,28859495,55330847,26471352,RLK
chr06,Bn26475,67772090,77091243,9319153,CN
chr06,Bn26476,47179029,76320052,29141023,TNL
chr06,Bn26477,77186293,82310288,5123995,RLP
chr06,Bn26478,74837973,89449717,14611744,TN
chr06,Bn26479,71860274,75429467,3569193,RLP
chr06,Bn26480,82745798,86338221,3592423,RLK
chr06,Bn26481,92212912,96085907,3872995,NBS
chr06,Bn26482,12828608,85622861,72794253,CNL
chr06,Bn26483,43520024,57813744,14293720,TN
chr06,Bn26484,49222348,65266325,16043977,RLK
chr06,Bn26485,99871395,99996031,124636,CN
chr06,Bn26486,37106657,46943615,9836958,NBS
chr06,Bn26487,69260887,98398433,29137546,CNL
chr06,Bn26488,72727889,92216464,19488575,TNL
chr06,Bn26489,30274927,60807526,30532599,TN
chr06,Bn26490,60170882,97210728,37039846,RLP
chr06,Bn26491,47651849,92809760,45157911,RLP
chr06,Bn26492,14091944,83227450,69135506,NBS
chr06,Bn26493,80749502,99860582,19111080,RLK
chr06,Bn26494,9478224,33582910,24104686,CN
chr06,Bn26495,4867876,47560734,42692858,CNL
chr06,Bn26496,89375040,91298128,1923088,RLK
chr06,Bn26497,66670356,77820140,11149784,CNL
chr06,Bn26498,6236254,41773012,35536758,NBS
chr06,Bn26499,33357029,50206666,16849637,CNL
chr06,Bn26500,71461282,97197267,25735985,NBS
chr06,Bn26501,84574660,96777507,12202847,CN
chr06,Bn26502,37566135,59050160,21484025,CN
chr06,Bn26503,5057178,15703140,10645962,CN
chr06,Bn26504,10353428,18613707,8260279,TN
chr06,Bn26505,76258872,78619949,2361077,RLK
chr06,Bn26506,60056312,80761178,20704866,CN
chr06,Bn26507,53798553,93373389,39574836,TN
chr06,Bn26508,88574716,94485330,5910614,RLK
chr06,Bn26509,75918262,86561211,10642949,TNL
chr06,Bn26510,90458145,99458811,9000666,TNL
chr06,Bn26511,92415065,96002049,3586984,CN
chr06,Bn26512,13741715,21930525,8188810,TNL
chr06,Bn26513,99854500,99870306,15806,RLK
chr06,Bn26514,46735395,54175881,7440486,TNL
chr06,Bn26515,3637710,60355205,56717495,NBS
chr06,Bn26516,96717769,98395937,1678168,NBS
chr06,Bn26517,77870942,79447272,1576330,CN
chr06,Bn26518,66099348,92009380,25910032,TN
chr06,Bn26519,6406603,39660774,33254171,RLP
chr06,Bn26520,54314340,68436366,14122026,TN
chr06,Bn26521,56946713,75711952,18765239,CN
chr06,Bn26522,59490728,66029069,6538341,CN
chr06,Bn26523,4062382,12043134,7980752,NBS
chr06,Bn26524,7956434,95762617,87806183,TN
chr06,Bn26525,94690587,97754206,3063619,RLP
chr06,Bn26526,53047817,88446971,35399154,TN
chr06,Bn26527,67994000,82164420,14170420,NBS
chr06,Bn26528,53140944,80663080,27522136,RLP
chr06,Bn26529,39540305,75606294,36065989,RLP
chr06,Bn26530,33317109,83412167,50095058,NBS
chr06,Bn26531,36799667,56206430,19406763,RLK
chr06,Bn26532,36129226,90388229,54259003,CNL
chr06,Bn26533,73586493,91373110,17786617,CN
chr06,Bn26534,26707661,38414358,11706697,CNL
chr06,Bn26535,85858129,88210460,2352331,CNL
chr06,Bn26536,15841500,93748572,77907072,TN
chr06,Bn26537,91452240,99428322,7976082,TNL
chr06,Bn26538,53157682,72093148,18935466,TNL
chr06,Bn26539,36672561,70296737,33624176,CNL
chr06,Bn26540,60708075,84191762,23483687,RLP
chr06,Bn26541,69170459,88166419,18995960,CN
chr06,Bn26542,81951675,91901909,9950234,RLK
chr06,Bn26543,82304435,88975838,6671403,CN
chr06,Bn26544,74400304,87469968,13069664,NBS
chr06,Bn26545,8526818,79915379,71388561,TN
chr06,Bn26546,75104808,99927168,24822360,NBS
chr06,Bn26547,25319197,35119840,9800643,NBS
chr06,Bn26548,41538399,94598896,53060497,CNL
chr06,Bn26549,71710623,83467014,11756391,CN
chr06,Bn26550,66958717,75511788,8553071,RLP
chr06,Bn26551,88257039,88549515,292476,CN
chr06,Bn26552,18798668,61852852,43054184,TNL
chr06,Bn26553,82148709,94443781,12295072,CNL
chr06,Bn26554,22067100,62099785,40032685,RLP
chr06,Bn26555,41672303,88430946,46758643,TN
chr06,Bn26556,23941765,53116572,29174807,TN
chr06,Bn26557,72523196,92904564,20381368,CNL
chr06,Bn26558,85368347,99348879,13980532,RLP
chr06,Bn26559,1626295,75766397,74140102,TNL
chr06,Bn26560,50366012,96969098,46603086,CNL
chr06,Bn26561,23045488,68897109,45851621,CNL
chr06,Bn26562,6931985,82721949,75789964,NBS
chr06,Bn26563,3461100,69250131,65789031,RLK
chr06,Bn26564,14625899,75283399,60657500,RLP
chr06,Bn26565,90449446,93904309,3454863,TN
chr06,Bn26566,52650803,96031337,43380534,TNL
chr06,Bn26567,40699241,66190823,25491582,NBS
chr06,Bn26568,44033280,91291465,47258185,NBS
chr06,Bn26569,84336593,92963856,8627263,TNL
chr06,Bn26570,20147614,21276683,1129069,RLP
chr06,Bn26571,17916845,54587366,36670521,TN
chr06,Bn26572,52550452,86966096,34415644,RLP
chr06,Bn26573,98832108,99547391,715283,NBS
chr06,Bn26574,74650189,92310859,17660670,CN
chr06,Bn26575,88668060,91931869,3263809,CNL
chr06,Bn26576,46784277,64474153,17689876,CN
chr06,Bn26577,47828442,95488810,47660368,RLP
chr06,Bn26578,96146044,96770795,624751,RLP
chr06,Bn26579,93523109,98924320,5401211,CN
chr06,Bn26580,30044545,97738743,67694198,TNL
chr06,Bn26581,76261639,91927187,15665548,CNL
chr06,Bn26582,42567316,83822164,41254848,RLP
chr06,Bn26583,68361335,78136454,9775119,NBS
chr06,Bn26584,43084065,76634404,33550339,CNL
chr06,Bn26585,57435516,58027275,591759,TN
chr06,Bn26586,91742433,92691794,949361,RLK
chr06,Bn26587,13783679,89898097,76114418,RLK
chr06,Bn26588,91069761,96249192,5179431,CNL
chr06,Bn26589,88690819,90487918,1797099,TNL
chr06,Bn26590,77377184,82665359,5288175,RLP
chr06,Bn26591,51448298,66484689,15036391,CN
chr06,Bn26592,33303700,38334151,5030451,TNL
chr06,Bn26593,11052013,88281801,77229788,RLK
chr06,Bn26594,72096889,77303776,5206887,TNL
chr06,Bn26595,57877982,95474271,37596289,RLP
chr06,Bn26596,2405661,13234117,10828456,NBS
chr06,Bn26597,1444104,13661961,12217857,NBS
chr06,Bn26598,1474192,19838935,18364743,CN
chr06,Bn26599,87063882,93277997,6214115,CNL
chr06,Bn26600,44527311,56077469,11550158,TN
chr06,Bn26601,97349829,99540730,2190901,TNL
chr06,Bn26602,32678858,98449345,65770487,CN
chr06,Bn26603,2286539,21222260,18935721,CNL
chr06,Bn26604,18731228,25478754,6747526,CNL
chr06,Bn26605,56618203,88402032,31783829,CN
chr06,Bn26606,81309592,97282411,15972819,RLK
chr06,Bn26607,78380879,94697926,16317047,RLP
chr06,Bn26608,82188121,92119343,9931222,NBS
chr06,Bn26609,9831854,75546954,65715100,RLK
chr06,Bn26610,97905089,99020811,1115722,RLP
chr06,Bn26611,45114699,86989266,41874567,NBS
chr06,Bn26612,12294296,20833349,8539053,TN
chr06,Bn26613,4888654,96676129,91787475,CNL
chr06,Bn26614,26099854,91614938,65515084,RLK
chr06,Bn26615,81009710,93719727,12710017,CN
chr06,Bn26616,29117207,64677791,35560584,RLK
chr06,Bn26617,57325560,98440639,41115079,RLP
chr06,Bn26618,58882711,95478748,36596037,RLP
chr06,Bn26619,13833898,79725546,65891648,CN
chr06,Bn26620,28897297,91692980,62795683,RLP
chr06,Bn26621,33097838,89777403,56679565,CN
chr06,Bn26622,28311118,70033790,41722672,TN
chr06,Bn26623,42956153,76879707,33923554,RLK
chr06,Bn26624,5766723,70943889,65177166,TN
chr06,Bn26625,83158755,94347228,11188473,RLK
chr06,Bn26626,9870548,33606976,23736428,CN
chr06,Bn26627,92616577,93974646,1358069,CN
chr06,Bn26628,17304074,40485289,23181215,TN
chr06,Bn26629,44256130,84699873,40443743,RLP
chr06,Bn26630,42087180,61255924,19168744,TN
chr06,Bn26631,78491838,79818880,1327042,RLK
chr06,Bn26632,5088786,36009274,30920488,CN
chr06,Bn26633,10271905,12547482,2275577,RLK
chr06,Bn26634,15236560,28935955,13699395,RLP
chr06,Bn26635,31746150,83556139,51809989,CN
chr06,Bn26636,98550867,99566888,1016021,RLP
chr06,Bn26637,30026022,72367012,42340990,CNL
chr06,Bn26638,61222449,91549996,30327547,NBS
chr06,Bn26639,46293120,78282722,31989602,TNL
chr06,Bn26640,60481478,82057803,21576325,RLK
chr06,Bn26641,70735428,74098681,3363253,CN
chr06,Bn26642,63379325,98276331,34897006,RLP
chr06,Bn26643,47893430,51284422,3390992,CN
chr06,Bn26644,58092070,94867656,36775586,NBS
chr06,Bn26645,18383492,53587367,35203875,TN
chr06,Bn26646,41436803,49326975,7890172,TNL
chr06,Bn26647,16839662,82722017,65882355,RLK
chr06,Bn26648,99564986,99719166,154180,TNL
chr06,Bn26649,95137923,97769292,2631369,TN
chr06,Bn26650,27346692,90465952,63119260,RLP
chr06,Bn26651,92299267,93915867,1616600,CNL
chr06,Bn26652,9775266,54675753,44900487,TNL
chr06,Bn26653,84222234,92666105,8443871,NBS
chr06,Bn26654,38674606,89102863,50428257,CN
chr06,Bn26655,68242152,77948289,9706137,RLK
chr06,Bn26656,82782767,93317945,10535178,TNL
chr06,Bn26657,70206911,84616655,14409744,RLK
chr06,Bn26658,19328270,35174630,15846360,TN
chr06,Bn26659,87804082,94160383,6356301,TN
chr06,Bn26660,93683558,95149496,1465938,CNL
chr06,Bn26661,78097564,98680639,20583075,CNL
chr06,Bn26662,31801629,88802518,57000889,CN
chr06,Bn26663,75822950,97944545,22121595,TNL
chr06,Bn26664,88524927,99033064,10508137,CNL
chr06,Bn26665,62300501,78391061,16090560,CN
chr06,Bn26666,76630483,81577914,4947431,TNL
chr06,Bn26667,10931441,40998318,30066877,RLK
chr06,Bn26668,18771474,71699260,52927786,CN
chr06,Bn26669,68659148,83101867,14442719,RLK
chr06,Bn26670,99404984,99794531,389547,RLP
chr06,Bn26671,30040588,34381742,4341154,TNL
chr06,Bn26672,45956084,55459498,9503414,TN
chr06,Bn26673,83784638,88788910,5004272,RLP
chr06,Bn26674,51266612,52081557,814945,CN
chr06,Bn26675,34845854,46550445,11704591,RLP
chr06,Bn26676,62289880,99031136,36741256,RLP
chr06,Bn26677,45299445,46264088,964643,NBS
chr06,Bn26678,25495282,99642058,74146776,CNL
chr06,Bn26679,98257734,99834686,1576952,RLP
chr06,Bn26680,37852627,63872221,26019594,NBS
chr06,Bn26681,37088143,83430704,46342561,CN
chr06,Bn26682,4879207,66683325,61804118,RLP
chr06,Bn26683,31436176,61520939,30084763,RLP
chr06,Bn26684,43835028,55156081,11321053,NBS
chr06,Bn26685,43074437,82685095,39610658,TN
chr06,Bn26686,74856025,96020407,21164382,TNL
chr06,Bn26687,70627716,97913874,27286158,TN
chr06,Bn26688,2990410,15364934,12374524,TN
chr06,Bn26689,12414214,98525603,86111389,RLK
chr06,Bn26690,55517770,69000005,13482235,CN
chr06,Bn26691,26518212,34411373,7893161,CNL
chr06,Bn26692,72791912,74330951,1539039,NBS
chr06,Bn26693,10385281,50499734,40114453,RLP
chr06,Bn26694,67466393,72243937,4777544,TN
chr06,Bn26695,55664766,92316901,36652135,NBS
chr06,Bn26696,69196245,97632517,28436272,CNL
chr06,Bn26697,51740814,81761602,30020788,CNL
chr06,Bn26698,15519804,67774513,52254709,CNL
chr06,Bn26699,10574888,55153881,44578993,TN
chr06,Bn26700,72292275,75477429,3185154,TNL
chr06,Bn26701,14027369,53017570,38990201,TN
chr06,Bn26702,45926445,58311013,12384568,NBS
chr06,Bn26703,80859882,85718886,4859004,NBS
chr06,Bn26704,29955303,32396843,2441540,TN
chr06,Bn26705,10569811,93087481,82517670,TN
chr06,Bn26706,42238623,96882779,54644156,RLP
chr06,Bn26707,53769253,81614451,27845198,RLK
chr06,Bn26708,70599227,95584661,24985434,TNL
chr06,Bn26709,56695305,68939476,12244171,TNL
chr06,Bn26710,43501978,81853326,38351348,TNL
chr06,Bn26711,56735137,97071193,40336056,CN
chr06,Bn26712,39063354,80360300,41296946,CNL
chr06,Bn26713,29676892,53216641,23539749,CNL
chr06,Bn26714,10869901,37706412,26836511,TNL
chr06,Bn26715,45243485,65714050,20470565,TNL
chr06,Bn26716,30087096,80638654,50551558,TNL
chr06,Bn26717,56907338,83165243,26257905,CNL
chr06,Bn26718,3097411,94297329,91199918,CNL
chr06,Bn26719,96792205,97883612,1091407,TNL
chr06,Bn26720,62277025,89331474,27054449,RLP
chr06,Bn26721,40537083,79078591,38541508,RLK
chr06,Bn26722,10285196,67466518,57181322,NBS
chr06,Bn26723,66672521,75647205,8974684,NBS
chr06,Bn26724,4707446,47137807,42430361,CNL
chr06,Bn26725,22170484,56803022,34632538,TNL
chr06,Bn26726,48999983,77425952,28425969,RLK
chr06,Bn26727,69121519,91387517,22265998,TNL
chr06,Bn26728,59687449,64149114,4461665,CNL
chr06,Bn26729,53641099,90071684,36430585,RLK
chr06,Bn26730,12405630,92855677,80450047,RLK
chr06,Bn26731,32418121,96235227,63817106,CNL
chr06,Bn26732,7697861,29586978,21889117,RLK
chr06,Bn26733,86398173,90073848,3675675,NBS
chr06,Bn26734,85971819,95222633,9250814,CNL
chr06,Bn26735,7448199,49934761,42486562,CN
chr06,Bn26736,31506349,80464070,48957721,TN
chr06,Bn26737,12722134,21354833,8632699,TN
chr06,Bn26738,87319349,92836450,5517101,CNL
chr06,Bn26739,35388601,99676486,64287885,NBS
chr06,Bn26740,68944539,76415045,7470506,RLK
chr06,Bn26741,62116794,98871281,36754487,TN
chr06,Bn26742,46509340,78073360,31564020,RLK
chr06,Bn26743,47828463,90291476,42463013,CNL
chr06,Bn26744,13334338,59166097,45831759,NBS
chr06,Bn26745,70105023,75311437,5206414,CNL
chr06,Bn26746,1631812,48296894,46665082,TN
chr06,Bn26747,93423550,96959492,3535942,CNL
chr06,Bn26748,97505469,98265990,760521,RLK
chr06,Bn26749,20364151,94816814,74452663,RLP
chr06,Bn26750,93571491,95654219,2082728,RLP
chr06,Bn26751,42336684,89694600,47357916,TN
chr06,Bn26752,13646859,14750957,1104098,NBS
chr06,Bn26753,80190957,80871124,680167,CN
chr06,Bn26754,88162871,90108681,1945810,CNL
chr06,Bn26755,94488027,97863059,3375032,CN
chr06,Bn26756,48723996,77066741,28342745,NBS
chr06,Bn26757,3218181,11170675,7952494,CN
chr06,Bn26758,27000385,37394920,10394535,RLP
chr06,Bn26759,47358958,79170221,31811263,TN
chr06,Bn26760,70923534,89335588,18412054,CNL
chr06,Bn26761,69975816,89869359,19893543,TN
chr06,Bn26762,64750530,92615477,27864947,CN
chr06,Bn26763,85798454,86494916,696462,TN
chr06,Bn26764,41009085,92181575,51172490,RLP
chr06,Bn26765,26791049,57757385,30966336,TNL
chr06,Bn26766,87762720,92337876,4575156,TN
chr06,Bn26767,54454036,55163191,709155,TN
chr06,Bn26768,27921132,57512012,29590880,TN
chr06,Bn26769,80755162,95436005,14680843,CNL
chr06,Bn26770,12004273,27577508,15573235,CN
chr06,Bn26771,17046487,20294612,3248125,CN
chr06,Bn26772,21394784,55686430,34291646,CN
chr06,Bn26773,31576739,43792086,12215347,TN
chr06,Bn26774,24067149,94624311,70557162,NBS
chr06,Bn26775,10863454,86720228,75856774,TN
chr06,Bn26776,48344584,50779903,2435319,TN
chr06,Bn26777,66853100,99982522,33129422,RLK
chr06,Bn26778,93027547,99895452,6867905,TNL
chr06,Bn26779,45755413,61948726,16193313,TNL
chr06,Bn26780,18749253,22786943,4037690,TN
chr06,Bn26781,19093377,88386488,69293111,TN
chr06,Bn26782,62418748,81764619,19345871,NBS
chr06,Bn26783,91830771,92596601,765830,CNL
chr06,Bn26784,32538634,83571066,51032432,RLK
chr06,Bn26785,62002559,93448932,31446373,TN
chr06,Bn26786,10296698,58797284,48500586,TN
chr06,Bn26787,39324216,41364678,2040462,TN
chr06,Bn26788,83788700,99106396,15317696,TNL
chr06,Bn26789,55487808,68729244,13241436,CNL
chr06,Bn26790,75297027,94595675,19298648,CN
chr06,Bn26791,44870996,87407961,42536965,RLP
chr06,Bn26792,54380851,64147208,9766357,RLP
chr06,Bn26793,74088488,86117296,12028808,CNL
chr06,Bn26794,8604980,66311917,57706937,TNL
chr06,Bn26795,30110934,52483459,22372525,CN
chr06,Bn26796,72722499,80950963,8228464,TNL
chr06,Bn26797,80145293,98980137,18834844,RLK
chr06,Bn26798,2056432,33417409,31360977,TN
chr06,Bn26799,40877729,89496756,48619027,CNL
chr06,Bn26800,75192361,88737653,13545292,RLP
chr06,Bn26801,45307247,88930179,43622932,NBS
chr06,Bn26802,38114282,62563578,24449296,TNL
chr06,Bn26803,85285965,95926860,10640895,NBS
chr06,Bn26804,1643723,16716846,15073123,TNL
chr06,Bn26805,25639457,77035895,51396438,CN
chr06,Bn26806,90776240,94701161,3924921,RLP
chr06,Bn26807,17158548,79168478,62009930,NBS
chr06,Bn26808,67597213,68351603,754390,TNL
chr06,Bn26809,77665499,81430279,3764780,NBS
chr06,Bn26810,18929528,53470385,34540857,CNL
chr06,Bn26811,34815168,42072339,7257171,CNL
chr06,Bn26812,15524112,23345944,7821832,NBS
chr06,Bn26813,75227350,79985258,4757908,RLK
chr06,Bn26814,38116541,90905568,52789027,TN
chr06,Bn26815,47427317,58277949,10850632,RLK
chr06,Bn26816,9493474,95149689,85656215,TN
chr06,Bn26817,44195271,49657920,5462649,NBS
chr06,Bn26818,84223771,89949103,5725332,TN
chr06,Bn26819,76495234,99336677,22841443,CN
chr06,Bn26820,80252638,91644260,11391622,TN
chr06,Bn26821,92557343,98062368,5505025,CN
chr06,Bn26822,42067580,77593495,35525915,NBS
chr06,Bn26823,47932994,59113613,11180619,TN
chr06,Bn26824,69637714,73340149,3702435,CN
chr06,Bn26825,74010185,89289046,15278861,TNL
chr06,Bn26826,39538967,66144309,26605342,CN
chr06,Bn26827,70674593,70684431,9838,NBS
chr06,Bn26828,66696057,68984145,2288088,CN
chr06,Bn26829,74792223,90302089,15509866,CNL
chr06,Bn26830,61163528,91363289,30199761,NBS
chr06,Bn26831,41045958,80500250,39454292,RLP
chr06,Bn26832,74960981,92634921,17673940,TNL
chr06,Bn26833,43769779,69181211,25411432,NBS
chr06,Bn26834,64540257,68612438,4072181,CNL
chr06,Bn26835,94155066,96442446,2287380,RLK
chr06,Bn26836,9580903,41741811,32160908,TN
chr06,Bn26837,40356531,47389066,7032535,TN
chr06,Bn26838,38057493,82068955,44011462,NBS
chr06,Bn26839,3202911,99472988,96270077,TNL
chr06,Bn26840,74753033,96994633,22241600,TNL
chr06,Bn26841,42730271,56961280,14231009,CNL
chr06,Bn26842,90757013,94211395,3454382,RLK
chr06,Bn26843,36278542,86501771,50223229,CN
chr06,Bn26844,74226918,91908634,17681716,CNL
chr06,Bn26845,91381126,96588462,5207336,RLK
chr06,Bn26846,77933945,91385294,13451349,RLP
chr06,Bn26847,57362094,64381802,7019708,RLP
chr06,Bn26848,7771757,24784580,17012823,NBS
chr06,Bn26849,98127570,98689621,562051,TN
chr06,Bn26850,59396881,74242984,14846103,RLP
chr06,Bn26851,39740260,57917918,18177658,NBS
chr06,Bn26852,28178898,37585186,9406288,CN
chr06,Bn26853,89478251,90294298,816047,CNL
chr06,Bn26854,32042670,67388318,35345648,RLP
chr06,Bn26855,12840039,92007452,79167413,RLK
chr06,Bn26856,47917864,76610560,28692696,TNL
chr06,Bn26857,39855454,72407306,32551852,RLK
chr06,Bn26858,76189857,85456006,9266149,RLK
chr06,Bn26859,16389533,41696299,25306766,NBS
chr06,Bn26860,40293124,57572814,17279690,NBS
chr06,Bn26861,63755143,90190714,26435571,RLP
chr06,Bn26862,18035271,76249944,58214673,RLP
chr06,Bn26863,47358128,50060718,2702590,TN
chr06,Bn26864,26741268,53609605,26868337,CN
chr06,Bn26865,15297948,62880517,47582569,TN
chr06,Bn26866,92514477,93002888,488411,TNL
chr06,Bn26867,68778427,79294091,10515664,RLP
chr06,Bn26868,31008973,77701679,46692706,CNL
chr06,Bn26869,50496096,59597487,9101391,RLK
chr06,Bn26870,58090465,97536709,39446244,RLP
chr06,Bn26871,2089289,22859369,20770080,TNL
chr06,Bn26872,94721366,96357165,1635799,RLK
chr06,Bn26873,29926201,75916859,45990658,CN
chr06,Bn26874,94736533,95231536,495003,NBS
chr06,Bn26875,54190583,90365481,36174898,CNL
chr06,Bn26876,27309783,43195808,15886025,CNL
chr06,Bn26877,7551929,74589664,67037735,CN
chr06,Bn26878,37758834,41164803,3405969,TNL
chr06,Bn26879,50461056,73525806,23064750,CNL
chr06,Bn26880,67093880,74527237,7433357,RLP
chr06,Bn26881,37967321,42399543,4432222,RLK
chr06,Bn26882,16446944,77385369,60938425,CN
chr06,Bn26883,79651869,99263813,19611944,CN
chr06,Bn26884,92114104,98983718,6869614,TNL
chr06,Bn26885,48448895,71937659,23488764,TN
chr06,Bn26886,21904773,84748786,62844013,NBS
chr06,Bn26887,28838928,33203189,4364261,RLK
chr06,Bn26888,97422548,99188350,1765802,NBS
chr06,Bn26889,67401496,86971683,19570187,TNL
chr06,Bn26890,45209374,81497687,36288313,RLP
chr06,Bn26891,83411422,98430857,15019435,RLP
chr06,Bn26892,72387509,82655480,10267971,RLP
chr06,Bn26893,45437618,84233286,38795668,RLK
chr06,Bn26894,72398539,90295101,17896562,TNL
chr06,Bn26895,82763819,95351340,12587521,TN
chr06,Bn26896,39690029,93244996,53554967,CN
chr06,Bn26897,6562478,94413154,87850676,NBS
chr06,Bn26898,11266758,30324314,19057556,CNL
chr06,Bn26899,53280372,83312810,30032438,CNL
chr06,Bn26900,22068201,45593499,23525298,CN
chr06,Bn26901,32449275,83745022,51295747,CN
chr06,Bn26902,1120284,68829843,67709559,CN
chr06,Bn26903,90699281,99330832,8631551,RLP
chr06,Bn26904,16324574,77069859,60745285,TNL
chr06,Bn26905,73779937,77043343,3263406,NBS
chr06,Bn26906,85359661,88106721,2747060,NBS
chr06,Bn26907,12751905,48482153,35730248,TNL
chr06,Bn26908,30323854,85475593,55151739,CNL
chr06,Bn26909,63803585,78285425,14481840,CNL
chr06,Bn26910,6554691,75282925,68728234,TNL
chr06,Bn26911,31773615,77510977,45737362,CNL
chr06,Bn26912,33569856,36902061,3332205,RLP
chr06,Bn26913,87388777,96835988,9447211,RLP
chr06,Bn26914,26634088,78626477,51992389,RLK
chr06,Bn26915,27379985,41917155,14537170,TN
chr06,Bn26916,93459391,97455609,3996218,TN
chr06,Bn26917,58030350,91164112,33133762,CNL
chr06,Bn26918,50799309,62462288,11662979,RLP
chr06,Bn26919,3309940,79120127,75810187,TN
chr06,Bn26920,41542037,49381472,7839435,RLP
chr06,Bn26921,60227416,89586105,29358689,CN
chr06,Bn26922,35914625,63099741,27185116,CNL
chr06,Bn26923,89092440,95024917,5932477,RLP
chr06,Bn26924,35816264,52159513,16343249,TN
chr06,Bn26925,67585757,76337095,8751338,RLK
chr06,Bn26926,70070852,70538218,467366,TNL
chr06,Bn26927,21286523,48482532,27196009,RLP
chr06,Bn26928,5952928,34085940,28133012,RLK
chr06,Bn26929,90728527,97456970,6728443,RLP
chr06,Bn26930,5170069,61276234,56106165,RLP
chr06,Bn26931,88256187,99325049,11068862,TN
chr06,Bn26932,81632137,87944706,6312569,CNL
chr06,Bn26933,1992960,62636421,60643461,RLP
chr06,Bn26934,38251409,86248286,47996877,TNL
chr06,Bn26935,26101389,67417013,41315624,RLK
chr06,Bn26936,86593797,87724362,1130565,CNL
chr06,Bn26937,20862865,21712603,849738,RLP
chr06,Bn26938,11158034,47038601,35880567,NBS
chr06,Bn26939,93639258,98055073,4415815,NBS
chr06,Bn26940,45501491,70295515,24794024,TN
chr06,Bn26941,35095894,77604180,42508286,CN
chr06,Bn26942,28466227,41271627,12805400,RLP
chr06,Bn26943,84000007,88083438,4083431,CNL
chr06,Bn26944,31790807,68514420,36723613,CN
chr06,Bn26945,74896989,90310951,15413962,RLK
chr06,Bn26946,33484991,61476541,27991550,TN
chr06,Bn26947,60069132,74950369,14881237,TN
chr06,Bn26948,79118006,88417081,9299075,TN
chr06,Bn26949,87348312,95283954,7935642,RLP
chr06,Bn26950,82744181,90614762,7870581,CNL
chr06,Bn26951,33702032,43926455,10224423,RLP
chr06,Bn26952,23045498,45968680,22923182,TN
chr06,Bn26953,5554805,46981927,41427122,TNL
chr06,Bn26954,89463312,99473273,10009961,TN
chr06,Bn26955,50794250,94455521,43661271,RLP
chr06,Bn26956,18802786,93053329,74250543,TNL
chr06,Bn26957,91463680,93580907,2117227,RLK
chr06,Bn26958,52314020,66540977,14226957,RLK
chr06,Bn26959,17953924,55714275,37760351,NBS
chr06,Bn26960,32037273,85223978,53186705,CN
chr06,Bn26961,59672991,93717075,34044084,TNL
chr06,Bn26962,68925857,82600241,13674384,TN
chr06,Bn26963,14853112,49030923,34177811,CNL
chr06,Bn26964,52888537,98209780,45321243,TNL
chr06,Bn26965,82996885,89876462,6879577,NBS
chr06,Bn26966,67947374,89101137,21153763,CNL
chr06,Bn26967,24068609,89929843,65861234,RLP
chr06,Bn26968,30193226,84812661,54619435,TNL
chr06,Bn26969,66997883,98812056,31814173,TNL
chr06,Bn26970,74746104,89473609,14727505,RLK
chr06,Bn26971,59716443,76324338,16607895,TNL
chr06,Bn26972,18210999,97894385,79683386,TN
chr06,Bn26973,52444302,68683536,16239234,TN
chr06,Bn26974,35941343,87421217,51479874,RLK
chr06,Bn26975,51396455,87513087,36116632,RLK
chr06,Bn26976,29331831,95225613,65893782,CN
chr06,Bn26977,94294194,96815015,2520821,TNL
chr06,Bn26978,54190001,67104360,12914359,RLK
chr06,Bn26979,65604658,68176269,2571611,CNL
chr06,Bn26980,22454773,79390411,56935638,NBS
chr06,Bn26981,96770870,98745108,1974238,TNL
chr06,Bn26982,24752944,63950926,39197982,RLP
chr06,Bn26983,38538292,98640454,60102162,CNL
chr06,Bn26984,81537728,99672854,18135126,RLP
chr06,Bn26985,93872221,94749398,877177,CNL
chr06,Bn26986,19150118,55562428,36412310,RLP
chr06,Bn26987,45260810,56988544,11727734,NBS
chr06,Bn26988,53333140,73460364,20127224,CNL
chr06,Bn26989,24593583,63009053,38415470,RLK
chr06,Bn26990,27606657,84088223,56481566,CN
chr06,Bn26991,47822319,85213540,37391221,NBS
chr06,Bn26992,77960731,95518125,17557394,TNL
chr06,Bn26993,33194093,34233928,1039835,TNL
chr06,Bn26994,48574143,64437857,15863714,CN
chr06,Bn26995,23076881,38837752,15760871,RLP
chr06,Bn26996,95427018,99741658,4314640,TNL
chr06,Bn26997,70128204,78790867,8662663,CN
chr06,Bn26998,73590981,74408131,817150,RLP
chr06,Bn26999,27080590,86565033,59484443,TNL
chr06,Bn27000,52087165,59194648,7107483,RLP
chr06,Bn27001,78218865,84942186,6723321,TNL
chr06,Bn27002,29021311,95578947,66557636,TN
chr06,Bn27003,12535077,55335144,42800067,TNL
chr06,Bn27004,40229958,94655751,54425793,RLP
chr06,Bn27005,6333071,45754876,39421805,RLK
chr06,Bn27006,33371188,99092285,65721097,TNL
chr06,Bn27007,61883563,62344807,461244,RLP
chr06,Bn27008,10734803,92008423,81273620,CN
chr06,Bn27009,31798027,32683675,885648,CN
chr06,Bn27010,97665773,98370506,704733,TN
chr06,Bn27011,5469309,67577206,62107897,CN
chr06,Bn27012,16447024,62400470,45953446,TN
chr06,Bn27013,92167283,97863826,5696543,CNL
chr06,Bn27014,13344052,63953171,50609119,TN
chr06,Bn27015,35230396,62540163,27309767,CN
chr06,Bn27016,58374161,74821504,16447343,TN
chr06,Bn27017,14805334,69165050,54359716,CN
chr06,Bn27018,2708880,42693618,39984738,NBS
chr06,Bn27019,61623995,97476104,35852109,RLK
chr06,Bn27020,73353921,81184205,7830284,CN
chr06,Bn27021,97030394,98767209,1736815,CN
chr06,Bn27022,26443937,62628437,36184500,RLP
chr06,Bn27023,14836926,45790204,30953278,NBS
chr06,Bn27024,97732592,98899788,1167196,RLP
chr06,Bn27025,17663073,83683940,66020867,CN
chr06,Bn27026,71491456,73005880,1514424,CNL
chr06,Bn27027,56807653,67248300,10440647,CNL
chr06,Bn27028,19860291,23307227,3446936,TN
chr06,Bn27029,53232607,73251972,20019365,RLK
chr06,Bn27030,93778841,97222147,3443306,RLP
chr06,Bn27031,93944168,98113598,4169430,NBS
chr06,Bn27032,42488348,57988498,15500150,CNL
chr06,Bn27033,5641036,49232012,43590976,TNL
chr06,Bn27034,95839501,99141717,3302216,RLK
chr06,Bn27035,28724682,71333533,42608851,CN
chr06,Bn27036,21480383,56137977,34657594,RLK
chr06,Bn27037,73580724,91771347,18190623,NBS
chr06,Bn27038,88836337,98576368,9740031,RLK
chr06,Bn27039,69681811,75441495,5759684,TNL
chr06,Bn27040,5406934,49170889,43763955,TNL
chr06,Bn27041,15890810,68813530,52922720,TNL
chr06,Bn27042,15816795,40078178,24261383,RLK
chr06,Bn27043,60546153,68940232,8394079,CN
chr06,Bn27044,56451749,99804842,43353093,CNL
chr06,Bn27045,14949725,86025089,71075364,TN
chr06,Bn27046,80100540,93766530,13665990,TNL
chr06,Bn27047,86893403,87637181,743778,RLK
chr06,Bn27048,18382370,61532644,43150274,CNL
chr06,Bn27049,24388890,77024823,52635933,TNL
chr06,Bn27050,97149250,99051642,1902392,TNL
chr06,Bn27051,1223753,88850301,87626548,CNL
chr06,Bn27052,21903738,36783171,14879433,TNL
chr06,Bn27053,24478754,51626189,27147435,CN
chr06,Bn27054,62171249,63727631,1556382,RLP
chr06,Bn27055,74057562,76001478,1943916,TN
chr06,Bn27056,19106325,81022956,61916631,RLP
chr06,Bn27057,17584078,31611187,14027109,RLK
chr06,Bn27058,45627556,54165980,8538424,NBS
chr06,Bn27059,80567527,81247644,680117,RLK
chr06,Bn27060,34238627,58911614,24672987,CN
chr06,Bn27061,4170791,42164302,37993511,CNL
chr06,Bn27062,98890675,99884631,993956,TN
chr06,Bn27063,23987246,85293716,61306470,CN
chr06,Bn27064,97739419,98898601,1159182,RLP
chr06,Bn27065,18645260,29618113,10972853,CN
chr06,Bn27066,15088107,45452041,30363934,TN
chr06,Bn27067,41219464,92111790,50892326,RLK
chr06,Bn27068,85178413,98850914,13672501,CNL
chr06,Bn27069,63689165,90197378,26508213,RLP
chr06,Bn27070,19017923,37806923,18789000,NBS
chr06,Bn27071,52006971,90910437,38903466,RLP
chr06,Bn27072,47149488,47553352,403864,CN
chr06,Bn27073,20795022,54604566,33809544,RLP
chr06,Bn27074,69610571,85156799,15546228,RLK
chr06,Bn27075,84162114,98699981,14537867,CNL
chr06,Bn27076,84587752,86159125,1571373,RLK
chr06,Bn27077,47409909,88501930,41092021,TN
chr06,Bn27078,29794719,80801642,51006923,NBS
chr06,Bn27079,1383700,57677792,56294092,CNL
chr06,Bn27080,8718530,56395495,47676965,TNL
chr06,Bn27081,82155568,96435992,14280424,RLP
chr06,Bn27082,71991435,75829040,3837605,TN
chr06,Bn27083,53404844,84229388,30824544,TN
chr06,Bn27084,93602053,94679492,1077439,NBS
chr06,Bn27085,90380356,95972542,5592186,RLK
chr06,Bn27086,35315174,64697889,29382715,TN
chr06,Bn27087,53974645,96405487,42430842,CN
chr06,Bn27088,18011110,93139447,75128337,CNL
chr06,Bn27089,74950279,87630458,12680179,NBS
chr06,Bn27090,4497525,57317232,52819707,TN
chr06,Bn27091,95572661,99384816,3812155,RLP
chr06,Bn27092,19016117,91879959,72863842,RLK
chr06,Bn27093,28143607,43794155,15650548,TN
chr06,Bn27094,56229323,80826683,24597360,NBS
chr06,Bn27095,61277832,80643568,19365736,RLP
chr06,Bn27096,44932525,93317102,48384577,TNL
chr06,Bn27097,17898144,46076453,28178309,RLP
chr06,Bn27098,88917322,91958150,3040828,RLK
chr06,Bn27099,84312967,86187574,1874607,CN
chr06,Bn27100,23854921,74066168,50211247,NBS
chr06,Bn27101,57391465,65061025,7669560,RLP
chr06,Bn27102,49419992,95058743,45638751,CNL
chr06,Bn27103,11460253,47784380,36324127,CN
chr06,Bn27104,98771215,99230203,458988,RLP
chr06,Bn27105,14057120,91232421,77175301,TNL
chr06,Bn27106,95403731,99516753,4113022,RLP
chr06,Bn27107,55035823,82117764,27081941,CNL
chr06,Bn27108,11027933,47091916,36063983,CN
chr06,Bn27109,1144012,46494081,45350069,TNL
chr06,Bn27110,77640311,96047153,18406842,RLP
chr06,Bn27111,9207610,82197717,72990107,NBS
chr06,Bn27112,65322632,99841869,34519237,RLP
chr06,Bn27113,58945134,66020352,7075218,TN
chr06,Bn27114,95232559,99480752,4248193,TNL
chr06,Bn27115,97966986,99790410,1823424,RLP
chr06,Bn27116,80861935,82730484,1868549,TN
chr06,Bn27117,45096002,94544387,49448385,TN
chr06,Bn27118,92503644,99993384,7489740,CN
chr06,Bn27119,84446563,91960875,7514312,RLK
chr06,Bn27120,23334042,26891733,3557691,NBS
chr06,Bn27121,64845615,79906791,15061176,CN
chr06,Bn27122,91483792,91707557,223765,RLP
chr06,Bn27123,45902906,80481924,34579018,CNL
chr06,Bn27124,23609466,41511229,17901763,CN
chr06,Bn27125,43177821,90268095,47090274,CN
chr06,Bn27126,6496349,73531648,67035299,TNL
chr06,Bn27127,83134264,93078670,9944406,TNL
chr06,Bn27128,37234666,68200494,30965828,RLK
chr06,Bn27129,93733507,98193284,4459777,CNL
chr06,Bn27130,66926686,80914187,13987501,CN
chr06,Bn27131,99458300,99731462,273162,CN
chr06,Bn27132,86451250,89516270,3065020,NBS
chr06,Bn27133,6403200,28495131,22091931,TNL
chr06,Bn27134,59269013,75881210,16612197,RLP
chr06,Bn27135,91798251,92315192,516941,TNL
chr06,Bn27136,69680775,75626800,5946025,CN
chr06,Bn27137,5710152,22964350,17254198,CNL
chr06,Bn27138,66837015,73233165,6396150,TNL
chr06,Bn27139,98682672,98746994,64322,CNL
chr06,Bn27140,32045094,42671104,10626010,RLP
chr06,Bn27141,46677469,98266938,51589469,RLK
chr06,Bn27142,45716436,70840883,25124447,CN
chr06,Bn27143,18143933,56878899,38734966,CN
chr06,Bn27144,80661672,87645359,6983687,CN
chr06,Bn27145,29490961,95770869,66279908,TN
chr06,Bn27146,90003018,95742986,5739968,CN
chr06,Bn27147,1573477,23731480,22158003,CN
chr06,Bn27148,9474602,86540425,77065823,RLP
chr06,Bn27149,42276797,54659548,12382751,RLP
chr06,Bn27150,44671316,66477972,21806656,TN
chr06,Bn27151,81772312,91202698,9430386,RLK
chr06,Bn27152,34742208,44439226,9697018,CN
chr06,Bn27153,34991498,66705592,31714094,RLK
chr06,Bn27154,49364554,83828693,34464139,TN
chr06,Bn27155,20374529,24266144,3891615,CN
chr06,Bn27156,19300230,19395716,95486,TN
chr06,Bn27157,86217965,93542013,7324048,NBS
chr06,Bn27158,84847900,99021366,14173466,TNL
chr06,Bn27159,94686542,96584743,1898201,TNL
chr06,Bn27160,59504298,71056901,11552603,NBS
chr06,Bn27161,41679239,99954239,58275000,CN
chr06,Bn27162,96573504,98314401,1740897,TN
chr06,Bn27163,29956480,60995409,31038929,CN
chr06,Bn27164,63250041,68918291,5668250,RLK
chr06,Bn27165,62691737,78126101,15434364,CNL
chr06,Bn27166,93643765,94165229,521464,NBS
chr06,Bn27167,34588384,66664184,32075800,CNL
chr06,Bn27168,55520407,92670674,37150267,TNL
chr06,Bn27169,56288585,74827924,18539339,CN
chr06,Bn27170,5184822,46909073,41724251,CN
chr06,Bn27171,74528094,78253586,3725492,TNL
chr06,Bn27172,99145240,99490914,345674,CN
chr06,Bn27173,18233127,64966051,46732924,TN
chr06,Bn27174,67702858,72859275,5156417,TNL
chr06,Bn27175,4317862,45058224,40740362,TN
chr06,Bn27176,10579796,37361279,26781483,TNL
chr06,Bn27177,38299773,78732522,40432749,TN
chr06,Bn27178,36204106,63743677,27539571,RLP
chr06,Bn27179,65596235,97529229,31932994,RLP
chr06,Bn27180,3109117,97379923,94270806,RLP
chr06,Bn27181,9813867,90669789,80855922,NBS
chr06,Bn27182,39428930,69537713,30108783,CNL
chr06,Bn27183,94190365,98356308,4165943,NBS
chr06,Bn27184,21105591,76319461,55213870,RLP
chr06,Bn27185,85596676,85763304,166628,CN
chr06,Bn27186,43082398,73010468,29928070,TNL
chr06,Bn27187,95562757,97571006,2008249,CNL
chr06,Bn27188,93174233,96036101,2861868,NBS
chr06,Bn27189,90985687,95914804,4929117,TNL
chr06,Bn27190,80520884,87484448,6963564,NBS
chr06,Bn27191,6344606,18923671,12579065,NBS
chr06,Bn27192,83948505,91558917,7610412,RLP
chr06,Bn27193,98807943,99312867,504924,TN
chr06,Bn27194,20182075,34988420,14806345,TNL
chr06,Bn27195,97271915,98398175,1126260,RLP
chr06,Bn27196,74026227,78055270,4029043,RLK
chr06,Bn27197,83695108,98219537,14524429,RLP
chr06,Bn27198,93206084,95569716,2363632,CNL
chr06,Bn27199,64290336,92131172,27840836,CNL
chr06,Bn27200,26177447,89258551,63081104,RLP
chr06,Bn27201,64901007,76651562,11750555,TNL
chr06,Bn27202,17877031,76514174,58637143,TNL
chr06,Bn27203,26125464,86533667,60408203,RLP
chr06,Bn27204,52755053,95374446,42619393,TNL
chr06,Bn27205,25036713,37726045,12689332,NBS
chr06,Bn27206,24984144,60984864,36000720,CN
chr06,Bn27207,10222071,13867287,3645216,CNL
chr06,Bn27208,52292498,57457783,5165285,CNL
chr06,Bn27209,65360318,90890794,25530476,NBS
chr06,Bn27210,48713594,64353304,15639710,NBS
chr06,Bn27211,94398590,97799091,3400501,CN
chr06,Bn27212,27030805,97960523,70929718,NBS
chr06,Bn27213,51917456,71782097,19864641,CN
chr06,Bn27214,59589501,66760314,7170813,NBS
chr06,Bn27215,88628814,92043977,3415163,CN
chr06,Bn27216,4425279,40866248,36440969,NBS
chr06,Bn27217,86371151,90969873,4598722,NBS
chr06,Bn27218,56744182,95908888,39164706,TNL
chr06,Bn27219,10640679,88054348,77413669,TN
chr06,Bn27220,50641606,79102046,28460440,TN
chr06,Bn27221,29288855,60049701,30760846,TN
chr06,Bn27222,74742946,90598556,15855610,CN
chr06,Bn27223,20825607,82745865,61920258,CNL
chr06,Bn27224,79659763,85200043,5540280,TNL
chr06,Bn27225,41463830,89812162,48348332,NBS
chr06,Bn27226,38498617,67062880,28564263,CN
chr06,Bn27227,46347299,60870393,14523094,TN
chr06,Bn27228,2157436,51936206,49778770,CNL
chr06,Bn27229,58676618,61369423,2692805,TN
chr06,Bn27230,17486635,30249324,12762689,TN
chr06,Bn27231,38766133,38955327,189194,TN
chr06,Bn27232,38631477,79671023,41039546,CN
chr06,Bn27233,75568941,96423696,20854755,TNL
chr06,Bn27234,37028131,40727865,3699734,RLK
chr06,Bn27235,69332232,79900403,10568171,TN
chr06,Bn27236,86265510,90428339,4162829,TNL
chr06,Bn27237,69348059,87610236,18262177,CN
chr06,Bn27238,97034661,98631832,1597171,CNL
chr06,Bn27239,44323931,63216158,18892227,CNL
chr06,Bn27240,95701942,98713006,3011064,RLP
chr06,Bn27241,7458341,27456819,19998478,CNL
chr06,Bn27242,31216660,71218011,40001351,RLP
chr06,Bn27243,42407480,82633474,40225994,RLP
chr06,Bn27244,74954498,95380106,20425608,CN
chr06,Bn27245,58108335,96581596,38473261,NBS
chr06,Bn27246,77139148,96935252,19796104,CN
chr06,Bn27247,14979061,94357041,79377980,TNL
chr06,Bn27248,42843690,51068066,8224376,CNL
chr06,Bn27249,92994692,96962710,3968018,TNL
chr06,Bn27250,18400576,63399848,44999272,NBS
chr06,Bn27251,40135367,94168612,54033245,TN
chr06,Bn27252,20252948,49407999,29155051,RLK
chr06,Bn27253,19886169,76157407,56271238,CNL
chr06,Bn27254,12411525,96744047,84332522,TNL
chr06,Bn27255,65110087,74036887,8926800,CNL
chr06,Bn27256,85299978,94866850,9566872,RLP
chr06,Bn27257,32702490,40460852,7758362,CNL
chr06,Bn27258,30784252,68951667,38167415,RLP
chr06,Bn27259,42671089,65989531,23318442,RLK
chr06,Bn27260,82662661,95823658,13160997,TN
chr06,Bn27261,24701260,86663267,61962007,TN
chr06,Bn27262,66209151,93717744,27508593,TNL
chr06,Bn27263,37263233,54063965,16800732,CNL
chr06,Bn27264,89411762,99955365,10543603,RLP
chr06,Bn27265,38644352,77427927,38783575,RLK
chr06,Bn27266,6970475,70484897,63514422,CN
chr06,Bn27267,99769624,99894061,124437,NBS
chr06,Bn27268,19046993,23326940,4279947,TNL
chr06,Bn27269,44840946,92086823,47245877,CNL
chr06,Bn27270,59215439,97284065,38068626,CNL
chr06,Bn27271,68785109,76701049,7915940,TNL
chr06,Bn27272,94549223,97591764,3042541,RLP
chr06,Bn27273,1590042,51281051,49691009,TNL
chr06,Bn27274,74567090,84479841,9912751,NBS
chr06,Bn27275,36672528,41406229,4733701,TNL
chr06,Bn27276,81585449,94889939,13304490,TNL
chr06,Bn27277,9120823,55070084,45949261,RLK
chr06,Bn27278,15840482,76252109,60411627,RLK
chr06,Bn27279,56468805,58774833,2306028,CN
chr06,Bn27280,15599046,59154728,43555682,RLP
chr06,Bn27281,95384816,96510776,1125960,RLK
chr06,Bn27282,8546984,62763728,54216744,CN
chr06,Bn27283,92948763,98579778,5631015,TNL
chr06,Bn27284,81896559,97958719,16062160,CN
chr06,Bn27285,32750691,52323787,19573096,TN
chr06,Bn27286,76691362,77348819,657457,NBS
chr06,Bn27287,72609703,89964716,17355013,TNL
chr06,Bn27288,57837589,69479423,11641834,NBS
chr06,Bn27289,28219087,29099110,880023,TNL
chr06,Bn27290,28618383,82957298,54338915,CNL
chr06,Bn27291,67549731,86863502,19313771,TNL
chr06,Bn27292,17903059,84164468,66261409,RLK
chr06,Bn27293,6810650,48288208,41477558,CN
chr06,Bn27294,43682573,64288498,20605925,CNL
chr06,Bn27295,55584071,86056637,30472566,TN
chr06,Bn27296,29533015,64266157,34733142,RLK
chr06,Bn27297,30225831,74453075,44227244,CNL
chr06,Bn27298,16645395,36331058,19685663,NBS
chr06,Bn27299,62165418,65974698,3809280,TN
chr06,Bn27300,16435140,71118336,54683196,TNL
chr06,Bn27301,73393929,73414685,20756,NBS
chr06,Bn27302,54570973,63995818,9424845,RLK
chr06,Bn27303,9435607,54556875,45121268,CNL
chr06,Bn27304,89508287,96579194,7070907,RLP
chr06,Bn27305,33546087,33972590,426503,RLK
chr06,Bn27306,13158441,77040459,63882018,TNL
chr06,Bn27307,21153828,49594581,28440753,NBS
chr06,Bn27308,27717722,54511529,26793807,CN
chr06,Bn27309,78942965,96253464,17310499,CN
chr06,Bn27310,12902038,37811627,24909589,RLP
chr06,Bn27311,39962143,99705844,59743701,NBS
chr06,Bn27312,56762239,57032048,269809,RLP
chr06,Bn27313,76707644,97520470,20812826,NBS
chr06,Bn27314,45145794,52356175,7210381,RLP
chr06,Bn27315,94952324,97492631,2540307,TNL
chr06,Bn27316,30026446,72705785,42679339,TNL
chr06,Bn27317,83062475,98182032,15119557,RLK
chr06,Bn27318,97162578,97582260,419682,TN
chr06,Bn27319,78640324,99150642,20510318,RLP
chr06,Bn27320,33960988,62112942,28151954,TNL
chr06,Bn27321,52939415,56256503,3317088,RLK
chr06,Bn27322,57756084,66272694,8516610,CNL
chr06,Bn27323,33571009,61029358,27458349,NBS
chr06,Bn27324,20363956,67432875,47068919,RLK
chr06,Bn27325,5980655,96289068,90308413,CNL
chr06,Bn27326,74211703,89573659,15361956,CN
chr06,Bn27327,63532816,69594234,6061418,TN
chr06,Bn27328,57486642,64121710,6635068,CNL
chr06,Bn27329,79419865,90871660,11451795,NBS
chr06,Bn27330,14249757,38957612,24707855,CN
chr06,Bn27331,23086084,96703961,73617877,RLP
chr06,Bn27332,52248165,90007089,37758924,RLP
chr06,Bn27333,93672624,95688588,2015964,CNL
chr06,Bn27334,60872583,63321026,2448443,CNL
chr06,Bn27335,76583743,88991004,12407261,CN
chr06,Bn27336,8012066,85654987,77642921,TN
chr06,Bn27337,4769671,33181710,28412039,RLP
chr06,Bn27338,82007744,92085706,10077962,CN
chr06,Bn27339,36852627,95871220,59018593,RLK
chr06,Bn27340,30146476,97378754,67232278,NBS
chr06,Bn27341,97566147,97719809,153662,TNL
chr06,Bn27342,31205998,78276388,47070390,RLP
chr06,Bn27343,32014865,70325258,38310393,RLP
chr06,Bn27344,20956886,60486558,39529672,TNL
chr06,Bn27345,73630319,90718513,17088194,RLP
chr06,Bn27346,18436661,77597546,59160885,TN
chr06,Bn27347,74680463,89902327,15221864,RLK
chr06,Bn27348,97332483,99520314,2187831,CN
chr06,Bn27349,26529004,57633118,31104114,CNL
chr06,Bn27350,99954547,99996748,42201,TN
chr06,Bn27351,98269649,98434772,165123,CNL
chr06,Bn27352,97270626,99614342,2343716,TN
chr06,Bn27353,25434897,73995880,48560983,RLP
chr06,Bn27354,7885895,74159739,66273844,CN
chr06,Bn27355,83001809,87515864,4514055,TNL
chr06,Bn27356,54281197,72301879,18020682,CN
chr06,Bn27357,99993139,99997328,4189,RLP
chr06,Bn27358,78294686,90202392,11907706,CNL
chr06,Bn27359,42797856,78379627,35581771,TNL
chr06,Bn27360,20068016,99329268,79261252,TN
chr06,Bn27361,31415185,95719949,64304764,TN
chr06,Bn27362,66305564,76603093,10297529,TNL
chr06,Bn27363,52781979,82433534,29651555,CN
chr06,Bn27364,38624728,96764279,58139551,TN
chr06,Bn27365,42379292,89621116,47241824,CNL
chr06,Bn27366,6870376,31944745,25074369,RLP
chr06,Bn27367,74009020,88876510,14867490,CNL
chr06,Bn27368,48699046,74954759,26255713,CN
chr06,Bn27369,12567876,93018807,80450931,RLP
chr06,Bn27370,67327324,80119139,12791815,TNL
chr06,Bn27371,58148610,79047650,20899040,TN
chr06,Bn27372,62042047,76678035,14635988,TN
chr06,Bn27373,22939398,38867435,15928037,NBS
chr06,Bn27374,17776630,99750085,81973455,CNL
chr06,Bn27375,49239151,60003838,10764687,CNL
chr06,Bn27376,69298536,94911452,25612916,TN
chr06,Bn27377,97111407,98427826,1316419,RLK
chr06,Bn27378,98017801,99515106,1497305,RLP
chr06,Bn27379,85146758,85449612,302854,NBS
chr06,Bn27380,45070897,49130568,4059671,CNL
chr06,Bn27381,67439151,99823943,32384792,CN
chr06,Bn27382,48894078,52577096,3683018,CNL
chr06,Bn27383,68884053,98228608,29344555,CNL
chr06,Bn27384,49679671,52193774,2514103,RLK
chr06,Bn27385,68516037,83633205,15117168,RLP
chr06,Bn27386,54246159,87460675,33214516,TN
chr06,Bn27387,29869802,93603696,63733894,CNL
chr06,Bn27388,56931673,68828792,11897119,RLP
chr06,Bn27389,51261049,93790556,42529507,NBS
chr06,Bn27390,11249778,41854519,30604741,TNL
chr06,Bn27391,76363276,83914470,7551194,CNL
chr06,Bn27392,86898130,96025406,9127276,TNL
chr06,Bn27393,81821350,95517849,13696499,CN
chr06,Bn27394,72793986,86442194,13648208,TN
chr06,Bn27395,87111874,93171436,6059562,CNL
chr06,Bn27396,76173149,78956863,2783714,NBS
chr06,Bn27397,72370896,75087628,2716732,RLK
chr06,Bn27398,35612782,55062299,19449517,CN
chr06,Bn27399,3731436,55228272,51496836,TN
chr06,Bn27400,52319924,82108221,29788297,CN
chr06,Bn27401,39211744,63919851,24708107,TN
chr06,Bn27402,79415718,93702862,14287144,CN
chr06,Bn27403,2031247,66520860,64489613,TN
chr06,Bn27404,68421938,79007499,10585561,CNL
chr06,Bn27405,25507732,49236398,23728666,TN
chr06,Bn27406,53738960,59915473,6176513,RLK
chr06,Bn27407,1870454,22232745,20362291,TNL
chr06,Bn27408,80632490,86463041,5830551,TN
chr06,Bn27409,37237549,71075397,33837848,RLP
chr06,Bn27410,35904053,78250532,42346479,CN
chr06,Bn27411,94675196,96818788,2143592,CNL
chr06,Bn27412,42191436,81303086,39111650,TNL
chr06,Bn27413,29018885,51568249,22549364,TNL
chr06,Bn27414,94688217,94849636,161419,RLK
chr06,Bn27415,60722983,99321620,38598637,TN
chr06,Bn27416,8057014,22436470,14379456,CNL
chr06,Bn27417,11793293,77274549,65481256,TN
chr06,Bn27418,5999422,35679386,29679964,TN
chr06,Bn27419,44271486,53693550,9422064,CNL
chr06,Bn27420,69914270,78349685,8435415,TNL
chr06,Bn27421,99630491,99966189,335698,CN
chr06,Bn27422,44694522,99262236,54567714,NBS
chr06,Bn27423,13815594,19645839,5830245,NBS
chr06,Bn27424,92791014,96917194,4126180,CNL
chr06,Bn27425,86354783,87433195,1078412,CNL
chr06,Bn27426,60663048,73096587,12433539,CNL
chr06,Bn27427,58030592,83406537,25375945,CNL
chr06,Bn27428,64314240,92293556,27979316,TN
chr06,Bn27429,37357746,62636519,25278773,NBS
chr06,Bn27430,81927091,99614660,17687569,CN
chr06,Bn27431,95653007,95938617,285610,NBS
chr06,Bn27432,94322713,99923301,5600588,TN
chr06,Bn27433,89512097,96622568,7110471,RLP
chr06,Bn27434,11734426,51801047,40066621,RLK
chr06,Bn27435,92900246,98163605,5263359,RLK
chr06,Bn27436,58343392,68385389,10041997,CNL
chr06,Bn27437,95797708,97714507,1916799,RLK
chr06,Bn27438,98238849,99788250,1549401,CNL
chr06,Bn27439,52988160,69205787,16217627,CNL
chr06,Bn27440,4234095,79958091,75723996,TN
chr06,Bn27441,29122484,57695137,28572653,NBS
chr06,Bn27442,51035549,99736607,48701058,CNL
chr06,Bn27443,94066433,97236503,3170070,CN
chr06,Bn27444,49339915,89545333,40205418,TN
chr06,Bn27445,15001857,88517581,73515724,TN
chr06,Bn27446,25446436,70681586,45235150,RLK
chr06,Bn27447,60583411,72894810,12311399,TN
chr06,Bn27448,44240227,75739134,31498907,TNL
chr06,Bn27449,74149722,84835429,10685707,TN
chr06,Bn27450,43050952,51382698,8331746,TN
chr06,Bn27451,5951762,21732923,15781161,RLP
chr06,Bn27452,22423935,58962443,36538508,CN
chr06,Bn27453,66079385,90728229,24648844,NBS
chr06,Bn27454,16053659,79883278,63829619,TN
chr06,Bn27455,29331071,92631177,63300106,CNL
chr06,Bn27456,33803942,68157235,34353293,NBS
chr06,Bn27457,75132764,85452788,10320024,RLK
chr06,Bn27458,60407248,85863920,25456672,TN
chr06,Bn27459,91558618,94394499,2835881,CNL
chr06,Bn27460,9917057,19384392,9467335,TN
chr06,Bn27461,41786337,83255087,41468750,RLK
chr06,Bn27462,59166576,79191423,20024847,RLP
chr06,Bn27463,78743601,92301497,13557896,TNL
chr06,Bn27464,19157785,93667622,74509837,TN
chr06,Bn27465,54778093,77542516,22764423,RLP
chr06,Bn27466,59695634,92425731,32730097,NBS
chr06,Bn27467,66110208,89289709,23179501,NBS
chr06,Bn27468,66653085,83398680,16745595,RLP
chr06,Bn27469,78884366,83102031,4217665,RLK
chr06,Bn27470,86761681,98875502,12113821,CN
chr06,Bn27471,9165130,18798564,9633434,TN
chr06,Bn27472,92664917,99073239,6408322,CN
chr06,Bn27473,42339270,67111620,24772350,CN
chr06,Bn27474,43232430,69146121,25913691,TNL
chr06,Bn27475,59207723,97178988,37971265,RLK
chr06,Bn27476,8134709,38880815,30746106,RLK
chr06,Bn27477,28437511,85062113,56624602,CN
chr06,Bn27478,32542753,94156196,61613443,TN
chr06,Bn27479,46868206,99160917,52292711,RLP
chr06,Bn27480,83925544,92804856,8879312,TNL
chr06,Bn27481,47368603,95838176,48469573,RLK
chr06,Bn27482,80192260,99227915,19035655,CNL
chr06,Bn27483,88451088,94559065,6107977,TNL
chr06,Bn27484,64639675,73668264,9028589,TNL
chr06,Bn27485,46199024,83476239,37277215,TNL
chr06,Bn27486,24971024,45675587,20704563,CNL
chr06,Bn27487,75140911,85567200,10426289,TN
chr06,Bn27488,30481532,83658846,53177314,CNL
chr06,Bn27489,5152874,58471969,53319095,TNL
chr06,Bn27490,97416292,98448142,1031850,TN
chr06,Bn27491,92694254,97468068,4773814,TN
chr06,Bn27492,29550868,36939820,7388952,CNL
chr06,Bn27493,3042953,37917529,34874576,RLK
chr06,Bn27494,40323971,70503415,30179444,RLK
chr06,Bn27495,6960872,82426117,75465245,RLP
chr06,Bn27496,67004587,73635029,6630442,CNL
chr06,Bn27497,71508840,85032664,13523824,TN
chr06,Bn27498,80184794,90335243,10150449,CN
chr06,Bn27499,17017779,21452955,4435176,CNL
chr06,Bn27500,8214842,57000859,48786017,TN
chr06,Bn27501,54223416,89128901,34905485,CN
chr06,Bn27502,96966284,98196984,1230700,NBS
chr06,Bn27503,69241112,82783320,13542208,CN
chr06,Bn27504,80140857,96151290,16010433,RLP
chr06,Bn27505,4780818,94215344,89434526,TN
chr06,Bn27506,48025583,96644869,48619286,RLP
chr06,Bn27507,92308712,97638953,5330241,CN
chr06,Bn27508,43399517,88362289,44962772,CN
chr06,Bn27509,44972451,60962634,15990183,CN
chr06,Bn27510,45613536,62434433,16820897,TNL
chr06,Bn27511,61366662,64708145,3341483,NBS
chr06,Bn27512,71833943,87150806,15316863,RLP
chr06,Bn27513,42183909,63838994,21655085,TNL
chr06,Bn27514,82598393,83766950,1168557,RLP
chr06,Bn27515,72308340,97433190,25124850,RLP
chr06,Bn27516,22812446,94994047,72181601,CN
chr06,Bn27517,14233969,32634124,18400155,TN
chr06,Bn27518,74374513,86551962,12177449,CN
chr06,Bn27519,50421507,90325083,39903576,RLP
chr06,Bn27520,73781354,92635926,18854572,RLP
chr06,Bn27521,52644506,69895514,17251008,CNL
chr06,Bn27522,89781181,99240179,9458998,RLP
chr06,Bn27523,71102557,73757067,2654510,RLP
chr06,Bn27524,80794948,86461017,5666069,RLK
chr06,Bn27525,32528648,74861959,42333311,CN
chr06,Bn27526,37268834,70563647,33294813,NBS
chr06,Bn27527,99920941,99965841,44900,RLK
chr06,Bn27528,64962069,68040965,3078896,CN
chr06,Bn27529,45951084,56231177,10280093,RLK
chr06,Bn27530,91298199,92008297,710098,CN
chr06,Bn27531,48962044,72847414,23885370,CN
chr06,Bn27532,38276030,64810067,26534037,CN
chr06,Bn27533,59490842,79684974,20194132,RLP
chr06,Bn27534,29886366,68761812,38875446,RLK
chr06,Bn27535,7445926,96897444,89451518,RLK
chr06,Bn27536,63968722,69164991,5196269,NBS
chr06,Bn27537,27700767,80399845,52699078,RLK
chr06,Bn27538,45954269,90730982,44776713,CNL
chr06,Bn27539,65923382,76983618,11060236,TNL
chr06,Bn27540,7009606,86504649,79495043,CNL
chr06,Bn27541,70652488,73104116,2451628,CN
chr06,Bn27542,91086106,93877410,2791304,CN
chr06,Bn27543,46216784,96897996,50681212,TNL
chr06,Bn27544,3720704,52823521,49102817,CNL
chr06,Bn27545,7929800,18889053,10959253,RLP
chr06,Bn27546,53395322,89529837,36134515,TN
chr06,Bn27547,36229861,70950861,34721000,CN
chr06,Bn27548,2982876,18591561,15608685,CN
chr06,Bn27549,56155254,70661347,14506093,NBS
chr06,Bn27550,30129272,34483543,4354271,TNL
chr06,Bn27551,85737040,92481665,6744625,CN
chr06,Bn27552,22531779,51579404,29047625,RLP
chr06,Bn27553,25055054,64604931,39549877,NBS
chr06,Bn27554,81973975,86963768,4989793,CNL
chr06,Bn27555,63783609,97641493,33857884,CN
chr06,Bn27556,50386104,81598602,31212498,CN
chr06,Bn27557,34356689,93703793,59347104,TNL
chr06,Bn27558,27163326,55760308,28596982,RLP
chr06,Bn27559,39450779,43081764,3630985,TNL
chr06,Bn27560,46126788,91221538,45094750,RLP
chr06,Bn27561,56828086,90423222,33595136,CN
chr06,Bn27562,78106440,93136365,15029925,TNL
chr06,Bn27563,1670964,42787140,41116176,TNL
chr06,Bn27564,33440889,71913290,38472401,RLK
chr06,Bn27565,13678259,31063278,17385019,CN
chr06,Bn27566,92659518,99505653,6846135,CN
chr06,Bn27567,32122297,89294849,57172552,RLK
chr06,Bn27568,59805130,75491045,15685915,TNL
chr06,Bn27569,65116808,81735291,16618483,CN
chr06,Bn27570,35231550,92883932,57652382,TNL
chr06,Bn27571,13185524,46730049,33544525,RLP
chr06,Bn27572,51417633,54222274,2804641,CNL
chr06,Bn27573,31675710,96261155,64585445,NBS
chr06,Bn27574,99951337,99997333,45996,CNL
chr06,Bn27575,91620343,95111619,3491276,TNL
chr06,Bn27576,16472714,76171257,59698543,RLP
chr06,Bn27577,75197669,95746689,20549020,RLK
chr06,Bn27578,83416860,83554152,137292,TNL
chr06,Bn27579,34719433,44816606,10097173,RLP
chr06,Bn27580,11072677,40502319,29429642,RLK
chr06,Bn27581,72738648,74485812,1747164,RLK
chr06,Bn27582,61832813,74064340,12231527,RLK
chr06,Bn27583,59282519,91847758,32565239,TNL
chr06,Bn27584,61325854,95979899,34654045,CN
chr06,Bn27585,99838069,99849085,11016,RLK
chr06,Bn27586,24254630,67481175,43226545,NBS
chr06,Bn27587,76838048,96132027,19293979,CNL
chr06,Bn27588,95030085,96168272,1138187,CN
chr06,Bn27589,68173768,93819904,25646136,TNL
chr06,Bn27590,66899398,79635652,12736254,CN
chr06,Bn27591,87862679,90495426,2632747,CN
chr06,Bn27592,28597357,44173016,15575659,NBS
chr06,Bn27593,76856123,98259597,21403474,RLK
chr06,Bn27594,92635929,95149404,2513475,RLP
chr06,Bn27595,88223677,89281725,1058048,TNL
chr06,Bn27596,1404767,25041050,23636283,CN
chr06,Bn27597,22848476,67267686,44419210,NBS
chr06,Bn27598,56735572,75321492,18585920,NBS
chr06,Bn27599,60587158,75021779,14434621,CN
chr06,Bn27600,9399527,76762789,67363262,RLK
chr06,Bn27601,82655278,98912373,16257095,CN
chr06,Bn27602,27786188,98353107,70566919,TNL
chr06,Bn27603,92114235,97040720,4926485,TNL
chr06,Bn27604,89745317,93893256,4147939,NBS
chr06,Bn27605,13030277,38364649,25334372,TN
chr06,Bn27606,44778764,75023141,30244377,RLK
chr06,Bn27607,39249710,59689488,20439778,CN
chr06,Bn27608,42260035,89670042,47410007,CNL
chr06,Bn27609,58903362,75171600,16268238,TNL
chr06,Bn27610,12775431,27113525,14338094,TNL
chr06,Bn27611,94092540,95528582,1436042,TNL
chr06,Bn27612,39276343,56038090,16761747,RLP
chr06,Bn27613,18540480,74940122,56399642,RLK
chr06,Bn27614,61527060,85339957,23812897,RLK
chr06,Bn27615,93947320,99996037,6048717,TN
chr06,Bn27616,61793839,74430683,12636844,TNL
chr06,Bn27617,5976192,23680592,17704400,CN
chr06,Bn27618,39051403,83060899,44009496,RLP
chr06,Bn27619,19325234,32061837,12736603,NBS
chr06,Bn27620,53628800,74842212,21213412,RLP
chr06,Bn27621,89291587,90361842,1070255,TNL
chr06,Bn27622,76943764,92605246,15661482,TN
chr06,Bn27623,53351557,58279992,4928435,NBS
chr06,Bn27624,84179579,92311026,8131447,CN
chr06,Bn27625,71752784,81505739,9752955,CNL
chr06,Bn27626,73671279,96328760,22657481,CN
chr06,Bn27627,25025941,64365874,39339933,RLP
chr06,Bn27628,27425210,52501531,25076321,TNL
chr06,Bn27629,60483755,66652155,6168400,RLP
chr06,Bn27630,66308489,67445475,1136986,TNL
chr06,Bn27631,18892021,86524711,67632690,CNL
chr06,Bn27632,47431359,51649737,4218378,RLP
chr06,Bn27633,29713261,44084817,14371556,NBS
chr06,Bn27634,46438672,59958622,13519950,CNL
chr06,Bn27635,19581314,31169020,11587706,TNL
chr06,Bn27636,7804703,34794451,26989748,TNL
chr06,Bn27637,92755556,93958086,1202530,CN
chr06,Bn27638,29272164,70288006,41015842,TN
chr06,Bn27639,72514908,92995526,20480618,CNL
chr06,Bn27640,98557755,99643839,1086084,TN
chr06,Bn27641,56072584,90823770,34751186,CNL
chr06,Bn27642,11374461,48584774,37210313,TN
chr06,Bn27643,89731333,98213891,8482558,RLP
chr06,Bn27644,63749129,72659618,8910489,NBS
chr06,Bn27645,5600173,68082513,62482340,CNL
chr06,Bn27646,16795279,18103791,1308512,CNL
chr06,Bn27647,72084202,74540548,2456346,RLK
chr06,Bn27648,29318714,95993335,66674621,NBS
chr06,Bn27649,65192653,70950748,5758095,CNL
chr06,Bn27650,40154843,85986290,45831447,TN
chr06,Bn27651,69524880,83426339,13901459,TN
chr06,Bn27652,90327798,93245257,2917459,CNL
chr06,Bn27653,63776652,73909208,10132556,TN
chr06,Bn27654,31070711,54679032,23608321,CNL
chr06,Bn27655,1908698,3473878,1565180,TNL
chr06,Bn27656,98981062,99775279,794217,CN
chr06,Bn27657,9333594,84736059,75402465,RLP
chr06,Bn27658,88373667,93202631,4828964,CNL
chr06,Bn27659,31604510,32717026,1112516,RLP
chr06,Bn27660,6801587,47831768,41030181,TNL
chr06,Bn27661,39187166,71973589,32786423,TN
chr06,Bn27662,37876092,75181150,37305058,TNL
chr06,Bn27663,20275636,79461565,59185929,RLK
chr06,Bn27664,9836154,83184827,73348673,RLP
chr06,Bn27665,39188000,50418381,11230381,RLK
chr06,Bn27666,31355072,75593740,44238668,TNL
chr06,Bn27667,31355619,97526488,66170869,RLK
chr06,Bn27668,68701821,95319869,26618048,TN
chr06,Bn27669,29619600,82261185,52641585,CNL
chr06,Bn27670,77477399,87339255,9861856,CN
chr06,Bn27671,26534016,91950618,65416602,NBS
chr06,Bn27672,79456079,94373758,14917679,NBS
chr06,Bn27673,7661791,26951450,19289659,RLP
chr06,Bn27674,20654334,62657838,42003504,RLP
chr06,Bn27675,11704579,51489085,39784506,RLK
chr06,Bn27676,58662026,59059627,397601,CN
chr06,Bn27677,91868907,94770001,2901094,TN
chr06,Bn27678,99878983,99959126,80143,RLP
chr06,Bn27679,47337161,70664044,23326883,CNL
chr06,Bn27680,6328184,91644313,85316129,CN
chr06,Bn27681,75513153,91389454,15876301,TNL
chr06,Bn27682,69816842,91018031,21201189,RLP
chr06,Bn27683,88605689,91837342,3231653,CN
chr06,Bn27684,67541300,68504293,962993,TNL
chr06,Bn27685,25742898,84558480,58815582,CNL
chr06,Bn27686,49742409,92980106,43237697,RLP
chr06,Bn27687,29363802,88132125,58768323,RLK
chr06,Bn27688,80915931,83421202,2505271,CN
chr06,Bn27689,42839414,85404740,42565326,NBS
chr06,Bn27690,6082027,65893145,59811118,RLP
chr06,Bn27691,67023001,91150386,24127385,RLP
chr06,Bn27692,41595127,88307206,46712079,CNL
chr06,Bn27693,45762525,63854892,18092367,RLK
chr06,Bn27694,29710564,61927271,32216707,RLP
chr06,Bn27695,86335926,95226658,8890732,CN
chr06,Bn27696,4429365,99452956,95023591,TNL
chr06,Bn27697,39345153,51298190,11953037,NBS
chr06,Bn27698,62190638,72245467,10054829,TN
chr06,Bn27699,46115203,51247254,5132051,RLK
chr06,Bn27700,78684369,91988314,13303945,CN
chr06,Bn27701,80827468,88428818,7601350,RLP
chr06,Bn27702,29025688,29827389,801701,TNL
chr06,Bn27703,80365283,94240256,13874973,NBS
chr06,Bn27704,8739298,26481155,17741857,CN
chr06,Bn27705,32044875,41792091,9747216,NBS
chr06,Bn27706,42969461,44697767,1728306,TNL
chr06,Bn27707,84314312,97201838,12887526,NBS
chr06,Bn27708,1729747,81790529,80060782,TN
chr06,Bn27709,47654362,97325699,49671337,CNL
chr06,Bn27710,43025467,97553392,54527925,RLK
chr06,Bn27711,69995995,98578891,28582896,TNL
chr06,Bn27712,74577392,94506352,19928960,CNL
chr06,Bn27713,77964945,94999847,17034902,CNL
chr06,Bn27714,31496881,39940674,8443793,TN
chr06,Bn27715,34857876,94322833,59464957,NBS
chr06,Bn27716,43241014,60302391,17061377,RLP
chr06,Bn27717,13390748,72176957,58786209,RLP
chr06,Bn27718,21917713,55709717,33792004,TNL
chr06,Bn27719,96308438,98192345,1883907,TNL
chr06,Bn27720,29424531,78948169,49523638,RLK
chr06,Bn27721,57513881,94802179,37288298,RLK
chr06,Bn27722,85921004,89063072,3142068,CN
chr06,Bn27723,8866957,45473316,36606359,TN
chr06,Bn27724,25740604,62817390,37076786,RLK
chr06,Bn27725,12559701,39219613,26659912,CN
chr06,Bn27726,95484681,97941260,2456579,TNL
chr06,Bn27727,66994724,99414080,32419356,RLP
chr06,Bn27728,51145151,60019811,8874660,CN
chr06,Bn27729,90679781,91930016,1250235,NBS
chr06,Bn27730,70721891,70742337,20446,NBS
chr06,Bn27731,4950598,53139397,48188799,NBS
chr06,Bn27732,41650569,91408285,49757716,TN
chr06,Bn27733,24302181,70573751,46271570,RLK
chr06,Bn27734,1434546,86038300,84603754,TN
chr06,Bn27735,80159201,96574777,16415576,NBS
chr06,Bn27736,5082818,82868051,77785233,RLK
chr06,Bn27737,11266060,90261022,78994962,CNL
chr06,Bn27738,91505624,95684588,4178964,TN
chr06,Bn27739,57545857,71456919,13911062,NBS
chr06,Bn27740,42813619,57488701,14675082,CN
chr06,Bn27741,72130402,99180752,27050350,NBS
chr06,Bn27742,61938227,84040126,22101899,TN
chr06,Bn27743,42179665,57185755,15006090,NBS
chr06,Bn27744,5778551,32012350,26233799,RLK
chr06,Bn27745,24923711,52689391,27765680,CNL
chr06,Bn27746,30407872,73538612,43130740,CNL
chr06,Bn27747,34292936,67518557,33225621,TNL
chr06,Bn27748,13425692,32705906,19280214,NBS
chr06,Bn27749,64770061,86411171,21641110,NBS
chr06,Bn27750,76522549,89071609,12549060,CNL
chr06,Bn27751,16797969,19349846,2551877,TNL
chr06,Bn27752,20473910,87924028,67450118,RLK
chr06,Bn27753,19196751,97466365,78269614,CN
chr06,Bn27754,80031194,89588486,9557292,RLP
chr06,Bn27755,19272412,47651596,28379184,RLP
chr06,Bn27756,48567128,89200616,40633488,NBS
chr06,Bn27757,88630920,88782987,152067,CN
chr06,Bn27758,14935700,16814348,1878648,CNL
chr06,Bn27759,22590308,51071613,28481305,NBS
chr06,Bn27760,11929478,67573884,55644406,RLK
chr06,Bn27761,64252660,72010096,7757436,TN
chr06,Bn27762,7456338,48564048,41107710,TN
chr06,Bn27763,67086359,82649431,15563072,NBS
chr06,Bn27764,61237551,62149220,911669,RLK
chr06,Bn27765,89430489,99026082,9595593,TNL
chr06,Bn27766,78408165,98652950,20244785,TN
chr06,Bn27767,80001581,90959930,10958349,RLP
chr06,Bn27768,20549006,32294542,11745536,CN
chr06,Bn27769,99289526,99521940,232414,CNL
chr06,Bn27770,16383348,33990888,17607540,CNL
chr06,Bn27771,52075507,80476015,28400508,CN
chr06,Bn27772,41196022,47208381,6012359,NBS
chr06,Bn27773,82566481,99479763,16913282,CN
chr06,Bn27774,53859093,67483805,13624712,TNL
chr06,Bn27775,13931350,81703195,67771845,CN
chr06,Bn27776,46458460,47113410,654950,NBS
chr06,Bn27777,80069365,83209969,3140604,TNL
chr06,Bn27778,31366876,35022560,3655684,TNL
chr06,Bn27779,29223199,88298609,59075410,NBS
chr06,Bn27780,2559120,16141557,13582437,RLP
chr06,Bn27781,51916280,95072881,43156601,TN
chr06,Bn27782,69652257,95022946,25370689,NBS
chr06,Bn27783,49735203,54808319,5073116,RLK
chr06,Bn27784,60038327,81114455,21076128,RLK
chr06,Bn27785,89572807,93444968,3872161,CNL
chr06,Bn27786,28854207,56244301,27390094,RLK
chr06,Bn27787,70633034,84761160,14128126,RLP
chr06,Bn27788,92311907,99707334,7395427,RLK
chr06,Bn27789,55215191,91535493,36320302,NBS
chr06,Bn27790,6674444,13181867,6507423,NBS
chr06,Bn27791,52760242,52978660,218418,RLP
chr06,Bn27792,37653282,45546961,7893679,CNL
chr06,Bn27793,60935139,69252984,8317845,NBS
chr06,Bn27794,51287346,94837272,43549926,CNL
chr06,Bn27795,86647761,88376495,1728734,TN
chr06,Bn27796,48768060,73160885,24392825,CNL
chr06,Bn27797,27340937,81098518,53757581,RLK
chr06,Bn27798,52700534,88106705,35406171,TN
chr06,Bn27799,30194803,43577967,13383164,CN
chr06,Bn27800,23713006,44837418,21124412,RLK
chr06,Bn27801,95179225,97828447,2649222,NBS
chr06,Bn27802,43441748,46055563,2613815,CNL
chr06,Bn27803,12595273,71734679,59139406,TN
chr06,Bn27804,99074855,99337461,262606,CN
chr06,Bn27805,17263071,58570858,41307787,TN
chr06,Bn27806,89321660,95959142,6637482,TN
chr06,Bn27807,2508320,53475716,50967396,RLK
chr06,Bn27808,63466960,89019906,25552946,TN
chr06,Bn27809,38221890,53716122,15494232,CN
chr06,Bn27810,44534053,67995311,23461258,RLP
chr06,Bn27811,4720935,38621427,33900492,CNL
chr06,Bn27812,17924172,81821262,63897090,RLK
chr06,Bn27813,14791870,49476952,34685082,CN
chr06,Bn27814,57438820,60492513,3053693,RLP
chr06,Bn27815,81832456,85897136,4064680,TN
chr06,Bn27816,57374666,67998583,10623917,RLK
chr06,Bn27817,17104355,77264358,60160003,CN
chr06,Bn27818,62545694,71745139,9199445,CN
chr06,Bn27819,22501108,99580942,77079834,RLK
chr06,Bn27820,44509725,76004834,31495109,RLP
chr06,Bn27821,41066014,86091730,45025716,NBS
chr06,Bn27822,81611964,81911986,300022,CN
chr06,Bn27823,92251110,94983461,2732351,TNL
chr06,Bn27824,65616847,85922128,20305281,RLK
chr06,Bn27825,72217714,80890438,8672724,NBS
chr06,Bn27826,17405925,30654944,13249019,TN
chr06,Bn27827,24246359,75686924,51440565,NBS
chr06,Bn27828,85120068,88237699,3117631,CN
chr06,Bn27829,31941017,44272029,12331012,TNL
chr06,Bn27830,14215187,85046107,70830920,NBS
chr06,Bn27831,51566172,93038884,41472712,RLK
chr06,Bn27832,65811584,74900702,9089118,NBS
chr06,Bn27833,68868378,92857366,23988988,TNL
chr06,Bn27834,24777331,25914908,1137577,CNL
chr06,Bn27835,65263302,83646477,18383175,RLK
chr06,Bn27836,83686376,98522299,14835923,TN
chr06,Bn27837,6310551,20304801,13994250,NBS
chr06,Bn27838,1151954,46313372,45161418,TN
chr06,Bn27839,73296274,94256654,20960380,RLK
chr06,Bn27840,3955767,38789940,34834173,CNL
chr06,Bn27841,41040564,66808407,25767843,TNL
chr06,Bn27842,36409951,71127512,34717561,TN
chr06,Bn27843,18362882,93031621,74668739,RLP
chr06,Bn27844,59881149,70761858,10880709,TNL
chr06,Bn27845,14822506,22530456,7707950,NBS
chr06,Bn27846,67123253,82414313,15291060,TNL
chr06,Bn27847,5106135,66999728,61893593,TN
chr06,Bn27848,30470158,43588921,13118763,CN
chr06,Bn27849,13590161,56616246,43026085,RLP
chr06,Bn27850,63027029,94625272,31598243,TNL
chr06,Bn27851,60021936,63092636,3070700,CN
chr06,Bn27852,73555335,96941728,23386393,TN
chr06,Bn27853,42718230,87506683,44788453,RLP
chr06,Bn27854,87522104,94165815,6643711,CN
chr06,Bn27855,84610387,94329709,9719322,TNL
chr06,Bn27856,44949332,45895546,946214,CNL
chr06,Bn27857,39597232,83802289,44205057,NBS
chr06,Bn27858,32637284,66000247,33362963,RLK
chr06,Bn27859,59236384,71749761,12513377,TNL
chr06,Bn27860,32210575,51520186,19309611,RLK
chr06,Bn27861,24228070,56675037,32446967,NBS
chr06,Bn27862,99333987,99620712,286725,CNL
chr06,Bn27863,14799579,75485570,60685991,CNL
chr06,Bn27864,71789759,83503170,11713411,NBS
chr06,Bn27865,49693516,72773163,23079647,CNL
chr06,Bn27866,15674808,42729237,27054429,TN
chr06,Bn27867,51208633,73377601,22168968,TN
chr06,Bn27868,64290523,99651635,35361112,RLK
chr06,Bn27869,42414734,69024326,26609592,TN
chr06,Bn27870,62760897,92390654,29629757,NBS
chr06,Bn27871,74603884,84060313,9456429,CNL
chr06,Bn27872,91828845,97032251,5203406,CN
chr06,Bn27873,36459881,63547013,27087132,TNL
chr06,Bn27874,29008309,50627237,21618928,TNL
chr06,Bn27875,64969611,81746669,16777058,CN
chr06,Bn27876,97471654,99753736,2282082,RLK
chr06,Bn27877,26345135,26484308,139173,RLP
chr06,Bn27878,27532849,46097297,18564448,RLK
chr06,Bn27879,45107084,57302365,12195281,TN
chr06,Bn27880,27723372,96481539,68758167,CN
chr06,Bn27881,53458914,55734473,2275559,RLP
chr06,Bn27882,85484719,98334773,12850054,RLK
chr06,Bn27883,48031333,66895771,18864438,NBS
chr06,Bn27884,2340475,31179543,28839068,TNL
chr06,Bn27885,20259723,44625910,24366187,RLK
chr06,Bn27886,42962913,53010037,10047124,CN
chr06,Bn27887,72890860,88293837,15402977,CNL
chr06,Bn27888,54088630,77005070,22916440,RLK
chr06,Bn27889,27788591,43930062,16141471,NBS
chr06,Bn27890,36000021,98124840,62124819,CNL
chr06,Bn27891,33790200,39092931,5302731,TNL
chr06,Bn27892,10856780,15029229,4172449,TN
chr06,Bn27893,24695462,43041075,18345613,RLP
chr06,Bn27894,16537943,56030999,39493056,RLK
chr06,Bn27895,79373408,87451362,8077954,TN
chr06,Bn27896,58724382,90854010,32129628,RLK
chr06,Bn27897,15284139,20597328,5313189,CN
chr06,Bn27898,32788670,78722218,45933548,TN
chr06,Bn27899,48549651,64820185,16270534,CNL
chr06,Bn27900,61765022,68070579,6305557,CNL
chr06,Bn27901,87164679,88100056,935377,NBS
chr06,Bn27902,10312892,71938685,61625793,NBS
chr06,Bn27903,29650509,87346371,57695862,RLP
chr06,Bn27904,29140154,42339120,13198966,NBS
chr06,Bn27905,91656130,98588311,6932181,CN
chr06,Bn27906,76385216,84510825,8125609,TN
chr06,Bn27907,3137170,80229772,77092602,TNL
chr06,Bn27908,63767056,73882128,10115072,RLP
chr06,Bn27909,96458854,99424893,2966039,TN
chr06,Bn27910,32213464,52559893,20346429,RLP
chr06,Bn27911,39948381,70146330,30197949,CNL
chr06,Bn27912,72277546,77975306,5697760,TN
chr06,Bn27913,41303060,65416400,24113340,NBS
chr06,Bn27914,38201808,78557389,40355581,RLP
chr06,Bn27915,13333316,70318992,56985676,CN
chr06,Bn27916,93019817,95513383,2493566,NBS
chr06,Bn27917,56650930,75087062,18436132,RLK
chr06,Bn27918,26162501,79703432,53540931,NBS
chr06,Bn27919,75573159,99086705,23513546,CNL
chr06,Bn27920,43390700,65709933,22319233,CN
chr06,Bn27921,14953382,52668707,37715325,RLK
chr06,Bn27922,35934660,77295759,41361099,NBS
chr06,Bn27923,49756682,87182866,37426184,TN
chr06,Bn27924,50531780,61832069,11300289,RLK
chr06,Bn27925,4692625,75199883,70507258,NBS
chr06,Bn27926,95926108,96697693,771585,CNL
chr06,Bn27927,47611402,58871728,11260326,NBS
chr06,Bn27928,47058993,80831488,33772495,RLP
chr06,Bn27929,78322203,85972625,7650422,RLK
chr06,Bn27930,76791888,78493426,1701538,TNL
chr06,Bn27931,65093453,83412913,18319460,TNL
chr06,Bn27932,64276192,64798952,522760,NBS
chr06,Bn27933,12536942,66362069,53825127,TNL
chr06,Bn27934,50754599,72998724,22244125,TNL
chr06,Bn27935,52527501,71595967,19068466,CN
chr06,Bn27936,70084875,92610463,22525588,TNL
chr06,Bn27937,50711560,80134218,29422658,RLK
chr06,Bn27938,93593753,96719119,3125366,NBS
chr06,Bn27939,35308920,99132932,63824012,CNL
chr06,Bn27940,8934687,68559497,59624810,CN
chr06,Bn27941,84093932,95818277,11724345,CN
chr06,Bn27942,77253914,97849458,20595544,NBS
chr06,Bn27943,49959894,64478173,14518279,TNL
chr06,Bn27944,68595072,99955415,31360343,RLP
chr06,Bn27945,55017088,97218765,42201677,CN
chr06,Bn27946,98179708,98748550,568842,CN
chr06,Bn27947,67336999,68844309,1507310,CN
chr06,Bn27948,35523590,39935185,4411595,NBS
chr06,Bn27949,69687430,93199200,23511770,RLP
chr06,Bn27950,5250839,62418139,57167300,CNL
chr06,Bn27951,47310143,98323517,51013374,RLP
chr06,Bn27952,94780599,98333139,3552540,TNL
chr06,Bn27953,34026386,56454164,22427778,CN
chr06,Bn27954,69431574,95192368,25760794,TNL
chr06,Bn27955,65469909,70171882,4701973,TN
chr06,Bn27956,23229117,32292761,9063644,RLK
chr06,Bn27957,14964737,95400216,80435479,TN
chr06,Bn27958,28675325,55228906,26553581,TNL
chr06,Bn27959,91746169,94406236,2660067,RLK
chr06,Bn27960,92215080,95487328,3272248,RLK
chr06,Bn27961,93355627,97907657,4552030,CN
chr06,Bn27962,27463525,76337353,48873828,TN
chr06,Bn27963,85017937,95122136,10104199,CNL
chr06,Bn27964,5051132,68644556,63593424,NBS
chr06,Bn27965,49732681,64482330,14749649,RLK
chr06,Bn27966,25750473,35922559,10172086,NBS
chr06,Bn27967,90780326,91182063,401737,TN
chr06,Bn27968,79475482,80372701,897219,CNL
chr06,Bn27969,93641589,97502524,3860935,RLP
chr06,Bn27970,52557611,80008569,27450958,TNL
chr06,Bn27971,72846380,90143671,17297291,TN
chr06,Bn27972,39858431,64051233,24192802,CNL
chr06,Bn27973,21488087,26191434,4703347,TNL
chr06,Bn27974,62207878,81214347,19006469,RLP
chr06,Bn27975,23918595,30912497,6993902,NBS
chr06,Bn27976,13766321,72920692,59154371,CN
chr06,Bn27977,40311772,47121440,6809668,CN
chr06,Bn27978,78970644,85881908,6911264,NBS
chr06,Bn27979,26216604,94550211,68333607,RLK
chr06,Bn27980,57304827,73783386,16478559,CN
chr06,Bn27981,5390820,69715793,64324973,TNL
chr06,Bn27982,71693238,74415753,2722515,NBS
chr06,Bn27983,48976450,57538246,8561796,NBS
chr06,Bn27984,58335041,70312300,11977259,TNL
chr06,Bn27985,52953211,65053474,12100263,RLP
chr06,Bn27986,71536667,93318930,21782263,NBS
chr06,Bn27987,21836924,37092978,15256054,RLP
chr06,Bn27988,19507220,86487747,66980527,CN
chr06,Bn27989,77042703,96969844,19927141,RLP
chr06,Bn27990,73807533,95336111,21528578,CN
chr06,Bn27991,90714408,97412913,6698505,TNL
chr06,Bn27992,75572692,93269977,17697285,RLP
chr06,Bn27993,19043528,81492112,62448584,RLK
chr06,Bn27994,57720365,98391415,40671050,NBS
chr06,Bn27995,62324803,95992575,33667772,RLP
chr06,Bn27996,88721615,93191858,4470243,TNL
chr06,Bn27997,18574792,75437501,56862709,RLK
chr06,Bn27998,98835791,99106398,270607,NBS
chr06,Bn27999,19756096,94122085,74365989,TNL
chr06,Bn28000,63916330,89518010,25601680,NBS
chr06,Bn28001,84131982,86311953,2179971,RLP
chr06,Bn28002,94763753,95596465,832712,CNL
chr06,Bn28003,7449159,89384682,81935523,CNL
chr06,Bn28004,82618297,84408906,1790609,CN
chr06,Bn28005,7964425,34991073,27026648,TN
chr06,Bn28006,32057124,74192125,42135001,CN
chr06,Bn28007,7450659,19506225,12055566,CNL
chr06,Bn28008,18632518,78542391,59909873,CNL
chr06,Bn28009,98491035,99754986,1263951,RLP
chr06,Bn28010,47580174,66096682,18516508,RLP
chr06,Bn28011,40667946,50311935,9643989,CNL
chr06,Bn28012,39403857,80142355,40738498,RLP
chr06,Bn28013,23528822,66908673,43379851,CNL
chr06,Bn28014,7955596,97173969,89218373,CN
chr06,Bn28015,50802305,77037277,26234972,RLP
chr06,Bn28016,8564206,17288330,8724124,CN
chr06,Bn28017,81504776,95860189,14355413,CN
chr06,Bn28018,92294988,92328350,33362,CN
chr06,Bn28019,1482551,25499020,24016469,CNL
chr06,Bn28020,90124576,99415385,9290809,CNL
chr06,Bn28021,77307310,82409349,5102039,RLK
chr06,Bn28022,96219950,98333976,2114026,CNL
chr06,Bn28023,85253512,98064289,12810777,TNL
chr06,Bn28024,57982993,76049627,18066634,CN
chr06,Bn28025,9048293,49169651,40121358,TN
chr06,Bn28026,75392639,80267574,4874935,RLP
chr06,Bn28027,29467647,72303701,42836054,NBS
chr06,Bn28028,79898259,91287491,11389232,CNL
chr06,Bn28029,5418321,28985004,23566683,RLP
chr06,Bn28030,10557910,54094068,43536158,CNL
chr06,Bn28031,49716366,51232115,1515749,RLK
chr06,Bn28032,17260621,61369868,44109247,RLP
chr06,Bn28033,15227021,75009481,59782460,NBS
chr06,Bn28034,34949127,92597540,57648413,CNL
chr06,Bn28035,82739676,90322504,7582828,NBS
chr06,Bn28036,26513584,29525201,3011617,RLP
chr06,Bn28037,93922193,96592706,2670513,CN
chr06,Bn28038,6340369,60648273,54307904,TNL
chr06,Bn28039,24626529,80351726,55725197,RLP
chr06,Bn28040,48073354,81822542,33749188,TN
chr06,Bn28041,56214933,58957255,2742322,CNL
chr06,Bn28042,66773808,83635822,16862014,NBS
chr06,Bn28043,30220644,84744499,54523855,RLK
chr06,Bn28044,92199951,94201231,2001280,RLP
chr06,Bn28045,28615648,42528175,13912527,CNL
chr06,Bn28046,12319077,13414507,1095430,CN
chr06,Bn28047,49654041,62610770,12956729,CN
chr06,Bn28048,44899966,63280597,18380631,NBS
chr06,Bn28049,97414790,99177620,1762830,CNL
chr06,Bn28050,55055010,92952139,37897129,RLP
chr06,Bn28051,42426692,81325640,38898948,CN
chr06,Bn28052,68092176,91326869,23234693,TN
chr06,Bn28053,5522123,16554821,11032698,TNL
chr06,Bn28054,53541500,70041136,16499636,CN
chr06,Bn28055,57445598,92161731,34716133,TNL
chr06,Bn28056,85505864,93189574,7683710,NBS
chr06,Bn28057,74048564,90807466,16758902,RLK
chr06,Bn28058,3425374,48611440,45186066,CN
chr06,Bn28059,95335237,96523496,1188259,CNL
chr06,Bn28060,88985796,99100881,10115085,TNL
chr06,Bn28061,10122412,12914201,2791789,TN
chr06,Bn28062,94609427,98340489,3731062,CN
chr06,Bn28063,64621886,66662052,2040166,CNL
chr06,Bn28064,83027728,83035306,7578,CN
chr06,Bn28065,62538176,75118664,12580488,RLK
chr06,Bn28066,8919823,69705726,60785903,CN
chr06,Bn28067,57959825,74784104,16824279,TN
chr06,Bn28068,89714878,92725775,3010897,NBS
chr06,Bn28069,84058422,88543648,4485226,TNL
chr06,Bn28070,91399737,92652635,1252898,RLK
chr06,Bn28071,67244140,80863568,13619428,TNL
chr06,Bn28072,82574100,94695041,12120941,CNL
chr06,Bn28073,40910945,45375758,4464813,RLP
chr06,Bn28074,81227113,88065657,6838544,NBS
chr06,Bn28075,42923115,61447144,18524029,CNL
chr06,Bn28076,84344978,86859077,2514099,NBS
chr06,Bn28077,5120498,14021982,8901484,RLK
chr06,Bn28078,53094812,99908143,46813331,RLP
chr06,Bn28079,41639127,57848424,16209297,CNL
chr06,Bn28080,1921247,88104501,86183254,CNL
chr06,Bn28081,78337681,78522894,185213,CN
chr06,Bn28082,62772641,97926446,35153805,TN
chr06,Bn28083,21595802,38102548,16506746,TN
chr06,Bn28084,32876548,44821274,11944726,TN
chr06,Bn28085,49005485,91280852,42275367,TN
chr06,Bn28086,81110972,91205475,10094503,RLK
chr06,Bn28087,43781540,61868806,18087266,RLP
chr06,Bn28088,47082657,63598564,16515907,CN
chr06,Bn28089,24144667,56355087,32210420,CN
chr06,Bn28090,16486391,18490341,2003950,CN
chr06,Bn28091,53514197,67732361,14218164,NBS
chr06,Bn28092,39784494,43282818,3498324,TN
chr06,Bn28093,27521224,85397483,57876259,NBS
chr06,Bn28094,42632519,50525156,7892637,RLP
chr06,Bn28095,73824579,97899057,24074478,CN
chr06,Bn28096,84647491,93239748,8592257,CNL
chr06,Bn28097,66612846,71584514,4971668,NBS
chr06,Bn28098,44664754,90488927,45824173,RLK
chr06,Bn28099,6471480,30357052,23885572,CNL
chr06,Bn28100,94015813,94952355,936542,CN
chr06,Bn28101,52341297,90342983,38001686,TNL
chr06,Bn28102,1855627,33017372,31161745,TNL
chr06,Bn28103,15738937,36101391,20362454,CNL
chr06,Bn28104,59541878,91756645,32214767,CNL
chr06,Bn28105,89604165,89651158,46993,RLP
chr06,Bn28106,91920512,92388368,467856,RLP
chr06,Bn28107,92757627,98825870,6068243,TN
chr06,Bn28108,14367435,60754097,46386662,TNL
chr06,Bn28109,24960550,92659859,67699309,CN
chr06,Bn28110,62755037,82650726,19895689,TN
chr06,Bn28111,90576664,97139623,6562959,RLK
chr06,Bn28112,72645180,90985875,18340695,TN
chr06,Bn28113,76335389,88502471,12167082,RLK
chr06,Bn28114,76591180,82326865,5735685,NBS
chr06,Bn28115,70342854,84891775,14548921,TNL
chr06,Bn28116,90325191,94672923,4347732,CN
chr06,Bn28117,7941117,80097852,72156735,CN
chr06,Bn28118,96809383,98117275,1307892,RLK
chr06,Bn28119,9728439,38758644,29030205,NBS
chr06,Bn28120,80743837,89010015,8266178,CN
chr06,Bn28121,14332492,87304123,72971631,RLP
chr06,Bn28122,84781570,97160248,12378678,RLP
chr06,Bn28123,13770786,14059443,288657,RLP
chr06,Bn28124,31442626,87967989,56525363,RLP
chr06,Bn28125,59720376,71002765,11282389,TN
chr06,Bn28126,48753137,54637459,5884322,CNL
chr06,Bn28127,56363372,60962754,4599382,CN
chr06,Bn28128,74935166,91838193,16903027,CN
chr06,Bn28129,48043079,71457785,23414706,CN
chr06,Bn28130,2291062,96653664,94362602,CN
chr06,Bn28131,54799355,69109617,14310262,CNL
chr06,Bn28132,36403993,71404596,35000603,RLK
chr06,Bn28133,2336973,73195525,70858552,RLK
chr06,Bn28134,7049706,21455730,14406024,TNL
chr06,Bn28135,19960381,45538063,25577682,CN
chr06,Bn28136,89122876,97369432,8246556,RLK
chr06,Bn28137,74113629,76479110,2365481,RLK
chr06,Bn28138,65264735,79796388,14531653,CNL
chr06,Bn28139,24192821,70495527,46302706,TN
chr06,Bn28140,97673064,97836549,163485,RLP
chr06,Bn28141,27242771,78103019,50860248,CN
chr06,Bn28142,75052167,93931635,18879468,RLP
chr06,Bn28143,49434142,51940064,2505922,RLP
chr06,Bn28144,15531122,45555564,30024442,CN
chr06,Bn28145,20944786,64796983,43852197,TNL
chr06,Bn28146,17133587,71638786,54505199,TN
chr06,Bn28147,16609899,93402043,76792144,RLP
chr06,Bn28148,28201381,45797767,17596386,NBS
chr06,Bn28149,35081022,35130187,49165,RLK
chr06,Bn28150,71036959,77626230,6589271,NBS
chr06,Bn28151,89432754,94534085,5101331,CNL
chr06,Bn28152,63515053,89081650,25566597,CNL
chr06,Bn28153,59128657,78642236,19513579,NBS
chr06,Bn28154,64685763,80062655,15376892,CNL
chr06,Bn28155,99803982,99855523,51541,RLP
chr06,Bn28156,56119614,82773181,26653567,NBS
chr06,Bn28157,22992156,41035933,18043777,RLK
chr06,Bn28158,46426129,73588465,27162336,TN
chr06,Bn28159,68368601,68612016,243415,RLK
chr06,Bn28160,44879601,81722378,36842777,TN
chr06,Bn28161,19057571,71758498,52700927,CNL
chr06,Bn28162,38122454,58236235,20113781,TNL
chr06,Bn28163,53557124,55013038,1455914,NBS
chr06,Bn28164,41774845,80973005,39198160,CN
chr06,Bn28165,78452184,99187955,20735771,RLP
chr06,Bn28166,88047544,99544135,11496591,TNL
chr06,Bn28167,38263215,95154735,56891520,CNL
chr06,Bn28168,58566409,68180168,9613759,NBS
chr06,Bn28169,54729102,92752618,38023516,RLK
chr06,Bn28170,29364896,84992358,55627462,RLP
chr06,Bn28171,99284681,99795285,510604,RLP
chr06,Bn28172,21198846,57444060,36245214,RLK
chr06,Bn28173,42291048,57698905,15407857,TN
chr06,Bn28174,7911316,53343338,45432022,NBS
chr06,Bn28175,11535244,24251659,12716415,CNL
chr06,Bn28176,96425184,98312080,1886896,TNL
chr06,Bn28177,43322084,83435545,40113461,TN
chr06,Bn28178,99093184,99624574,531390,TN
chr06,Bn28179,76486429,94383302,17896873,RLP
chr06,Bn28180,82772921,85331789,2558868,NBS
chr06,Bn28181,71098344,72775747,1677403,CNL
chr06,Bn28182,63795640,82838843,19043203,TNL
chr06,Bn28183,23405003,24639931,1234928,NBS
chr06,Bn28184,54335141,90221979,35886838,CNL
chr06,Bn28185,37366350,99746771,62380421,RLK
chr06,Bn28186,1193045,70901316,69708271,RLK
chr06,Bn28187,43590243,99860592,56270349,TNL
chr06,Bn28188,30761522,30986416,224894,NBS
chr06,Bn28189,8355101,48938133,40583032,TN
chr06,Bn28190,39040262,86770833,47730571,CNL
chr06,Bn28191,79707686,89198076,9490390,CNL
chr06,Bn28192,27167961,53681437,26513476,RLP
chr06,Bn28193,9286566,94176584,84890018,CN
chr06,Bn28194,12746636,85959343,73212707,CN
chr06,Bn28195,3612450,83625851,80013401,NBS
chr06,Bn28196,62155167,65136881,2981714,CNL
chr06,Bn28197,36293180,83144345,46851165,CN
chr06,Bn28198,54443588,69493398,15049810,CNL
chr06,Bn28199,15643715,74604866,58961151,RLP
chr06,Bn28200,13787781,25404793,11617012,CN
chr06,Bn28201,17600890,95370406,77769516,RLK
chr06,Bn28202,85000374,93288378,8288004,RLP
chr06,Bn28203,76557621,97481469,20923848,CN
chr06,Bn28204,78812125,98865182,20053057,CN
chr06,Bn28205,38134449,43336294,5201845,RLK
chr06,Bn28206,76518280,91842976,15324696,CNL
chr06,Bn28207,49951869,93730650,43778781,NBS
chr06,Bn28208,76657492,89675953,13018461,RLK
chr06,Bn28209,79525739,80887966,1362227,CNL
chr06,Bn28210,45860171,80050770,34190599,CNL
chr06,Bn28211,18348749,62838828,44490079,TNL
chr06,Bn28212,20414124,99117312,78703188,TNL
chr06,Bn28213,24982548,66608618,41626070,NBS
chr06,Bn28214,56231570,72130955,15899385,RLP
chr06,Bn28215,24289471,81823685,57534214,TN
chr06,Bn28216,51755597,66308030,14552433,CN
chr06,Bn28217,78789107,96947564,18158457,CN
chr06,Bn28218,87913427,93777377,5863950,NBS
chr06,Bn28219,3991945,66613979,62622034,CNL
chr06,Bn28220,5869009,67681746,61812737,NBS
chr06,Bn28221,92208173,95537453,3329280,RLP
chr06,Bn28222,21165718,27858975,6693257,TNL
chr06,Bn28223,81999066,94199891,12200825,RLP
chr06,Bn28224,35995435,48871476,12876041,TNL
chr06,Bn28225,51112592,54925173,3812581,NBS
chr06,Bn28226,5541392,56007625,50466233,NBS
chr06,Bn28227,2688129,54334395,51646266,TN
chr06,Bn28228,83525985,98884380,15358395,CNL
chr06,Bn28229,22974919,68233331,45258412,RLP
chr06,Bn28230,75699641,87074629,11374988,RLP
chr06,Bn28231,59928807,91468501,31539694,CNL
chr06,Bn28232,63388998,91121808,27732810,RLP
chr06,Bn28233,39603916,73187370,33583454,RLP
chr06,Bn28234,64312661,92707878,28395217,CN
chr06,Bn28235,88378506,88529016,150510,NBS
chr06,Bn28236,58787819,95393567,36605748,RLK
chr06,Bn28237,92869555,93898176,1028621,RLK
chr06,Bn28238,21791541,44054008,22262467,NBS
chr06,Bn28239,18783899,43403294,24619395,TN
chr06,Bn28240,31848844,58669749,26820905,CN
chr06,Bn28241,50892528,82248398,31355870,CN
chr06,Bn28242,1748735,92074997,90326262,RLK
chr06,Bn28243,85322807,94197287,8874480,TNL
chr06,Bn28244,40370970,92996482,52625512,CNL
chr06,Bn28245,46918127,73919321,27001194,CNL
chr06,Bn28246,60316396,99658896,39342500,RLK
chr06,Bn28247,53829739,60752847,6923108,RLP
chr06,Bn28248,68496082,84506198,16010116,CN
chr06,Bn28249,76582497,76925157,342660,RLK
chr06,Bn28250,33420730,81753460,48332730,CNL
chr06,Bn28251,69520621,71488930,1968309,TNL
chr06,Bn28252,97908044,97983256,75212,RLK
chr06,Bn28253,53324966,79230316,25905350,RLK
chr06,Bn28254,30552616,98804273,68251657,NBS
chr06,Bn28255,24641308,59157540,34516232,RLP
chr06,Bn28256,44527440,54151164,9623724,NBS
chr06,Bn28257,44113506,58165158,14051652,RLP
chr06,Bn28258,28070409,45677644,17607235,TN
chr06,Bn28259,73025527,78875369,5849842,NBS
chr06,Bn28260,86074272,92458841,6384569,RLP
chr06,Bn28261,20359995,49489461,29129466,TNL
chr06,Bn28262,4568455,51983304,47414849,CN
chr06,Bn28263,70358827,82080646,11721819,RLP
chr06,Bn28264,34741533,54903862,20162329,CNL
chr06,Bn28265,69911102,95648050,25736948,RLP
chr06,Bn28266,20349041,83471305,63122264,CNL
chr06,Bn28267,2612770,57030461,54417691,CN
chr06,Bn28268,64650009,85238600,20588591,RLP
chr06,Bn28269,55630874,72298887,16668013,CN
chr06,Bn28270,24574665,53445407,28870742,RLK
chr06,Bn28271,97571062,97724397,153335,RLP
chr06,Bn28272,56460100,59831405,3371305,RLP
chr06,Bn28273,71715868,72644058,928190,CN
chr06,Bn28274,1679590,43860844,42181254,TNL
chr06,Bn28275,43315168,71723224,28408056,CN
chr06,Bn28276,26250287,94163324,67913037,CN
chr06,Bn28277,2120612,34606929,32486317,RLP
chr06,Bn28278,22861191,86655880,63794689,NBS
chr06,Bn28279,57259082,68569497,11310415,CN
chr06,Bn28280,78724420,79110981,386561,TN
chr06,Bn28281,78241693,82195212,3953519,TN
chr06,Bn28282,51895879,75272893,23377014,CN
chr06,Bn28283,79846149,83297541,3451392,TNL
chr06,Bn28284,53904244,87028338,33124094,CN
chr06,Bn28285,82562062,92072809,9510747,NBS
chr06,Bn28286,5142648,7834723,2692075,TNL
chr06,Bn28287,56765295,99255912,42490617,RLK
chr06,Bn28288,94982031,99794029,4811998,TN
chr06,Bn28289,42228784,96894176,54665392,RLK
chr06,Bn28290,33605572,76901032,43295460,TN
chr06,Bn28291,92493110,97175458,4682348,TNL
chr06,Bn28292,32731039,47899046,15168007,TNL
chr06,Bn28293,58508866,99266171,40757305,NBS
chr06,Bn28294,60620949,88970686,28349737,RLP
chr06,Bn28295,22185745,63008164,40822419,TNL
chr06,Bn28296,36149313,50475881,14326568,TNL
chr06,Bn28297,52494897,73980741,21485844,RLP
chr06,Bn28298,2925580,98175771,95250191,CNL
chr06,Bn28299,23747177,38969825,15222648,CNL
chr06,Bn28300,12077521,35784768,23707247,CN
chr06,Bn28301,74813227,85254964,10441737,NBS
chr06,Bn28302,28434265,58010710,29576445,RLP
chr06,Bn28303,71651381,89030860,17379479,RLK
chr06,Bn28304,16514283,25364529,8850246,RLP
chr06,Bn28305,46695501,72229085,25533584,TN
chr06,Bn28306,15636271,26815392,11179121,CN
chr06,Bn28307,57929541,98909192,40979651,NBS
chr06,Bn28308,44533926,60887106,16353180,NBS
chr06,Bn28309,40285883,53971653,13685770,CNL
chr06,Bn28310,90796137,95130250,4334113,RLK
chr06,Bn28311,66947989,80272904,13324915,NBS
chr06,Bn28312,76398113,96926395,20528282,CN
chr06,Bn28313,93308328,99982336,6674008,RLP
chr06,Bn28314,1754330,8363928,6609598,RLK
chr06,Bn28315,74568001,82927828,8359827,TNL
chr06,Bn28316,65083822,84102024,19018202,CN
chr06,Bn28317,75647360,95963885,20316525,RLK
chr06,Bn28318,73795876,81178733,7382857,RLK
chr06,Bn28319,74074163,94448682,20374519,RLP
chr06,Bn28320,23941551,90117684,66176133,CNL
chr06,Bn28321,68919623,88878598,19958975,CNL
chr06,Bn28322,65879772,92184166,26304394,NBS
chr06,Bn28323,57821108,69708182,11887074,NBS
chr06,Bn28324,99353441,99777299,423858,TNL
chr06,Bn28325,28553249,79651328,51098079,TNL
chr06,Bn28326,99514927,99690507,175580,CN
chr06,Bn28327,70862812,83878682,13015870,TNL
chr06,Bn28328,27267438,66920728,39653290,TN
chr06,Bn28329,57454650,83940025,26485375,CNL
chr06,Bn28330,84256782,96776203,12519421,CNL
chr06,Bn28331,35933967,64057943,28123976,RLP
chr06,Bn28332,43636265,86606424,42970159,RLP
chr06,Bn28333,30603779,92249630,61645851,CNL
chr06,Bn28334,99398879,99909775,510896,RLK
chr06,Bn28335,78990085,98678694,19688609,RLP
chr06,Bn28336,73440692,87609750,14169058,RLK
chr06,Bn28337,45940349,50955852,5015503,TN
chr06,Bn28338,3318241,40134622,36816381,RLP
chr06,Bn28339,26961524,58807803,31846279,NBS
chr06,Bn28340,46280839,88992872,42712033,TNL
chr06,Bn28341,55913503,89891804,33978301,RLK
chr06,Bn28342,6445386,82289511,75844125,TNL
chr06,Bn28343,2912233,61524043,58611810,NBS
chr06,Bn28344,82021585,97167891,15146306,RLP
chr06,Bn28345,51988556,85602684,33614128,RLP
chr06,Bn28346,63901431,78057578,14156147,TNL
chr06,Bn28347,42316628,56054139,13737511,RLP
chr06,Bn28348,81632902,87597802,5964900,TNL
chr06,Bn28349,23079435,70593853,47514418,CN
chr06,Bn28350,89119753,93294571,4174818,CN
chr06,Bn28351,78801045,89779107,10978062,CN
chr06,Bn28352,39917134,90294656,50377522,RLK
chr06,Bn28353,57853529,72193658,14340129,TNL
chr06,Bn28354,81166453,98161073,16994620,RLK
chr06,Bn28355,39770921,70261887,30490966,TN
chr06,Bn28356,61005032,79107246,18102214,NBS
chr06,Bn28357,71744019,95169373,23425354,CNL
chr06,Bn28358,84920116,85236446,316330,RLP
chr06,Bn28359,59308827,68558566,9249739,NBS
chr06,Bn28360,88176282,89690202,1513920,NBS
chr06,Bn28361,92257440,98313870,6056430,RLK
chr06,Bn28362,98318029,99382394,1064365,TN
chr06,Bn28363,70307953,96748093,26440140,RLP
chr06,Bn28364,63925737,69421601,5495864,RLK
chr06,Bn28365,85555497,91219626,5664129,TN
chr06,Bn28366,96371549,96947229,575680,TN
chr06,Bn28367,72631639,92953658,20322019,CN
chr06,Bn28368,48889533,94035271,45145738,CNL
chr06,Bn28369,10698361,94551370,83853009,TNL
chr06,Bn28370,81759191,90754984,8995793,RLP
chr06,Bn28371,5776365,95696022,89919657,RLP
chr06,Bn28372,91535325,96280883,4745558,RLK
chr06,Bn28373,82048963,88093809,6044846,CN
chr06,Bn28374,61122579,70399422,9276843,RLK
chr06,Bn28375,26785918,85148760,58362842,TNL
chr06,Bn28376,48649255,51101581,2452326,CNL
chr06,Bn28377,49181785,78178412,28996627,RLK
chr06,Bn28378,79138121,85617119,6478998,CN
chr06,Bn28379,4176973,64523434,60346461,RLK
chr06,Bn28380,51585606,78376702,26791096,CNL
chr06,Bn28381,12586209,39898439,27312230,TN
chr06,Bn28382,53227963,77964936,24736973,TNL
chr06,Bn28383,42930950,60513783,17582833,RLK
chr06,Bn28384,27334595,45077949,17743354,TNL
chr06,Bn28385,8347026,24699657,16352631,TNL
chr06,Bn28386,7233940,7451472,217532,CN
chr06,Bn28387,54319741,86561805,32242064,NBS
chr06,Bn28388,3719925,68795740,65075815,CNL
chr06,Bn28389,8125395,25769799,17644404,TNL
chr06,Bn28390,72473507,78558888,6085381,TN
chr06,Bn28391,24267197,38432822,14165625,NBS
chr06,Bn28392,48980003,83482926,34502923,CN
chr06,Bn28393,79870181,86404062,6533881,RLK
chr06,Bn28394,63536970,73034995,9498025,CN
chr06,Bn28395,14738323,46252120,31513797,NBS
chr06,Bn28396,43151513,62938695,19787182,TNL
chr06,Bn28397,2386384,11913356,9526972,CNL
chr06,Bn28398,84602106,86642590,2040484,RLP
chr06,Bn28399,37780224,38834476,1054252,TNL
chr06,Bn28400,36291468,78124502,41833034,CNL
chr06,Bn28401,32188081,84568613,52380532,NBS
chr06,Bn28402,77899915,85747697,7847782,RLP
chr06,Bn28403,14539592,79403746,64864154,NBS
chr06,Bn28404,61119188,63127012,2007824,CNL
chr06,Bn28405,41499021,49585057,8086036,CNL
chr06,Bn28406,88603063,98085355,9482292,CN
chr06,Bn28407,70439945,79914203,9474258,RLP
chr06,Bn28408,66985256,67562494,577238,TNL
chr06,Bn28409,58655156,89251796,30596640,CNL
chr06,Bn28410,79304810,98078261,18773451,RLP
chr06,Bn28411,90138637,92806119,2667482,CNL
chr06,Bn28412,17182876,66587980,49405104,TN
chr06,Bn28413,41905300,71340603,29435303,CNL
chr06,Bn28414,73976984,91353251,17376267,NBS
chr06,Bn28415,13225485,74223530,60998045,NBS
chr06,Bn28416,91997683,98965388,6967705,RLK
chr06,Bn28417,5421917,40298506,34876589,NBS
chr06,Bn28418,59357825,79998272,20640447,RLK
chr06,Bn28419,14608112,34878723,20270611,NBS
chr06,Bn28420,99132983,99308710,175727,RLK
chr06,Bn28421,19541586,91555907,72014321,RLK
chr06,Bn28422,5342018,91333570,85991552,RLP
chr06,Bn28423,96681916,97853112,1171196,CNL
chr06,Bn28424,89591795,89843552,251757,RLP
chr06,Bn28425,74509688,86781702,12272014,CN
chr06,Bn28426,26022904,51065940,25043036,RLP
chr06,Bn28427,19129528,34183007,15053479,RLK
chr06,Bn28428,29646839,67396345,37749506,CN
chr06,Bn28429,91377882,92595028,1217146,NBS
chr06,Bn28430,94671845,94676966,5121,RLK
chr06,Bn28431,90674068,97971993,7297925,RLP
chr06,Bn28432,36918128,68702043,31783915,CNL
chr06,Bn28433,74298328,98861654,24563326,TN
chr06,Bn28434,9086419,88757949,79671530,TN
chr06,Bn28435,76955526,98623755,21668229,TNL
chr06,Bn28436,29362715,46686680,17323965,TNL
chr06,Bn28437,3349687,23486279,20136592,TN
chr06,Bn28438,46158739,86935253,40776514,CNL
chr06,Bn28439,68900088,87218710,18318622,RLK
chr06,Bn28440,34309398,68811832,34502434,CN
chr06,Bn28441,19130377,93733370,74602993,NBS
chr06,Bn28442,16918841,26683615,9764774,TN
chr06,Bn28443,15283647,40695763,25412116,TNL
chr06,Bn28444,78929449,88265511,9336062,CN
chr06,Bn28445,56005885,63847749,7841864,TN
chr06,Bn28446,56752287,59771078,3018791,TN
chr06,Bn28447,30193488,96121911,65928423,RLP
chr06,Bn28448,35267496,95858607,60591111,CN
chr06,Bn28449,18106027,83408368,65302341,NBS
chr06,Bn28450,52507028,91750292,39243264,CN
chr06,Bn28451,54567455,70436766,15869311,RLP
chr06,Bn28452,15674099,76136060,60461961,TNL
chr06,Bn28453,55847195,73841838,17994643,CN
chr06,Bn28454,71071465,77318942,6247477,TN
chr06,Bn28455,25005375,55318698,30313323,RLP
chr06,Bn28456,53093141,92820076,39726935,CN
chr06,Bn28457,40170359,56569951,16399592,CN
chr06,Bn28458,90228922,91587763,1358841,TN
chr06,Bn28459,27851329,29024012,1172683,RLK
chr06,Bn28460,46156312,48935329,2779017,RLK
chr06,Bn28461,80235736,99388125,19152389,CN
chr06,Bn28462,51483602,75952643,24469041,CN
chr06,Bn28463,81502097,86341497,4839400,RLK
chr06,Bn28464,84945973,97071190,12125217,TN
chr06,Bn28465,40297160,77726440,37429280,CN
chr06,Bn28466,68400299,72685071,4284772,RLP
chr06,Bn28467,84218446,97443177,13224731,CN
chr06,Bn28468,48410169,98421620,50011451,TNL
chr06,Bn28469,26625578,44330574,17704996,CN
chr06,Bn28470,31662648,39271950,7609302,RLP
chr06,Bn28471,24683518,82330978,57647460,CN
chr06,Bn28472,93401418,98967209,5565791,CN
chr06,Bn28473,12073668,88834043,76760375,NBS
chr06,Bn28474,42032780,69607909,27575129,RLK
chr06,Bn28475,16949907,60307659,43357752,CNL
chr06,Bn28476,6736355,85225864,78489509,CNL
chr06,Bn28477,13220146,90348698,77128552,CNL
chr06,Bn28478,3433047,6693924,3260877,RLK
chr06,Bn28479,85478322,95120060,9641738,CNL
chr06,Bn28480,73455396,88093456,14638060,TN
chr06,Bn28481,60343289,66851044,6507755,CNL
chr06,Bn28482,32761308,51439541,18678233,RLK
chr06,Bn28483,99584934,99736603,151669,CNL
chr06,Bn28484,99825778,99848504,22726,RLK
chr06,Bn28485,92325926,96430906,4104980,NBS
chr06,Bn28486,24546268,86915913,62369645,NBS
chr06,Bn28487,26285917,39730438,13444521,RLP
chr06,Bn28488,65398005,82012149,16614144,RLP
chr06,Bn28489,6347154,32412345,26065191,RLK
chr06,Bn28490,97758781,98507241,748460,NBS
chr06,Bn28491,40908620,50407403,9498783,NBS
chr06,Bn28492,48503429,81256820,32753391,RLK
chr06,Bn28493,97340302,99693926,2353624,CNL
chr06,Bn28494,16463580,82809293,66345713,TNL
chr06,Bn28495,17867864,96217108,78349244,CN
chr06,Bn28496,18794643,83008297,64213654,TN
chr06,Bn28497,2065343,15035122,12969779,CN
chr06,Bn28498,9839296,97225297,87386001,RLP
chr06,Bn28499,64570114,93302194,28732080,TNL
chr06,Bn28500,96013647,97602743,1589096,RLP
chr06,Bn28501,65733204,74591132,8857928,TN
chr06,Bn28502,77832982,79280738,1447756,RLP
chr06,Bn28503,1703849,50558344,48854495,TNL
chr06,Bn28504,97948274,99215549,1267275,TNL
chr06,Bn28505,40993563,75184549,34190986,CN
chr06,Bn28506,2626437,8387919,5761482,CNL
chr06,Bn28507,92708129,99037274,6329145,CN
chr06,Bn28508,75783414,93424195,17640781,RLK
chr06,Bn28509,1846429,3215899,1369470,RLP
chr06,Bn28510,61456665,68306955,6850290,RLK
chr06,Bn28511,77440028,97879105,20439077,RLP
chr06,Bn28512,1692866,63261113,61568247,NBS
chr06,Bn28513,70710477,83622814,12912337,RLP
chr06,Bn28514,4054870,34647396,30592526,RLP
chr06,Bn28515,95645335,98670097,3024762,RLK
chr06,Bn28516,51193683,93229183,42035500,CN
chr06,Bn28517,76955104,98535809,21580705,TN
chr06,Bn28518,62542856,88593480,26050624,NBS
chr06,Bn28519,44546996,70734227,26187231,NBS
chr06,Bn28520,19575946,66699039,47123093,CNL
chr06,Bn28521,79383265,89003330,9620065,TN
chr06,Bn28522,37812877,48210153,10397276,CN
chr06,Bn28523,86934183,98064887,11130704,NBS
chr06,Bn28524,98243671,98288212,44541,TNL
chr06,Bn28525,38500468,81105187,42604719,CN
chr06,Bn28526,70668012,80984803,10316791,RLK
chr06,Bn28527,1437017,14692616,13255599,TN
chr06,Bn28528,29713907,48018438,18304531,CNL
chr06,Bn28529,28324084,40048660,11724576,NBS
chr06,Bn28530,89855246,91057886,1202640,TN
chr06,Bn28531,94780012,98627840,3847828,TNL
chr06,Bn28532,25607696,42347607,16739911,TNL
chr06,Bn28533,92158122,94229006,2070884,CNL
chr06,Bn28534,27338703,41989770,14651067,TN
chr06,Bn28535,95917627,99510269,3592642,RLP
chr06,Bn28536,76217719,77799099,1581380,TN
chr06,Bn28537,92642071,96328638,3686567,TNL
chr06,Bn28538,87921376,96292933,8371557,RLP
chr06,Bn28539,46228336,60003989,13775653,NBS
chr06,Bn28540,74224108,99999212,25775104,CN
chr06,Bn28541,31109928,88443210,57333282,CN
chr06,Bn28542,13098338,45012038,31913700,TNL
chr06,Bn28543,27731840,85151271,57419431,TNL
chr06,Bn28544,61923431,67751457,5828026,TN
chr06,Bn28545,28066330,64978241,36911911,TNL
chr06,Bn28546,25392856,96150057,70757201,TN
chr06,Bn28547,84379385,91979071,7599686,RLP
chr06,Bn28548,24001458,83646340,59644882,TN
chr06,Bn28549,95286874,99632899,4346025,TN
chr06,Bn28550,44102284,51776380,7674096,NBS
chr06,Bn28551,9514786,89950926,80436140,CN
chr06,Bn28552,82377587,96056471,13678884,NBS
chr06,Bn28553,5344281,55249392,49905111,RLP
chr06,Bn28554,15481571,84563608,69082037,NBS
chr06,Bn28555,81850833,94484787,12633954,TNL
chr06,Bn28556,9975961,25394996,15419035,NBS
chr06,Bn28557,41361543,74683086,33321543,TN
chr06,Bn28558,81572181,98584883,17012702,CNL
chr06,Bn28559,43049692,69646076,26596384,CN
chr06,Bn28560,18058313,80640786,62582473,NBS
chr06,Bn28561,98851392,99448320,596928,CN
chr06,Bn28562,45550031,75063807,29513776,CN
chr06,Bn28563,33872000,79818132,45946132,CN
chr06,Bn28564,22945548,30697551,7752003,RLK
chr06,Bn28565,55304217,56135777,831560,RLP
chr06,Bn28566,61704320,67416339,5712019,TN
chr06,Bn28567,63323525,81497287,18173762,TN
chr06,Bn28568,91565876,93951550,2385674,CNL
chr06,Bn28569,65016891,80693206,15676315,NBS
chr06,Bn28570,1732849,2796562,1063713,RLP
chr06,Bn28571,16902771,47543465,30640694,TN
chr06,Bn28572,69769922,77116123,7346201,NBS
chr06,Bn28573,40544308,79163596,38619288,RLP
chr06,Bn28574,16363707,24779673,8415966,RLP
chr06,Bn28575,44835707,76204076,31368369,NBS
chr06,Bn28576,94360713,99393934,5033221,RLP
chr06,Bn28577,85561896,92378221,6816325,RLP
chr06,Bn28578,25599905,33012322,7412417,TNL
chr06,Bn28579,59236971,95939751,36702780,TNL
chr06,Bn28580,46802401,98495628,51693227,NBS
chr06,Bn28581,49503692,88324698,38821006,RLP
chr06,Bn28582,58479104,70368175,11889071,NBS
chr06,Bn28583,64995563,87959540,22963977,CN
chr06,Bn28584,30267718,67639929,37372211,TN
chr06,Bn28585,59743667,81408999,21665332,RLK
chr06,Bn28586,10156110,41100411,30944301,TN
chr06,Bn28587,94895341,96991131,2095790,RLP
chr06,Bn28588,61070653,70548055,9477402,RLP
chr06,Bn28589,63380750,94763411,31382661,RLK
chr06,Bn28590,20940839,79312576,58371737,RLP
chr06,Bn28591,91541493,92959255,1417762,TNL
chr06,Bn28592,49172885,90350926,41178041,CNL
chr06,Bn28593,92606947,96074721,3467774,NBS
chr06,Bn28594,32443847,43326249,10882402,CNL
chr06,Bn28595,63890289,98808056,34917767,RLP
chr06,Bn28596,40337047,75465909,35128862,RLP
chr06,Bn28597,10243425,80355950,70112525,RLP
chr06,Bn28598,55648771,68919724,13270953,RLK
chr06,Bn28599,19004174,85813023,66808849,TNL
chr06,Bn28600,52814425,59890975,7076550,NBS
chr06,Bn28601,12395489,49630102,37234613,TNL
chr06,Bn28602,72113134,91078944,18965810,RLP
chr06,Bn28603,51482465,54308402,2825937,NBS
chr06,Bn28604,37290749,68456993,31166244,RLP
chr06,Bn28605,34190762,70092018,35901256,RLP
chr06,Bn28606,30545334,42114134,11568800,NBS
chr06,Bn28607,29997874,61967665,31969791,TNL
chr06,Bn28608,63016583,67337792,4321209,CNL
chr06,Bn28609,59038119,77067002,18028883,CNL
chr06,Bn28610,89219956,99124171,9904215,RLK
chr06,Bn28611,70656654,83624716,12968062,CN
chr06,Bn28612,38825078,59244809,20419731,CNL
chr06,Bn28613,53585455,77279857,23694402,NBS
chr06,Bn28614,18204993,69696997,51492004,RLP
chr06,Bn28615,66832405,96431907,29599502,RLK
chr06,Bn28616,79821459,88916706,9095247,TNL
chr06,Bn28617,62408318,94229858,31821540,TNL
chr06,Bn28618,5900044,87538585,81638541,RLK
chr06,Bn28619,8292300,93941255,85648955,RLK
chr06,Bn28620,83992556,87064892,3072336,CNL
chr06,Bn28621,89867598,91470015,1602417,CNL
chr06,Bn28622,30613121,86045218,55432097,RLK
chr06,Bn28623,12071947,82081088,70009141,CNL
chr06,Bn28624,13159773,29870137,16710364,NBS
chr06,Bn28625,28979312,40405119,11425807,NBS
chr06,Bn28626,36059415,74682017,38622602,TNL
chr06,Bn28627,94404698,96987245,2582547,TNL
chr06,Bn28628,92506288,94419761,1913473,RLP
chr06,Bn28629,16795657,46490473,29694816,NBS
chr06,Bn28630,58856457,76837334,17980877,TN
chr06,Bn28631,26861462,53887363,27025901,TNL
chr06,Bn28632,28886732,97931740,69045008,TN
chr06,Bn28633,19886185,69272829,49386644,RLP
chr06,Bn28634,3324581,89663682,86339101,TN
chr06,Bn28635,65010131,90361088,25350957,NBS
chr06,Bn28636,9954048,98177636,88223588,NBS
chr06,Bn28637,47582658,94834960,47252302,TNL
chr06,Bn28638,42761079,62163544,19402465,CNL
chr06,Bn28639,76954946,78663891,1708945,CN
chr06,Bn28640,90301557,92781780,2480223,NBS
chr06,Bn28641,20311926,62317978,42006052,CNL
chr06,Bn28642,21410237,36473395,15063158,TN
chr06,Bn28643,2595131,15705386,13110255,NBS
chr06,Bn28644,89184758,92195231,3010473,NBS
chr06,Bn28645,30485850,64301931,33816081,RLK
chr06,Bn28646,20913651,56447923,35534272,CNL
chr06,Bn28647,42319537,83889167,41569630,CNL
chr06,Bn28648,90162312,96998065,6835753,CN
chr06,Bn28649,14415809,75105729,60689920,TNL
chr06,Bn28650,99094857,99422044,327187,RLP
chr06,Bn28651,73838867,75582274,1743407,TN
chr06,Bn28652,40701103,42038356,1337253,TN
chr06,Bn28653,17199973,47160436,29960463,TNL
chr06,Bn28654,6510886,13502735,6991849,RLK
chr06,Bn28655,80045911,89020060,8974149,TNL
chr06,Bn28656,27994142,31225924,3231782,RLP
chr06,Bn28657,32157090,84294246,52137156,RLK
chr06,Bn28658,68893318,82299908,13406590,RLK
chr06,Bn28659,8893617,64869997,55976380,RLP
chr06,Bn28660,40022819,51118729,11095910,NBS
chr06,Bn28661,11076033,58651605,47575572,NBS
chr06,Bn28662,65214986,88464159,23249173,NBS
chr06,Bn28663,64299813,86797780,22497967,RLK
chr06,Bn28664,69757987,81519121,11761134,TNL
chr06,Bn28665,82841931,85228142,2386211,RLP
chr06,Bn28666,40427517,81581003,41153486,TN
chr06,Bn28667,87955541,88805314,849773,CN
chr06,Bn28668,15200914,56358651,41157737,TN
chr06,Bn28669,52320140,85434075,33113935,CNL
chr06,Bn28670,96671843,97862995,1191152,CN
chr06,Bn28671,93416421,98309586,4893165,NBS
chr06,Bn28672,16388474,55480881,39092407,CNL
chr06,Bn28673,95364685,98320096,2955411,TN
chr06,Bn28674,3008801,92955832,89947031,TNL
chr06,Bn28675,87393395,94305637,6912242,RLK
chr06,Bn28676,4812884,22386930,17574046,CN
chr06,Bn28677,98985174,99752048,766874,CN
chr06,Bn28678,79365273,92845476,13480203,TN
chr06,Bn28679,83905447,96183760,12278313,RLK
chr06,Bn28680,97238953,99301443,2062490,TNL
chr06,Bn28681,99912218,99984978,72760,TN
chr06,Bn28682,20393072,24805245,4412173,RLP
chr06,Bn28683,65010903,93783789,28772886,NBS
chr06,Bn28684,89006751,95508266,6501515,RLK
chr06,Bn28685,92836110,99872308,7036198,RLP
chr06,Bn28686,8813907,31988628,23174721,CN
chr06,Bn28687,23828482,71944629,48116147,TN
chr06,Bn28688,88839074,92631648,3792574,CNL
chr06,Bn28689,43199925,59901410,16701485,CNL
chr06,Bn28690,56344547,64674161,8329614,RLP
chr06,Bn28691,96867191,99497538,2630347,RLK
chr06,Bn28692,81925922,84163180,2237258,RLP
chr06,Bn28693,37116784,82553913,45437129,RLP
chr06,Bn28694,40327538,49255021,8927483,NBS
chr06,Bn28695,30481362,56004315,25522953,NBS
chr06,Bn28696,95415977,97106896,1690919,TN
chr06,Bn28697,70343581,92630501,22286920,CNL
chr06,Bn28698,53072862,55284962,2212100,CNL
chr06,Bn28699,15379852,99574335,84194483,RLP
chr06,Bn28700,82561995,96900644,14338649,NBS
chr06,Bn28701,83819641,94083512,10263871,RLP
chr06,Bn28702,46782530,81156510,34373980,CN
chr06,Bn28703,78461800,90236643,11774843,CNL
chr06,Bn28704,47230780,94947528,47716748,RLK
chr06,Bn28705,13342931,84085511,70742580,RLK
chr06,Bn28706,67215788,85994916,18779128,RLK
chr06,Bn28707,12354254,92123595,79769341,RLP
chr06,Bn28708,76992739,82141483,5148744,TNL
chr06,Bn28709,34384084,60405954,26021870,CN
chr06,Bn28710,57290915,81515048,24224133,CNL
chr06,Bn28711,35814829,83141965,47327136,TN
chr06,Bn28712,25512623,96609667,71097044,CNL
chr06,Bn28713,58704308,61079136,2374828,NBS
chr06,Bn28714,9928011,48760461,38832450,TNL
chr06,Bn28715,14621000,34321336,19700336,TN
chr06,Bn28716,24678536,94482688,69804152,RLK
chr06,Bn28717,88775993,98044065,9268072,CNL
chr06,Bn28718,82973819,88986991,6013172,CNL
chr06,Bn28719,85430489,87486070,2055581,CNL
chr06,Bn28720,56403343,99525148,43121805,CN
chr06,Bn28721,91622987,93972365,2349378,CNL
chr06,Bn28722,59796489,75982262,16185773,CNL
chr06,Bn28723,56248689,89808231,33559542,TNL
chr06,Bn28724,98011441,98488898,477457,CN
chr06,Bn28725,96931598,99500929,2569331,TNL
chr06,Bn28726,10872822,12350679,1477857,CN
chr06,Bn28727,61685640,77579886,15894246,TNL
chr06,Bn28728,25285495,47144697,21859202,RLK
chr06,Bn28729,18082336,64863347,46781011,TNL
chr06,Bn28730,95273722,98946750,3673028,RLP
chr06,Bn28731,48097560,73599652,25502092,CNL
chr06,Bn28732,11398063,24501527,13103464,CNL
chr06,Bn28733,19657780,66628377,46970597,CNL
chr06,Bn28734,79449907,89935644,10485737,RLK
chr06,Bn28735,8652404,60480060,51827656,RLK
chr06,Bn28736,38383943,65428271,27044328,CN
chr06,Bn28737,59745651,66302152,6556501,RLP
chr06,Bn28738,4991790,74019488,69027698,TN
chr06,Bn28739,39440527,87927644,48487117,TNL
chr06,Bn28740,85122360,92933872,7811512,CN
chr06,Bn28741,39549661,87546655,47996994,RLK
chr06,Bn28742,32625936,92168192,59542256,RLP
chr06,Bn28743,15056182,31603966,16547784,RLK
chr06,Bn28744,90868217,97153890,6285673,TNL
chr06,Bn28745,77108363,99041528,21933165,CN
chr06,Bn28746,46999537,49613182,2613645,CNL
chr06,Bn28747,61063879,66892182,5828303,NBS
chr06,Bn28748,11565677,80628805,69063128,CN
chr06,Bn28749,72941210,82492045,9550835,TN
chr06,Bn28750,49463144,78148438,28685294,TNL
chr06,Bn28751,45419218,63482411,18063193,TNL
chr06,Bn28752,27896515,31462160,3565645,RLP
chr06,Bn28753,33957657,96107662,62150005,RLP
chr06,Bn28754,72237537,95196463,22958926,CNL
chr06,Bn28755,62448941,75458643,13009702,CN
chr06,Bn28756,96031304,98737596,2706292,RLP
chr06,Bn28757,19261372,93351487,74090115,CN
chr06,Bn28758,40215468,61145916,20930448,TN
chr06,Bn28759,83314022,98149086,14835064,NBS
chr06,Bn28760,77795563,85731180,7935617,NBS
chr06,Bn28761,1775162,64143761,62368599,CN
chr06,Bn28762,47336837,66006203,18669366,RLP
chr06,Bn28763,89783859,92891376,3107517,RLP
chr06,Bn28764,20742243,68778987,48036744,CN
chr06,Bn28765,63356677,84373029,21016352,TN
chr06,Bn28766,9867568,67279727,57412159,CNL
chr06,Bn28767,60392947,75768041,15375094,RLK
chr06,Bn28768,8335941,33086263,24750322,RLK
chr06,Bn28769,56360947,74717155,18356208,NBS
chr06,Bn28770,55837459,72438381,16600922,CNL
chr06,Bn28771,16474669,43279655,26804986,RLP
chr06,Bn28772,7766653,67392995,59626342,TN
chr06,Bn28773,5639134,44994331,39355197,RLP
chr06,Bn28774,15497540,84408385,68910845,NBS
chr06,Bn28775,37075502,98039489,60963987,TNL
chr06,Bn28776,93741967,99658340,5916373,CN
chr06,Bn28777,2070035,19732687,17662652,RLK
chr06,Bn28778,43771757,94940419,51168662,CN
chr06,Bn28779,82799619,92615267,9815648,CNL
chr06,Bn28780,98893079,99252565,359486,CN
chr06,Bn28781,38281275,85910658,47629383,TN
chr06,Bn28782,54936607,65549446,10612839,CN
chr06,Bn28783,27682276,63270875,35588599,CNL
chr06,Bn28784,42666002,82925253,40259251,CNL
chr06,Bn28785,2215882,46999400,44783518,TNL
chr06,Bn28786,40722402,72020638,31298236,CNL
chr06,Bn28787,32233397,76057353,43823956,CN
chr06,Bn28788,66135509,76342718,10207209,TNL
chr06,Bn28789,21582958,69279488,47696530,CN
chr06,Bn28790,3679552,29427134,25747582,CNL
chr06,Bn28791,36675626,87337902,50662276,RLP
chr06,Bn28792,68184196,81724572,13540376,TNL
chr06,Bn28793,26821147,32841950,6020803,NBS
chr06,Bn28794,54551321,96566771,42015450,CNL
chr06,Bn28795,65577271,65842265,264994,CN
chr06,Bn28796,8131340,16681840,8550500,RLK
chr06,Bn28797,38012951,64293363,26280412,RLK
chr06,Bn28798,26531988,30088618,3556630,TNL
chr06,Bn28799,37936719,71956925,34020206,RLP
chr06,Bn28800,16319111,49360037,33040926,NBS
chr06,Bn28801,27545505,80064999,52519494,CN
chr06,Bn28802,34791542,57891700,23100158,CN
chr06,Bn28803,66747758,85690536,18942778,TN
chr06,Bn28804,76783846,85933297,9149451,RLP
chr06,Bn28805,20366781,38178535,17811754,TNL
chr06,Bn28806,50207254,64842434,14635180,TNL
chr06,Bn28807,94598338,97221696,2623358,NBS
chr06,Bn28808,34495061,58744937,24249876,RLK
chr06,Bn28809,66527634,85714627,19186993,RLP
chr06,Bn28810,5597926,28614589,23016663,TNL
chr06,Bn28811,81758166,88638102,6879936,RLP
chr06,Bn28812,33435845,95764086,62328241,TNL
chr06,Bn28813,10445513,61890084,51444571,TN
chr06,Bn28814,32812182,94624256,61812074,TN
chr06,Bn28815,78341379,90616148,12274769,NBS
chr06,Bn28816,70061941,99152137,29090196,TNL
chr06,Bn28817,63868328,90669611,26801283,CNL
chr06,Bn28818,67428032,79980886,12552854,TN
chr06,Bn28819,19435412,52383268,32947856,TN
chr06,Bn28820,7054650,44836521,37781871,CN
chr06,Bn28821,46967125,78984738,32017613,RLK
chr06,Bn28822,44434127,58421417,13987290,CNL
chr06,Bn28823,80100473,99927864,19827391,CN
chr06,Bn28824,5911297,98845783,92934486,CNL
chr06,Bn28825,18363911,40220961,21857050,CN
chr06,Bn28826,17094974,24883525,7788551,TNL
chr06,Bn28827,10294914,79092572,68797658,NBS
chr06,Bn28828,39512933,82443181,42930248,TNL
chr06,Bn28829,98321954,99359039,1037085,TNL
chr06,Bn28830,86645106,90648414,4003308,TNL
chr06,Bn28831,8027358,53546600,45519242,RLP
chr06,Bn28832,97867873,99187613,1319740,CN
chr06,Bn28833,85614483,90245078,4630595,CNL
chr06,Bn28834,33273209,96999224,63726015,CN
chr06,Bn28835,61649065,81595767,19946702,RLK
chr06,Bn28836,72545258,91732250,19186992,RLK
chr06,Bn28837,98088521,98158625,70104,CN
chr06,Bn28838,35577816,83707532,48129716,CN
chr06,Bn28839,63931552,93051871,29120319,RLP
chr06,Bn28840,94034151,98017352,3983201,RLP
chr06,Bn28841,66961740,83216332,16254592,CN
chr06,Bn28842,40716586,48519939,7803353,RLK
chr06,Bn28843,57422242,86744563,29322321,TN
chr06,Bn28844,9165321,23680923,14515602,CN
chr06,Bn28845,30825854,31736952,911098,TNL
chr06,Bn28846,62141103,98306773,36165670,TNL
chr06,Bn28847,31442890,67877757,36434867,TNL
chr06,Bn28848,71066012,98546757,27480745,RLK
chr06,Bn28849,99456104,99768025,311921,TNL
chr06,Bn28850,9185378,61138953,51953575,NBS
chr06,Bn28851,3741886,7186460,3444574,TN
chr06,Bn28852,91178866,94315702,3136836,RLK
chr06,Bn28853,70280143,89900977,19620834,RLK
chr06,Bn28854,24198104,47572465,23374361,TN
chr06,Bn28855,18977315,53009005,34031690,RLP
chr06,Bn28856,28561314,69720182,41158868,CN
chr06,Bn28857,48473924,98762994,50289070,RLP
chr06,Bn28858,10867985,78010729,67142744,RLP
chr06,Bn28859,58845971,63909098,5063127,RLP
chr06,Bn28860,28767300,40648866,11881566,RLK
chr06,Bn28861,23056418,84160915,61104497,CNL
chr06,Bn28862,76408563,84201593,7793030,CN
chr06,Bn28863,84527074,87209153,2682079,NBS
chr06,Bn28864,30713495,99140381,68426886,RLP
chr06,Bn28865,93006552,93505906,499354,NBS
chr06,Bn28866,95973926,98503113,2529187,RLK
chr06,Bn28867,31174002,45000820,13826818,TN
chr06,Bn28868,48984183,92746245,43762062,RLK
chr06,Bn28869,38431218,60802379,22371161,TN
chr06,Bn28870,41000194,97538588,56538394,CNL
chr06,Bn28871,69575081,70415165,840084,CNL
chr06,Bn28872,71375123,94735101,23359978,NBS
chr06,Bn28873,9077704,98904028,89826324,NBS
chr06,Bn28874,62055559,88870238,26814679,CNL
chr06,Bn28875,95490001,99152440,3662439,TN
chr06,Bn28876,28565899,92125299,63559400,NBS
chr06,Bn28877,49473992,73871963,24397971,NBS
chr06,Bn28878,52876691,72512114,19635423,RLK
chr06,Bn28879,58371446,84543182,26171736,TNL
chr06,Bn28880,43077118,66210436,23133318,RLK
chr06,Bn28881,17739382,83023174,65283792,RLP
chr06,Bn28882,57888244,73965489,16077245,CNL
chr06,Bn28883,7397855,46793693,39395838,NBS
chr06,Bn28884,75674636,81797929,6123293,RLP
chr06,Bn28885,38572054,98366393,59794339,CN
chr06,Bn28886,10203196,58732885,48529689,CNL
chr06,Bn28887,30095142,57344153,27249011,CNL
chr06,Bn28888,1436011,48903122,47467111,RLK
chr06,Bn28889,73459597,90936087,17476490,NBS
chr06,Bn28890,13621777,48567319,34945542,RLK
chr06,Bn28891,89709985,96130462,6420477,CN
chr06,Bn28892,15589151,72803307,57214156,CNL
chr06,Bn28893,57485538,63115994,5630456,RLP
chr06,Bn28894,8158252,61929356,53771104,TN
chr06,Bn28895,67633523,67805438,171915,TN
chr06,Bn28896,7085339,93119589,86034250,NBS
chr06,Bn28897,55321275,63155756,7834481,TN
chr06,Bn28898,77744127,82046282,4302155,TN
chr06,Bn28899,3959227,79624409,75665182,TN
chr06,Bn28900,29445547,94009845,64564298,CNL
chr06,Bn28901,66876600,80143847,13267247,RLK
chr06,Bn28902,41730325,61108356,19378031,CN
chr06,Bn28903,38878680,41315829,2437149,TN
chr06,Bn28904,1000042,34823686,33823644,RLP
chr06,Bn28905,98079921,99394906,1314985,RLK
chr06,Bn28906,16453655,23892973,7439318,RLP
chr06,Bn28907,31905278,65409475,33504197,NBS
chr06,Bn28908,43047628,47204867,4157239,RLP
chr06,Bn28909,49800995,77487792,27686797,TNL
chr06,Bn28910,59105691,95316284,36210593,CNL
chr06,Bn28911,49302493,64087555,14785062,CN
chr06,Bn28912,61422882,79287844,17864962,RLK
chr06,Bn28913,79655288,98981924,19326636,RLK
chr06,Bn28914,46057741,87466068,41408327,RLP
chr06,Bn28915,62989154,70229432,7240278,CN
chr06,Bn28916,71858495,88620499,16762004,NBS
chr06,Bn28917,72116701,73341138,1224437,TN
chr06,Bn28918,66953044,70724148,3771104,NBS
chr06,Bn28919,31806915,39247848,7440933,RLP
chr06,Bn28920,97446600,97662449,215849,NBS
chr06,Bn28921,82657519,94286230,11628711,CN
chr06,Bn28922,65580051,71220159,5640108,TN
chr06,Bn28923,7572482,38991437,31418955,CN
chr06,Bn28924,11635233,86405694,74770461,CN
chr06,Bn28925,37533825,49107683,11573858,CNL
chr06,Bn28926,45930301,46923172,992871,RLK
chr06,Bn28927,15701696,44678896,28977200,NBS
chr06,Bn28928,64160230,71248820,7088590,NBS
chr06,Bn28929,12025844,57084627,45058783,CNL
chr06,Bn28930,9037340,9084036,46696,RLK
chr06,Bn28931,42106858,68854610,26747752,TN
chr06,Bn28932,46406938,50338591,3931653,TNL
chr06,Bn28933,69764239,69819610,55371,TNL
chr06,Bn28934,98302705,99513936,1211231,NBS
chr06,Bn28935,93431767,95624615,2192848,RLK
chr06,Bn28936,62656447,80517970,17861523,CNL
chr06,Bn28937,48769584,91609067,42839483,TN
chr06,Bn28938,3430144,35896069,32465925,CN
chr06,Bn28939,19002527,57827464,38824937,RLP
chr06,Bn28940,73150511,88152618,15002107,CNL
chr06,Bn28941,8289152,17552251,9263099,RLK
chr06,Bn28942,75727194,80630316,4903122,TNL
chr06,Bn28943,91780651,94078025,2297374,CNL
chr06,Bn28944,31314565,87001838,55687273,TNL
chr06,Bn28945,92068943,98494936,6425993,RLK
chr06,Bn28946,79815506,80734432,918926,TN
chr06,Bn28947,53048693,64825815,11777122,CNL
chr06,Bn28948,9256553,26656777,17400224,CN
chr06,Bn28949,36806709,62044247,25237538,NBS
chr06,Bn28950,74068566,93956358,19887792,TN
chr06,Bn28951,96703552,98900491,2196939,CN
chr06,Bn28952,18895399,51865884,32970485,RLP
chr06,Bn28953,64017231,88558906,24541675,CN
chr06,Bn28954,38984845,79601399,40616554,CNL
chr06,Bn28955,51342829,97265832,45923003,RLP
chr06,Bn28956,26122901,32969440,6846539,TNL
chr06,Bn28957,45572281,57311655,11739374,TNL
chr06,Bn28958,74313806,74487839,174033,CN
chr06,Bn28959,59433042,91136309,31703267,TNL
chr06,Bn28960,42729997,54865162,12135165,CN
chr06,Bn28961,66466548,91621199,25154651,RLK
chr06,Bn28962,82332714,89309504,6976790,RLK
chr06,Bn28963,41864648,75914099,34049451,TNL
chr06,Bn28964,58128955,99890820,41761865,NBS
chr06,Bn28965,80862467,99887068,19024601,TNL
chr06,Bn28966,59205411,71421196,12215785,CN
chr06,Bn28967,45425913,48756849,3330936,CN
chr06,Bn28968,14120219,37424901,23304682,CN
chr06,Bn28969,66812457,79079729,12267272,CNL
chr06,Bn28970,92851024,95144288,2293264,TNL
chr06,Bn28971,34163424,55842691,21679267,CN
chr06,Bn28972,92537210,93373131,835921,RLP
chr06,Bn28973,95174222,96557984,1383762,CNL
chr06,Bn28974,62025470,89541503,27516033,NBS
chr06,Bn28975,92870608,96566383,3695775,RLK
chr06,Bn28976,19168383,26268642,7100259,TNL
chr06,Bn28977,79915359,98246081,18330722,RLK
chr06,Bn28978,63074420,81502059,18427639,RLP
chr06,Bn28979,49533396,63981661,14448265,CN
chr06,Bn28980,70139349,83238629,13099280,RLP
chr06,Bn28981,5373385,56949944,51576559,CN
chr06,Bn28982,48654592,60217138,11562546,RLP
chr06,Bn28983,71863610,79211098,7347488,RLP
chr06,Bn28984,33098648,65724378,32625730,TNL
chr06,Bn28985,60767309,74577616,13810307,RLK
chr06,Bn28986,17219893,52885738,35665845,NBS
chr06,Bn28987,55813591,73163408,17349817,TNL
chr06,Bn28988,3537429,83766388,80228959,NBS
chr06,Bn28989,78494406,90317251,11822845,TNL
chr06,Bn28990,73980030,87180843,13200813,TNL
chr06,Bn28991,11885967,39508512,27622545,RLP
chr06,Bn28992,44788413,75593787,30805374,CN
chr06,Bn28993,66870134,90472980,23602846,CN
chr06,Bn28994,5460178,98391470,92931292,CNL
chr06,Bn28995,58033841,64905503,6871662,NBS
chr06,Bn28996,1890036,69290142,67400106,RLP
chr06,Bn28997,61010140,98096675,37086535,RLK
chr06,Bn28998,53908220,82932265,29024045,CN
chr06,Bn28999,41246145,97569684,56323539,CNL
chr06,Bn29000,51424795,73115103,21690308,RLP
chr06,Bn29001,47560851,72613447,25052596,CNL
chr06,Bn29002,59883376,91443473,31560097,TNL
chr06,Bn29003,3521905,19002155,15480250,TNL
chr06,Bn29004,93624787,94708373,1083586,TNL
chr06,Bn29005,49065934,88051634,38985700,RLP
chr06,Bn29006,44942419,63282068,18339649,TNL
chr06,Bn29007,64307195,65432648,1125453,TNL
chr06,Bn29008,97728989,98949366,1220377,TN
chr06,Bn29009,79405676,86399062,6993386,RLP
chr06,Bn29010,32383899,56284630,23900731,TNL
chr06,Bn29011,3400540,91096028,87695488,CN
chr06,Bn29012,27629758,71051941,43422183,RLK
chr06,Bn29013,91865971,92642637,776666,TNL
chr06,Bn29014,76628471,92519910,15891439,CN
chr06,Bn29015,59620311,84729910,25109599,TN
chr06,Bn29016,23490323,77580826,54090503,RLK
chr06,Bn29017,56522167,92360778,35838611,RLK
chr06,Bn29018,54716024,73631748,18915724,NBS
chr06,Bn29019,32164800,64386809,32222009,NBS
chr06,Bn29020,40053624,54926580,14872956,RLK
chr06,Bn29021,98441249,99007449,566200,TN
chr06,Bn29022,12247165,61838468,49591303,CNL
chr06,Bn29023,67867524,91234727,23367203,TNL
chr06,Bn29024,50328551,52358944,2030393,CNL
chr06,Bn29025,45893700,49234278,3340578,CN
chr06,Bn29026,79662205,95800941,16138736,CN
chr06,Bn29027,56205290,64869733,8664443,NBS
chr06,Bn29028,17187614,94297050,77109436,RLP
chr06,Bn29029,91888666,99774385,7885719,TNL
chr06,Bn29030,62519364,67825802,5306438,TN
chr06,Bn29031,92038096,99200050,7161954,CN
chr06,Bn29032,17500195,35395904,17895709,RLK
chr06,Bn29033,81870731,91758149,9887418,TNL
chr06,Bn29034,77516563,94549248,17032685,RLP
chr06,Bn29035,15447070,54136192,38689122,NBS
chr06,Bn29036,39549987,84357835,44807848,CNL
chr06,Bn29037,62897960,63981165,1083205,TNL
chr06,Bn29038,64115706,75409179,11293473,CNL
chr06,Bn29039,42972607,51916497,8943890,RLP
chr06,Bn29040,8991820,19512546,10520726,RLK
chr06,Bn29041,54464865,97566998,43102133,RLP
chr06,Bn29042,15370068,25311118,9941050,CNL
chr06,Bn29043,24657550,76092865,51435315,TN
chr06,Bn29044,5023426,14914020,9890594,TNL
chr06,Bn29045,9723953,14440358,4716405,CNL
chr06,Bn29046,17978369,66409179,48430810,RLK
chr06,Bn29047,36849002,45154451,8305449,CN
chr06,Bn29048,5437269,51691780,46254511,NBS
chr06,Bn29049,29008059,47882994,18874935,CNL
chr06,Bn29050,97704739,98534257,829518,NBS
chr06,Bn29051,97455766,97546295,90529,TN
chr06,Bn29052,89098719,97976335,8877616,TN
chr06,Bn29053,87518463,95402435,7883972,TN
chr06,Bn29054,16602576,63748348,47145772,RLK
chr06,Bn29055,69268505,94994853,25726348,RLK
chr06,Bn29056,27228776,37674025,10445249,CN
chr06,Bn29057,76499476,95073186,18573710,CN
chr06,Bn29058,75773697,88432750,12659053,RLP
chr06,Bn29059,58691601,76989374,18297773,TN
chr06,Bn29060,19045816,62642479,43596663,TN
chr06,Bn29061,26725045,94172088,67447043,RLP
chr06,Bn29062,9026940,40727621,31700681,NBS
chr06,Bn29063,69035654,85285691,16250037,TNL
chr06,Bn29064,61816731,68675370,6858639,TNL
chr06,Bn29065,44452007,64172972,19720965,TN
chr06,Bn29066,34462549,65302523,30839974,CN
chr06,Bn29067,99833955,99968634,134679,CNL
chr06,Bn29068,71549179,89844655,18295476,RLP
chr06,Bn29069,84266640,98093970,13827330,TNL
chr06,Bn29070,20132190,28401395,8269205,TN
chr06,Bn29071,41809513,69800642,27991129,CNL
chr06,Bn29072,4679851,75935015,71255164,NBS
chr06,Bn29073,41748560,70775592,29027032,RLK
chr06,Bn29074,58483874,64521539,6037665,TNL
chr06,Bn29075,31253442,51596103,20342661,CNL
chr06,Bn29076,81440062,97341936,15901874,TNL
chr06,Bn29077,3156711,9638331,6481620,RLP
chr06,Bn29078,13265909,91762053,78496144,RLK
chr06,Bn29079,92489577,99982840,7493263,RLP
chr06,Bn29080,63573800,98304925,34731125,NBS
chr06,Bn29081,14989558,82229777,67240219,RLP
chr06,Bn29082,45311833,77720056,32408223,RLK
chr06,Bn29083,4436081,63529431,59093350,TNL
chr06,Bn29084,58943689,88966191,30022502,RLK
chr06,Bn29085,85961532,93971602,8010070,NBS
chr06,Bn29086,30507287,88218593,57711306,CN
chr06,Bn29087,48373670,72877460,24503790,RLP
chr06,Bn29088,8757771,69077573,60319802,CN
chr06,Bn29089,27273787,81434068,54160281,RLP
chr06,Bn29090,53916653,75860932,21944279,CNL
chr06,Bn29091,8762913,41564507,32801594,RLP
chr06,Bn29092,23265884,99070832,75804948,NBS
chr06,Bn29093,39592403,88803080,49210677,TN
chr06,Bn29094,55555444,87870525,32315081,CN
chr06,Bn29095,16643551,66291790,49648239,CNL
chr06,Bn29096,63303356,95039657,31736301,CNL
chr06,Bn29097,90107078,90825478,718400,CN
chr06,Bn29098,33161450,57632248,24470798,NBS
chr06,Bn29099,51353687,68328083,16974396,CNL
chr06,Bn29100,44259622,54023815,9764193,RLK
chr06,Bn29101,93661808,97568514,3906706,TNL
chr06,Bn29102,98982077,99348182,366105,RLP
chr06,Bn29103,19024669,43534562,24509893,RLK
chr06,Bn29104,1132155,95533094,94400939,NBS
chr06,Bn29105,15012166,37530530,22518364,RLK
chr06,Bn29106,50897320,94094686,43197366,CNL
chr06,Bn29107,44211191,73808852,29597661,RLP
chr06,Bn29108,23835414,89714055,65878641,CN
chr06,Bn29109,47705387,90521829,42816442,CN
chr06,Bn29110,82530526,82652172,121646,TN
chr06,Bn29111,1808301,33607015,31798714,RLK
chr06,Bn29112,4164138,12711262,8547124,TN
chr06,Bn29113,36441847,59573792,23131945,NBS
chr06,Bn29114,35440351,39379277,3938926,NBS
chr06,Bn29115,64457794,70614906,6157112,TN
chr06,Bn29116,45954497,90311576,44357079,CNL
chr06,Bn29117,74892836,80363329,5470493,RLK
chr06,Bn29118,40792847,93823975,53031128,RLP
chr06,Bn29119,9621706,89046281,79424575,TNL
chr06,Bn29120,96545607,97168664,623057,RLP
chr06,Bn29121,47650162,81421135,33770973,RLK
chr06,Bn29122,24614192,32872945,8258753,TNL
chr06,Bn29123,62983084,66677455,3694371,RLP
chr06,Bn29124,26580683,57171782,30591099,TNL
chr06,Bn29125,83477485,95980236,12502751,RLK
chr06,Bn29126,2460759,71994872,69534113,TNL
chr06,Bn29127,20859754,45713162,24853408,TNL
chr06,Bn29128,53404205,56093473,2689268,RLP
chr06,Bn29129,70097322,93744660,23647338,CNL
chr06,Bn29130,40605922,50887823,10281901,CNL
chr06,Bn29131,59070046,80997514,21927468,NBS
chr06,Bn29132,1726127,32677572,30951445,NBS
chr06,Bn29133,79656107,86338167,6682060,RLK
chr06,Bn29134,15572454,24361284,8788830,TNL
chr06,Bn29135,16555588,72408194,55852606,CNL
chr06,Bn29136,68054607,96548189,28493582,CN
chr06,Bn29137,51291184,92552735,41261551,RLP
chr06,Bn29138,61860678,65730952,3870274,TN
chr06,Bn29139,38174126,43135201,4961075,RLP
chr06,Bn29140,3331567,22273008,18941441,NBS
chr06,Bn29141,98057577,99502732,1445155,RLK
chr06,Bn29142,3298110,79456051,76157941,NBS
chr06,Bn29143,13938556,28072195,14133639,TNL
chr06,Bn29144,26437133,73799845,47362712,RLP
chr06,Bn29145,58101702,92380063,34278361,CNL
chr06,Bn29146,47734504,86983792,39249288,RLK
chr06,Bn29147,45768324,70771514,25003190,TN
chr06,Bn29148,11055400,35414623,24359223,CNL
chr06,Bn29149,46739652,98361580,51621928,CNL
chr06,Bn29150,9320308,34360675,25040367,TNL
chr06,Bn29151,49353325,65336839,15983514,RLK
chr06,Bn29152,53032332,98822746,45790414,TN
chr06,Bn29153,94295732,94738734,443002,NBS
chr06,Bn29154,71233751,91786135,20552384,RLK
chr06,Bn29155,91847640,98050434,6202794,CNL
chr06,Bn29156,93652712,99061249,5408537,NBS
chr06,Bn29157,12527649,67372683,54845034,NBS
chr06,Bn29158,72566885,85012734,12445849,NBS
chr06,Bn29159,30432237,50923840,20491603,TNL
chr06,Bn29160,97556102,99298813,1742711,TNL
chr06,Bn29161,38422769,67013586,28590817,RLP
chr06,Bn29162,91350548,96026670,4676122,RLP
chr06,Bn29163,5524779,84758232,79233453,RLK
chr06,Bn29164,59181753,74277850,15096097,TN
chr06,Bn29165,76627433,83995486,7368053,TN
chr06,Bn29166,71959715,88270713,16310998,RLP
chr06,Bn29167,29153543,63913715,34760172,TNL
chr06,Bn29168,74019871,82381815,8361944,TN
chr06,Bn29169,66898119,84173711,17275592,RLK
chr06,Bn29170,86417130,89070877,2653747,TN
chr06,Bn29171,41567441,57461679,15894238,NBS
chr06,Bn29172,61504018,62770241,1266223,RLP
chr06,Bn29173,53923814,94198951,40275137,CN
chr06,Bn29174,26836050,96511280,69675230,NBS
chr06,Bn29175,43836855,58563753,14726898,TN
chr06,Bn29176,97096314,98595275,1498961,RLP
chr06,Bn29177,87125824,95343476,8217652,CN
chr06,Bn29178,9207017,27219279,18012262,CN
chr06,Bn29179,96699835,97892397,1192562,CNL
chr06,Bn29180,33960475,79001757,45041282,RLP
chr06,Bn29181,75354431,94150711,18796280,CNL
chr06,Bn29182,1591632,44129405,42537773,TN
chr06,Bn29183,91178987,91438684,259697,CNL
chr06,Bn29184,61623301,66908921,5285620,TNL
chr06,Bn29185,7263310,12449005,5185695,CNL
chr06,Bn29186,17431810,59783892,42352082,RLK
chr06,Bn29187,65523511,98136664,32613153,CN
chr06,Bn29188,44485767,79515132,35029365,CNL
chr06,Bn29189,74289409,87080644,12791235,RLK
chr06,Bn29190,68761893,76644844,7882951,RLP
chr06,Bn29191,87261380,94114621,6853241,RLP
chr06,Bn29192,37061709,87029953,49968244,TNL
chr06,Bn29193,25275839,65158467,39882628,RLP
chr06,Bn29194,38212044,63395281,25183237,CNL
chr06,Bn29195,48630808,89281304,40650496,NBS
chr06,Bn29196,52677636,95502802,42825166,NBS
chr06,Bn29197,82552930,97430132,14877202,RLK
chr06,Bn29198,26140281,60807546,34667265,CN
chr06,Bn29199,76709706,88538214,11828508,RLP
chr06,Bn29200,77087822,83758908,6671086,TN
chr06,Bn29201,61089362,82794797,21705435,CN
chr06,Bn29202,60694835,80913001,20218166,CN
chr06,Bn29203,48247307,75218726,26971419,TN
chr06,Bn29204,5906418,43257599,37351181,RLP
chr06,Bn29205,35839680,61648698,25809018,CN
chr06,Bn29206,45697817,67609168,21911351,RLK
chr06,Bn29207,11857219,57730428,45873209,CNL
chr06,Bn29208,96962775,97322689,359914,CNL
chr06,Bn29209,13975859,50607801,36631942,RLK
chr06,Bn29210,92920681,99720499,6799818,CNL
chr06,Bn29211,17895810,62772425,44876615,NBS
chr06,Bn29212,4982531,72248959,67266428,TN
chr06,Bn29213,72655601,87228083,14572482,NBS
chr06,Bn29214,22126744,45559933,23433189,RLK
chr06,Bn29215,59451985,82004751,22552766,CN
chr06,Bn29216,83715775,93941685,10225910,NBS
chr06,Bn29217,14344754,19391336,5046582,RLP
chr06,Bn29218,18749604,68153046,49403442,CN
chr06,Bn29219,69607098,73763383,4156285,RLK
chr06,Bn29220,29016273,47458159,18441886,CNL
chr06,Bn29221,85677064,92617102,6940038,TN
chr06,Bn29222,74736008,87101739,12365731,RLK
chr06,Bn29223,81615326,95956241,14340915,CN
chr06,Bn29224,68381946,86340213,17958267,NBS
chr06,Bn29225,52977888,53258262,280374,NBS
chr06,Bn29226,51594745,90249784,38655039,TNL
chr06,Bn29227,72372703,95765646,23392943,NBS
chr06,Bn29228,11561941,19353684,7791743,RLP
chr06,Bn29229,50585096,65010163,14425067,TN
chr06,Bn29230,49571514,66729976,17158462,TN
chr06,Bn29231,18088609,70135426,52046817,TN
chr06,Bn29232,85143207,88577034,3433827,TN
chr06,Bn29233,59582102,80218929,20636827,TNL
chr06,Bn29234,99548590,99853210,304620,CNL
chr06,Bn29235,95966306,98706730,2740424,RLK
chr06,Bn29236,96950459,97440467,490008,CN
chr06,Bn29237,44117112,71457474,27340362,CN
chr06,Bn29238,27962208,45360427,17398219,TNL
chr06,Bn29239,30800141,97877681,67077540,CN
chr06,Bn29240,47096038,68229263,21133225,RLP
chr06,Bn29241,17643854,62026620,44382766,NBS
chr06,Bn29242,72561155,81765033,9203878,RLK
chr06,Bn29243,49044701,98263757,49219056,TN
chr06,Bn29244,81099646,91650887,10551241,CN
chr06,Bn29245,43001077,49875143,6874066,RLK
chr06,Bn29246,55682673,70138873,14456200,CN
chr06,Bn29247,4108297,65577042,61468745,RLK
chr06,Bn29248,28503070,93667042,65163972,CN
chr06,Bn29249,16090576,49769779,33679203,NBS
chr06,Bn29250,11986486,14747217,2760731,RLP
chr06,Bn29251,25998012,42169301,16171289,CNL
chr06,Bn29252,6590820,74494143,67903323,RLK
chr06,Bn29253,36156136,99686052,63529916,NBS
chr06,Bn29254,2058879,25223202,23164323,TN
chr06,Bn29255,74786762,86276478,11489716,TN
chr06,Bn29256,32551475,66502402,33950927,TNL
chr06,Bn29257,28879216,85523737,56644521,TNL
chr06,Bn29258,78313707,82925350,4611643,TN
chr06,Bn29259,76605985,80959829,4353844,CNL
chr06,Bn29260,37036954,98652018,61615064,RLK
chr06,Bn29261,80248381,87213104,6964723,RLP
chr06,Bn29262,89844126,90564495,720369,RLK
chr06,Bn29263,1862488,90940383,89077895,NBS
chr06,Bn29264,44706118,71218828,26512710,CN
chr06,Bn29265,71948825,86275096,14326271,CNL
chr06,Bn29266,55566361,99836056,44269695,CN
chr06,Bn29267,93474636,94969953,1495317,RLK
chr06,Bn29268,45400845,56201610,10800765,RLP
chr06,Bn29269,18171107,26030702,7859595,CNL
chr06,Bn29270,7283048,24367270,17084222,CNL
chr06,Bn29271,97801181,99890817,2089636,RLK
chr06,Bn29272,61896758,74700443,12803685,CNL
chr06,Bn29273,65934253,82673019,16738766,NBS
chr06,Bn29274,30783106,73526372,42743266,RLK
chr06,Bn29275,59628664,90531593,30902929,RLK
chr06,Bn29276,51641946,76662400,25020454,RLP
chr06,Bn29277,51154931,79337701,28182770,RLK
chr06,Bn29278,86799438,99495897,12696459,RLP
chr06,Bn29279,45769293,86756156,40986863,RLP
chr06,Bn29280,17286942,33575775,16288833,TNL
chr06,Bn29281,27148518,33265275,6116757,RLP
chr06,Bn29282,66021453,86024059,20002606,CNL
chr06,Bn29283,58569697,60334443,1764746,CN
chr06,Bn29284,47496446,52326524,4830078,CNL
chr06,Bn29285,77834260,95554802,17720542,CNL
chr06,Bn29286,51522248,67963773,16441525,RLK
chr06,Bn29287,42605074,66387605,23782531,CNL
chr06,Bn29288,36522132,67450750,30928618,RLP
chr06,Bn29289,93726079,93933078,206999,RLP
chr06,Bn29290,9324954,71059257,61734303,RLP
chr06,Bn29291,29842740,86834909,56992169,NBS
chr06,Bn29292,84791172,94927440,10136268,NBS
chr06,Bn29293,88915887,98629603,9713716,RLK
chr06,Bn29294,87564765,93023420,5458655,CNL
chr06,Bn29295,76841083,99356449,22515366,CNL
chr06,Bn29296,21841520,54733751,32892231,NBS
chr06,Bn29297,13249030,73099410,59850380,RLP
chr06,Bn29298,6211887,55678709,49466822,TNL
chr06,Bn29299,56848742,77896641,21047899,RLK
chr06,Bn29300,78035692,87973019,9937327,RLK
chr06,Bn29301,43773715,84069791,40296076,RLP
chr06,Bn29302,12642853,55853683,43210830,CN
chr06,Bn29303,77935571,94032032,16096461,CN
chr06,Bn29304,54244205,82918997,28674792,TN
chr06,Bn29305,69754411,91642249,21887838,RLP
chr06,Bn29306,79837093,85756342,5919249,RLK
chr06,Bn29307,41431013,56443905,15012892,TN
chr06,Bn29308,24502140,35082700,10580560,CN
chr06,Bn29309,46838131,78428408,31590277,TN
chr06,Bn29310,84067953,94372015,10304062,NBS
chr06,Bn29311,88595772,89329927,734155,NBS
chr06,Bn29312,73695344,99401848,25706504,CNL
chr06,Bn29313,14552467,78514000,63961533,TN
chr06,Bn29314,97808926,98382780,573854,TN
chr06,Bn29315,57207315,73979607,16772292,RLP
chr06,Bn29316,86643547,94114461,7470914,RLP
chr06,Bn29317,72287916,78118149,5830233,CN
chr06,Bn29318,53719779,82272274,28552495,CNL
chr06,Bn29319,50365976,52713406,2347430,TN
chr06,Bn29320,18971930,31420111,12448181,RLP
chr06,Bn29321,95083321,99414728,4331407,CNL
chr06,Bn29322,17295189,17761100,465911,CNL
chr06,Bn29323,65304468,69827544,4523076,NBS
chr06,Bn29324,75232932,76229030,996098,TN
chr06,Bn29325,33578706,71211852,37633146,RLK
chr06,Bn29326,87301853,95248384,7946531,TNL
chr06,Bn29327,50513017,64406247,13893230,CN
chr06,Bn29328,92024524,97882162,5857638,RLK
chr06,Bn29329,55763551,62799434,7035883,RLK
chr06,Bn29330,76965063,94849971,17884908,TNL
chr06,Bn29331,18193401,46811722,28618321,RLP
chr06,Bn29332,9189366,75080387,65891021,CNL
chr06,Bn29333,19539809,55482004,35942195,NBS
chr06,Bn29334,9196964,88429945,79232981,RLP
chr06,Bn29335,67633709,95930703,28296994,RLP
chr06,Bn29336,23490071,43867643,20377572,CNL
chr06,Bn29337,50786184,70822636,20036452,CN
chr06,Bn29338,86218804,91682715,5463911,RLP
chr06,Bn29339,36948830,91284363,54335533,TN
chr06,Bn29340,66651711,80440832,13789121,NBS
chr06,Bn29341,87884550,91830199,3945649,CNL
chr06,Bn29342,3311198,90693103,87381905,NBS
chr06,Bn29343,62640316,65522290,2881974,RLK
chr06,Bn29344,35365171,95400292,60035121,TNL
chr06,Bn29345,72798779,92957218,20158439,NBS
chr06,Bn29346,41499500,91089449,49589949,TN
chr06,Bn29347,12952362,79476277,66523915,TNL
chr06,Bn29348,27599530,41385738,13786208,NBS
chr06,Bn29349,77821033,89737132,11916099,TN
chr06,Bn29350,72016866,83550790,11533924,TNL
chr06,Bn29351,71636913,88898413,17261500,TNL
chr06,Bn29352,18401016,28075597,9674581,CN
chr06,Bn29353,32810235,57708030,24897795,CN
chr06,Bn29354,28351932,52029855,23677923,CN
chr06,Bn29355,8030160,14282511,6252351,TNL
chr06,Bn29356,74027462,87283258,13255796,NBS
chr06,Bn29357,53672780,85045984,31373204,TN
chr06,Bn29358,38583169,62351754,23768585,NBS
chr06,Bn29359,57232518,76013166,18780648,RLP
chr06,Bn29360,81322081,84963001,3640920,NBS
chr06,Bn29361,48690643,56680171,7989528,CNL
chr06,Bn29362,10184001,14666496,4482495,NBS
chr06,Bn29363,99083352,99948227,864875,RLK
chr06,Bn29364,80068992,86810795,6741803,RLK
chr06,Bn29365,31399805,74387578,42987773,TNL
chr06,Bn29366,92617666,97917417,5299751,CN
chr06,Bn29367,25917046,54451603,28534557,TNL
chr06,Bn29368,92591822,94182006,1590184,CNL
chr06,Bn29369,8615942,64231926,55615984,CN
chr06,Bn29370,28091933,44974716,16882783,CN
chr06,Bn29371,36756427,48430431,11674004,NBS
chr06,Bn29372,44699118,76011916,31312798,NBS
chr06,Bn29373,22091477,85721743,63630266,TNL
chr06,Bn29374,56770231,98128398,41358167,TNL
chr06,Bn29375,51526824,73927222,22400398,NBS
chr06,Bn29376,77945683,92312246,14366563,CNL
chr06,Bn29377,78454010,78645747,191737,CN
chr06,Bn29378,37213711,76496146,39282435,CNL
chr06,Bn29379,44434491,50875906,6441415,RLK
chr06,Bn29380,47742687,63756742,16014055,TNL
chr06,Bn29381,56593865,74424439,17830574,NBS
chr06,Bn29382,35750395,50053336,14302941,CN
chr06,Bn29383,93107883,94279990,1172107,TN
chr06,Bn29384,49622001,64069925,14447924,CNL
chr06,Bn29385,74106343,75449184,1342841,TNL
chr06,Bn29386,83139698,90708084,7568386,NBS
chr06,Bn29387,81908989,89619994,7711005,TNL
chr06,Bn29388,72005545,85918944,13913399,RLP
chr06,Bn29389,51469336,97875158,46405822,TN
chr06,Bn29390,86241080,96989868,10748788,RLK
chr06,Bn29391,59879707,80280858,20401151,CN
chr06,Bn29392,72043679,76859593,4815914,RLP
chr06,Bn29393,53725719,63778279,10052560,TN
chr06,Bn29394,91751422,98291919,6540497,RLP
chr06,Bn29395,34432214,45220851,10788637,TNL
chr06,Bn29396,1235898,69954889,68718991,CNL
chr06,Bn29397,14660827,37790548,23129721,RLP
chr06,Bn29398,49430574,74969657,25539083,TNL
chr06,Bn29399,46215544,52915483,6699939,NBS
chr06,Bn29400,6321847,66969418,60647571,CNL
chr06,Bn29401,94128489,94426747,298258,CNL
chr06,Bn29402,37903099,66593137,28690038,TNL
chr06,Bn29403,13262395,71311251,58048856,RLK
chr06,Bn29404,14669582,28279484,13609902,CN
chr06,Bn29405,34105668,59736736,25631068,RLP
chr06,Bn29406,20241175,78835941,58594766,RLP
chr06,Bn29407,98276820,99046274,769454,RLP
chr06,Bn29408,32786051,60628366,27842315,TNL
chr06,Bn29409,10781981,71527311,60745330,CN
chr06,Bn29410,63310236,64271804,961568,CN
chr06,Bn29411,70894584,87281604,16387020,RLK
chr06,Bn29412,26156992,90684848,64527856,CN
chr06,Bn29413,37022579,54091465,17068886,NBS
chr06,Bn29414,99029162,99192986,163824,CN
chr06,Bn29415,30923436,79423224,48499788,TNL
chr06,Bn29416,75844693,83492861,7648168,RLP
chr06,Bn29417,62286209,95083885,32797676,RLP
chr06,Bn29418,43047693,78249270,35201577,RLP
chr06,Bn29419,37457307,75944787,38487480,RLK
chr06,Bn29420,36760416,42161593,5401177,NBS
chr06,Bn29421,5108695,24627459,19518764,TN
chr06,Bn29422,5842761,40296034,34453273,TNL
chr06,Bn29423,21067156,53170628,32103472,TNL
chr06,Bn29424,74521665,94749394,20227729,RLK
chr06,Bn29425,26342621,98917807,72575186,RLK
chr06,Bn29426,48884528,59572349,10687821,TN
chr06,Bn29427,20389422,52686952,32297530,TN
chr06,Bn29428,48407571,95506284,47098713,TN
chr06,Bn29429,59992393,93065232,33072839,TNL
chr06,Bn29430,78951163,98526717,19575554,CNL
chr06,Bn29431,59353545,85965716,26612171,TN
chr06,Bn29432,47878499,68679756,20801257,CN
chr06,Bn29433,26705284,65105023,38399739,RLP
chr06,Bn29434,75672020,91635210,15963190,RLP
chr06,Bn29435,4352622,55714062,51361440,CNL
chr06,Bn29436,65940993,74158403,8217410,RLK
chr06,Bn29437,99191691,99670947,479256,CNL
chr06,Bn29438,36018114,39634972,3616858,NBS
chr06,Bn29439,2872989,8241516,5368527,CNL
chr06,Bn29440,76543049,93961359,17418310,CNL
chr06,Bn29441,33194465,54864642,21670177,RLP
chr06,Bn29442,59632270,67120142,7487872,CNL
chr06,Bn29443,42105799,83285322,41179523,CNL
chr06,Bn29444,65163083,65749264,586181,RLP
chr06,Bn29445,17448807,77940458,60491651,CN
chr06,Bn29446,28994152,64170944,35176792,TN
chr06,Bn29447,63709158,74583489,10874331,CNL
chr06,Bn29448,75816391,92770990,16954599,RLP
chr06,Bn29449,9609187,78297045,68687858,CN
chr06,Bn29450,73210774,84258679,11047905,TN
chr06,Bn29451,2014190,46728347,44714157,RLP
chr06,Bn29452,32641877,86944965,54303088,TNL
chr06,Bn29453,6790430,72871146,66080716,TN
chr06,Bn29454,37964935,66643744,28678809,RLP
chr06,Bn29455,37482885,42244265,4761380,RLK
chr06,Bn29456,57152011,99093910,41941899,RLK
chr06,Bn29457,68467183,91042668,22575485,CNL
chr06,Bn29458,5871993,75338078,69466085,TN
chr06,Bn29459,38742112,64736090,25993978,CN
chr06,Bn29460,16608166,89776045,73167879,RLK
chr06,Bn29461,53583255,99631191,46047936,NBS
chr06,Bn29462,97486779,99584473,2097694,CN
chr06,Bn29463,3040156,5284135,2243979,CN
chr06,Bn29464,57399736,74072014,16672278,CNL
chr06,Bn29465,29209555,46131908,16922353,CN
chr06,Bn29466,52463305,89624683,37161378,CN
chr06,Bn29467,12025752,49666462,37640710,TN
chr06,Bn29468,39868796,82636343,42767547,TNL
chr06,Bn29469,23183835,28916652,5732817,CNL
chr06,Bn29470,88414813,89601777,1186964,RLP
chr06,Bn29471,69279616,98031645,28752029,TN
chr06,Bn29472,6001441,74963433,68961992,CN
chr06,Bn29473,8472175,59876890,51404715,CN
chr06,Bn29474,54778242,63770301,8992059,TNL
chr06,Bn29475,96441648,96580327,138679,CN
chr06,Bn29476,69408597,82713551,13304954,RLK
chr06,Bn29477,80413628,82370334,1956706,TN
chr06,Bn29478,61197645,92283476,31085831,CN
chr06,Bn29479,32876455,75066346,42189891,RLP
chr06,Bn29480,65052812,76046908,10994096,CN
chr06,Bn29481,6199324,33574737,27375413,NBS
chr06,Bn29482,55883686,98837072,42953386,CN
chr06,Bn29483,6929292,22594618,15665326,NBS
chr06,Bn29484,5657128,74090351,68433223,TN
chr06,Bn29485,75698949,99367841,23668892,TNL
chr06,Bn29486,61790716,62745496,954780,CN
chr06,Bn29487,31474796,82067133,50592337,RLK
chr06,Bn29488,32036170,73868407,41832237,TNL
chr06,Bn29489,65060698,67857088,2796390,CNL
chr06,Bn29490,12798259,50852177,38053918,CN
chr06,Bn29491,26144306,68660024,42515718,NBS
chr06,Bn29492,69599561,74073542,4473981,NBS
chr06,Bn29493,88283579,99416170,11132591,RLP
chr06,Bn29494,2060094,64709346,62649252,TN
chr06,Bn29495,14201618,83985204,69783586,TNL
chr06,Bn29496,46403925,90501505,44097580,TN
chr06,Bn29497,45386492,83811071,38424579,NBS
chr06,Bn29498,28672247,85573238,56900991,CNL
chr06,Bn29499,7100556,67615278,60514722,TNL
chr06,Bn29500,94729322,96459623,1730301,TN
chr06,Bn29501,70443718,86979479,16535761,TN
chr06,Bn29502,23801919,86819411,63017492,RLP
chr06,Bn29503,6746569,56982079,50235510,CN
chr06,Bn29504,40995963,92494758,51498795,RLK
chr06,Bn29505,95029026,95586888,557862,NBS
chr06,Bn29506,33937392,75170490,41233098,NBS
chr06,Bn29507,15127099,37437947,22310848,RLK
chr06,Bn29508,84020926,98586487,14565561,NBS
chr06,Bn29509,71597571,94692292,23094721,CNL
chr06,Bn29510,97136091,99051354,1915263,TN
chr06,Bn29511,44596389,71309914,26713525,CNL
chr06,Bn29512,27316000,35069522,7753522,NBS
chr06,Bn29513,38119992,50663935,12543943,CN
chr06,Bn29514,44617795,87347781,42729986,TNL
chr06,Bn29515,84424496,94627637,10203141,TNL
chr06,Bn29516,67503833,72106091,4602258,CN
chr06,Bn29517,80413545,90620977,10207432,RLK
chr06,Bn29518,6510340,10953577,4443237,CN
chr06,Bn29519,66472063,80745158,14273095,CNL
chr06,Bn29520,78355734,98264277,19908543,TN
chr06,Bn29521,73869433,96150028,22280595,CN
chr06,Bn29522,71232866,89209651,17976785,TN
chr06,Bn29523,80555044,87666651,7111607,CNL
chr06,Bn29524,48735936,57460009,8724073,TN
chr06,Bn29525,67357260,97578153,30220893,RLP
chr06,Bn29526,82079992,85254956,3174964,TNL
chr06,Bn29527,93465901,95923961,2458060,TN
chr06,Bn29528,96950897,98207178,1256281,CN
chr06,Bn29529,31107574,54976989,23869415,RLP
chr06,Bn29530,28339503,79362072,51022569,CNL
chr06,Bn29531,48636731,99589144,50952413,CN
chr06,Bn29532,8492878,25744263,17251385,RLP
chr06,Bn29533,80255951,83403033,3147082,CN
chr06,Bn29534,40104036,45156665,5052629,RLK
chr06,Bn29535,12487338,22438646,9951308,TNL
chr06,Bn29536,46592625,83599863,37007238,CN
chr06,Bn29537,70274463,73960758,3686295,TN
chr06,Bn29538,65484899,90251697,24766798,TN
chr06,Bn29539,76260003,77079216,819213,RLP
chr06,Bn29540,60788635,84874058,24085423,RLP
chr06,Bn29541,40849824,60045298,19195474,CN
chr06,Bn29542,22901882,44496930,21595048,NBS
chr06,Bn29543,32414811,74695970,42281159,CN
chr06,Bn29544,62676409,90164395,27487986,CNL
chr06,Bn29545,53380676,70322677,16942001,RLP
chr06,Bn29546,63150793,75507399,12356606,RLP
chr06,Bn29547,30514523,32219712,1705189,TN
chr06,Bn29548,53060006,73653962,20593956,TNL
chr06,Bn29549,28470868,49335320,20864452,TN
chr06,Bn29550,21108054,54685397,33577343,RLK
chr06,Bn29551,49148481,90446119,41297638,CN
chr06,Bn29552,2842751,33022217,30179466,NBS
chr06,Bn29553,14387483,25002339,10614856,CNL
chr06,Bn29554,64191875,92510903,28319028,CNL
chr06,Bn29555,34161987,55068864,20906877,CNL
chr06,Bn29556,27153755,61925558,34771803,RLK
chr06,Bn29557,78007200,95124119,17116919,CNL
chr06,Bn29558,54832203,56224361,1392158,TN
chr06,Bn29559,9981437,46117107,36135670,NBS
chr06,Bn29560,23970137,95209623,71239486,RLK
chr06,Bn29561,48341062,86483806,38142744,RLK
chr06,Bn29562,4454304,36825211,32370907,CNL
chr06,Bn29563,29772431,35691831,5919400,NBS
chr06,Bn29564,91247359,98805529,7558170,CNL
chr06,Bn29565,27609051,78035589,50426538,RLP
chr06,Bn29566,21950437,69172570,47222133,TN
chr06,Bn29567,26979687,28049539,1069852,RLK
chr06,Bn29568,53525385,65050221,11524836,CNL
chr06,Bn29569,6413928,13483136,7069208,RLP
chr06,Bn29570,10631941,61099992,50468051,NBS
chr06,Bn29571,66950570,83584704,16634134,CN
chr06,Bn29572,84171097,96414952,12243855,TNL
chr06,Bn29573,70894715,79651067,8756352,RLP
chr06,Bn29574,23862619,69979881,46117262,CNL
chr06,Bn29575,39699453,45633268,5933815,RLK
chr06,Bn29576,81560899,94235488,12674589,RLK
chr06,Bn29577,17130142,98806624,81676482,RLP
chr06,Bn29578,83883682,92934540,9050858,RLP
chr06,Bn29579,43498394,43990083,491689,RLK
chr06,Bn29580,99461274,99516881,55607,CN
chr06,Bn29581,99612959,99819009,206050,TN
chr06,Bn29582,47044481,74411066,27366585,CN
chr06,Bn29583,86132727,91648897,5516170,TN
chr06,Bn29584,96856445,98738275,1881830,TN
chr06,Bn29585,35864286,74536179,38671893,CN
chr06,Bn29586,48178786,48731317,552531,RLP
chr06,Bn29587,20414613,75018772,54604159,TNL
chr06,Bn29588,94706784,95924883,1218099,RLP
chr06,Bn29589,26751415,64501441,37750026,NBS
chr06,Bn29590,63012545,76024442,13011897,NBS
chr06,Bn29591,15892531,38649998,22757467,TNL
chr06,Bn29592,13894719,85500381,71605662,CN
chr06,Bn29593,73695901,87795377,14099476,TN
chr06,Bn29594,9440616,63449650,54009034,CN
chr06,Bn29595,84418583,99465883,15047300,RLK
chr06,Bn29596,22073072,87512745,65439673,RLP
chr06,Bn29597,35112564,54588804,19476240,NBS
chr06,Bn29598,94177973,96434787,2256814,TNL
chr06,Bn29599,32990610,79419483,46428873,CNL
chr06,Bn29600,33729196,34132384,403188,CNL
chr06,Bn29601,16086673,91275188,75188515,NBS
chr06,Bn29602,5173976,22738199,17564223,RLK
chr06,Bn29603,89497251,92390348,2893097,RLP
chr06,Bn29604,84386530,89532879,5146349,CNL
chr06,Bn29605,12420175,40151114,27730939,RLK
chr06,Bn29606,17577766,99674351,82096585,RLK
chr06,Bn29607,96267081,99197929,2930848,CNL
chr06,Bn29608,44012269,98776466,54764197,CNL
chr06,Bn29609,67668670,92541448,24872778,TN
chr06,Bn29610,57753101,93111836,35358735,CNL
chr06,Bn29611,41928022,99572917,57644895,NBS
chr06,Bn29612,68631440,83769961,15138521,NBS
chr06,Bn29613,81020769,81191234,170465,NBS
chr06,Bn29614,9659799,50207595,40547796,CN
chr06,Bn29615,99990321,99994600,4279,CNL
chr06,Bn29616,33407912,40791436,7383524,RLK
chr06,Bn29617,80107489,95139716,15032227,RLK
chr06,Bn29618,39912838,50294780,10381942,TNL
chr06,Bn29619,72485598,72821887,336289,CN
chr06,Bn29620,86469532,96327330,9857798,NBS
chr06,Bn29621,84386876,88844924,4458048,CN
chr06,Bn29622,15805993,72653770,56847777,TNL
chr06,Bn29623,21386724,31654428,10267704,RLP
chr06,Bn29624,3816292,79126423,75310131,CN
chr06,Bn29625,91065788,91167933,102145,CNL
chr06,Bn29626,11443003,12216629,773626,CN
chr06,Bn29627,86436623,99437705,13001082,RLK
chr06,Bn29628,50057847,63375582,13317735,CN
chr06,Bn29629,40663595,42678009,2014414,NBS
chr06,Bn29630,69390685,78902402,9511717,TNL
chr06,Bn29631,79859419,84046347,4186928,TNL
chr06,Bn29632,97319203,99087753,1768550,TNL
chr06,Bn29633,29820104,55987849,26167745,RLK
chr06,Bn29634,14915054,89790628,74875574,CN
chr06,Bn29635,83223368,97344269,14120901,CN
chr06,Bn29636,20487946,38596935,18108989,RLK
chr06,Bn29637,63828464,93951805,30123341,CN
chr06,Bn29638,88749084,92973232,4224148,RLP
chr06,Bn29639,20404038,72690636,52286598,RLK
chr06,Bn29640,33632609,84589241,50956632,CNL
chr06,Bn29641,82978519,96828722,13850203,CN
chr06,Bn29642,90125532,96664507,6538975,NBS
chr06,Bn29643,61494935,63240329,1745394,TNL
chr06,Bn29644,78986833,98411379,19424546,CN
chr06,Bn29645,19641436,68263207,48621771,CN
chr06,Bn29646,3615302,83431361,79816059,RLK
chr06,Bn29647,37375774,67695460,30319686,NBS
chr06,Bn29648,18814857,60274381,41459524,NBS
chr06,Bn29649,25834320,46632070,20797750,CN
chr06,Bn29650,78136165,80033711,1897546,TN
chr06,Bn29651,58868618,88062425,29193807,RLK
chr06,Bn29652,26903752,96995562,70091810,RLK
chr06,Bn29653,84071558,96010360,11938802,CN
chr06,Bn29654,21635500,71682206,50046706,TN
chr06,Bn29655,33726284,68910846,35184562,TN
chr06,Bn29656,18408541,95238390,76829849,NBS
chr06,Bn29657,10399293,57829877,47430584,CN
chr06,Bn29658,10926524,75084506,64157982,RLP
chr06,Bn29659,27373032,31633340,4260308,NBS
chr06,Bn29660,33074576,43170062,10095486,NBS
chr06,Bn29661,80475179,98963817,18488638,TNL
chr06,Bn29662,61483639,96887633,35403994,CNL
chr06,Bn29663,4835653,34388602,29552949,CN
chr06,Bn29664,72225821,89028173,16802352,NBS
chr06,Bn29665,65785648,72275741,6490093,RLK
chr06,Bn29666,51348186,78692880,27344694,NBS
chr06,Bn29667,36066073,51320601,15254528,RLK
chr06,Bn29668,33644848,56767801,23122953,TN
chr06,Bn29669,3589943,55919281,52329338,CNL
chr06,Bn29670,50975006,65566176,14591170,RLP
chr06,Bn29671,6333851,85420847,79086996,NBS
chr06,Bn29672,74711786,97861367,23149581,TNL
chr06,Bn29673,60153428,76198793,16045365,RLK
chr06,Bn29674,92657570,94922399,2264829,CN
chr06,Bn29675,91323074,92086249,763175,TN
chr06,Bn29676,96588329,99033515,2445186,RLK
chr06,Bn29677,63717993,70211797,6493804,CN
chr06,Bn29678,18498674,88893454,70394780,RLP
chr06,Bn29679,88200819,93512586,5311767,TNL
chr06,Bn29680,50958948,91990271,41031323,NBS
chr06,Bn29681,40179856,84164304,43984448,CNL
chr06,Bn29682,64232358,90097187,25864829,NBS
chr06,Bn29683,14067129,67270003,53202874,CN
chr06,Bn29684,19043134,53750375,34707241,TNL
chr06,Bn29685,13974480,91144992,77170512,RLP
chr06,Bn29686,79803340,90732716,10929376,CN
chr06,Bn29687,40750092,67155728,26405636,TN
chr06,Bn29688,56073796,99755761,43681965,NBS
chr06,Bn29689,11906794,89218714,77311920,RLK
chr06,Bn29690,37030188,76819905,39789717,RLP
chr06,Bn29691,18710871,20996278,2285407,CNL
chr06,Bn29692,68523279,81101500,12578221,NBS
chr06,Bn29693,8286303,56081860,47795557,RLK
chr06,Bn29694,34335580,83231451,48895871,RLK
chr06,Bn29695,39843943,92540189,52696246,TNL
chr06,Bn29696,89314203,92604263,3290060,NBS
chr06,Bn29697,68965212,91427900,22462688,TNL
chr06,Bn29698,84856066,93880126,9024060,CNL
chr06,Bn29699,22181035,71347313,49166278,CN
chr06,Bn29700,78821998,89770995,10948997,TNL
chr06,Bn29701,17792541,70991369,53198828,TNL
chr06,Bn29702,59932709,95191524,35258815,TN
chr06,Bn29703,91470310,95461478,3991168,NBS
chr06,Bn29704,60333108,88653326,28320218,TNL
chr06,Bn29705,39489977,52177655,12687678,TNL
chr06,Bn29706,99450478,99456226,5748,RLK
chr06,Bn29707,54932322,78354632,23422310,TN
chr06,Bn29708,92360626,95632954,3272328,RLP
chr06,Bn29709,93792285,98841533,5049248,CN
chr06,Bn29710,25963744,43790865,17827121,RLP
chr06,Bn29711,34061607,66024420,31962813,RLP
chr06,Bn29712,85814928,88421813,2606885,CNL
chr06,Bn29713,8652609,35086713,26434104,TNL
chr06,Bn29714,84788791,98608320,13819529,TNL
chr06,Bn29715,44456704,72026721,27570017,CNL
chr06,Bn29716,67520956,99479504,31958548,RLP
chr06,Bn29717,53344292,83977864,30633572,NBS
chr06,Bn29718,11587752,97785074,86197322,CN
chr06,Bn29719,49776089,87736720,37960631,RLP
chr06,Bn29720,82118135,95857313,13739178,RLK
chr06,Bn29721,83414215,84115494,701279,NBS
chr06,Bn29722,64786965,82869542,18082577,TN
chr06,Bn29723,1942075,58676443,56734368,RLK
chr06,Bn29724,73980331,92050612,18070281,TN
chr06,Bn29725,21560477,60450941,38890464,TNL
chr06,Bn29726,82564531,86119370,3554839,CNL
chr06,Bn29727,86601338,86803846,202508,NBS
chr06,Bn29728,28939741,56425426,27485685,CNL
chr06,Bn29729,50609985,64401740,13791755,RLP
chr06,Bn29730,20678806,85376776,64697970,CNL
chr06,Bn29731,70395344,80749285,10353941,TNL
chr06,Bn29732,13560002,85484244,71924242,CN
chr06,Bn29733,57563811,96352051,38788240,TNL
chr06,Bn29734,1451948,98866218,97414270,TN
chr06,Bn29735,50116417,56241475,6125058,RLP
chr06,Bn29736,28631104,75604975,46973871,CN
chr06,Bn29737,56129749,80163171,24033422,TNL
chr06,Bn29738,37341796,47651612,10309816,CNL
chr06,Bn29739,31467109,35285096,3817987,CN
chr06,Bn29740,6614773,55380362,48765589,TNL
chr06,Bn29741,30728617,91783390,61054773,NBS
chr06,Bn29742,71703253,89059797,17356544,TN
chr06,Bn29743,74731401,82499914,7768513,RLP
chr06,Bn29744,35458362,40075304,4616942,CNL
chr06,Bn29745,66310743,93990164,27679421,TN
chr06,Bn29746,23597421,82098155,58500734,NBS
chr06,Bn29747,34328709,72982845,38654136,NBS
chr06,Bn29748,63027957,91643763,28615806,NBS
chr06,Bn29749,23970829,68157898,44187069,CNL
chr06,Bn29750,42693129,47612653,4919524,TN
chr06,Bn29751,53020872,62357513,9336641,CN
chr06,Bn29752,91248258,91923301,675043,TN
chr06,Bn29753,98845944,99606187,760243,RLP
chr06,Bn29754,4953892,77628220,72674328,CNL
chr06,Bn29755,69696951,72521139,2824188,CNL
chr06,Bn29756,33273330,57513954,24240624,NBS
chr06,Bn29757,60137863,82926852,22788989,CN
chr06,Bn29758,4436573,15081333,10644760,TN
chr06,Bn29759,79595064,90018790,10423726,CNL
chr06,Bn29760,77307609,91195679,13888070,CNL
chr06,Bn29761,72025576,82700509,10674933,TNL
chr06,Bn29762,17335885,18653025,1317140,NBS
chr06,Bn29763,81655820,82377165,721345,CN
chr06,Bn29764,27923294,41761647,13838353,CNL
chr06,Bn29765,85386619,97061663,11675044,RLK
chr06,Bn29766,1417838,63485603,62067765,RLK
chr06,Bn29767,77395833,90246661,12850828,TNL
chr06,Bn29768,70185548,85815467,15629919,CN
chr06,Bn29769,90051232,90797696,746464,NBS
chr06,Bn29770,99145020,99232454,87434,CNL
chr06,Bn29771,73697013,90806833,17109820,TN
chr06,Bn29772,71644962,87163358,15518396,CN
chr06,Bn29773,44122351,90362318,46239967,RLP
chr06,Bn29774,30659873,39219936,8560063,RLK
chr06,Bn29775,74581719,74651775,70056,RLK
chr06,Bn29776,40601777,84228179,43626402,NBS
chr06,Bn29777,36003086,85635992,49632906,RLP
chr06,Bn29778,21095556,81744802,60649246,RLK
chr06,Bn29779,67100368,94977227,27876859,TNL
chr06,Bn29780,75371595,85039613,9668018,CNL
chr06,Bn29781,7162428,40165668,33003240,CNL
chr06,Bn29782,25211952,51075295,25863343,NBS
chr06,Bn29783,16680323,49241361,32561038,RLK
chr06,Bn29784,18390881,58640443,40249562,CNL
chr06,Bn29785,45562540,93589833,48027293,TN
chr06,Bn29786,54560712,64786562,10225850,RLP
chr06,Bn29787,56707363,89159884,32452521,RLK
chr06,Bn29788,93152832,96836189,3683357,TNL
chr06,Bn29789,24455341,40332100,15876759,RLK
chr06,Bn29790,73447218,99223350,25776132,TN
chr06,Bn29791,76720226,77716957,996731,TN
chr06,Bn29792,73331531,78154304,4822773,RLK
chr06,Bn29793,9917678,47907615,37989937,CNL
chr06,Bn29794,49106215,85601756,36495541,TN
chr06,Bn29795,60981593,79758800,18777207,RLP
chr06,Bn29796,84070073,98836850,14766777,TN
chr06,Bn29797,39524708,57203688,17678980,CNL
chr06,Bn29798,3188359,78100572,74912213,RLK
chr06,Bn29799,24810379,85741535,60931156,CN
chr06,Bn29800,31076603,62375336,31298733,TNL
chr06,Bn29801,13938582,75500611,61562029,TNL
chr06,Bn29802,96547330,99946010,3398680,NBS
chr06,Bn29803,15204015,55433327,40229312,RLK
chr06,Bn29804,44552040,69400672,24848632,CN
chr06,Bn29805,78621621,83614687,4993066,CN
chr06,Bn29806,79046821,89087085,10040264,CN
chr06,Bn29807,45152762,48388564,3235802,NBS
chr06,Bn29808,99688092,99843633,155541,CNL
chr06,Bn29809,5675910,87976620,82300710,TNL
chr06,Bn29810,33454022,52222474,18768452,TN
chr06,Bn29811,74965440,92028336,17062896,TN
chr06,Bn29812,17421125,34332077,16910952,RLK
chr06,Bn29813,41945443,73010799,31065356,CNL
chr06,Bn29814,51508508,70034754,18526246,RLK
chr06,Bn29815,52145033,84156390,32011357,CN
chr06,Bn29816,45279755,99147251,53867496,TN
chr06,Bn29817,58652055,92108735,33456680,NBS
chr06,Bn29818,36354249,41578769,5224520,TNL
chr06,Bn29819,94671089,96890747,2219658,TN
chr06,Bn29820,21149929,78806270,57656341,CNL
chr06,Bn29821,45672499,58195272,12522773,RLP
chr06,Bn29822,13377349,13720945,343596,RLP
chr06,Bn29823,91656251,96780157,5123906,TN
chr06,Bn29824,1261037,42882803,41621766,TNL
chr06,Bn29825,92834864,93023143,188279,RLP
chr06,Bn29826,74453201,98939083,24485882,RLK
chr06,Bn29827,29045469,99093347,70047878,TN
chr06,Bn29828,52564148,79087278,26523130,CNL
chr06,Bn29829,7993982,65300334,57306352,RLP
chr06,Bn29830,96847758,98953336,2105578,RLP
chr06,Bn29831,81944913,97248233,15303320,RLP
chr06,Bn29832,60892422,79478862,18586440,TN
chr06,Bn29833,36042028,72189992,36147964,CN
chr06,Bn29834,49784862,95006290,45221428,CN
chr06,Bn29835,24983734,70544031,45560297,TN
chr06,Bn29836,17009218,29990934,12981716,TNL
chr06,Bn29837,16440031,68662468,52222437,CNL
chr06,Bn29838,65704299,84633786,18929487,TNL
chr06,Bn29839,96613131,98060939,1447808,NBS
chr06,Bn29840,16037967,57907241,41869274,CNL
chr06,Bn29841,4017958,17820039,13802081,RLP
chr06,Bn29842,7680920,44327639,36646719,TN
chr06,Bn29843,48064348,97087061,49022713,NBS
chr06,Bn29844,25387427,76946093,51558666,RLP
chr06,Bn29845,8202581,29616781,21414200,NBS
chr06,Bn29846,32456777,83606972,51150195,RLP
chr06,Bn29847,23342692,55209202,31866510,TN
chr06,Bn29848,86663339,91143469,4480130,TN
chr06,Bn29849,57029655,59239830,2210175,TN
chr06,Bn29850,1695001,45613570,43918569,RLK
chr06,Bn29851,2386018,85878178,83492160,TN
chr06,Bn29852,45206314,45801062,594748,CN
chr06,Bn29853,29973920,41940587,11966667,TN
chr06,Bn29854,92299499,96680508,4381009,CNL
chr06,Bn29855,3102999,85844999,82742000,CNL
chr06,Bn29856,82666056,96095011,13428955,RLP
chr06,Bn29857,91704420,96483592,4779172,CNL
chr06,Bn29858,10815587,92538983,81723396,CNL
chr06,Bn29859,88798747,95125177,6326430,CNL
chr06,Bn29860,49348629,85990745,36642116,TN
chr06,Bn29861,77720969,97086138,19365169,RLP
chr06,Bn29862,61905704,94516429,32610725,CN
chr06,Bn29863,58905733,63287599,4381866,RLP
chr06,Bn29864,81880220,98448499,16568279,RLK
chr06,Bn29865,39941953,83217688,43275735,RLK
chr06,Bn29866,82680591,91246313,8565722,RLP
chr06,Bn29867,17102588,84873291,67770703,TNL
chr06,Bn29868,92497747,94316505,1818758,NBS
chr06,Bn29869,78775788,96471096,17695308,TNL
chr06,Bn29870,94164334,98214492,4050158,NBS
chr06,Bn29871,43134804,77410942,34276138,TN
chr06,Bn29872,19990572,95067394,75076822,NBS
chr06,Bn29873,31991046,50586137,18595091,CNL
chr06,Bn29874,34842486,47791124,12948638,RLP
chr06,Bn29875,31463469,48039265,16575796,TNL
chr06,Bn29876,65412381,98502682,33090301,CN
chr06,Bn29877,99089807,99749565,659758,NBS
chr06,Bn29878,9709693,63069463,53359770,RLK
chr06,Bn29879,4812715,95270179,90457464,NBS
chr06,Bn29880,15315308,17648341,2333033,RLK
chr06,Bn29881,17402886,78417507,61014621,NBS
chr06,Bn29882,78902275,93752769,14850494,CN
chr06,Bn29883,86607748,88921865,2314117,NBS
chr06,Bn29884,87304536,89182988,1878452,TN
chr06,Bn29885,33100187,55572847,22472660,NBS
chr06,Bn29886,11304125,89194141,77890016,RLK
chr06,Bn29887,25996177,57346279,31350102,TNL
chr06,Bn29888,52560993,72948967,20387974,TN
chr06,Bn29889,58762637,70635942,11873305,CNL
chr06,Bn29890,33261433,79423865,46162432,RLK
chr06,Bn29891,93600028,96378239,2778211,TNL
chr06,Bn29892,85477795,94796664,9318869,NBS
chr06,Bn29893,63689557,76936404,13246847,NBS
chr06,Bn29894,2792401,84429386,81636985,CNL
chr06,Bn29895,72767152,82135272,9368120,CN
chr06,Bn29896,15830759,19378206,3547447,NBS
chr06,Bn29897,95198380,98939612,3741232,RLP
chr06,Bn29898,19276895,93547499,74270604,TN
chr06,Bn29899,4856776,86747394,81890618,RLK
chr06,Bn29900,4350198,93171659,88821461,TN
chr06,Bn29901,1701041,18764716,17063675,RLP
chr06,Bn29902,11657219,38813936,27156717,NBS
chr06,Bn29903,2063869,23659840,21595971,NBS
chr06,Bn29904,4482674,45711803,41229129,TNL
chr06,Bn29905,2600529,29200562,26600033,NBS
chr06,Bn29906,63090236,89532535,26442299,CNL
chr06,Bn29907,41223745,78028578,36804833,RLP
chr06,Bn29908,90480311,95177952,4697641,RLK
chr06,Bn29909,34278539,99572908,65294369,CN
chr06,Bn29910,11682488,82596331,70913843,RLK
chr06,Bn29911,29193810,55229244,26035434,TNL
chr06,Bn29912,5373978,74256403,68882425,CN
chr06,Bn29913,64021183,82147513,18126330,NBS
chr06,Bn29914,40643478,64917741,24274263,NBS
chr06,Bn29915,29945475,36005503,6060028,TN
chr06,Bn29916,73036375,78445844,5409469,TN
chr06,Bn29917,12022901,17411725,5388824,CNL
chr06,Bn29918,41530597,88983643,47453046,CN
chr06,Bn29919,52014902,59877218,7862316,RLP
chr06,Bn29920,80940316,95857285,14916969,NBS
chr06,Bn29921,26614340,49222638,22608298,CN
chr06,Bn29922,82522768,82724278,201510,CNL
chr06,Bn29923,5709566,59115846,53406280,CN
chr06,Bn29924,64702993,79989513,15286520,CN
chr06,Bn29925,8743214,84839347,76096133,TNL
chr06,Bn29926,8160477,58745487,50585010,TNL
chr06,Bn29927,65518144,89913388,24395244,CN
chr06,Bn29928,41324372,91872012,50547640,CN
chr06,Bn29929,44856518,78616166,33759648,NBS
chr06,Bn29930,60726529,99923714,39197185,RLK
chr06,Bn29931,81070719,92019880,10949161,TN
chr06,Bn29932,5174307,48935842,43761535,NBS
chr06,Bn29933,52522847,56090028,3567181,CN
chr06,Bn29934,10056163,13655914,3599751,CN
chr06,Bn29935,60311149,62685133,2373984,NBS
chr06,Bn29936,61043023,70351643,9308620,TNL
chr06,Bn29937,99468140,99663170,195030,TNL
chr06,Bn29938,3933678,10521172,6587494,TNL
chr06,Bn29939,38129843,51353726,13223883,CNL
chr06,Bn29940,37617518,63935765,26318247,CN
chr06,Bn29941,1811411,10817850,9006439,TNL
chr06,Bn29942,10550129,71276504,60726375,TN
chr06,Bn29943,56596728,91769011,35172283,TN
chr06,Bn29944,80986786,96240404,15253618,CN
chr06,Bn29945,34247924,53089359,18841435,RLK
chr06,Bn29946,77455487,78006244,550757,NBS
chr06,Bn29947,24225957,96355559,72129602,RLK
chr06,Bn29948,77559399,78261231,701832,TN
chr06,Bn29949,10020730,54494185,44473455,RLP
chr06,Bn29950,6078775,71494665,65415890,RLP
chr06,Bn29951,54389062,80136480,25747418,CN
chr06,Bn29952,51696963,55365458,3668495,TNL
chr06,Bn29953,37743669,43280684,5537015,TNL
chr06,Bn29954,15713243,98198654,82485411,CN
chr06,Bn29955,26709995,32572416,5862421,CNL
chr06,Bn29956,99973663,99978997,5334,RLK
chr06,Bn29957,42623011,70847684,28224673,CNL
chr06,Bn29958,23114532,64144792,41030260,TN
chr06,Bn29959,49950014,85632636,35682622,NBS
chr06,Bn29960,6650909,96404628,89753719,CNL
chr06,Bn29961,93061734,94057114,995380,TNL
chr06,Bn29962,99623120,99824360,201240,TNL
chr06,Bn29963,95818975,98293240,2474265,RLK
chr06,Bn29964,64030268,92064556,28034288,RLK
chr06,Bn29965,4338650,96799623,92460973,CNL
chr06,Bn29966,77475272,82806603,5331331,TNL
chr06,Bn29967,85887070,94169495,8282425,TN
chr06,Bn29968,94896577,95200901,304324,TNL
chr06,Bn29969,84196118,85444522,1248404,RLP
chr06,Bn29970,27186468,98426886,71240418,CNL
chr06,Bn29971,61744012,74816687,13072675,RLP
chr06,Bn29972,14373257,21767385,7394128,CN
chr06,Bn29973,33438030,66469700,33031670,TN
chr06,Bn29974,90756795,91291230,534435,NBS
chr06,Bn29975,80107649,96875281,16767632,NBS
chr06,Bn29976,37511934,88337027,50825093,CN
chr06,Bn29977,59461401,80982497,21521096,CN
chr06,Bn29978,35582295,53923137,18340842,CNL
chr06,Bn29979,47155460,98960987,51805527,NBS
chr06,Bn29980,48095360,89459735,41364375,RLK
chr06,Bn29981,34723237,63136492,28413255,RLP
chr06,Bn29982,28666785,82078498,53411713,TNL
chr06,Bn29983,24458312,79354135,54895823,CN
chr06,Bn29984,28498930,33638790,5139860,RLP
chr06,Bn29985,43201955,44442815,1240860,CNL
chr06,Bn29986,38584790,41624805,3040015,CN
chr06,Bn29987,42966366,82406174,39439808,TN
chr06,Bn29988,5283779,15909685,10625906,RLP
chr06,Bn29989,38664610,83843469,45178859,TNL
chr06,Bn29990,50803669,77691741,26888072,TNL
chr06,Bn29991,1941284,88300582,86359298,TN
chr06,Bn29992,47446738,90631579,43184841,RLP
chr06,Bn29993,30941151,85545284,54604133,CN
chr06,Bn29994,34840805,75960745,41119940,RLK
chr06,Bn29995,9799048,62291784,52492736,CNL
chr06,Bn29996,82614571,83234469,619898,TN
chr06,Bn29997,82812444,96787500,13975056,TNL
chr06,Bn29998,55557614,61683782,6126168,CN
chr06,Bn29999,84880334,99445446,14565112,TNL
chr06,Bn30000,54291840,96711387,42419547,CNL
chr06,Bn30001,72371531,77060260,4688729,RLP
chr06,Bn30002,93521554,97023621,3502067,RLP
chr06,Bn30003,62823894,99904876,37080982,TN
chr06,Bn30004,20364535,24630241,4265706,TNL
chr06,Bn30005,60208800,70938185,10729385,TNL
chr06,Bn30006,12236220,42880834,30644614,TNL
chr06,Bn30007,44874957,77718697,32843740,CN
chr06,Bn30008,24018949,51909638,27890689,CNL
chr06,Bn30009,52308934,68672805,16363871,TNL
chr06,Bn30010,9438684,20972480,11533796,CN
chr06,Bn30011,79798453,83111752,3313299,RLK
chr06,Bn30012,84663913,87759306,3095393,CN
chr06,Bn30013,86444839,92496613,6051774,TN
chr06,Bn30014,2145930,70150507,68004577,NBS
chr06,Bn30015,96108376,97657406,1549030,RLK
chr06,Bn30016,8104572,66351790,58247218,TN
chr06,Bn30017,72844571,92668279,19823708,NBS
chr06,Bn30018,10096624,21564135,11467511,RLK
chr06,Bn30019,43514556,80965551,37450995,RLP
chr06,Bn30020,90393684,91473854,1080170,NBS
chr06,Bn30021,8997981,58026913,49028932,TN
chr06,Bn30022,42327968,77224457,34896489,RLP
chr06,Bn30023,28543555,67599877,39056322,RLP
chr06,Bn30024,31138867,31521907,383040,RLK
chr06,Bn30025,38657150,41189143,2531993,CNL
chr06,Bn30026,23711120,48062820,24351700,RLP
chr06,Bn30027,61204344,98692821,37488477,NBS
chr06,Bn30028,40796264,50419941,9623677,TNL
chr06,Bn30029,47091323,48992124,1900801,RLP
chr06,Bn30030,14523817,26686479,12162662,RLP
chr06,Bn30031,11903724,84166486,72262762,CN
chr06,Bn30032,68941381,69452983,511602,RLK
chr06,Bn30033,21028114,71055053,50026939,CN
chr06,Bn30034,85168137,86913906,1745769,TNL
chr06,Bn30035,29896891,79875940,49979049,CN
chr06,Bn30036,25929418,38864030,12934612,CNL
chr06,Bn30037,81079480,83018714,1939234,TN
chr06,Bn30038,32915978,79487062,46571084,RLP
chr06,Bn30039,16400035,91409377,75009342,CN
chr06,Bn30040,1147204,93261246,92114042,RLP
chr06,Bn30041,81948319,91517532,9569213,TN
chr06,Bn30042,55108500,91085401,35976901,RLP
chr06,Bn30043,71872384,97681457,25809073,RLK
chr06,Bn30044,46305200,52090178,5784978,RLK
chr06,Bn30045,72740481,98938307,26197826,TN
chr06,Bn30046,2344872,79235050,76890178,TNL
chr06,Bn30047,25093588,61201920,36108332,RLP
chr06,Bn30048,90172549,91849494,1676945,CN
chr06,Bn30049,15238842,64398226,49159384,RLK
chr06,Bn30050,57189112,94498605,37309493,RLP
chr06,Bn30051,52608222,74631489,22023267,RLK
chr06,Bn30052,42576343,95648017,53071674,TN
chr06,Bn30053,7914208,25069104,17154896,RLP
chr06,Bn30054,23284612,95718041,72433429,RLK
chr06,Bn30055,22704805,40120455,17415650,CNL
chr06,Bn30056,29784298,40168873,10384575,RLK
chr06,Bn30057,18620936,49822902,31201966,TN
chr06,Bn30058,74017587,94429751,20412164,RLK
chr06,Bn30059,67724650,71450628,3725978,TNL
chr06,Bn30060,24871636,91520554,66648918,CN
chr06,Bn30061,46152640,89221833,43069193,NBS
chr06,Bn30062,20996849,91684175,70687326,TN
chr06,Bn30063,27769800,68028958,40259158,CNL
chr06,Bn30064,99285825,99486137,200312,TNL
chr06,Bn30065,59711741,98452957,38741216,TNL
chr06,Bn30066,36060391,41446662,5386271,RLK
chr06,Bn30067,47534991,82819577,35284586,NBS
chr06,Bn30068,69554726,77735946,8181220,NBS
chr06,Bn30069,4506360,99147103,94640743,TN
chr06,Bn30070,6740887,74139212,67398325,TNL
chr06,Bn30071,13198966,38217595,25018629,RLP
chr06,Bn30072,4490571,49469850,44979279,CN
chr06,Bn30073,74131228,87206019,13074791,TN
chr06,Bn30074,97808995,99495538,1686543,NBS
chr06,Bn30075,16038761,23935451,7896690,TN
chr06,Bn30076,69337128,76162463,6825335,CNL
chr06,Bn30077,45890886,96436663,50545777,RLK
chr06,Bn30078,37352266,42003411,4651145,RLP
chr06,Bn30079,45523379,51225786,5702407,NBS
chr06,Bn30080,66938810,95729792,28790982,TN
chr06,Bn30081,33357846,96942908,63585062,TNL
chr06,Bn30082,85124420,85837421,713001,NBS
chr06,Bn30083,70213589,75164526,4950937,NBS
chr06,Bn30084,3126052,58251045,55124993,TN
chr06,Bn30085,2825258,48441127,45615869,RLK
chr06,Bn30086,42219834,83135866,40916032,RLP
chr06,Bn30087,13037700,91533085,78495385,CNL
chr06,Bn30088,29985982,99104275,69118293,TNL
chr06,Bn30089,57463074,95239955,37776881,RLK
chr06,Bn30090,16808063,55429890,38621827,RLK
chr06,Bn30091,47034987,98994379,51959392,TNL
chr06,Bn30092,27418682,33451702,6033020,NBS
chr06,Bn30093,70537669,72800279,2262610,CNL
chr06,Bn30094,43502592,79082266,35579674,CNL
chr06,Bn30095,94531610,95319615,788005,RLP
chr06,Bn30096,90525772,98705177,8179405,CN
chr06,Bn30097,37788203,74624273,36836070,NBS
chr06,Bn30098,69483187,85910255,16427068,RLP
chr06,Bn30099,63644513,87473524,23829011,RLP
chr06,Bn30100,19252302,32269426,13017124,TNL
chr06,Bn30101,76320008,85389517,9069509,TNL
chr06,Bn30102,87143850,97724668,10580818,NBS
chr06,Bn30103,5901479,50309678,44408199,RLP
chr06,Bn30104,20608887,89715145,69106258,TNL
chr06,Bn30105,25613995,37729450,12115455,NBS
chr06,Bn30106,16327294,74580640,58253346,RLK
chr06,Bn30107,74466117,84071289,9605172,CN
chr06,Bn30108,71388254,78568903,7180649,RLP
chr06,Bn30109,82205747,96742377,14536630,NBS
chr06,Bn30110,42553874,83140405,40586531,CN
chr06,Bn30111,18398203,86571178,68172975,CN
chr06,Bn30112,87480522,91831994,4351472,CN
chr06,Bn30113,86678187,93482142,6803955,CNL
chr06,Bn30114,44000201,97016344,53016143,CNL
chr06,Bn30115,82168089,89712923,7544834,RLP
chr06,Bn30116,33811687,58343740,24532053,RLP
chr06,Bn30117,24421129,66419598,41998469,CNL
chr06,Bn30118,19915501,73040032,53124531,RLK
chr06,Bn30119,45461683,90017681,44555998,TNL
chr06,Bn30120,61675797,94142104,32466307,TN
chr06,Bn30121,74238969,76544942,2305973,TNL
chr06,Bn30122,33856876,72259560,38402684,CN
chr06,Bn30123,43054097,59715155,16661058,TNL
chr06,Bn30124,47487630,85354401,37866771,TN
chr06,Bn30125,64699557,75446128,10746571,TN
chr06,Bn30126,34180621,77808317,43627696,CNL
chr06,Bn30127,54052490,88718014,34665524,CNL
chr06,Bn30128,85839980,93587838,7747858,NBS
chr06,Bn30129,12448694,73377058,60928364,NBS
chr06,Bn30130,80116863,98881212,18764349,RLP
chr06,Bn30131,75183955,76017569,833614,RLK
chr06,Bn30132,82927904,83614174,686270,NBS
chr06,Bn30133,39482964,51394567,11911603,TNL
chr06,Bn30134,54087155,61681257,7594102,RLP
chr06,Bn30135,56299210,58624887,2325677,RLP
chr06,Bn30136,6277374,26140856,19863482,RLP
chr06,Bn30137,99670903,99914458,243555,TNL
chr06,Bn30138,41778909,42355539,576630,CNL
chr06,Bn30139,33398222,81240088,47841866,TNL
chr06,Bn30140,9814289,11348591,1534302,NBS
chr06,Bn30141,14091320,70103065,56011745,TN
chr06,Bn30142,21312842,56954427,35641585,TN
chr06,Bn30143,22719978,63505870,40785892,RLP
chr06,Bn30144,54780782,74487605,19706823,TN
chr06,Bn30145,70032555,94582322,24549767,RLP
chr06,Bn30146,35350797,72581878,37231081,TN
chr06,Bn30147,14463462,78767365,64303903,RLP
chr06,Bn30148,40525500,72355361,31829861,RLP
chr06,Bn30149,30051881,79130898,49079017,CN
chr06,Bn30150,74277656,99742815,25465159,RLP
chr06,Bn30151,57488821,68156446,10667625,RLP
chr06,Bn30152,39104302,39517520,413218,RLP
chr06,Bn30153,38351578,90799586,52448008,CN
chr06,Bn30154,16968911,50874007,33905096,RLP
chr06,Bn30155,35679943,48088417,12408474,NBS
chr06,Bn30156,17654120,67977092,50322972,RLP
chr06,Bn30157,55002669,64364531,9361862,RLK
chr06,Bn30158,7355352,16457533,9102181,TNL
chr06,Bn30159,2741399,8612751,5871352,RLK
chr06,Bn30160,50684563,78926078,28241515,TNL
chr06,Bn30161,44785855,81313655,36527800,RLK
chr06,Bn30162,2333787,53902077,51568290,TNL
chr06,Bn30163,23453670,28295556,4841886,TN
chr06,Bn30164,63272018,81647762,18375744,TNL
chr06,Bn30165,3240109,64882695,61642586,TN
chr06,Bn30166,52160798,99787965,47627167,TN
chr06,Bn30167,20669142,29089109,8419967,NBS
chr06,Bn30168,73801674,79589755,5788081,TN
chr06,Bn30169,71012118,83319417,12307299,RLK
chr06,Bn30170,63602966,94855292,31252326,TN
chr06,Bn30171,62296071,84804643,22508572,RLK
chr06,Bn30172,80212744,88862007,8649263,RLP
chr06,Bn30173,43321051,83336563,40015512,RLK
chr06,Bn30174,11044218,27822268,16778050,CNL
chr06,Bn30175,6059987,79486568,73426581,CN
chr06,Bn30176,6621368,96819960,90198592,RLP
chr06,Bn30177,44220691,81849890,37629199,RLP
chr06,Bn30178,88201714,92071460,3869746,RLP
chr06,Bn30179,5137303,50241516,45104213,RLK
chr06,Bn30180,29333344,87376338,58042994,CN
chr06,Bn30181,35153964,74385194,39231230,CNL
chr06,Bn30182,42104912,60392777,18287865,RLP
chr06,Bn30183,42966800,98255961,55289161,RLK
chr06,Bn30184,43360145,74413541,31053396,RLK
chr06,Bn30185,21732432,89231519,67499087,CNL
chr06,Bn30186,8477634,17021391,8543757,RLK
chr06,Bn30187,54507758,99546735,45038977,NBS
chr06,Bn30188,63652829,81660796,18007967,TN
chr06,Bn30189,47579690,91181468,43601778,NBS
chr06,Bn30190,57011275,88111442,31100167,RLP
chr06,Bn30191,47678002,55221274,7543272,RLP
chr06,Bn30192,18531954,23408364,4876410,CN
chr06,Bn30193,53178622,87530496,34351874,CN
chr06,Bn30194,55358659,68103832,12745173,TNL
chr06,Bn30195,72530145,78349780,5819635,NBS
chr06,Bn30196,61658344,68900060,7241716,TNL
chr06,Bn30197,70830567,98149638,27319071,NBS
chr06,Bn30198,22873047,33621508,10748461,TN
chr06,Bn30199,56696910,92466849,35769939,TN
chr06,Bn30200,8019259,91508807,83489548,TN
chr06,Bn30201,27324527,34668650,7344123,RLK
chr06,Bn30202,10968309,60741464,49773155,CNL
chr06,Bn30203,93401374,95620388,2219014,CN
chr06,Bn30204,14227289,47844824,33617535,TNL
chr06,Bn30205,88238041,96171199,7933158,TN
chr06,Bn30206,17756957,69141943,51384986,TNL
chr06,Bn30207,14732096,72766554,58034458,CNL
chr06,Bn30208,48393763,55470053,7076290,TN
chr06,Bn30209,33299463,94201891,60902428,NBS
chr06,Bn30210,82623740,88586945,5963205,TN
chr06,Bn30211,70889395,99927460,29038065,RLP
chr06,Bn30212,76449877,91577330,15127453,RLP
chr06,Bn30213,74150426,77165338,3014912,TNL
chr06,Bn30214,72085663,83497572,11411909,NBS
chr06,Bn30215,21919511,66862032,44942521,TN
chr06,Bn30216,53724478,65219033,11494555,TNL
chr06,Bn30217,18037073,59013601,40976528,RLK
chr06,Bn30218,36087370,50046215,13958845,CNL
chr06,Bn30219,94342182,99257871,4915689,CNL
chr06,Bn30220,63455111,84314821,20859710,CNL
chr06,Bn30221,22476453,56988883,34512430,TNL
chr06,Bn30222,30986089,82363525,51377436,RLK
chr06,Bn30223,46000051,58759527,12759476,RLP
chr06,Bn30224,78585539,89977623,11392084,CNL
chr06,Bn30225,11934546,50910382,38975836,RLK
chr06,Bn30226,94453432,99698574,5245142,RLP
chr06,Bn30227,72199961,76973532,4773571,CN
chr06,Bn30228,42843240,49700426,6857186,TN
chr06,Bn30229,79335936,82144835,2808899,TN
chr06,Bn30230,68405443,99898589,31493146,RLP
chr06,Bn30231,98996060,99777112,781052,TNL
chr06,Bn30232,99931694,99963104,31410,CNL
chr06,Bn30233,25908591,66681336,40772745,CNL
chr06,Bn30234,33479773,79002291,45522518,NBS
chr06,Bn30235,51555592,58856623,7301031,NBS
chr06,Bn30236,64152286,68440627,4288341,NBS
chr06,Bn30237,15485405,79916844,64431439,RLK
chr06,Bn30238,51231443,92413122,41181679,CN
chr06,Bn30239,31856461,63232274,31375813,CNL
chr06,Bn30240,71133589,74384003,3250414,RLK
chr06,Bn30241,52023565,56933517,4909952,RLK
chr06,Bn30242,32874651,56528983,23654332,RLK
chr06,Bn30243,33635398,85233163,51597765,CN
chr06,Bn30244,16412288,98392665,81980377,TNL
chr06,Bn30245,77831595,89633121,11801526,TNL
chr06,Bn30246,25386627,84255371,58868744,TN
chr06,Bn30247,7133235,7950758,817523,TN
chr06,Bn30248,28659454,63359324,34699870,RLP
chr06,Bn30249,68104024,70290545,2186521,CNL
chr06,Bn30250,96264743,96935645,670902,TNL
chr06,Bn30251,51529386,68184862,16655476,TN
chr06,Bn30252,10808008,18241114,7433106,CNL
chr06,Bn30253,15311985,28047629,12735644,RLP
chr06,Bn30254,31608078,60392912,28784834,CNL
chr06,Bn30255,46141031,94122569,47981538,RLP
chr06,Bn30256,91298793,96740378,5441585,RLP
chr06,Bn30257,55648511,56000201,351690,TN
chr06,Bn30258,65394329,97315572,31921243,NBS
chr06,Bn30259,49244434,75483669,26239235,CNL
chr06,Bn30260,39144510,39273891,129381,TNL
chr06,Bn30261,53362020,64356202,10994182,CN
chr06,Bn30262,31875078,56577910,24702832,TN
chr06,Bn30263,43838058,57807219,13969161,CN
chr06,Bn30264,91661278,99406365,7745087,TNL
chr06,Bn30265,3263815,26526932,23263117,RLK
chr06,Bn30266,59708255,76381551,16673296,TNL
chr06,Bn30267,56100236,75420843,19320607,CNL
chr06,Bn30268,33880823,67753042,33872219,NBS
chr06,Bn30269,52849007,68361942,15512935,TNL
chr06,Bn30270,41069287,61918509,20849222,TN
chr06,Bn30271,50680649,87419112,36738463,TN
chr06,Bn30272,11603415,87425395,75821980,TN
chr06,Bn30273,68395613,78495652,10100039,TN
chr06,Bn30274,12696658,88625381,75928723,NBS
chr06,Bn30275,96399019,97924919,1525900,RLK
chr06,Bn30276,49891033,75778440,25887407,TNL
chr06,Bn30277,63691817,80483938,16792121,RLK
chr06,Bn30278,70769286,72067851,1298565,TN
chr06,Bn30279,65032622,67462012,2429390,RLK
chr06,Bn30280,86602824,91344806,4741982,CN
chr06,Bn30281,75634639,78011843,2377204,TNL
chr06,Bn30282,21134628,21258424,123796,RLP
chr06,Bn30283,53632103,58489569,4857466,RLK
chr06,Bn30284,23015333,88245009,65229676,RLK
chr06,Bn30285,69737334,98549890,28812556,CN
chr06,Bn30286,17061521,76405674,59344153,TN
chr06,Bn30287,55627704,63843810,8216106,RLK
chr06,Bn30288,89401711,90726727,1325016,CN
chr06,Bn30289,59429655,96419321,36989666,CNL
chr06,Bn30290,40695017,46596560,5901543,RLP
chr06,Bn30291,98007130,99851873,1844743,NBS
chr06,Bn30292,49940139,98342852,48402713,NBS
chr06,Bn30293,48843241,94566679,45723438,RLP
chr06,Bn30294,32801109,85266815,52465706,RLP
chr06,Bn30295,14593942,80960394,66366452,RLK
chr06,Bn30296,38027233,85500899,47473666,RLP
chr06,Bn30297,37351462,59626292,22274830,CNL
chr06,Bn30298,25823562,62529924,36706362,CNL
chr06,Bn30299,14852839,41610230,26757391,CNL
chr06,Bn30300,96201257,97620051,1418794,TNL
chr06,Bn30301,28509897,42758313,14248416,NBS
chr06,Bn30302,99620801,99659517,38716,CN
chr06,Bn30303,50061562,73912587,23851025,NBS
chr06,Bn30304,55901815,78167471,22265656,RLP
chr06,Bn30305,71704348,84427285,12722937,CN
chr06,Bn30306,98930431,99022622,92191,TN
chr06,Bn30307,95764448,96332501,568053,TN
chr06,Bn30308,88077400,96102151,8024751,RLK
chr06,Bn30309,22359511,84227801,61868290,TN
chr06,Bn30310,71484258,75364972,3880714,TN
chr06,Bn30311,57117905,92081358,34963453,TN
chr06,Bn30312,61663378,79004932,17341554,RLP
chr06,Bn30313,11044811,25549918,14505107,CNL
chr06,Bn30314,17536354,72610788,55074434,CNL
chr06,Bn30315,6924809,98518931,91594122,RLP
chr06,Bn30316,21514315,47950276,26435961,RLP
chr06,Bn30317,5839559,38661963,32822404,RLP
chr06,Bn30318,87077381,97775937,10698556,RLK
chr06,Bn30319,89816346,97519354,7703008,CN
chr06,Bn30320,23154181,90742683,67588502,CN
chr06,Bn30321,72428515,96632394,24203879,NBS
chr06,Bn30322,83478930,90937488,7458558,NBS
chr06,Bn30323,86906858,87579234,672376,CN
chr06,Bn30324,59824975,68217680,8392705,RLP
chr06,Bn30325,13476913,66697983,53221070,RLK
chr06,Bn30326,48211239,59235952,11024713,RLK
chr06,Bn30327,92689788,99436753,6746965,CNL
chr06,Bn30328,15348634,63298181,47949547,RLK
chr06,Bn30329,46750710,51257278,4506568,CN
chr06,Bn30330,45247353,70941013,25693660,CNL
chr06,Bn30331,20655459,24467178,3811719,TNL
chr06,Bn30332,29346339,38425371,9079032,RLP
chr06,Bn30333,33659930,41008319,7348389,NBS
chr06,Bn30334,15391966,42047082,26655116,TN
chr06,Bn30335,54829560,89451845,34622285,TN
chr06,Bn30336,93558940,98009657,4450717,RLP
chr06,Bn30337,23606729,41028532,17421803,TNL
chr06,Bn30338,99317055,99668902,351847,RLK
chr06,Bn30339,39177772,53567039,14389267,RLK
chr06,Bn30340,51426034,60691361,9265327,CN
chr06,Bn30341,81837619,86974436,5136817,CNL
chr06,Bn30342,51776203,55906259,4130056,TN
chr06,Bn30343,70597507,83661576,13064069,TN
chr06,Bn30344,76329517,81455528,5126011,TN
chr06,Bn30345,86833362,89513331,2679969,RLK
chr06,Bn30346,9758256,50635577,40877321,RLK
chr06,Bn30347,31152198,74952267,43800069,TN
chr06,Bn30348,42420417,76122966,33702549,TNL
chr06,Bn30349,79755410,89640395,9884985,RLK
chr06,Bn30350,17446173,60828711,43382538,CNL
chr06,Bn30351,82403937,94465971,12062034,CN
chr06,Bn30352,19521988,48473021,28951033,NBS
chr06,Bn30353,53248009,91303754,38055745,CN
chr06,Bn30354,16326777,75588729,59261952,CNL
chr06,Bn30355,55683141,72842176,17159035,RLP
chr06,Bn30356,29778449,85479895,55701446,RLK
chr06,Bn30357,55817644,74437794,18620150,CN
chr06,Bn30358,46751052,84315786,37564734,TNL
chr06,Bn30359,8486112,53841561,45355449,NBS
chr06,Bn30360,55369547,62907382,7537835,NBS
chr06,Bn30361,78176347,85334799,7158452,RLP
chr06,Bn30362,25426561,78133044,52706483,CNL
chr06,Bn30363,58827776,98687299,39859523,TN
chr06,Bn30364,41998414,78813539,36815125,RLK
chr06,Bn30365,29899584,97932239,68032655,CNL
chr06,Bn30366,64331165,99037588,34706423,CNL
chr06,Bn30367,59954303,73270600,13316297,TNL
chr06,Bn30368,95957107,97342863,1385756,RLK
chr06,Bn30369,61136600,91190340,30053740,RLK
chr06,Bn30370,94934990,99345949,4410959,CN
chr06,Bn30371,10030359,17844409,7814050,RLK
chr06,Bn30372,17031518,31112090,14080572,TN
chr06,Bn30373,47148310,73586169,26437859,TN
chr06,Bn30374,33990684,64524809,30534125,RLP
chr06,Bn30375,42540171,92533494,49993323,TNL
chr06,Bn30376,47768409,54701658,6933249,CNL
chr06,Bn30377,26563530,43666378,17102848,RLK
chr06,Bn30378,42739828,74489803,31749975,TN
chr06,Bn30379,86004447,99671917,13667470,TN
chr06,Bn30380,10082622,38975422,28892800,TNL
chr06,Bn30381,92579515,95921048,3341533,RLP
chr06,Bn30382,42303861,68122028,25818167,TN
chr06,Bn30383,9111710,58102424,48990714,CNL
chr06,Bn30384,97769163,98791147,1021984,TNL
chr06,Bn30385,46394485,83109422,36714937,CN
chr06,Bn30386,41591235,69348198,27756963,TNL
chr06,Bn30387,20833737,73523220,52689483,RLK
chr06,Bn30388,29404802,93444772,64039970,CNL
chr06,Bn30389,8140485,91740023,83599538,TNL
chr06,Bn30390,17744973,66990509,49245536,CNL
chr06,Bn30391,29955216,96728348,66773132,TNL
chr06,Bn30392,69599402,98383868,28784466,TN
chr06,Bn30393,44074945,80149792,36074847,NBS
chr06,Bn30394,58477030,73029679,14552649,TNL
chr06,Bn30395,67065191,97589141,30523950,RLK
chr06,Bn30396,1011731,90191986,89180255,RLP
chr06,Bn30397,84766839,94940748,10173909,NBS
chr06,Bn30398,25861535,39724551,13863016,CNL
chr06,Bn30399,10138818,86388489,76249671,CN
chr06,Bn30400,51914988,80712619,28797631,RLK
chr06,Bn30401,93475904,98490163,5014259,TN
chr06,Bn30402,98957144,99051810,94666,RLP
chr06,Bn30403,34463808,70503566,36039758,RLK
chr06,Bn30404,21969438,89897075,67927637,CN
chr06,Bn30405,51258068,80780674,29522606,CNL
chr06,Bn30406,65642128,86968282,21326154,CNL
chr06,Bn30407,47213446,67072308,19858862,TNL
chr06,Bn30408,22138959,37591538,15452579,RLK
chr06,Bn30409,46371377,59898609,13527232,RLK
chr06,Bn30410,18006497,55728246,37721749,TNL
chr06,Bn30411,80443761,98950378,18506617,RLK
chr06,Bn30412,12643814,68673740,56029926,TNL
chr06,Bn30413,60171828,70866066,10694238,TN
chr06,Bn30414,20151947,88976713,68824766,CN
chr06,Bn30415,98208148,98284241,76093,CN
chr06,Bn30416,3778107,98711194,94933087,CNL
chr06,Bn30417,20773958,34236714,13462756,RLK
chr06,Bn30418,26234888,89570899,63336011,CN
chr06,Bn30419,80519084,92541515,12022431,TNL
chr06,Bn30420,39812222,78126537,38314315,TN
chr06,Bn30421,59686533,78070947,18384414,TNL
chr06,Bn30422,7472509,30735343,23262834,RLK
chr06,Bn30423,21256092,23155876,1899784,CNL
chr06,Bn30424,25522606,67512607,41990001,NBS
chr06,Bn30425,34236491,53979159,19742668,NBS
chr06,Bn30426,41513812,61747397,20233585,TNL
chr06,Bn30427,68480520,76029813,7549293,RLP
chr06,Bn30428,67596261,78314735,10718474,RLK
chr06,Bn30429,55865744,69811094,13945350,CNL
chr06,Bn30430,33972746,63806781,29834035,NBS
chr06,Bn30431,90233533,94691955,4458422,RLP
chr06,Bn30432,68600042,92923053,24323011,TN
chr06,Bn30433,44121265,55145647,11024382,RLP
chr06,Bn30434,54359495,70801485,16441990,RLP
chr06,Bn30435,77456976,78254724,797748,CN
chr06,Bn30436,3973433,73777189,69803756,NBS
chr06,Bn30437,46216050,71005790,24789740,TNL
chr06,Bn30438,56828376,78368107,21539731,RLK
chr06,Bn30439,54202035,92944476,38742441,NBS
chr06,Bn30440,27605371,63046409,35441038,TN
chr06,Bn30441,35094411,83650570,48556159,CN
chr06,Bn30442,40187797,73405551,33217754,TNL
chr06,Bn30443,53783000,91221915,37438915,CN
chr06,Bn30444,43051447,83711477,40660030,CN
chr06,Bn30445,61668556,64078626,2410070,TNL
chr06,Bn30446,63653301,87635249,23981948,NBS
chr06,Bn30447,67229916,68240158,1010242,RLK
chr06,Bn30448,13450063,72876133,59426070,TN
chr06,Bn30449,3849059,50865213,47016154,NBS
chr06,Bn30450,74447673,91273788,16826115,CNL
chr06,Bn30451,65285803,69359302,4073499,CN
chr06,Bn30452,40177567,65399734,25222167,RLP
chr06,Bn30453,40059307,65948360,25889053,RLP
chr06,Bn30454,46691958,70738683,24046725,CNL
chr06,Bn30455,49799234,95989111,46189877,RLK
chr06,Bn30456,46806668,90770654,43963986,TNL
chr06,Bn30457,35363517,58481338,23117821,CNL
chr06,Bn30458,3700110,55721543,52021433,TN
chr06,Bn30459,26389834,34728250,8338416,TNL
chr06,Bn30460,33410072,56259968,22849896,TN
chr06,Bn30461,67998214,83706010,15707796,TN
chr06,Bn30462,80121034,91118770,10997736,RLK
chr06,Bn30463,35425341,55928078,20502737,NBS
chr06,Bn30464,97413928,97969077,555149,RLP
chr06,Bn30465,94605132,96950429,2345297,RLK
chr06,Bn30466,5447589,95475488,90027899,TN
chr06,Bn30467,47543081,57540821,9997740,TNL
chr06,Bn30468,68697026,73313030,4616004,TNL
chr06,Bn30469,44214415,81247944,37033529,TNL
chr06,Bn30470,86818776,89585917,2767141,TN
chr06,Bn30471,26803297,77524818,50721521,RLK
chr06,Bn30472,82665452,86418070,3752618,RLK
chr06,Bn30473,52111604,73411786,21300182,TN
chr06,Bn30474,10709425,39096871,28387446,CN
chr06,Bn30475,84674035,90546816,5872781,NBS
chr06,Bn30476,68667229,80127175,11459946,NBS
chr06,Bn30477,70606292,77248760,6642468,RLP
chr06,Bn30478,84904072,95047753,10143681,CNL
chr06,Bn30479,55283879,89969308,34685429,TN
chr06,Bn30480,33012149,78724134,45711985,RLK
chr06,Bn30481,66057033,82066471,16009438,TN
chr06,Bn30482,72290767,96053273,23762506,CN
chr06,Bn30483,44480705,95800305,51319600,TN
chr06,Bn30484,4761638,81651193,76889555,RLP
chr06,Bn30485,58527642,78022811,19495169,RLP
chr06,Bn30486,21706147,82282320,60576173,RLK
chr06,Bn30487,96955232,99868743,2913511,TN
chr06,Bn30488,24612035,95043119,70431084,TN
chr06,Bn30489,67885494,95462977,27577483,RLP
chr06,Bn30490,50757513,82122317,31364804,TN
chr06,Bn30491,92071299,94812960,2741661,CNL
chr06,Bn30492,3814821,29383156,25568335,CN
chr06,Bn30493,32475918,67595721,35119803,NBS
chr06,Bn30494,77052365,77210108,157743,TN
chr06,Bn30495,76242872,78071608,1828736,CNL
chr06,Bn30496,97309132,98786580,1477448,RLP
chr06,Bn30497,74844141,98863563,24019422,CN
chr06,Bn30498,14488082,25867892,11379810,TN
chr06,Bn30499,12565768,25581851,13016083,CNL
chr06,Bn30500,9416386,30736286,21319900,CN
chr06,Bn30501,98714924,99028207,313283,TNL
chr06,Bn30502,96127305,99245187,3117882,CN
chr06,Bn30503,77309821,86081760,8771939,TNL
chr06,Bn30504,94812539,97745918,2933379,RLK
chr06,Bn30505,75351557,89840586,14489029,CN
chr06,Bn30506,36890863,84994102,48103239,RLP
chr06,Bn30507,11655976,24783299,13127323,TN
chr06,Bn30508,78336987,94527478,16190491,TN
chr06,Bn30509,31826999,54903878,23076879,TNL
chr06,Bn30510,79116456,91375572,12259116,TNL
chr06,Bn30511,28981590,86923499,57941909,RLK
chr06,Bn30512,27096692,75293362,48196670,TNL
chr06,Bn30513,60248683,74780358,14531675,RLP
chr06,Bn30514,92238006,95516888,3278882,TNL
chr06,Bn30515,37150900,95311404,58160504,NBS
chr06,Bn30516,85879943,99671295,13791352,NBS
chr06,Bn30517,3079541,93977867,90898326,CNL
chr06,Bn30518,29493840,91510204,62016364,TN
chr06,Bn30519,52416034,66212526,13796492,RLP
chr06,Bn30520,38747984,63402193,24654209,CN
chr06,Bn30521,31090133,36628705,5538572,TNL
chr06,Bn30522,45587447,70776381,25188934,CN
chr06,Bn30523,74533607,87677590,13143983,CN
chr06,Bn30524,42582093,60720407,18138314,TN
chr06,Bn30525,37660125,69944017,32283892,TNL
chr06,Bn30526,71779299,77274362,5495063,CNL
chr06,Bn30527,64170283,72944921,8774638,CN
chr06,Bn30528,24736443,80894671,56158228,CN
chr06,Bn30529,98958718,99038317,79599,NBS
chr06,Bn30530,17000878,18500483,1499605,CN
chr06,Bn30531,17680703,59430145,41749442,TN
chr06,Bn30532,24842503,28672350,3829847,TNL
chr06,Bn30533,4329755,9707292,5377537,RLP
chr06,Bn30534,1969159,91966810,89997651,TN
chr06,Bn30535,20691599,54363476,33671877,CN
chr06,Bn30536,38523962,58075907,19551945,TN
chr06,Bn30537,81505528,91709410,10203882,NBS
chr06,Bn30538,31308328,34213528,2905200,TNL
chr06,Bn30539,45602445,47178452,1576007,TN
chr06,Bn30540,2119045,85643375,83524330,CN
chr06,Bn30541,27156456,99138365,71981909,CN
chr06,Bn30542,99495808,99682749,186941,TN
chr06,Bn30543,71290217,92047311,20757094,RLP
chr06,Bn30544,68319582,72695423,4375841,TNL
chr06,Bn30545,73141069,80039767,6898698,RLK
chr06,Bn30546,54927833,55967804,1039971,CN
chr06,Bn30547,30536444,60864026,30327582,NBS
chr06,Bn30548,40825701,52055448,11229747,CN
chr06,Bn30549,50735964,88983750,38247786,TNL
chr06,Bn30550,65576104,75811647,10235543,RLK
chr06,Bn30551,76004869,76846376,841507,RLK
chr06,Bn30552,8587540,30296443,21708903,CN
chr06,Bn30553,91827655,96563079,4735424,CNL
chr06,Bn30554,16475338,54724805,38249467,CNL
chr06,Bn30555,38414012,40974546,2560534,RLK
chr06,Bn30556,86608315,87679195,1070880,TN
chr06,Bn30557,19659256,46024270,26365014,RLK
chr06,Bn30558,13381068,87504228,74123160,TN
chr06,Bn30559,67962583,74827182,6864599,CNL
chr06,Bn30560,97784681,99517057,1732376,RLP
chr06,Bn30561,92749469,96618131,3868662,TN
chr06,Bn30562,22917936,94539887,71621951,NBS
chr06,Bn30563,24024851,83949274,59924423,CNL
chr06,Bn30564,59396259,64423527,5027268,RLK
chr06,Bn30565,17727689,86592048,68864359,CN
chr06,Bn30566,60521231,89039341,28518110,NBS
chr06,Bn30567,20343204,72820934,52477730,CNL
chr06,Bn30568,79528380,96599385,17071005,CNL
chr06,Bn30569,30259507,40444656,10185149,NBS
chr06,Bn30570,99626193,99915462,289269,RLP
chr06,Bn30571,16305572,87634471,71328899,CN
chr06,Bn30572,79420500,94330795,14910295,RLP
chr06,Bn30573,96577182,99731769,3154587,CN
chr06,Bn30574,75732675,90625256,14892581,RLP
chr06,Bn30575,50518863,86023111,35504248,NBS
chr06,Bn30576,18458992,50188317,31729325,RLP
chr06,Bn30577,93857524,96340485,2482961,RLP
chr06,Bn30578,35025388,51568940,16543552,TNL
chr06,Bn30579,25191463,67786764,42595301,NBS
chr06,Bn30580,27256609,81041806,53785197,TN
chr06,Bn30581,32570925,77964204,45393279,RLP
chr06,Bn30582,89630872,93219892,3589020,TN
chr06,Bn30583,13341505,98650535,85309030,CN
chr06,Bn30584,16099693,60678247,44578554,CN
chr06,Bn30585,4066831,27557322,23490491,RLP
chr06,Bn30586,72968160,87741844,14773684,TNL
chr06,Bn30587,47249370,89781154,42531784,TNL
chr06,Bn30588,79589790,81941950,2352160,CNL
chr06,Bn30589,14385438,95583183,81197745,RLK
chr06,Bn30590,11885404,23055636,11170232,CNL
chr06,Bn30591,38989327,83092086,44102759,TNL
chr06,Bn30592,16868215,91925640,75057425,TNL
chr06,Bn30593,5780651,12929663,7149012,NBS
chr06,Bn30594,16822515,37125340,20302825,CNL
chr06,Bn30595,41624521,46942471,5317950,CNL
chr06,Bn30596,45503444,93199986,47696542,RLK
chr06,Bn30597,20113698,63707922,43594224,RLK
chr06,Bn30598,7719053,36906563,29187510,TNL
chr06,Bn30599,47507962,53525636,6017674,NBS
chr06,Bn30600,81493500,90886609,9393109,RLK
chr06,Bn30601,20460027,85708434,65248407,CN
chr06,Bn30602,43762661,80762667,37000006,TNL
chr06,Bn30603,3946998,83693712,79746714,CN
chr06,Bn30604,54378539,71025899,16647360,CNL
chr06,Bn30605,6091065,10164088,4073023,CNL
chr06,Bn30606,88187095,90238410,2051315,TN
chr06,Bn30607,14865114,38322159,23457045,NBS
chr06,Bn30608,22719987,84434361,61714374,TNL
chr06,Bn30609,69316361,86981982,17665621,RLP
chr06,Bn30610,98889101,99446037,556936,RLP
chr06,Bn30611,67845644,90925774,23080130,NBS
chr06,Bn30612,59295983,77608892,18312909,RLP
chr06,Bn30613,57405787,98931380,41525593,CNL
chr06,Bn30614,94908684,95843539,934855,CNL
chr06,Bn30615,10459798,53337958,42878160,NBS
chr06,Bn30616,13791093,24124545,10333452,NBS
chr06,Bn30617,29282351,47341336,18058985,CN
chr06,Bn30618,31749886,82935357,51185471,CN
chr06,Bn30619,65889391,75692284,9802893,NBS
chr06,Bn30620,88863415,91578646,2715231,NBS
chr06,Bn30621,81701004,99425617,17724613,TNL
chr06,Bn30622,84729424,96872535,12143111,RLK
chr06,Bn30623,12820303,89461881,76641578,TN
chr06,Bn30624,31652205,96514111,64861906,RLP
chr06,Bn30625,53836557,59748248,5911691,CN
chr06,Bn30626,32811510,71929709,39118199,NBS
chr06,Bn30627,70549692,76841827,6292135,CN
chr06,Bn30628,1316900,79527067,78210167,NBS
chr06,Bn30629,74249836,89406822,15156986,TN
chr06,Bn30630,28534584,46780625,18246041,NBS
chr06,Bn30631,47610252,73605127,25994875,CN
chr06,Bn30632,67053012,78088040,11035028,CN
chr06,Bn30633,35350824,87645259,52294435,NBS
chr06,Bn30634,85719884,94430593,8710709,TN
chr06,Bn30635,50748296,54805990,4057694,TNL
chr06,Bn30636,75330153,88959032,13628879,RLK
chr06,Bn30637,83897505,95831407,11933902,RLK
chr06,Bn30638,26760187,76729849,49969662,CNL
chr06,Bn30639,1319703,86032089,84712386,RLK
chr06,Bn30640,1317790,1831351,513561,NBS
chr06,Bn30641,4705026,61398431,56693405,CN
chr06,Bn30642,6750859,48083023,41332164,RLP
chr06,Bn30643,86816390,90045703,3229313,TNL
chr06,Bn30644,61176006,84436243,23260237,NBS
chr06,Bn30645,97737510,99371695,1634185,RLK
chr06,Bn30646,53039491,92826278,39786787,TN
chr06,Bn30647,86014254,89059363,3045109,RLP
chr06,Bn30648,51978535,66778821,14800286,RLP
chr06,Bn30649,64780691,88055029,23274338,NBS
chr06,Bn30650,10070208,32412526,22342318,RLP
chr06,Bn30651,97136572,98327967,1191395,TNL
chr06,Bn30652,4197362,81214754,77017392,CNL
chr06,Bn30653,55568089,96653861,41085772,TNL
chr06,Bn30654,9352156,43766670,34414514,CNL
chr06,Bn30655,83665251,91451935,7786684,RLK
chr06,Bn30656,95849775,96921280,1071505,NBS
chr06,Bn30657,76262734,79661522,3398788,RLK
chr06,Bn30658,41063438,64533764,23470326,NBS
chr06,Bn30659,29579453,68657246,39077793,CN
chr06,Bn30660,4635954,39951339,35315385,NBS
chr06,Bn30661,49175322,97895313,48719991,CNL
chr06,Bn30662,35107534,52329692,17222158,TNL
chr06,Bn30663,63608648,92961296,29352648,RLP
chr06,Bn30664,29216740,82796621,53579881,RLP
chr06,Bn30665,24033173,28264300,4231127,CN
chr06,Bn30666,82162658,93299131,11136473,CN
chr06,Bn30667,86923428,94931220,8007792,RLP
chr06,Bn30668,75317602,86360059,11042457,TN
chr06,Bn30669,69752976,74778656,5025680,NBS
chr06,Bn30670,21655101,47733878,26078777,CNL
chr06,Bn30671,82750793,98188244,15437451,TN
chr06,Bn30672,8324225,31671278,23347053,CNL
chr06,Bn30673,58462008,82952202,24490194,TNL
chr06,Bn30674,52549319,92042150,39492831,RLK
chr06,Bn30675,6418958,34549700,28130742,TN
chr06,Bn30676,47553688,92332775,44779087,RLK
chr06,Bn30677,94098890,99996796,5897906,TNL
chr06,Bn30678,63870100,69858396,5988296,RLP
chr06,Bn30679,53410404,67217380,13806976,TNL
chr06,Bn30680,13580192,27771180,14190988,TN
chr06,Bn30681,96519965,99857495,3337530,TNL
chr06,Bn30682,4143235,61387288,57244053,RLK
chr06,Bn30683,9168014,26544468,17376454,RLK
chr06,Bn30684,25294048,92232685,66938637,TNL
chr06,Bn30685,12672794,40715580,28042786,RLP
chr06,Bn30686,25032193,58021674,32989481,TNL
chr06,Bn30687,40025394,52499709,12474315,TN
chr06,Bn30688,57206609,88986969,31780360,TNL
chr06,Bn30689,31656028,84825724,53169696,CNL
chr06,Bn30690,90666046,97181812,6515766,RLP
chr06,Bn30691,97629395,99156525,1527130,RLK
chr06,Bn30692,50243903,86926414,36682511,RLP
chr06,Bn30693,83709097,95040993,11331896,RLP
chr06,Bn30694,79014720,98958995,19944275,NBS
chr06,Bn30695,28352086,99340411,70988325,TNL
chr06,Bn30696,11358421,50967573,39609152,RLK
chr06,Bn30697,2934326,31625895,28691569,CNL
chr06,Bn30698,60184743,79587332,19402589,CNL
chr06,Bn30699,91895977,98877733,6981756,RLK
chr06,Bn30700,58882130,78327482,19445352,TN
chr06,Bn30701,16483773,25242761,8758988,CNL
chr06,Bn30702,97521134,97989210,468076,RLK
chr06,Bn30703,38353400,66930659,28577259,RLP
chr06,Bn30704,16387922,26531792,10143870,RLP
chr06,Bn30705,38015730,60696098,22680368,CNL
chr06,Bn30706,45029787,48262930,3233143,NBS
chr06,Bn30707,17435576,19865014,2429438,RLK
chr06,Bn30708,28071008,45645104,17574096,CNL
chr06,Bn30709,34030657,57119540,23088883,RLP
chr06,Bn30710,35678448,65964333,30285885,RLP
chr06,Bn30711,30122220,82447934,52325714,TN
chr06,Bn30712,16934077,22017285,5083208,TN
chr06,Bn30713,53597399,72258535,18661136,CNL
chr06,Bn30714,18960171,35709039,16748868,NBS
chr06,Bn30715,33434552,49402220,15967668,TN
chr06,Bn30716,6546344,81506265,74959921,RLP
chr06,Bn30717,98787754,99438525,650771,TNL
chr06,Bn30718,97338565,97774781,436216,CN
chr06,Bn30719,96505778,97972786,1467008,CN
chr06,Bn30720,61768474,69849405,8080931,CNL
chr06,Bn30721,89862625,99076968,9214343,RLK
chr06,Bn30722,59739136,85668988,25929852,CNL
chr06,Bn30723,90033293,99772225,9738932,NBS
chr06,Bn30724,24545660,57720571,33174911,CNL
chr06,Bn30725,66437438,74109586,7672148,CN
chr06,Bn30726,94296848,96907175,2610327,RLP
chr06,Bn30727,56748767,93379921,36631154,RLP
chr06,Bn30728,64254463,96374105,32119642,TN
chr06,Bn30729,99770830,99914338,143508,CNL
chr06,Bn30730,51012948,94404754,43391806,RLK
chr06,Bn30731,10966916,68158169,57191253,TNL
chr06,Bn30732,87983457,95386279,7402822,CN
chr06,Bn30733,61221117,74546387,13325270,TNL
chr06,Bn30734,86759920,96352953,9593033,NBS
chr06,Bn30735,7236731,49366461,42129730,TNL
chr06,Bn30736,54366884,64873096,10506212,NBS
chr06,Bn30737,14081872,74204460,60122588,TNL
chr06,Bn30738,75010471,86331558,11321087,CNL
chr06,Bn30739,79179805,87317585,8137780,RLP
chr06,Bn30740,1326388,6693156,5366768,NBS
chr06,Bn30741,44459669,58053545,13593876,RLK
chr06,Bn30742,82126796,84434567,2307771,CNL
chr06,Bn30743,10806045,59380501,48574456,RLK
chr06,Bn30744,82387687,88520649,6132962,CNL
chr06,Bn30745,9285589,98167901,88882312,NBS
chr06,Bn30746,16793685,57158469,40364784,RLP
chr06,Bn30747,31262298,73235928,41973630,NBS
chr06,Bn30748,62665989,88514866,25848877,RLK
chr06,Bn30749,39636328,59745902,20109574,TN
chr06,Bn30750,78805411,93819978,15014567,CNL
chr06,Bn30751,68202887,70043135,1840248,RLK
chr06,Bn30752,63256786,80494492,17237706,CNL
chr06,Bn30753,8949374,74334842,65385468,TN
chr06,Bn30754,97333500,99911382,2577882,CN
chr06,Bn30755,59669078,70660648,10991570,CNL
chr06,Bn30756,69325416,82785554,13460138,RLK
chr06,Bn30757,22445153,59994698,37549545,RLK
chr06,Bn30758,25980789,63181296,37200507,NBS
chr06,Bn30759,3395880,43858063,40462183,TN
chr06,Bn30760,6637387,37201782,30564395,CNL
chr06,Bn30761,49840759,77124799,27284040,TNL
chr06,Bn30762,42948204,67194397,24246193,CN
chr06,Bn30763,53438535,59691149,6252614,CN
chr06,Bn30764,99619027,99970037,351010,TNL
chr06,Bn30765,18527373,60530699,42003326,CN
chr06,Bn30766,17656808,31293669,13636861,NBS
chr06,Bn30767,85301355,97863357,12562002,CN
chr06,Bn30768,12473070,60983821,48510751,TNL
chr06,Bn30769,67949780,93046817,25097037,NBS
chr06,Bn30770,56195657,85502965,29307308,TN
chr06,Bn30771,29645351,65864643,36219292,TNL
chr06,Bn30772,7808482,36806273,28997791,CN
chr06,Bn30773,75298330,89708478,14410148,CN
chr06,Bn30774,51006442,58885380,7878938,NBS
chr06,Bn30775,55729464,66373881,10644417,TNL
chr06,Bn30776,92349639,95803559,3453920,NBS
chr06,Bn30777,58193390,74151096,15957706,RLP
chr06,Bn30778,17493712,39577419,22083707,CN
chr06,Bn30779,47433174,97345647,49912473,RLK
chr06,Bn30780,8946545,28584115,19637570,TN
chr06,Bn30781,34978041,41929015,6950974,CN
chr06,Bn30782,24637689,59594481,34956792,RLK
chr06,Bn30783,78551891,87932377,9380486,CNL
chr06,Bn30784,84906219,91778207,6871988,CN
chr06,Bn30785,86517471,87619567,1102096,TN
chr06,Bn30786,98152066,99973305,1821239,CNL
chr06,Bn30787,51544269,94862430,43318161,RLK
chr06,Bn30788,61405531,65128652,3723121,CN
chr06,Bn30789,43419904,91953449,48533545,RLP
chr06,Bn30790,3451879,45799608,42347729,NBS
chr06,Bn30791,36308701,48995575,12686874,CNL
chr06,Bn30792,51985248,95701196,43715948,TN
chr06,Bn30793,77979814,98188452,20208638,NBS
chr06,Bn30794,24470653,42914170,18443517,RLP
chr06,Bn30795,20051515,80560471,60508956,TNL
chr06,Bn30796,86656490,87498383,841893,CN
chr06,Bn30797,82668692,87805233,5136541,RLK
chr06,Bn30798,26351872,95258513,68906641,RLK
chr06,Bn30799,90816526,93657005,2840479,TN
chr06,Bn30800,34205796,56169106,21963310,RLP
chr06,Bn30801,51438107,75813838,24375731,NBS
chr06,Bn30802,42785547,73395526,30609979,RLK
chr06,Bn30803,38783396,97285010,58501614,CN
chr06,Bn30804,39331547,62333103,23001556,RLP
chr06,Bn30805,59697430,96049682,36352252,NBS
chr06,Bn30806,15636638,68841797,53205159,NBS
chr06,Bn30807,47776015,53583274,5807259,CNL
chr06,Bn30808,8034262,18970549,10936287,CNL
chr06,Bn30809,23303398,97024304,73720906,TN
chr06,Bn30810,37895087,84104307,46209220,RLK
chr06,Bn30811,73218265,74722073,1503808,TNL
chr06,Bn30812,44920863,77898295,32977432,TN
chr06,Bn30813,22463487,41585212,19121725,NBS
chr06,Bn30814,40801912,62712729,21910817,TN
chr06,Bn30815,71761388,71808913,47525,NBS
chr06,Bn30816,46099719,61821037,15721318,TN
chr06,Bn30817,72053689,87623970,15570281,CNL
chr06,Bn30818,80511082,84640885,4129803,CNL
chr06,Bn30819,7124624,90432827,83308203,TN
chr06,Bn30820,20605858,30615867,10010009,CNL
chr06,Bn30821,35361319,44564344,9203025,RLP
chr06,Bn30822,2187733,96791513,94603780,TN
chr06,Bn30823,57839839,77004286,19164447,CNL
chr06,Bn30824,25470194,93185074,67714880,TN
chr06,Bn30825,70902633,84898150,13995517,CNL
chr06,Bn30826,19744927,65763473,46018546,RLK
chr06,Bn30827,29739158,57266033,27526875,RLK
chr06,Bn30828,2876467,27850526,24974059,CNL
chr06,Bn30829,52346426,75291548,22945122,TNL
chr06,Bn30830,76679959,90505326,13825367,RLK
chr06,Bn30831,74695237,82913895,8218658,CN
chr06,Bn30832,64090670,99374315,35283645,CN
chr06,Bn30833,28506833,66557842,38051009,CN
chr06,Bn30834,31776798,73447557,41670759,CNL
chr06,Bn30835,7191822,10952260,3760438,RLK
chr06,Bn30836,70705598,90278518,19572920,NBS
chr06,Bn30837,19952329,83374327,63421998,RLP
chr06,Bn30838,33071190,39776047,6704857,CN
chr06,Bn30839,95872560,95886430,13870,RLP
chr06,Bn30840,69722942,87322116,17599174,TNL
chr06,Bn30841,39684278,88119088,48434810,TN
chr06,Bn30842,5008025,61167812,56159787,NBS
chr06,Bn30843,63066463,97778214,34711751,CNL
chr06,Bn30844,75014916,83324226,8309310,CN
chr06,Bn30845,24178819,81237375,57058556,RLK
chr06,Bn30846,4930227,13045470,8115243,NBS
chr06,Bn30847,54179835,90260832,36080997,TNL
chr06,Bn30848,20149137,25642276,5493139,NBS
chr06,Bn30849,47913023,89176875,41263852,RLP
chr06,Bn30850,8509594,92154133,83644539,RLP
chr06,Bn30851,54422762,80502317,26079555,TNL
chr06,Bn30852,3216877,42975256,39758379,TNL
chr06,Bn30853,91732365,93914134,2181769,TN
chr06,Bn30854,14157985,25628869,11470884,RLK
chr06,Bn30855,71363674,85924582,14560908,TNL
chr06,Bn30856,90877838,93413631,2535793,TNL
chr06,Bn30857,77975094,97725031,19749937,RLK
chr06,Bn30858,11896378,22738939,10842561,CNL
chr06,Bn30859,92953471,98656412,5702941,RLK
chr06,Bn30860,16439303,58551120,42111817,RLP
chr06,Bn30861,66515655,87906210,21390555,TNL
chr06,Bn30862,2052567,31449985,29397418,NBS
chr06,Bn30863,24142742,72643385,48500643,CN
chr06,Bn30864,86536988,95617503,9080515,TNL
chr06,Bn30865,87075267,96373968,9298701,TNL
chr06,Bn30866,33584259,50754144,17169885,CNL
chr06,Bn30867,63086091,97684588,34598497,TN
chr06,Bn30868,61120149,96863941,35743792,NBS
chr06,Bn30869,3966246,32761673,28795427,TN
chr06,Bn30870,64358882,93718279,29359397,TNL
chr06,Bn30871,73099718,75502086,2402368,RLP
chr06,Bn30872,69844466,81906233,12061767,TNL
chr06,Bn30873,27278388,79479116,52200728,CN
chr06,Bn30874,22024318,72854302,50829984,CN
chr06,Bn30875,3541627,10715752,7174125,RLK
chr06,Bn30876,47745888,66928204,19182316,RLK
chr06,Bn30877,44324225,73083350,28759125,CN
chr06,Bn30878,23184622,84993432,61808810,TNL
chr06,Bn30879,26314165,94087761,67773596,TNL
chr06,Bn30880,1218015,70153736,68935721,RLP
chr06,Bn30881,64020304,85068053,21047749,RLP
chr06,Bn30882,48902592,58956571,10053979,TN
chr06,Bn30883,96462600,98183233,1720633,RLP
chr06,Bn30884,25698848,76816782,51117934,CNL
chr06,Bn30885,35306720,99926694,64619974,RLK
chr06,Bn30886,91314534,92737887,1423353,CN
chr06,Bn30887,70142468,99882751,29740283,CNL
chr06,Bn30888,34873985,78757266,43883281,TN
chr06,Bn30889,61889041,61948033,58992,RLK
chr06,Bn30890,72406155,72544677,138522,RLP
chr06,Bn30891,36568618,69766260,33197642,RLP
chr06,Bn30892,47110819,87185790,40074971,CN
chr06,Bn30893,64016721,98544634,34527913,RLP
chr06,Bn30894,61462400,98804578,37342178,RLP
chr06,Bn30895,9155137,97040049,87884912,CNL
chr06,Bn30896,93980032,97960423,3980391,TN
chr06,Bn30897,21052029,28628658,7576629,TN
chr06,Bn30898,68441245,89068198,20626953,TNL
chr06,Bn30899,28943225,65971594,37028369,RLP
chr06,Bn30900,40331738,73101530,32769792,CN
chr06,Bn30901,61822573,73894930,12072357,CN
chr06,Bn30902,3627076,48050214,44423138,CN
chr06,Bn30903,93643497,98832277,5188780,TNL
chr06,Bn30904,66024102,84008443,17984341,TNL
chr06,Bn30905,44601739,49414601,4812862,RLK
chr06,Bn30906,11429160,47320508,35891348,RLP
chr06,Bn30907,40331514,95386398,55054884,NBS
chr06,Bn30908,72623040,81137303,8514263,CNL
chr06,Bn30909,88771990,90249929,1477939,TN
chr06,Bn30910,59082534,92411822,33329288,NBS
chr06,Bn30911,8407556,17163063,8755507,TN
chr06,Bn30912,70434408,85937753,15503345,RLK
chr06,Bn30913,32336795,96946383,64609588,NBS
chr06,Bn30914,39931604,99446510,59514906,CNL
chr06,Bn30915,50588643,53864638,3275995,TNL
chr06,Bn30916,63020298,85288549,22268251,NBS
chr06,Bn30917,47666090,83654347,35988257,RLK
chr06,Bn30918,39156654,52948464,13791810,TNL
chr06,Bn30919,64919613,77725997,12806384,TN
chr06,Bn30920,11930897,91926048,79995151,RLP
chr06,Bn30921,90357878,93711231,3353353,CNL
chr06,Bn30922,65206876,86410298,21203422,RLP
chr06,Bn30923,44807182,69118351,24311169,CN
chr06,Bn30924,12656008,72771523,60115515,RLP
chr06,Bn30925,95692218,97378838,1686620,TN
chr06,Bn30926,31601419,77311365,45709946,CN
chr06,Bn30927,26627862,58432735,31804873,TNL
chr06,Bn30928,78340216,92952031,14611815,CN
chr06,Bn30929,82973175,88565767,5592592,TN
chr06,Bn30930,63566631,83297306,19730675,NBS
chr06,Bn30931,15786739,43780841,27994102,CN
chr06,Bn30932,80555595,91397825,10842230,NBS
chr06,Bn30933,46996572,82849998,35853426,TNL
chr06,Bn30934,84731318,97611743,12880425,RLK
chr06,Bn30935,72711609,73239421,527812,CNL
chr06,Bn30936,3189626,84884133,81694507,TNL
chr06,Bn30937,43859189,98891447,55032258,TNL
chr06,Bn30938,80941891,82121367,1179476,RLP
chr06,Bn30939,83762971,94037315,10274344,CNL
chr06,Bn30940,34114753,77482681,43367928,TNL
chr06,Bn30941,93420683,96697748,3277065,TNL
chr06,Bn30942,99028477,99250884,222407,TN
chr06,Bn30943,98745404,98986113,240709,TNL
chr06,Bn30944,1170510,99542500,98371990,RLP
chr06,Bn30945,44377364,87256703,42879339,NBS
chr06,Bn30946,70031988,79696873,9664885,CN
chr06,Bn30947,20881720,39992941,19111221,TN
chr06,Bn30948,71506805,73414428,1907623,RLP
chr06,Bn30949,37942777,91639040,53696263,NBS
chr06,Bn30950,44836671,71456358,26619687,NBS
chr06,Bn30951,23512038,28285165,4773127,NBS
chr06,Bn30952,87869197,92159832,4290635,TNL
chr06,Bn30953,35644087,75689231,40045144,NBS
chr06,Bn30954,50133585,53236073,3102488,RLP
chr06,Bn30955,56323967,66777967,10454000,TNL
chr06,Bn30956,88980597,89556686,576089,CN
chr06,Bn30957,82334856,90744678,8409822,TNL
chr06,Bn30958,42255404,47420641,5165237,TNL
chr06,Bn30959,60065555,81209326,21143771,CN
chr06,Bn30960,2527171,49200745,46673574,RLK
chr06,Bn30961,76596353,83861108,7264755,RLP
chr06,Bn30962,10626200,42694870,32068670,CN
chr06,Bn30963,62654808,83020292,20365484,TN
chr06,Bn30964,52108647,87102595,34993948,CN
chr06,Bn30965,51530086,72038242,20508156,NBS
chr06,Bn30966,45881585,97136684,51255099,RLP
chr06,Bn30967,45160253,58407660,13247407,RLK
chr06,Bn30968,98163593,99888203,1724610,RLP
chr06,Bn30969,16999185,51225368,34226183,CNL
chr06,Bn30970,93319161,94536290,1217129,TNL
chr06,Bn30971,1905179,74855792,72950613,TN
chr06,Bn30972,47125328,64157843,17032515,CN
chr06,Bn30973,71896511,72911600,1015089,TNL
chr06,Bn30974,63701281,96199856,32498575,TN
chr06,Bn30975,18148113,43343089,25194976,CNL
chr06,Bn30976,51022903,73345171,22322268,CNL
chr06,Bn30977,65328823,70699535,5370712,CN
chr06,Bn30978,46046758,99513081,53466323,CN
chr06,Bn30979,41375725,78055644,36679919,CN
chr06,Bn30980,26772339,80358660,53586321,RLK
chr06,Bn30981,96792086,97382385,590299,NBS
chr06,Bn30982,19348975,96242493,76893518,CNL
chr06,Bn30983,11458915,78918659,67459744,RLK
chr06,Bn30984,8468623,44598645,36130022,CN
chr06,Bn30985,30422802,42431328,12008526,TNL
chr06,Bn30986,91468525,98418046,6949521,RLP
chr06,Bn30987,19636292,50288204,30651912,CN
chr06,Bn30988,51037054,84201319,33164265,RLK
chr06,Bn30989,85735982,98848863,13112881,RLP
chr06,Bn30990,73331280,75094756,1763476,RLK
chr06,Bn30991,90243787,91760290,1516503,RLP
chr06,Bn30992,91152875,97810048,6657173,CNL
chr06,Bn30993,43242374,92607011,49364637,NBS
chr06,Bn30994,27513966,90798363,63284397,RLP
chr06,Bn30995,98953474,99260826,307352,CN
chr06,Bn30996,71773778,90178483,18404705,RLK
chr06,Bn30997,21918496,29425942,7507446,RLP
chr06,Bn30998,44861136,72940567,28079431,CN
chr06,Bn30999,78783600,98070082,19286482,RLK
chr06,Bn31000,51447835,96175993,44728158,TNL
chr06,Bn31001,94418627,95018806,600179,CN
chr06,Bn31002,71464158,89909328,18445170,CNL
chr06,Bn31003,92373765,95962032,3588267,CNL
chr06,Bn31004,73416352,84671326,11254974,RLP
chr06,Bn31005,45274349,76300164,31025815,RLK
chr06,Bn31006,17034116,19990890,2956774,RLP
chr06,Bn31007,98436190,99438946,1002756,TN
chr06,Bn31008,30172571,56699892,26527321,CN
chr06,Bn31009,53819121,98270468,44451347,RLP
chr06,Bn31010,97443037,98281938,838901,CN
chr06,Bn31011,59039031,81359403,22320372,RLP
chr06,Bn31012,51462620,52989520,1526900,NBS
chr06,Bn31013,2479456,60601385,58121929,NBS
chr06,Bn31014,80221324,87306534,7085210,CNL
chr06,Bn31015,85181893,91768922,6587029,TNL
chr06,Bn31016,79802931,81936929,2133998,RLK
chr06,Bn31017,9795531,37110579,27315048,TNL
chr06,Bn31018,65200029,74107900,8907871,RLK
chr06,Bn31019,89370915,96694753,7323838,RLP
chr06,Bn31020,1497750,2271608,773858,TNL
chr06,Bn31021,94815624,98784903,3969279,RLP
chr06,Bn31022,70655211,71245620,590409,CNL
chr06,Bn31023,8695072,96423426,87728354,TNL
chr06,Bn31024,27495696,76561523,49065827,RLK
chr06,Bn31025,67924080,88587551,20663471,CNL
chr06,Bn31026,65588756,95802298,30213542,CN
chr06,Bn31027,56298521,63765403,7466882,TNL
chr06,Bn31028,68050069,82771288,14721219,NBS
chr06,Bn31029,91437668,92139919,702251,CNL
chr06,Bn31030,90866234,96738401,5872167,RLK
chr06,Bn31031,5364881,17015997,11651116,CN
chr06,Bn31032,62698691,71081554,8382863,CNL
chr06,Bn31033,79406849,97967483,18560634,TN
chr06,Bn31034,18274007,77936333,59662326,RLP
chr06,Bn31035,77975339,78169341,194002,RLP
chr06,Bn31036,50413445,89132168,38718723,NBS
chr06,Bn31037,96910421,98864460,1954039,NBS
chr06,Bn31038,57686220,90487030,32800810,RLP
chr06,Bn31039,73211454,85104363,11892909,RLP
chr06,Bn31040,46589495,54416862,7827367,CNL
chr06,Bn31041,39714418,76850292,37135874,RLP
chr06,Bn31042,4322076,83330633,79008557,CN
chr06,Bn31043,38277428,91296650,53019222,CNL
chr06,Bn31044,33459079,47332438,13873359,CN
chr06,Bn31045,93829255,99480528,5651273,RLK
chr06,Bn31046,54432106,71712059,17279953,NBS
chr06,Bn31047,95486079,99729210,4243131,NBS
chr06,Bn31048,2271873,54367476,52095603,TN
chr06,Bn31049,48657987,76445262,27787275,CNL
chr06,Bn31050,20064360,60354303,40289943,CNL
chr06,Bn31051,57104421,98043584,40939163,RLK
chr06,Bn31052,49797962,51280826,1482864,CNL
chr06,Bn31053,92361911,95133192,2771281,CN
chr06,Bn31054,83357330,83889352,532022,CNL
chr06,Bn31055,91223745,98625372,7401627,RLP
chr06,Bn31056,41058835,56122432,15063597,TN
chr06,Bn31057,59260713,80813300,21552587,CNL
chr06,Bn31058,70097060,83954472,13857412,TN
chr06,Bn31059,88843327,98003806,9160479,NBS
chr06,Bn31060,24406439,82783764,58377325,CN
chr06,Bn31061,32588654,62723199,30134545,TN
chr06,Bn31062,70954487,71496290,541803,TN
chr06,Bn31063,1107264,27610407,26503143,CN
chr06,Bn31064,11828576,47564182,35735606,RLK
chr06,Bn31065,19709574,91826201,72116627,CNL
chr06,Bn31066,58016741,62821711,4804970,TNL
chr06,Bn31067,32416904,76231037,43814133,NBS
chr06,Bn31068,8173098,49414003,41240905,RLP
chr06,Bn31069,72195406,76813823,4618417,TNL
chr06,Bn31070,47025394,77620494,30595100,NBS
chr06,Bn31071,29219789,83767539,54547750,NBS
chr06,Bn31072,17026303,58086883,41060580,TNL
chr06,Bn31073,35213379,95203585,59990206,RLK
chr06,Bn31074,71741335,80975579,9234244,RLP
chr06,Bn31075,51030899,68144308,17113409,CNL
chr06,Bn31076,80831389,87991637,7160248,RLP
chr06,Bn31077,94349751,94518912,169161,NBS
chr06,Bn31078,93444962,95422419,1977457,NBS
chr06,Bn31079,58653134,95407361,36754227,NBS
chr06,Bn31080,45158843,84253773,39094930,NBS
chr06,Bn31081,81140991,94731552,13590561,RLP
chr06,Bn31082,76023822,96570204,20546382,RLK
chr06,Bn31083,64941351,95793729,30852378,TNL
chr06,Bn31084,10935134,33136708,22201574,TNL
chr06,Bn31085,49376723,49487877,111154,CN
chr06,Bn31086,25274182,57251234,31977052,CNL
chr06,Bn31087,25676512,26823378,1146866,NBS
chr06,Bn31088,97012523,99473847,2461324,TNL
chr06,Bn31089,66079755,85345418,19265663,CN
chr06,Bn31090,76609222,79916396,3307174,CN
chr06,Bn31091,24274452,89427354,65152902,TNL
chr06,Bn31092,79598900,99547564,19948664,CNL
chr06,Bn31093,24240501,54531352,30290851,RLK
chr06,Bn31094,48295193,99114675,50819482,NBS
chr06,Bn31095,7871062,26305575,18434513,CN
chr06,Bn31096,55727233,55915316,188083,TN
chr06,Bn31097,16628934,95394956,78766022,NBS
chr06,Bn31098,45354386,57046023,11691637,TN
chr06,Bn31099,66600439,83353595,16753156,CN
chr06,Bn31100,1006923,2831683,1824760,CN
chr06,Bn31101,47004492,48544276,1539784,CN
chr06,Bn31102,69388922,71719637,2330715,RLK
chr06,Bn31103,84594875,99994782,15399907,CN
chr06,Bn31104,73998828,91999248,18000420,RLP
chr06,Bn31105,33100927,52498522,19397595,CN
chr06,Bn31106,37430397,51671971,14241574,RLK
chr06,Bn31107,90506291,94330054,3823763,RLK
chr06,Bn31108,31443849,88920769,57476920,RLP
chr06,Bn31109,64590839,90685551,26094712,CN
chr06,Bn31110,42943341,49955921,7012580,CNL
chr06,Bn31111,68039681,72654995,4615314,TN
chr06,Bn31112,3746211,28642231,24896020,TN
chr06,Bn31113,64044170,85858196,21814026,CN
chr06,Bn31114,60664102,95407265,34743163,TN
chr06,Bn31115,64697124,99878418,35181294,TNL
chr06,Bn31116,72149650,79637339,7487689,TN
chr06,Bn31117,63214977,67168731,3953754,NBS
chr06,Bn31118,67712161,76202782,8490621,RLK
chr06,Bn31119,47670822,87190993,39520171,TN
chr06,Bn31120,86803899,94278326,7474427,RLK
chr06,Bn31121,78184103,95648856,17464753,RLP
chr06,Bn31122,93238499,94498190,1259691,TNL
chr06,Bn31123,87835485,93190733,5355248,CNL
chr06,Bn31124,53529892,84073364,30543472,RLK
chr06,Bn31125,65165884,71285264,6119380,TNL
chr06,Bn31126,47893796,50257007,2363211,RLK
chr06,Bn31127,42204806,61267990,19063184,NBS
chr06,Bn31128,19643327,66442605,46799278,RLK
chr06,Bn31129,25851197,49065066,23213869,RLP
chr06,Bn31130,43224696,94636681,51411985,NBS
chr06,Bn31131,45378452,74229646,28851194,CNL
chr06,Bn31132,33090976,94844132,61753156,TNL
chr06,Bn31133,52943611,72116041,19172430,TN
chr06,Bn31134,59385930,76399970,17014040,CNL
chr06,Bn31135,67476104,79917109,12441005,CN
chr06,Bn31136,83306556,88698978,5392422,TNL
chr06,Bn31137,8194881,51054569,42859688,CNL
chr06,Bn31138,98474781,99263512,788731,TNL
chr06,Bn31139,74993073,79658079,4665006,TNL
chr06,Bn31140,64330990,84588180,20257190,TN
chr06,Bn31141,49351139,77209287,27858148,TN
chr06,Bn31142,73837724,92517104,18679380,CNL
chr06,Bn31143,20888391,69114994,48226603,TNL
chr06,Bn31144,91372480,94961913,3589433,NBS
chr06,Bn31145,11468878,62236926,50768048,RLP
chr06,Bn31146,38662485,80879768,42217283,CNL
chr06,Bn31147,35114627,68912646,33798019,CN
chr06,Bn31148,40925113,97196563,56271450,CN
chr06,Bn31149,2933652,74082142,71148490,RLK
chr06,Bn31150,34227584,38364598,4137014,TNL
chr06,Bn31151,73370048,78462987,5092939,CNL
chr06,Bn31152,26197650,27921655,1724005,TN
chr06,Bn31153,92553180,99265824,6712644,TN
chr06,Bn31154,69191699,95464210,26272511,CN
chr06,Bn31155,92044050,94635016,2590966,RLP
chr06,Bn31156,5329011,84512204,79183193,CN
chr06,Bn31157,27572906,28494692,921786,RLP
chr06,Bn31158,22183465,22409267,225802,NBS
chr06,Bn31159,44678557,61306701,16628144,CNL
chr06,Bn31160,36524413,50386505,13862092,RLP
chr06,Bn31161,32889094,62874105,29985011,CN
chr06,Bn31162,50186103,53881453,3695350,TNL
chr06,Bn31163,44734560,65935270,21200710,TN
chr06,Bn31164,21113363,43224945,22111582,TNL
chr06,Bn31165,54714885,60685704,5970819,NBS
chr06,Bn31166,49434807,90483787,41048980,CNL
chr06,Bn31167,5371981,89953705,84581724,RLP
chr06,Bn31168,21936298,98822733,76886435,NBS
chr06,Bn31169,72040404,96971677,24931273,TNL
chr06,Bn31170,25997297,89695471,63698174,RLP
chr06,Bn31171,15026277,68521234,53494957,TN
chr06,Bn31172,18703556,36072874,17369318,RLP
chr06,Bn31173,24887903,88078739,63190836,TNL
chr06,Bn31174,94993420,95149406,155986,NBS
chr06,Bn31175,8031510,72121157,64089647,TNL
chr06,Bn31176,8971610,49380343,40408733,RLK
chr06,Bn31177,62606620,88842463,26235843,TN
chr06,Bn31178,65070115,84920680,19850565,CN
chr06,Bn31179,23189127,96344566,73155439,TN
chr06,Bn31180,30976771,88341901,57365130,RLP
chr06,Bn31181,7344107,72212072,64867965,TNL
chr06,Bn31182,34723170,40728933,6005763,RLP
chr06,Bn31183,82327081,92502866,10175785,CNL
chr06,Bn31184,43067283,87604954,44537671,NBS
chr06,Bn31185,95458449,97920449,2462000,TN
chr06,Bn31186,54164147,83782851,29618704,CNL
chr06,Bn31187,5974747,78224458,72249711,TNL
chr06,Bn31188,62432665,77515609,15082944,CNL
chr06,Bn31189,6161328,25831701,19670373,CN
chr06,Bn31190,40974364,45484802,4510438,CNL
chr06,Bn31191,70412051,92676949,22264898,CN
chr06,Bn31192,64843363,87039657,22196294,TNL
chr06,Bn31193,4116136,77529205,73413069,TNL
chr06,Bn31194,82274893,91822680,9547787,RLP
chr06,Bn31195,82727801,91398889,8671088,CNL
chr06,Bn31196,48504550,97260436,48755886,NBS
chr06,Bn31197,84640372,99483773,14843401,RLK
chr06,Bn31198,86527516,98679337,12151821,TN
chr06,Bn31199,3057003,64874179,61817176,RLP
chr06,Bn31200,11454973,90459478,79004505,RLP
chr06,Bn31201,35241966,84462539,49220573,CN
chr06,Bn31202,89105148,93476909,4371761,NBS
chr06,Bn31203,66203033,92190328,25987295,RLK
chr06,Bn31204,25056600,76270411,51213811,NBS
chr06,Bn31205,57802540,89791367,31988827,NBS
chr06,Bn31206,33191011,40208688,7017677,NBS
chr06,Bn31207,83490458,96524511,13034053,RLP
chr06,Bn31208,31707448,75223644,43516196,TNL
chr06,Bn31209,14272353,18476813,4204460,CNL
chr06,Bn31210,28202535,77390334,49187799,CN
chr06,Bn31211,98468604,99706948,1238344,TN
chr06,Bn31212,7022039,93557172,86535133,RLK
chr06,Bn31213,77031047,82510451,5479404,RLP
chr06,Bn31214,89696499,98634515,8938016,NBS
chr06,Bn31215,95205777,97975979,2770202,RLK
chr06,Bn31216,91080067,93025094,1945027,NBS
chr06,Bn31217,76923723,79168474,2244751,CN
chr06,Bn31218,68932353,71656887,2724534,CN
chr06,Bn31219,53343135,67334098,13990963,CN
chr06,Bn31220,11082868,69058328,57975460,RLK
chr06,Bn31221,40751164,89499740,48748576,CNL
chr06,Bn31222,6319525,80067387,73747862,RLK
chr06,Bn31223,88969836,89798101,828265,RLK
chr06,Bn31224,57530837,69677503,12146666,TNL
chr06,Bn31225,26446723,97524560,71077837,TNL
chr06,Bn31226,90664712,93120158,2455446,CN
chr06,Bn31227,30743295,45501652,14758357,RLP
chr06,Bn31228,99685059,99809314,124255,TN
chr06,Bn31229,39516493,99109614,59593121,TNL
chr06,Bn31230,63504252,88697904,25193652,RLK
chr06,Bn31231,57841030,67788309,9947279,TN
chr06,Bn31232,74437449,82120981,7683532,NBS
chr06,Bn31233,28744567,29352881,608314,TN
chr06,Bn31234,50793466,65305661,14512195,NBS
chr06,Bn31235,83874880,98230165,14355285,CNL
chr06,Bn31236,14588540,76613058,62024518,TN
chr06,Bn31237,16941326,17164577,223251,CN
chr06,Bn31238,60898327,65097588,4199261,CN
chr06,Bn31239,92285058,97748374,5463316,RLK
chr06,Bn31240,71802282,96577074,24774792,TNL
chr06,Bn31241,51172854,59176876,8004022,CNL
chr06,Bn31242,61530581,92853685,31323104,RLK
chr06,Bn31243,86157029,99907778,13750749,RLK
chr06,Bn31244,40418703,73249606,32830903,CN
chr06,Bn31245,9781451,59662118,49880667,TN
chr06,Bn31246,85934932,97493470,11558538,CNL
chr06,Bn31247,14784363,98946461,84162098,CNL
chr06,Bn31248,78123853,99494199,21370346,CNL
chr06,Bn31249,58983015,96910752,37927737,RLK
chr06,Bn31250,32229342,99646026,67416684,NBS
chr06,Bn31251,66308651,83113058,16804407,RLP
chr06,Bn31252,67708570,87616598,19908028,RLP
chr06,Bn31253,53622775,73802871,20180096,CNL
chr06,Bn31254,92876818,94138043,1261225,NBS
chr06,Bn31255,19170010,35284473,16114463,RLP
chr06,Bn31256,84347952,99081536,14733584,TN
chr06,Bn31257,44132572,49245295,5112723,RLK
chr06,Bn31258,88442640,96617993,8175353,NBS
chr06,Bn31259,64654125,93507148,28853023,RLK
chr06,Bn31260,61951453,69062525,7111072,RLK
chr06,Bn31261,67802521,97180713,29378192,RLK
chr06,Bn31262,21500430,29034499,7534069,TNL
chr06,Bn31263,8384151,39066971,30682820,TNL
chr06,Bn31264,87703497,89109855,1406358,RLP
chr06,Bn31265,47084987,90720660,43635673,TN
chr06,Bn31266,66968028,69805079,2837051,RLP
chr06,Bn31267,72168944,77490718,5321774,CN
chr06,Bn31268,74139437,78478219,4338782,RLP
chr06,Bn31269,41971919,77425687,35453768,RLK
chr06,Bn31270,56626484,67425464,10798980,CN
chr06,Bn31271,25470594,54012271,28541677,TN
chr06,Bn31272,41582606,43695959,2113353,NBS
chr06,Bn31273,71105968,77934504,6828536,NBS
chr06,Bn31274,32009639,54224746,22215107,CNL
chr06,Bn31275,56461170,67494459,11033289,NBS
chr06,Bn31276,1974513,19763945,17789432,CN
chr06,Bn31277,98555370,99134752,579382,CNL
chr06,Bn31278,60296319,63724665,3428346,RLP
chr06,Bn31279,93383488,98705762,5322274,TN
chr06,Bn31280,38476949,87452999,48976050,TNL
chr06,Bn31281,75316831,93486046,18169215,NBS
chr06,Bn31282,47162893,72291584,25128691,TNL
chr06,Bn31283,88342742,94476752,6134010,CNL
chr06,Bn31284,12390793,96510952,84120159,TN
chr06,Bn31285,34347284,56625661,22278377,RLP
chr06,Bn31286,78224872,89165185,10940313,CN
chr06,Bn31287,34592130,73550266,38958136,TNL
chr06,Bn31288,72473781,86295135,13821354,RLK
chr06,Bn31289,57252807,78375833,21123026,RLK
chr06,Bn31290,19783288,51543720,31760432,NBS
chr06,Bn31291,48050197,48903321,853124,RLK
chr06,Bn31292,22747105,81426363,58679258,TN
chr06,Bn31293,36867236,68795239,31928003,RLP
chr06,Bn31294,45606379,64891133,19284754,TNL
chr06,Bn31295,15261660,80226344,64964684,NBS
chr06,Bn31296,20596454,49377353,28780899,CNL
chr06,Bn31297,61398621,94792298,33393677,CNL
chr06,Bn31298,41974242,70601508,28627266,RLP
chr06,Bn31299,18175319,49552584,31377265,TNL
chr06,Bn31300,87563250,94398584,6835334,NBS
chr06,Bn31301,19634544,90872196,71237652,RLK
chr06,Bn31302,77086928,98693447,21606519,NBS
chr06,Bn31303,64957479,70412029,5454550,TNL
chr06,Bn31304,45754151,75385161,29631010,NBS
chr06,Bn31305,72458133,91271426,18813293,TN
chr06,Bn31306,51779571,84662090,32882519,NBS
chr06,Bn31307,48468044,56481895,8013851,TN
chr06,Bn31308,26599317,99653626,73054309,TNL
chr06,Bn31309,19545531,22786651,3241120,TN
chr06,Bn31310,48208509,54679670,6471161,CNL
chr06,Bn31311,1306088,18384032,17077944,RLK
chr06,Bn31312,79932521,89395136,9462615,RLK
chr06,Bn31313,33218543,70827693,37609150,CNL
chr06,Bn31314,41317887,61521074,20203187,NBS
chr06,Bn31315,29636184,54574182,24937998,CN
chr06,Bn31316,6643430,59660014,53016584,NBS
chr06,Bn31317,58356096,84981799,26625703,TNL
chr06,Bn31318,97750915,98634811,883896,TNL
chr06,Bn31319,79319117,92978174,13659057,CN
chr06,Bn31320,72479233,95972554,23493321,TN
chr06,Bn31321,36788308,66171536,29383228,CN
chr06,Bn31322,50872069,75414581,24542512,CN
chr06,Bn31323,82581161,83163557,582396,TN
chr06,Bn31324,91849514,92497907,648393,CN
chr06,Bn31325,81180576,86312902,5132326,TN
chr06,Bn31326,23638132,45105056,21466924,CNL
chr06,Bn31327,99376481,99712165,335684,TN
chr06,Bn31328,75899423,84474752,8575329,RLP
chr06,Bn31329,78831071,89677373,10846302,NBS
chr06,Bn31330,37129151,78994587,41865436,TNL
chr06,Bn31331,68605310,69980171,1374861,CNL
chr06,Bn31332,68054583,76991354,8936771,NBS
chr06,Bn31333,68629808,86519513,17889705,CN
chr06,Bn31334,30476541,31282610,806069,CN
chr06,Bn31335,53854329,81469559,27615230,CN
chr06,Bn31336,75328777,82149445,6820668,RLP
chr06,Bn31337,59886634,66107120,6220486,RLP
chr06,Bn31338,4877424,7431586,2554162,RLK
chr06,Bn31339,99206103,99329806,123703,RLK
chr06,Bn31340,82495928,86248091,3752163,TNL
chr06,Bn31341,95473530,96505619,1032089,TNL
chr06,Bn31342,72917768,90360228,17442460,TNL
chr06,Bn31343,55176627,95142272,39965645,TN
chr06,Bn31344,64731576,67380278,2648702,TNL
chr06,Bn31345,4002027,6257427,2255400,NBS
chr06,Bn31346,35472540,77653815,42181275,RLP
chr06,Bn31347,90495828,96751924,6256096,NBS
chr06,Bn31348,98028623,99469294,1440671,RLK
chr06,Bn31349,5662959,55530969,49868010,TN
chr06,Bn31350,9765710,90182697,80416987,TNL
chr06,Bn31351,64277983,69769442,5491459,TNL
chr06,Bn31352,92876023,95098800,2222777,NBS
chr06,Bn31353,65532365,73766808,8234443,TN
chr06,Bn31354,31304312,66468686,35164374,TN
chr06,Bn31355,82934064,92444638,9510574,TN
chr06,Bn31356,84652764,88082428,3429664,TNL
chr06,Bn31357,28869683,81119484,52249801,TN
chr06,Bn31358,32824958,88328970,55504012,TN
chr06,Bn31359,11186593,46007225,34820632,TN
chr06,Bn31360,77846958,93456811,15609853,RLP
chr06,Bn31361,41856206,51882286,10026080,RLP
chr06,Bn31362,27887023,79793799,51906776,TNL
chr06,Bn31363,8451559,31221065,22769506,CN
chr06,Bn31364,42201221,63005634,20804413,CN
chr06,Bn31365,24332308,87411371,63079063,RLP
chr06,Bn31366,4384915,17212434,12827519,CNL
chr06,Bn31367,15051066,66857182,51806116,RLP
chr06,Bn31368,21324787,49534244,28209457,CNL
chr06,Bn31369,54891654,61527631,6635977,CNL
chr06,Bn31370,35254946,97004173,61749227,RLK
chr06,Bn31371,33569130,55809611,22240481,TNL
chr06,Bn31372,71081984,91552163,20470179,CNL
chr06,Bn31373,34481353,55735264,21253911,CN
chr06,Bn31374,2259766,81084084,78824318,TNL
chr06,Bn31375,61151453,83265303,22113850,TN
chr06,Bn31376,81205354,87622367,6417013,RLK
chr06,Bn31377,65004143,86464617,21460474,RLP
chr06,Bn31378,84510278,96196245,11685967,TNL
chr06,Bn31379,23116090,36141987,13025897,CNL
chr06,Bn31380,74350206,93998449,19648243,NBS
chr06,Bn31381,43763319,63696399,19933080,NBS
chr06,Bn31382,33616283,79228610,45612327,TN
chr06,Bn31383,17771932,42740985,24969053,RLP
chr06,Bn31384,62027404,67605431,5578027,RLP
chr06,Bn31385,64663725,73194435,8530710,TNL
chr06,Bn31386,80975091,90044860,9069769,RLP
chr06,Bn31387,69575416,89481847,19906431,TN
chr06,Bn31388,62489898,94859098,32369200,NBS
chr06,Bn31389,57516111,62008757,4492646,TNL
chr06,Bn31390,32380677,36033735,3653058,RLK
chr06,Bn31391,64882242,65462701,580459,CN
chr06,Bn31392,54022779,96074151,42051372,TNL
chr06,Bn31393,27052041,43033296,15981255,NBS
chr06,Bn31394,91015444,97971406,6955962,RLK
chr06,Bn31395,22665328,37704409,15039081,NBS
chr06,Bn31396,46425347,75588694,29163347,RLP
chr06,Bn31397,39656598,99281043,59624445,CNL
chr06,Bn31398,78262725,95540295,17277570,CN
chr06,Bn31399,80009341,95125125,15115784,TNL
chr06,Bn31400,63556355,83907480,20351125,CNL
chr06,Bn31401,81837107,83362205,1525098,RLP
chr06,Bn31402,12388235,74083475,61695240,CNL
chr06,Bn31403,66033928,92378364,26344436,CN
chr06,Bn31404,8948275,9060154,111879,TNL
chr06,Bn31405,46250204,74669874,28419670,RLP
chr06,Bn31406,24560243,34760666,10200423,TN
chr06,Bn31407,37943455,43181701,5238246,RLK
chr06,Bn31408,18001838,69795621,51793783,RLP
chr06,Bn31409,9801757,85909293,76107536,NBS
chr06,Bn31410,99432726,99733148,300422,RLP
chr06,Bn31411,11202542,94303899,83101357,RLK
chr06,Bn31412,8536424,28109682,19573258,RLP
chr06,Bn31413,61722730,79514061,17791331,RLK
chr06,Bn31414,61813365,93664225,31850860,CN
chr06,Bn31415,61931008,77733812,15802804,CNL
chr06,Bn31416,53774964,62259636,8484672,CN
chr06,Bn31417,36198729,59107775,22909046,CNL
chr06,Bn31418,92029989,92331088,301099,CN
chr06,Bn31419,41407467,97804376,56396909,CN
chr06,Bn31420,98831708,99687440,855732,RLP
chr06,Bn31421,62481743,88164335,25682592,TNL
chr06,Bn31422,95488843,97497097,2008254,RLK
chr06,Bn31423,21722644,58588013,36865369,CNL
chr06,Bn31424,61616335,90354706,28738371,CNL
chr06,Bn31425,88005237,91098321,3093084,TN
chr06,Bn31426,83265182,95172926,11907744,TN
chr06,Bn31427,54234796,85016895,30782099,CNL
chr06,Bn31428,39696807,43501429,3804622,RLK
chr06,Bn31429,12422106,71618320,59196214,RLP
chr06,Bn31430,91395058,96777208,5382150,TNL
chr06,Bn31431,96036428,96349364,312936,CN
chr06,Bn31432,42867307,89410720,46543413,CN
chr06,Bn31433,77167148,78487667,1320519,RLP
chr06,Bn31434,11216935,13373329,2156394,RLK
chr06,Bn31435,47854838,79420024,31565186,RLP
chr06,Bn31436,19806062,95452239,75646177,TNL
chr06,Bn31437,38242222,47154505,8912283,TN
chr06,Bn31438,1990818,41098246,39107428,CNL
chr06,Bn31439,33412465,51083880,17671415,RLP
chr06,Bn31440,73405233,99086647,25681414,TNL
chr06,Bn31441,63369786,64109233,739447,RLP
chr06,Bn31442,86912727,91577803,4665076,RLK
chr06,Bn31443,78519552,86636502,8116950,RLK
chr06,Bn31444,21662347,34908448,13246101,RLK
chr06,Bn31445,33495497,72366820,38871323,TNL
chr06,Bn31446,40562284,56432188,15869904,CN
chr06,Bn31447,36620704,99423194,62802490,RLK
chr06,Bn31448,4763570,98856172,94092602,TNL
chr06,Bn31449,46589475,89694474,43104999,NBS
chr06,Bn31450,80604658,93347965,12743307,CN
chr06,Bn31451,99473926,99996282,522356,CN
chr06,Bn31452,37537634,79378491,41840857,RLP
chr06,Bn31453,30429696,74594062,44164366,TNL
chr06,Bn31454,56608025,91161154,34553129,CN
chr06,Bn31455,37574120,56079433,18505313,CNL
chr06,Bn31456,79701996,93068263,13366267,TN
chr06,Bn31457,24622491,75481559,50859068,CNL
chr06,Bn31458,35752288,67802567,32050279,TNL
chr06,Bn31459,15816596,32004977,16188381,TNL
chr06,Bn31460,29546552,53283817,23737265,TN
chr06,Bn31461,80090653,97594251,17503598,NBS
chr06,Bn31462,88305266,93056634,4751368,TN
chr06,Bn31463,5246117,90359868,85113751,RLK
chr06,Bn31464,46103172,93054725,46951553,RLK
chr06,Bn31465,20524882,75938920,55414038,RLP
chr06,Bn31466,93399969,96378025,2978056,RLP
chr06,Bn31467,40475572,60550700,20075128,CN
chr06,Bn31468,39349341,46415753,7066412,CNL
chr06,Bn31469,72159227,92945267,20786040,CN
chr06,Bn31470,29426431,77100997,47674566,CNL
chr06,Bn31471,8406240,89270143,80863903,RLK
chr06,Bn31472,60866115,88548581,27682466,TNL
chr06,Bn31473,22113203,68975104,46861901,CN
chr06,Bn31474,33293159,49111545,15818386,TN
chr06,Bn31475,16992354,91467897,74475543,RLP
chr06,Bn31476,67917947,70887863,2969916,CN
chr06,Bn31477,83496599,95788185,12291586,RLP
chr06,Bn31478,37437656,64712370,27274714,RLP
chr06,Bn31479,54053042,71327123,17274081,TN
chr06,Bn31480,90221078,94144649,3923571,RLK
chr06,Bn31481,15750356,54606221,38855865,NBS
chr06,Bn31482,60922787,90520484,29597697,RLP
chr06,Bn31483,16731344,34457129,17725785,TNL
chr06,Bn31484,35505430,42730248,7224818,CN
chr06,Bn31485,58379562,92501526,34121964,TN
chr06,Bn31486,38105689,88767063,50661374,TN
chr06,Bn31487,89142419,93427879,4285460,RLK
chr06,Bn31488,51529793,76831290,25301497,NBS
chr06,Bn31489,9121484,56971165,47849681,RLP
chr06,Bn31490,33166018,98996621,65830603,TN
chr06,Bn31491,86241916,89141633,2899717,NBS
chr06,Bn31492,88423991,98540536,10116545,CN
chr06,Bn31493,44089746,83300758,39211012,RLP
chr06,Bn31494,74223318,77687691,3464373,RLK
chr06,Bn31495,72493553,95585138,23091585,CNL
chr06,Bn31496,60221067,77243632,17022565,CN
chr06,Bn31497,47250088,92190256,44940168,CNL
chr06,Bn31498,34013673,67934744,33921071,RLP
chr06,Bn31499,84191687,86656190,2464503,NBS
chr06,Bn31500,40181908,88524358,48342450,CN
chr06,Bn31501,31860301,93406151,61545850,CNL
chr06,Bn31502,88481679,93892945,5411266,RLP
chr06,Bn31503,90248581,94025388,3776807,NBS
chr06,Bn31504,39852493,50704557,10852064,RLK
chr06,Bn31505,2254067,93015621,90761554,CNL
chr06,Bn31506,25052233,91676129,66623896,RLP
chr06,Bn31507,18453396,32682139,14228743,RLK
chr06,Bn31508,22964991,53295699,30330708,CN
chr06,Bn31509,98029222,98321732,292510,TNL
chr06,Bn31510,21377115,25167329,3790214,TN
chr06,Bn31511,67180021,94819103,27639082,TN
chr06,Bn31512,60339899,86983681,26643782,RLK
chr06,Bn31513,98757059,99756185,999126,RLP
chr06,Bn31514,56573663,74970643,18396980,RLP
chr06,Bn31515,9776718,40188596,30411878,RLP
chr06,Bn31516,30188750,69113581,38924831,RLP
chr06,Bn31517,95246637,98309113,3062476,CNL
chr06,Bn31518,44914060,48958251,4044191,RLK
chr06,Bn31519,16944692,30152185,13207493,CN
chr06,Bn31520,56490876,68331143,11840267,CNL
chr06,Bn31521,46658551,88449308,41790757,CNL
chr06,Bn31522,73191950,75206774,2014824,NBS
chr06,Bn31523,21712338,27489629,5777291,CNL
chr06,Bn31524,73131110,80011950,6880840,TN
chr06,Bn31525,29119080,65326878,36207798,TN
chr06,Bn31526,86763788,95985717,9221929,RLP
chr06,Bn31527,83595536,93322125,9726589,CN
chr06,Bn31528,26057427,68606947,42549520,NBS
chr06,Bn31529,78387274,97177448,18790174,RLK
chr06,Bn31530,17261465,58884401,41622936,CNL
chr06,Bn31531,17289821,73667846,56378025,NBS
chr06,Bn31532,89327920,90638823,1310903,CN
chr06,Bn31533,26953886,69815431,42861545,RLK
chr06,Bn31534,98757364,98933693,176329,RLP
chr06,Bn31535,56611981,87756864,31144883,TNL
chr06,Bn31536,42081633,54548684,12467051,RLK
chr06,Bn31537,16030341,47068101,31037760,TNL
chr06,Bn31538,14032934,94401334,80368400,CN
chr06,Bn31539,90127533,90701243,573710,NBS
chr06,Bn31540,90502062,94660957,4158895,CNL
chr06,Bn31541,87334923,98306021,10971098,RLP
chr06,Bn31542,5792568,53452178,47659610,TN
chr06,Bn31543,73555366,81939073,8383707,RLK
chr06,Bn31544,3140055,21871418,18731363,RLP
chr06,Bn31545,38300744,57523765,19223021,TN
chr06,Bn31546,18479485,99624431,81144946,RLK
chr06,Bn31547,1782350,5091707,3309357,NBS
chr06,Bn31548,81691635,89764340,8072705,CN
chr06,Bn31549,98973987,99795044,821057,RLK
chr06,Bn31550,74183101,94227849,20044748,RLP
chr06,Bn31551,91532739,96030410,4497671,RLK
chr06,Bn31552,82835849,94147623,11311774,CNL
chr06,Bn31553,90361953,95395365,5033412,TN
chr06,Bn31554,69759720,71546142,1786422,TN
chr06,Bn31555,72749132,81361827,8612695,TNL
chr06,Bn31556,73026388,99210137,26183749,TNL
chr06,Bn31557,82815698,96520379,13704681,NBS
chr06,Bn31558,53501374,85573929,32072555,NBS
chr06,Bn31559,2722036,54718296,51996260,CNL
chr06,Bn31560,50160655,66944926,16784271,TN
chr06,Bn31561,2026252,54985492,52959240,RLK
chr06,Bn31562,76514525,94618252,18103727,TN
chr06,Bn31563,44301799,95909736,51607937,CN
chr06,Bn31564,4572612,37189064,32616452,TN
chr06,Bn31565,92813293,93632495,819202,TN
chr06,Bn31566,21748397,30826364,9077967,TN
chr06,Bn31567,57947700,96429578,38481878,RLP
chr06,Bn31568,23588926,53061502,29472576,NBS
chr06,Bn31569,25150407,43476411,18326004,CNL
chr06,Bn31570,65530717,72734931,7204214,RLP
chr06,Bn31571,31477353,49592323,18114970,NBS
chr06,Bn31572,70264383,88444098,18179715,RLP
chr06,Bn31573,97558607,99833004,2274397,CNL
chr06,Bn31574,30828656,44586700,13758044,RLK
chr06,Bn31575,15584631,27112811,11528180,CN
chr06,Bn31576,24188800,65219598,41030798,NBS
chr06,Bn31577,16489979,86641430,70151451,RLP
chr06,Bn31578,80879989,87980137,7100148,CNL
chr06,Bn31579,78480551,83081364,4600813,NBS
chr06,Bn31580,73292104,86073798,12781694,TNL
chr06,Bn31581,97447718,99027580,1579862,RLP
chr06,Bn31582,54350371,66881204,12530833,TN
chr06,Bn31583,11462304,92489876,81027572,TN
chr06,Bn31584,21618046,84009662,62391616,NBS
chr06,Bn31585,95319641,98875038,3555397,RLK
chr06,Bn31586,65301608,76782765,11481157,TN
chr06,Bn31587,83090378,87159432,4069054,RLP
chr06,Bn31588,34694958,98048336,63353378,TN
chr06,Bn31589,93659881,94008595,348714,TNL
chr06,Bn31590,23254991,48096302,24841311,TN
chr06,Bn31591,81921854,90187995,8266141,TNL
chr06,Bn31592,46857380,87160680,40303300,NBS
chr06,Bn31593,40460036,50361007,9900971,CN
chr06,Bn31594,46030118,80255435,34225317,TN
chr06,Bn31595,8828306,81396625,72568319,CN
chr06,Bn31596,4818384,54243357,49424973,CN
chr06,Bn31597,48614444,83993217,35378773,RLP
chr06,Bn31598,45746459,61320035,15573576,CNL
chr06,Bn31599,23816656,69832057,46015401,RLK
chr06,Bn31600,32286753,53239441,20952688,NBS
chr06,Bn31601,69017865,92139076,23121211,NBS
chr06,Bn31602,55900351,58895715,2995364,RLP
chr06,Bn31603,95986575,97622192,1635617,NBS
chr06,Bn31604,98376686,99967448,1590762,NBS
chr06,Bn31605,26640168,70244201,43604033,CN
chr06,Bn31606,98190463,99500770,1310307,TNL
chr06,Bn31607,55463106,95455208,39992102,RLP
chr06,Bn31608,18693706,60840373,42146667,CNL
chr06,Bn31609,98672247,99102628,430381,RLP
chr06,Bn31610,89082148,90080870,998722,NBS
chr06,Bn31611,94493650,95805574,1311924,TN
chr06,Bn31612,70319382,93137519,22818137,CNL
chr06,Bn31613,21454537,28701583,7247046,TNL
chr06,Bn31614,35124351,95281533,60157182,RLK
chr06,Bn31615,9031754,54747899,45716145,NBS
chr06,Bn31616,86304790,91777939,5473149,RLP
chr06,Bn31617,80844099,82491586,1647487,RLP
chr06,Bn31618,56224111,60204349,3980238,RLP
chr06,Bn31619,67224405,92139764,24915359,TN
chr06,Bn31620,5850746,83221993,77371247,TN
chr06,Bn31621,18309380,38240292,19930912,TN
chr06,Bn31622,36741956,49261519,12519563,CNL
chr06,Bn31623,16013046,29695066,13682020,TNL
chr06,Bn31624,13295464,65936562,52641098,CNL
chr06,Bn31625,28115017,99745830,71630813,NBS
chr06,Bn31626,26690446,47251719,20561273,NBS
chr06,Bn31627,98579442,99486702,907260,CNL
chr06,Bn31628,81955590,90215041,8259451,RLP
chr06,Bn31629,19760919,60986006,41225087,RLP
chr06,Bn31630,79813697,80949183,1135486,RLK
chr06,Bn31631,28223769,42686368,14462599,RLK
chr06,Bn31632,6247694,99807528,93559834,NBS
chr06,Bn31633,32240824,61891766,29650942,NBS
chr06,Bn31634,59084069,83302195,24218126,RLP
chr06,Bn31635,62967620,76371994,13404374,CN
chr06,Bn31636,80669916,96847503,16177587,RLP
chr06,Bn31637,7401150,17049365,9648215,RLK
chr06,Bn31638,69073827,81862903,12789076,CN
chr06,Bn31639,44914711,45773410,858699,RLP
chr06,Bn31640,82938888,87462205,4523317,RLK
chr06,Bn31641,22978213,68239766,45261553,CNL
chr06,Bn31642,36690731,94419057,57728326,TN
chr06,Bn31643,37012224,45806042,8793818,CN
chr06,Bn31644,98956314,99338507,382193,CNL
chr06,Bn31645,60630187,65529215,4899028,CN
chr06,Bn31646,40120035,85278320,45158285,TNL
chr06,Bn31647,56678111,63304162,6626051,CNL
chr06,Bn31648,74124123,90769101,16644978,TN
chr06,Bn31649,42923570,92544889,49621319,TN
chr06,Bn31650,63788404,82732569,18944165,TNL
chr06,Bn31651,70926453,82044044,11117591,CNL
chr06,Bn31652,24436574,36580536,12143962,TNL
chr06,Bn31653,92920704,96327543,3406839,TNL
chr06,Bn31654,3168240,9065251,5897011,NBS
chr06,Bn31655,92486057,99637402,7151345,TNL
chr06,Bn31656,87198490,95702689,8504199,NBS
chr06,Bn31657,39471776,97679670,58207894,CNL
chr06,Bn31658,7113186,62007359,54894173,CN
chr06,Bn31659,63022574,69398276,6375702,TN
chr06,Bn31660,42286085,63811521,21525436,NBS
chr06,Bn31661,24726589,83861369,59134780,CN
chr06,Bn31662,90904825,99280052,8375227,CN
chr06,Bn31663,86027510,87298685,1271175,CN
chr06,Bn31664,56064378,93231529,37167151,RLK
chr06,Bn31665,73599059,83629220,10030161,CNL
chr06,Bn31666,9879194,19418335,9539141,NBS
chr06,Bn31667,21876275,81541510,59665235,CN
chr06,Bn31668,63141328,67498046,4356718,CN
chr06,Bn31669,90531630,90625359,93729,TN
chr06,Bn31670,50944049,96776860,45832811,RLP
chr06,Bn31671,23652492,47455501,23803009,CNL
chr06,Bn31672,97756090,97855901,99811,NBS
chr06,Bn31673,9213529,99967361,90753832,TNL
chr06,Bn31674,25212438,94035457,68823019,CN
chr06,Bn31675,69084254,77560821,8476567,NBS
chr06,Bn31676,75174164,90504427,15330263,CN
chr06,Bn31677,84935697,87564807,2629110,RLP
chr06,Bn31678,80860053,94440435,13580382,NBS
chr06,Bn31679,39057132,69568791,30511659,CN
chr06,Bn31680,58769944,70509905,11739961,TNL
chr06,Bn31681,83695721,97480603,13784882,CNL
chr06,Bn31682,39135635,68357280,29221645,CN
chr06,Bn31683,92346951,98028587,5681636,CNL
chr06,Bn31684,43525645,89839695,46314050,NBS
chr06,Bn31685,29736182,68000482,38264300,RLP
chr06,Bn31686,26015465,88096640,62081175,CNL
chr06,Bn31687,89378228,99467532,10089304,TN
chr06,Bn31688,35764302,94923285,59158983,TN
chr06,Bn31689,27198479,55833591,28635112,CNL
chr06,Bn31690,82927031,91035896,8108865,CNL
chr06,Bn31691,75233701,80763911,5530210,TNL
chr06,Bn31692,72290273,77719408,5429135,RLK
chr06,Bn31693,73855690,87582126,13726436,TN
chr06,Bn31694,77255231,86468194,9212963,RLK
chr06,Bn31695,12478439,81102711,68624272,CN
chr06,Bn31696,32580618,35628972,3048354,TN
chr06,Bn31697,65309581,92430626,27121045,CN
chr06,Bn31698,10330979,60797470,50466491,RLK
chr06,Bn31699,19483500,56337839,36854339,CN
chr06,Bn31700,14994272,65972824,50978552,TNL
chr06,Bn31701,12682924,36133931,23451007,RLK
chr06,Bn31702,26597696,74606218,48008522,RLP
chr06,Bn31703,48945538,78181682,29236144,RLP
chr06,Bn31704,3036831,96600400,93563569,CN
chr06,Bn31705,29447646,34509600,5061954,RLP
chr06,Bn31706,70200533,84357342,14156809,CNL
chr06,Bn31707,41996105,77685763,35689658,CN
chr06,Bn31708,87323247,96758004,9434757,NBS
chr06,Bn31709,72914140,87186272,14272132,TN
chr06,Bn31710,38483650,76395173,37911523,NBS
chr06,Bn31711,76961704,90704924,13743220,RLP
chr06,Bn31712,52553312,61843637,9290325,TNL
chr06,Bn31713,57768294,94275797,36507503,CN
chr06,Bn31714,73827342,96527951,22700609,TNL
chr06,Bn31715,16860503,33560764,16700261,RLK
chr06,Bn31716,39549709,81788729,42239020,TNL
chr06,Bn31717,2586825,4657707,2070882,TNL
chr06,Bn31718,68813728,70549085,1735357,CNL
chr06,Bn31719,15446431,60661504,45215073,CNL
chr06,Bn31720,30515578,47827407,17311829,CNL
chr06,Bn31721,42557326,83878270,41320944,CN
chr06,Bn31722,96396337,97588675,1192338,RLK
chr06,Bn31723,14558930,33419375,18860445,RLK
chr06,Bn31724,84699589,88738964,4039375,TN
chr06,Bn31725,55467950,66966945,11498995,TNL
chr06,Bn31726,68385816,96642130,28256314,RLP
chr06,Bn31727,41070389,88172828,47102439,CNL
chr06,Bn31728,88354362,95743622,7389260,CNL
chr06,Bn31729,41137282,98123542,56986260,CNL
chr06,Bn31730,45259679,91795137,46535458,RLK
chr06,Bn31731,13455800,32162872,18707072,RLK
chr06,Bn31732,87667523,90685759,3018236,CN
chr06,Bn31733,55901130,79075969,23174839,NBS
chr06,Bn31734,91822458,98245604,6423146,NBS
chr06,Bn31735,92777517,92985102,207585,RLK
chr06,Bn31736,80285145,90547676,10262531,TN
chr06,Bn31737,48162047,65521057,17359010,TN
chr06,Bn31738,87186346,88202087,1015741,RLP
chr06,Bn31739,97516085,99795857,2279772,NBS
chr06,Bn31740,35797256,58476129,22678873,RLK
chr06,Bn31741,60346348,87359940,27013592,TNL
chr06,Bn31742,87589544,90130761,2541217,RLK
chr06,Bn31743,69582625,93870173,24287548,TNL
chr06,Bn31744,64752678,81990215,17237537,CN
chr06,Bn31745,64503162,75241138,10737976,CNL
chr06,Bn31746,92701672,93686077,984405,NBS
chr06,Bn31747,52000719,87490587,35489868,TN
chr06,Bn31748,34957184,66504074,31546890,NBS
chr06,Bn31749,33449819,78721105,45271286,TNL
chr06,Bn31750,19017896,84683709,65665813,RLP
chr06,Bn31751,53774744,56139794,2365050,RLK
chr06,Bn31752,58857958,69103612,10245654,CN
chr06,Bn31753,10978129,36777877,25799748,CN
chr06,Bn31754,89836103,99609942,9773839,RLP
chr06,Bn31755,78744636,89462673,10718037,RLK
chr06,Bn31756,25566996,96493854,70926858,CNL
chr06,Bn31757,80254221,89664343,9410122,CNL
chr06,Bn31758,41022974,48600387,7577413,NBS
chr06,Bn31759,7765462,16280120,8514658,TNL
chr06,Bn31760,28796732,81530205,52733473,RLK
chr06,Bn31761,66928356,81403308,14474952,TNL
chr06,Bn31762,58500413,63863530,5363117,RLK
chr06,Bn31763,63423068,87886596,24463528,CNL
chr06,Bn31764,20787952,83046231,62258279,RLK
chr06,Bn31765,71857516,94391726,22534210,TN
chr06,Bn31766,72482162,82974605,10492443,TNL
chr06,Bn31767,91102790,92048538,945748,RLP
chr06,Bn31768,34463680,62199331,27735651,NBS
chr06,Bn31769,98999993,99201044,201051,TN
chr06,Bn31770,55134104,62205677,7071573,CNL
chr06,Bn31771,27283362,54984735,27701373,TNL
chr06,Bn31772,41743174,79831045,38087871,CNL
chr06,Bn31773,1497521,89616848,88119327,TN
chr06,Bn31774,10281921,43138503,32856582,TN
chr06,Bn31775,98371555,98964961,593406,TNL
chr06,Bn31776,25726166,74761656,49035490,CN
chr06,Bn31777,11745926,20373907,8627981,CN
chr06,Bn31778,68813597,96736619,27923022,RLP
chr06,Bn31779,27059926,33668384,6608458,CNL
chr06,Bn31780,97713350,98751556,1038206,NBS
chr06,Bn31781,2649795,2780355,130560,NBS
chr06,Bn31782,22569454,50827213,28257759,CN
chr06,Bn31783,68701782,81239136,12537354,TNL
chr06,Bn31784,57563409,85930053,28366644,CN
chr06,Bn31785,59192055,91503961,32311906,NBS
chr06,Bn31786,19727357,76622378,56895021,TNL
chr06,Bn31787,95372146,96213823,841677,TN
chr06,Bn31788,49033634,70993913,21960279,RLP
chr06,Bn31789,54306746,93416840,39110094,NBS
chr06,Bn31790,18427878,87419827,68991949,RLP
chr06,Bn31791,95508494,99006223,3497729,TNL
chr06,Bn31792,49762165,72058982,22296817,TN
chr06,Bn31793,88364941,99082398,10717457,CN
chr06,Bn31794,39735567,46910848,7175281,RLP
chr06,Bn31795,32172444,44010393,11837949,NBS
chr06,Bn31796,55538759,69948091,14409332,NBS
chr06,Bn31797,94861204,97008211,2147007,RLP
chr06,Bn31798,42481995,70250673,27768678,RLK
chr06,Bn31799,44520183,52544768,8024585,NBS
chr06,Bn31800,28165596,85803608,57638012,TNL
chr06,Bn31801,34188893,66241509,32052616,TNL
chr06,Bn31802,78534134,90806611,12272477,TNL
chr06,Bn31803,58165614,93419729,35254115,CNL
chr06,Bn31804,76369846,88549629,12179783,TN
chr06,Bn31805,93863696,94688410,824714,CNL
chr06,Bn31806,43757906,45738743,1980837,NBS
chr06,Bn31807,61584044,68028966,6444922,RLP
chr06,Bn31808,88394744,97284226,8889482,NBS
chr06,Bn31809,21888385,41345775,19457390,RLP
chr06,Bn31810,56942031,73814794,16872763,CN
chr06,Bn31811,49615472,53334827,3719355,NBS
chr06,Bn31812,72162766,75668829,3506063,RLK
chr06,Bn31813,80087115,86807602,6720487,CNL
chr06,Bn31814,8478730,44110471,35631741,TNL
chr06,Bn31815,65669644,94848728,29179084,TN
chr06,Bn31816,95519990,98552439,3032449,CN
chr06,Bn31817,85157613,88472541,3314928,CN
chr06,Bn31818,45615402,81072269,35456867,TN
chr06,Bn31819,72042239,88206149,16163910,CNL
chr06,Bn31820,36558398,49386433,12828035,TN
chr06,Bn31821,32155405,57325337,25169932,CN
chr06,Bn31822,79820161,84320053,4499892,TNL
chr06,Bn31823,23850796,33252295,9401499,CNL
chr06,Bn31824,47311513,54193863,6882350,CNL
chr06,Bn31825,57502930,99699020,42196090,TN
chr06,Bn31826,63373502,63977856,604354,NBS
chr06,Bn31827,80388838,99689687,19300849,CN
chr06,Bn31828,81318055,97421726,16103671,TNL
chr06,Bn31829,47782223,74404877,26622654,RLP
chr06,Bn31830,12191051,68627191,56436140,TN
chr06,Bn31831,43501971,85209105,41707134,NBS
chr06,Bn31832,44260773,84229255,39968482,TNL
chr06,Bn31833,60235327,87753707,27518380,RLP
chr06,Bn31834,89207151,98269794,9062643,RLP
chr06,Bn31835,63490332,85571778,22081446,RLK
chr06,Bn31836,52257663,99880905,47623242,TNL
chr06,Bn31837,79469461,97442853,17973392,NBS
chr06,Bn31838,49565747,51920394,2354647,NBS
chr06,Bn31839,4791083,12254925,7463842,TN
chr06,Bn31840,35070998,67574028,32503030,TN
chr06,Bn31841,81737089,88201136,6464047,CNL
chr06,Bn31842,9739279,90774825,81035546,CNL
chr06,Bn31843,70334697,89279457,18944760,CN
chr06,Bn31844,95369025,96377424,1008399,TNL
chr06,Bn31845,10348323,32471150,22122827,RLK
chr06,Bn31846,76820192,87082297,10262105,CN
chr06,Bn31847,33175785,51008849,17833064,RLP
chr06,Bn31848,71204073,74967740,3763667,TN
chr06,Bn31849,59561595,85553921,25992326,CNL
chr06,Bn31850,54547278,93040832,38493554,CN
chr06,Bn31851,53101599,89772751,36671152,CN
chr06,Bn31852,29523879,30769942,1246063,NBS
chr06,Bn31853,15089855,61710329,46620474,RLK
chr06,Bn31854,19172228,61554395,42382167,CNL
chr06,Bn31855,3567944,58137677,54569733,CN
chr06,Bn31856,42272731,60003959,17731228,NBS
chr06,Bn31857,88969863,90044325,1074462,CNL
chr06,Bn31858,13937417,13987746,50329,CNL
chr06,Bn31859,32467871,33637415,1169544,NBS
chr06,Bn31860,96231727,96909973,678246,NBS
chr06,Bn31861,40373746,82268155,41894409,CNL
chr06,Bn31862,6088312,19713027,13624715,CN
chr06,Bn31863,7068787,91919182,84850395,CN
chr06,Bn31864,52035849,65250992,13215143,NBS
chr06,Bn31865,12540089,27866010,15325921,RLP
chr06,Bn31866,9195532,21555045,12359513,NBS
chr06,Bn31867,64394087,98753435,34359348,CN
chr06,Bn31868,47060826,53469666,6408840,CN
chr06,Bn31869,14335430,85835328,71499898,TNL
chr06,Bn31870,3473388,34377560,30904172,TNL
chr06,Bn31871,77590709,93960032,16369323,TNL
chr06,Bn31872,12411289,76213857,63802568,TN
chr06,Bn31873,89491027,91621654,2130627,RLK
chr06,Bn31874,94149472,94253830,104358,RLK
chr06,Bn31875,28285276,98260373,69975097,CNL
chr06,Bn31876,67862413,74499781,6637368,NBS
chr06,Bn31877,5280970,32884309,27603339,RLP
chr06,Bn31878,59888119,71017564,11129445,TN
chr06,Bn31879,97321216,99921659,2600443,CN
chr06,Bn31880,79067413,85033970,5966557,TN
chr06,Bn31881,18958112,51491355,32533243,RLP
chr06,Bn31882,93162489,97800743,4638254,CNL
chr06,Bn31883,58800410,72122345,13321935,CNL
chr06,Bn31884,45502965,59472501,13969536,CNL
chr06,Bn31885,96992936,97203999,211063,CN
chr06,Bn31886,86219562,97071098,10851536,CN
chr06,Bn31887,6642750,21818919,15176169,TN
chr06,Bn31888,1133864,13202098,12068234,TNL
chr06,Bn31889,77474724,82931090,5456366,TN
chr06,Bn31890,28121980,79725387,51603407,TN
chr06,Bn31891,19983152,57759742,37776590,TNL
chr06,Bn31892,56684952,99462881,42777929,RLP
chr06,Bn31893,15367575,67244298,51876723,CNL
chr06,Bn31894,34090595,44838352,10747757,CN
chr06,Bn31895,2760682,7759266,4998584,NBS
chr06,Bn31896,20332602,54842706,34510104,TNL
chr06,Bn31897,49616725,53169330,3552605,TNL
chr06,Bn31898,58494905,84858692,26363787,NBS
chr06,Bn31899,12117538,42271690,30154152,CNL
chr06,Bn31900,76701589,88971696,12270107,RLP
chr06,Bn31901,29642676,39211167,9568491,CN
chr06,Bn31902,65476508,99255688,33779180,CN
chr06,Bn31903,98430072,98570174,140102,TN
chr06,Bn31904,77397886,89480129,12082243,TN
chr06,Bn31905,2503969,49235810,46731841,CN
chr06,Bn31906,85290381,90994243,5703862,CNL
chr06,Bn31907,57351653,94948905,37597252,RLP
chr06,Bn31908,63462631,67434708,3972077,TNL
chr06,Bn31909,97981095,98399888,418793,CNL
chr06,Bn31910,20500506,33909902,13409396,TN
chr06,Bn31911,15585491,50870922,35285431,RLP
chr06,Bn31912,79173224,82617013,3443789,RLP
chr06,Bn31913,74843753,83620428,8776675,TNL
chr06,Bn31914,52376886,71211500,18834614,CN
chr06,Bn31915,11412440,26219106,14806666,CNL
chr06,Bn31916,35301702,99224181,63922479,CN
chr06,Bn31917,17932674,52372894,34440220,RLP
chr06,Bn31918,17669303,53149694,35480391,TN
chr06,Bn31919,87809053,97533602,9724549,TN
chr06,Bn31920,22604848,68207421,45602573,RLP
chr06,Bn31921,88330285,97592909,9262624,TN
chr06,Bn31922,27894399,76958368,49063969,CNL
chr06,Bn31923,16843946,68154342,51310396,RLP
chr06,Bn31924,68220421,93516458,25296037,RLK
chr06,Bn31925,76153152,84994340,8841188,NBS
chr06,Bn31926,57224772,63780148,6555376,TN
chr06,Bn31927,36604273,78162830,41558557,RLP
chr06,Bn31928,26959770,74337782,47378012,NBS
chr06,Bn31929,71004233,85101130,14096897,CN
chr06,Bn31930,28286435,90841190,62554755,TNL
chr06,Bn31931,59018227,86264588,27246361,TN
chr06,Bn31932,13583766,46554822,32971056,CN
chr06,Bn31933,79754666,83270169,3515503,CN
chr06,Bn31934,68423172,76465587,8042415,TN
chr06,Bn31935,21086621,56164447,35077826,NBS
chr06,Bn31936,57722250,71586451,13864201,CN
chr06,Bn31937,94338839,98242567,3903728,TN
chr06,Bn31938,56168810,63569742,7400932,CNL
chr06,Bn31939,88267334,94090892,5823558,CNL
chr06,Bn31940,31793772,44687060,12893288,CN
chr06,Bn31941,96846386,97551825,705439,RLP
chr06,Bn31942,35039370,60065251,25025881,TN
chr06,Bn31943,56997283,87641563,30644280,CNL
chr06,Bn31944,67584360,86994259,19409899,CN
chr06,Bn31945,76495209,77667447,1172238,RLP
chr06,Bn31946,58890422,72898499,14008077,RLP
chr06,Bn31947,90517185,99494632,8977447,TNL
chr06,Bn31948,23433929,39292289,15858360,CNL
chr06,Bn31949,3942092,41863650,37921558,NBS
chr06,Bn31950,6304675,24551100,18246425,TNL
chr06,Bn31951,38680427,79046952,40366525,RLP
chr06,Bn31952,48343074,85079246,36736172,RLP
chr06,Bn31953,17040115,35107346,18067231,TN
chr06,Bn31954,4529310,33411434,28882124,CN
chr06,Bn31955,13182582,34867723,21685141,NBS
chr06,Bn31956,72357577,87665773,15308196,TNL
chr06,Bn31957,49798967,65116518,15317551,NBS
chr06,Bn31958,62744529,74726922,11982393,RLK
chr06,Bn31959,78493413,84015295,5521882,TNL
chr06,Bn31960,52558342,82428784,29870442,NBS
chr06,Bn31961,32175879,47689174,15513295,CN
chr06,Bn31962,19029609,30055295,11025686,CNL
chr06,Bn31963,5720706,20953674,15232968,RLP
chr06,Bn31964,6665191,83692414,77027223,NBS
chr06,Bn31965,48895950,64645269,15749319,RLP
chr06,Bn31966,65747777,85224569,19476792,NBS
chr06,Bn31967,66206134,92028980,25822846,NBS
chr06,Bn31968,67388207,79220104,11831897,TN
chr06,Bn31969,19710578,96928004,77217426,NBS
chr06,Bn31970,21232215,54755479,33523264,TN
chr06,Bn31971,43916811,81445184,37528373,RLK
chr06,Bn31972,1991926,99549252,97557326,RLP
chr06,Bn31973,55272247,68525180,13252933,TN
chr06,Bn31974,38800436,75578162,36777726,CNL
chr06,Bn31975,93750425,94546912,796487,TN
chr06,Bn31976,23998558,29665730,5667172,RLP
chr06,Bn31977,14689338,60562624,45873286,NBS
chr06,Bn31978,56250583,57059713,809130,TNL
chr06,Bn31979,8198331,61514043,53315712,NBS
chr06,Bn31980,44946963,88075571,43128608,TNL
chr06,Bn31981,53562066,60982429,7420363,RLK
chr06,Bn31982,37699699,94238982,56539283,TNL
chr06,Bn31983,11239864,77325127,66085263,NBS
chr06,Bn31984,14690723,17299287,2608564,NBS
chr06,Bn31985,42677227,64600111,21922884,RLP
chr06,Bn31986,68792254,89125875,20333621,TN
chr06,Bn31987,93771321,98125032,4353711,TNL
chr06,Bn31988,73139972,82828520,9688548,RLK
chr06,Bn31989,85516625,96291235,10774610,CN
chr06,Bn31990,35743281,50822486,15079205,TNL
chr06,Bn31991,19035808,56708633,37672825,RLP
chr06,Bn31992,25192007,89436018,64244011,CNL
chr06,Bn31993,55139484,72322879,17183395,CNL
chr06,Bn31994,64857830,78737369,13879539,NBS
chr06,Bn31995,40821400,64885692,24064292,TN
chr06,Bn31996,82544108,87858127,5314019,RLP
chr06,Bn31997,72355362,73848735,1493373,TN
chr06,Bn31998,75285163,99611347,24326184,RLK
chr06,Bn31999,85870950,97907783,12036833,TNL
chr06,Bn32000,62234037,91186277,28952240,NBS
chr06,Bn32001,27927778,51777411,23849633,RLP
chr06,Bn32002,79246372,83901611,4655239,TNL
chr06,Bn32003,50805999,54528517,3722518,CN
chr06,Bn32004,41587025,59222739,17635714,TN
chr06,Bn32005,56676601,98533760,41857159,RLP
chr06,Bn32006,48712525,89786272,41073747,TN
chr06,Bn32007,9441658,13061387,3619729,RLK
chr06,Bn32008,75049648,84298270,9248622,RLP
chr06,Bn32009,12908591,73398350,60489759,RLP
chr06,Bn32010,3781508,47207414,43425906,RLP
chr06,Bn32011,77089880,98960804,21870924,CN
chr06,Bn32012,80290367,97985465,17695098,CNL
chr06,Bn32013,99634336,99740442,106106,NBS
chr06,Bn32014,71200253,99586913,28386660,CN
chr06,Bn32015,91190645,98065313,6874668,NBS
chr06,Bn32016,90181786,93688232,3506446,RLP
chr06,Bn32017,88427744,88566490,138746,NBS
chr06,Bn32018,16964322,66288775,49324453,CN
chr06,Bn32019,47688895,81573279,33884384,NBS
chr06,Bn32020,4360238,53448744,49088506,RLK
chr06,Bn32021,23384598,30899540,7514942,CN
chr06,Bn32022,41812610,61438074,19625464,RLK
chr06,Bn32023,34705687,42896161,8190474,TNL
chr06,Bn32024,85229920,95600265,10370345,TN
chr06,Bn32025,80958357,89494997,8536640,NBS
chr06,Bn32026,84416826,98903433,14486607,CNL
chr06,Bn32027,88160802,89940532,1779730,CN
chr06,Bn32028,17932206,80622915,62690709,TNL
chr06,Bn32029,97326775,98111419,784644,RLK
chr06,Bn32030,84125944,95850859,11724915,CN
chr06,Bn32031,3710628,85081206,81370578,RLK
chr06,Bn32032,46221810,73816253,27594443,CNL
chr06,Bn32033,40094755,79789539,39694784,TN
chr06,Bn32034,26836273,87376780,60540507,TN
chr06,Bn32035,4709222,32228325,27519103,TN
chr06,Bn32036,68976187,82709786,13733599,RLK
chr06,Bn32037,16592723,68931611,52338888,RLP
chr06,Bn32038,60130000,87743631,27613631,CN
chr06,Bn32039,6467207,46753567,40286360,RLP
chr06,Bn32040,21297057,56340357,35043300,TNL
chr06,Bn32041,18986637,62729758,43743121,TNL
chr06,Bn32042,91142996,96899476,5756480,TN
chr06,Bn32043,87764695,99965985,12201290,TN
chr06,Bn32044,97751783,99140582,1388799,CNL
chr06,Bn32045,42843510,85170102,42326592,CN
chr06,Bn32046,56992426,68184809,11192383,RLK
chr06,Bn32047,75094138,87227818,12133680,NBS
chr06,Bn32048,29921002,81759179,51838177,TNL
chr06,Bn32049,20256256,60415682,40159426,NBS
chr06,Bn32050,87032277,96833444,9801167,CNL
chr06,Bn32051,12096501,51972532,39876031,TNL
chr06,Bn32052,39154730,56771049,17616319,CNL
chr06,Bn32053,81558495,86858258,5299763,TN
chr06,Bn32054,6661206,29152094,22490888,RLP
chr06,Bn32055,80027512,90600481,10572969,CNL
chr06,Bn32056,42274993,59519218,17244225,CN
chr06,Bn32057,55797060,87215196,31418136,CN
chr06,Bn32058,77922454,84865075,6942621,NBS
chr06,Bn32059,58249104,75547635,17298531,TNL
chr06,Bn32060,44021750,81490761,37469011,RLP
chr06,Bn32061,92489757,97554796,5065039,TNL
chr06,Bn32062,72276494,78240677,5964183,CNL
chr06,Bn32063,1274023,42796292,41522269,TN
chr06,Bn32064,50338255,70473635,20135380,NBS
chr06,Bn32065,69350561,80842190,11491629,CN
chr06,Bn32066,26350686,40663208,14312522,NBS
chr06,Bn32067,44652161,72780409,28128248,CNL
chr06,Bn32068,27451588,51436664,23985076,CNL
chr06,Bn32069,34715055,95536851,60821796,TNL
chr06,Bn32070,85119096,98529470,13410374,RLK
chr06,Bn32071,28908188,57315534,28407346,CN
chr06,Bn32072,15114938,47823636,32708698,NBS
chr06,Bn32073,24608560,84187473,59578913,TNL
chr06,Bn32074,71538376,73530998,1992622,CNL
chr06,Bn32075,36308693,60722680,24413987,NBS
chr06,Bn32076,6252641,99982235,93729594,RLK
chr06,Bn32077,53476257,57858777,4382520,RLP
chr06,Bn32078,8070115,74430552,66360437,RLP
chr06,Bn32079,49354752,65187585,15832833,TNL
chr06,Bn32080,83094322,91718029,8623707,NBS
chr06,Bn32081,24436951,28604876,4167925,TN
chr06,Bn32082,81156075,95526726,14370651,NBS
chr06,Bn32083,70914494,71320941,406447,RLK
chr06,Bn32084,46229575,90830065,44600490,RLK
chr06,Bn32085,10107864,69087311,58979447,RLP
chr06,Bn32086,14242205,31346873,17104668,CN
chr06,Bn32087,75718832,91185484,15466652,TN
chr06,Bn32088,98886574,99945651,1059077,TNL
chr06,Bn32089,6779642,77657881,70878239,TNL
chr06,Bn32090,67943848,85200411,17256563,CN
chr06,Bn32091,76503229,90203100,13699871,NBS
chr06,Bn32092,67265010,80860992,13595982,CN
chr06,Bn32093,24358471,90466763,66108292,TN
chr06,Bn32094,47587292,61669476,14082184,CNL
chr06,Bn32095,6645156,44628530,37983374,CNL
chr06,Bn32096,91955815,94694320,2738505,CN
chr06,Bn32097,81947712,92916116,10968404,RLP
chr06,Bn32098,50915254,57990551,7075297,RLK
chr06,Bn32099,93132524,94858502,1725978,CNL
chr06,Bn32100,32395029,95625871,63230842,TN
chr06,Bn32101,16478894,70651590,54172696,TNL
chr06,Bn32102,11181588,47025879,35844291,NBS
chr06,Bn32103,9377781,64611054,55233273,CNL
chr06,Bn32104,86575802,91149505,4573703,RLK
chr06,Bn32105,38622976,87057728,48434752,CN
chr06,Bn32106,67533756,81230153,13696397,NBS
chr06,Bn32107,65390549,87226869,21836320,RLP
chr06,Bn32108,5907313,25006848,19099535,RLP
chr06,Bn32109,89326077,97809379,8483302,NBS
chr06,Bn32110,67924493,87766801,19842308,RLP
chr06,Bn32111,88312376,96154463,7842087,CN
chr06,Bn32112,6570360,81534817,74964457,TN
chr06,Bn32113,43708952,58596602,14887650,TN
chr06,Bn32114,86490545,96757377,10266832,RLK
chr06,Bn32115,7908136,40847782,32939646,NBS
chr06,Bn32116,66596657,81491301,14894644,CNL
chr06,Bn32117,11303269,84429472,73126203,CNL
chr06,Bn32118,94519874,97966832,3446958,TN
chr06,Bn32119,22528897,94367582,71838685,RLK
chr06,Bn32120,76696616,79026986,2330370,CNL
chr06,Bn32121,7622920,29224583,21601663,RLP
chr06,Bn32122,60789913,65405050,4615137,CN
chr06,Bn32123,28806427,51493579,22687152,RLK
chr06,Bn32124,4316580,82142357,77825777,CNL
chr06,Bn32125,32945160,34276933,1331773,TNL
chr06,Bn32126,77025355,91361050,14335695,TN
chr06,Bn32127,34780319,69799894,35019575,CNL
chr06,Bn32128,69226497,92238881,23012384,NBS
chr06,Bn32129,11061728,20532481,9470753,RLK
chr06,Bn32130,8957222,77753707,68796485,TN
chr06,Bn32131,38346867,42007583,3660716,TNL
chr06,Bn32132,51624763,83645996,32021233,TN
chr06,Bn32133,98963742,99644363,680621,TNL
chr06,Bn32134,97076115,98235778,1159663,CNL
chr06,Bn32135,93414163,96570271,3156108,TNL
chr06,Bn32136,30936684,70057951,39121267,RLP
chr06,Bn32137,99784931,99791963,7032,CNL
chr06,Bn32138,48643159,62329805,13686646,NBS
chr06,Bn32139,50392771,66119710,15726939,TN
chr06,Bn32140,13190768,73511045,60320277,CN
chr06,Bn32141,55846961,87591094,31744133,TNL
chr06,Bn32142,8675412,67316913,58641501,RLK
chr06,Bn32143,46712394,50589079,3876685,TN
chr06,Bn32144,12409333,91256490,78847157,NBS
chr06,Bn32145,61408559,71762099,10353540,TNL
chr06,Bn32146,75178844,91444866,16266022,NBS
chr06,Bn32147,67589102,69485579,1896477,CN
chr06,Bn32148,38737617,42382916,3645299,CN
chr06,Bn32149,12319469,74537498,62218029,NBS
chr06,Bn32150,88481003,89576352,1095349,RLK
chr06,Bn32151,75580032,87431376,11851344,RLP
chr06,Bn32152,8767789,89659231,80891442,NBS
chr06,Bn32153,61254483,81634214,20379731,RLK
chr06,Bn32154,53144380,71492824,18348444,CN
chr06,Bn32155,58936420,98496815,39560395,RLP
chr06,Bn32156,4061718,56041735,51980017,RLP
chr06,Bn32157,34488423,59396469,24908046,CN
chr07,Bn32158,11314515,67081449,55766934,CN
chr07,Bn32159,27334154,75439638,48105484,RLP
chr07,Bn32160,90894488,94893020,3998532,CN
chr07,Bn32161,75544324,86747325,11203001,RLP
chr07,Bn32162,83114489,98653832,15539343,RLK
chr07,Bn32163,65606789,79682511,14075722,CN
chr07,Bn32164,84589203,97256794,12667591,NBS
chr07,Bn32165,45299382,47420647,2121265,RLP
chr07,Bn32166,51941414,66728298,14786884,TN
chr07,Bn32167,36276434,42630041,6353607,RLK
chr07,Bn32168,82504865,86184339,3679474,TN
chr07,Bn32169,61063081,85531201,24468120,RLK
chr07,Bn32170,41685019,81378751,39693732,TNL
chr07,Bn32171,94586036,97890726,3304690,TN
chr07,Bn32172,73806049,97164615,23358566,RLK
chr07,Bn32173,60000373,61417131,1416758,RLK
chr07,Bn32174,43981266,60295851,16314585,NBS
chr07,Bn32175,5627711,32134033,26506322,TN
chr07,Bn32176,32162474,41223866,9061392,CNL
chr07,Bn32177,27092377,35226926,8134549,TN
chr07,Bn32178,9506813,32668341,23161528,RLP
chr07,Bn32179,39613207,84246578,44633371,TNL
chr07,Bn32180,49794640,80244162,30449522,NBS
chr07,Bn32181,91254517,98227002,6972485,RLK
chr07,Bn32182,77921009,83619302,5698293,RLP
chr07,Bn32183,97877269,98095871,218602,TNL
chr07,Bn32184,41867201,83831115,41963914,RLK
chr07,Bn32185,74995593,88732621,13737028,RLP
chr07,Bn32186,75935280,89422215,13486935,RLK
chr07,Bn32187,96441569,99045582,2604013,CN
chr07,Bn32188,57110171,91918819,34808648,NBS
chr07,Bn32189,26779469,55426251,28646782,RLK
chr07,Bn32190,94988197,96631162,1642965,CN
chr07,Bn32191,55763482,64454420,8690938,CNL
chr07,Bn32192,86482137,97950613,11468476,NBS
chr07,Bn32193,36696993,79773694,43076701,TNL
chr07,Bn32194,34055730,74358244,40302514,NBS
chr07,Bn32195,67513569,75655252,8141683,CN
chr07,Bn32196,93312271,93529317,217046,RLP
chr07,Bn32197,90772154,93210348,2438194,RLK
chr07,Bn32198,80203905,95105958,14902053,CN
chr07,Bn32199,25963020,75205724,49242704,TNL
chr07,Bn32200,68966634,87831250,18864616,CNL
chr07,Bn32201,21670885,67508714,45837829,CNL
chr07,Bn32202,79840345,87274306,7433961,NBS
chr07,Bn32203,98467156,99730718,1263562,TN
chr07,Bn32204,59093753,92213006,33119253,RLP
chr07,Bn32205,78140359,98649232,20508873,NBS
chr07,Bn32206,5672953,79526626,73853673,RLK
chr07,Bn32207,7284705,96921103,89636398,CNL
chr07,Bn32208,79334931,89911022,10576091,TNL
chr07,Bn32209,93754781,97250246,3495465,NBS
chr07,Bn32210,57803137,91766930,33963793,NBS
chr07,Bn32211,96186978,99959164,3772186,TNL
chr07,Bn32212,60594001,85685485,25091484,RLP
chr07,Bn32213,76724638,94081977,17357339,RLK
chr07,Bn32214,76386510,83471832,7085322,CNL
chr07,Bn32215,77831637,84109958,6278321,CN
chr07,Bn32216,6828227,80240777,73412550,CNL
chr07,Bn32217,53707197,94993562,41286365,RLK
chr07,Bn32218,23421834,51972569,28550735,RLP
chr07,Bn32219,88406812,91837306,3430494,TN
chr07,Bn32220,54466357,69574492,15108135,TNL
chr07,Bn32221,74766087,83894035,9127948,CNL
chr07,Bn32222,21740344,59331721,37591377,CNL
chr07,Bn32223,71385413,88411732,17026319,CNL
chr07,Bn32224,58022374,66576869,8554495,RLK
chr07,Bn32225,68621679,83450148,14828469,TNL
chr07,Bn32226,88358334,90068356,1710022,RLK
chr07,Bn32227,73985530,93220248,19234718,CNL
chr07,Bn32228,31695359,99306116,67610757,TNL
chr07,Bn32229,51741434,72071691,20330257,CNL
chr07,Bn32230,39083181,64384996,25301815,CN
chr07,Bn32231,82677690,83921348,1243658,RLK
chr07,Bn32232,83537487,88974663,5437176,NBS
chr07,Bn32233,97181936,98632421,1450485,TNL
chr07,Bn32234,9592100,42535803,32943703,TN
chr07,Bn32235,61605918,75030781,13424863,TN
chr07,Bn32236,89566384,95599017,6032633,TNL
chr07,Bn32237,79908483,93240493,13332010,NBS
chr07,Bn32238,64487968,80363373,15875405,CNL
chr07,Bn32239,49116460,87283327,38166867,TN
chr07,Bn32240,28437734,45779784,17342050,RLP
chr07,Bn32241,80394494,87521717,7127223,TNL
chr07,Bn32242,98630457,99308208,677751,NBS
chr07,Bn32243,61406260,94187608,32781348,RLP
chr07,Bn32244,23754589,51072229,27317640,RLK
chr07,Bn32245,79720211,98441582,18721371,TN
chr07,Bn32246,60427947,74685930,14257983,RLP
chr07,Bn32247,4340918,88163055,83822137,RLK
chr07,Bn32248,83168445,94748630,11580185,CN
chr07,Bn32249,10459097,27994402,17535305,CNL
chr07,Bn32250,88379264,98862605,10483341,NBS
chr07,Bn32251,45309594,59613104,14303510,NBS
chr07,Bn32252,4803081,61694437,56891356,CNL
chr07,Bn32253,26351624,63190810,36839186,TNL
chr07,Bn32254,61597659,81922557,20324898,TNL
chr07,Bn32255,33274189,54217392,20943203,TNL
chr07,Bn32256,12013905,54069532,42055627,CN
chr07,Bn32257,82138819,94843523,12704704,CN
chr07,Bn32258,21124050,61701427,40577377,TNL
chr07,Bn32259,10610448,70729476,60119028,TNL
chr07,Bn32260,99352319,99482865,130546,TNL
chr07,Bn32261,77371814,98995484,21623670,RLP
chr07,Bn32262,87329620,88328603,998983,RLP
chr07,Bn32263,21834651,88277228,66442577,TN
chr07,Bn32264,99071816,99234080,162264,TN
chr07,Bn32265,29999187,73660378,43661191,TN
chr07,Bn32266,57876635,61908408,4031773,NBS
chr07,Bn32267,85900180,95567521,9667341,CNL
chr07,Bn32268,73216664,89371393,16154729,RLK
chr07,Bn32269,92230807,93642661,1411854,RLK
chr07,Bn32270,86134767,99551332,13416565,CN
chr07,Bn32271,47117607,47541774,424167,RLK
chr07,Bn32272,78891455,94463165,15571710,RLP
chr07,Bn32273,24472111,59796119,35324008,CNL
chr07,Bn32274,37983559,66544329,28560770,TN
chr07,Bn32275,36343389,68172068,31828679,TNL
chr07,Bn32276,93628846,98349343,4720497,RLK
chr07,Bn32277,91768395,96309147,4540752,RLP
chr07,Bn32278,47160701,70740067,23579366,NBS
chr07,Bn32279,47430565,96162165,48731600,TNL
chr07,Bn32280,56788760,78569366,21780606,RLK
chr07,Bn32281,56021220,73487089,17465869,RLP
chr07,Bn32282,12146748,78545269,66398521,RLP
chr07,Bn32283,61285308,82695089,21409781,NBS
chr07,Bn32284,79474627,95871859,16397232,NBS
chr07,Bn32285,80045176,84740592,4695416,TNL
chr07,Bn32286,30720628,98686469,67965841,NBS
chr07,Bn32287,87319858,93035071,5715213,TN
chr07,Bn32288,5921389,73076237,67154848,CNL
chr07,Bn32289,14826413,28130261,13303848,TNL
chr07,Bn32290,42420982,94387428,51966446,RLP
chr07,Bn32291,59392589,64091599,4699010,CN
chr07,Bn32292,68433778,79886329,11452551,TNL
chr07,Bn32293,42282700,61573696,19290996,CNL
chr07,Bn32294,17539027,77287955,59748928,NBS
chr07,Bn32295,10902609,43686812,32784203,TN
chr07,Bn32296,32798993,40345856,7546863,TNL
chr07,Bn32297,40319948,61824637,21504689,RLP
chr07,Bn32298,91096082,92721212,1625130,RLK
chr07,Bn32299,1587955,91493803,89905848,NBS
chr07,Bn32300,46202625,87916397,41713772,CNL
chr07,Bn32301,19843342,66795451,46952109,CN
chr07,Bn32302,32290182,55650144,23359962,RLK
chr07,Bn32303,21260048,85233260,63973212,RLK
chr07,Bn32304,92220435,93778698,1558263,CNL
chr07,Bn32305,17034079,97370350,80336271,NBS
chr07,Bn32306,64978392,74431932,9453540,CN
chr07,Bn32307,73222688,73657643,434955,RLP
chr07,Bn32308,91131975,98231238,7099263,CNL
chr07,Bn32309,99334794,99412227,77433,TNL
chr07,Bn32310,58050700,89879855,31829155,NBS
chr07,Bn32311,48180761,97798245,49617484,NBS
chr07,Bn32312,55768668,99854027,44085359,RLP
chr07,Bn32313,18181756,85719705,67537949,RLP
chr07,Bn32314,76604145,85578697,8974552,CNL
chr07,Bn32315,94413435,97192903,2779468,NBS
chr07,Bn32316,22972640,72053211,49080571,RLK
chr07,Bn32317,44909483,69913635,25004152,CN
chr07,Bn32318,12872401,35993304,23120903,TN
chr07,Bn32319,33636365,90903964,57267599,RLP
chr07,Bn32320,80991285,87827393,6836108,TN
chr07,Bn32321,10833771,94086098,83252327,CN
chr07,Bn32322,16650327,98135821,81485494,CNL
chr07,Bn32323,88041299,95768944,7727645,TNL
chr07,Bn32324,90645204,92341558,1696354,TN
chr07,Bn32325,24225563,59468592,35243029,TN
chr07,Bn32326,20485676,57705326,37219650,NBS
chr07,Bn32327,16347517,96304232,79956715,RLP
chr07,Bn32328,43983895,77498340,33514445,RLK
chr07,Bn32329,67886124,68694677,808553,CN
chr07,Bn32330,97760809,97791566,30757,RLK
chr07,Bn32331,26539056,88815738,62276682,RLK
chr07,Bn32332,71344647,87096574,15751927,TN
chr07,Bn32333,83446826,84782661,1335835,TN
chr07,Bn32334,75698013,80074498,4376485,NBS
chr07,Bn32335,72872833,73094019,221186,CN
chr07,Bn32336,51105746,70944590,19838844,CNL
chr07,Bn32337,80381613,93174374,12792761,RLK
chr07,Bn32338,94918553,99691519,4772966,TNL
chr07,Bn32339,39737906,95602707,55864801,CN
chr07,Bn32340,90135064,94337215,4202151,TN
chr07,Bn32341,31640172,56384399,24744227,CNL
chr07,Bn32342,8164454,64447485,56283031,TN
chr07,Bn32343,2388400,56090979,53702579,RLP
chr07,Bn32344,35390108,75864534,40474426,TN
chr07,Bn32345,57372610,62683231,5310621,CNL
chr07,Bn32346,65463841,83294359,17830518,CN
chr07,Bn32347,81696979,95946791,14249812,RLP
chr07,Bn32348,75051045,80196997,5145952,CNL
chr07,Bn32349,52223243,61164285,8941042,RLP
chr07,Bn32350,22037292,29250985,7213693,RLK
chr07,Bn32351,83254225,83793504,539279,TNL
chr07,Bn32352,61436354,89632871,28196517,TNL
chr07,Bn32353,37691865,49771650,12079785,CNL
chr07,Bn32354,22922013,93306948,70384935,CNL
chr07,Bn32355,30233945,31701871,1467926,CN
chr07,Bn32356,63185738,96357362,33171624,RLK
chr07,Bn32357,47512977,57813593,10300616,RLP
chr07,Bn32358,69505482,92340971,22835489,RLP
chr07,Bn32359,72354764,90020021,17665257,RLP
chr07,Bn32360,91781311,94652851,2871540,NBS
chr07,Bn32361,47548080,67285289,19737209,CNL
chr07,Bn32362,26538130,55704030,29165900,CN
chr07,Bn32363,76186504,77810496,1623992,CNL
chr07,Bn32364,63276280,78903233,15626953,TN
chr07,Bn32365,45647605,92101241,46453636,CN
chr07,Bn32366,33104889,81327880,48222991,RLP
chr07,Bn32367,49605379,65082466,15477087,CN
chr07,Bn32368,41474093,45565536,4091443,TNL
chr07,Bn32369,51771939,73316766,21544827,RLK
chr07,Bn32370,79942662,93263122,13320460,TNL
chr07,Bn32371,91146735,94402473,3255738,CN
chr07,Bn32372,97366488,99113110,1746622,NBS
chr07,Bn32373,29413744,45478555,16064811,CNL
chr07,Bn32374,48038159,57404178,9366019,CNL
chr07,Bn32375,11020545,36080105,25059560,TNL
chr07,Bn32376,45155588,57196841,12041253,CN
chr07,Bn32377,74757324,80272855,5515531,TN
chr07,Bn32378,28861118,44211491,15350373,CNL
chr07,Bn32379,5623154,56660958,51037804,RLK
chr07,Bn32380,84207160,94492745,10285585,RLK
chr07,Bn32381,37233863,45228700,7994837,CNL
chr07,Bn32382,71452041,91082345,19630304,RLK
chr07,Bn32383,85266239,88084811,2818572,RLP
chr07,Bn32384,72395155,84061654,11666499,CN
chr07,Bn32385,76553153,81920414,5367261,CN
chr07,Bn32386,67862072,91061295,23199223,NBS
chr07,Bn32387,20195385,25387886,5192501,CNL
chr07,Bn32388,5489903,94470978,88981075,TNL
chr07,Bn32389,1047003,55819433,54772430,NBS
chr07,Bn32390,62875861,79255230,16379369,TNL
chr07,Bn32391,18984337,44889870,25905533,CNL
chr07,Bn32392,91758465,93698177,1939712,TNL
chr07,Bn32393,1473362,73624052,72150690,CN
chr07,Bn32394,51419702,87836757,36417055,RLP
chr07,Bn32395,25534857,91556629,66021772,NBS
chr07,Bn32396,37347768,39478379,2130611,CN
chr07,Bn32397,4877989,86530188,81652199,NBS
chr07,Bn32398,47269071,54132915,6863844,CN
chr07,Bn32399,99300692,99886932,586240,CN
chr07,Bn32400,73646939,88591224,14944285,NBS
chr07,Bn32401,63688581,88490394,24801813,TN
chr07,Bn32402,54744868,99463626,44718758,TN
chr07,Bn32403,62016311,90734411,28718100,TNL
chr07,Bn32404,21748803,82225914,60477111,TN
chr07,Bn32405,69248924,74160347,4911423,RLK
chr07,Bn32406,36525425,79149079,42623654,TNL
chr07,Bn32407,5663227,50761359,45098132,TN
chr07,Bn32408,82926196,88893976,5967780,RLK
chr07,Bn32409,41195400,44783117,3587717,CN
chr07,Bn32410,86864162,97365162,10501000,CNL
chr07,Bn32411,11512649,60618235,49105586,RLK
chr07,Bn32412,66022209,68709308,2687099,NBS
chr07,Bn32413,34982771,59750503,24767732,RLP
chr07,Bn32414,49206484,89730110,40523626,TNL
chr07,Bn32415,11456427,59796704,48340277,RLK
chr07,Bn32416,96305770,97744174,1438404,TN
chr07,Bn32417,24196277,33162667,8966390,CN
chr07,Bn32418,37763618,42491693,4728075,NBS
chr07,Bn32419,53410802,99223378,45812576,RLP
chr07,Bn32420,61745005,88016409,26271404,CNL
chr07,Bn32421,98778062,98939117,161055,CNL
chr07,Bn32422,62054921,87201505,25146584,CN
chr07,Bn32423,65634310,99139267,33504957,RLP
chr07,Bn32424,31041823,42549816,11507993,RLK
chr07,Bn32425,63840013,79394779,15554766,TN
chr07,Bn32426,60870087,89915275,29045188,TN
chr07,Bn32427,49902953,72719051,22816098,CNL
chr07,Bn32428,17113706,32548027,15434321,CNL
chr07,Bn32429,48492300,78837114,30344814,TN
chr07,Bn32430,67058479,88784315,21725836,RLK
chr07,Bn32431,23260073,26133377,2873304,NBS
chr07,Bn32432,18677150,53071279,34394129,RLK
chr07,Bn32433,22470146,77017319,54547173,CNL
chr07,Bn32434,1443811,36471192,35027381,RLP
chr07,Bn32435,21814376,78275581,56461205,TNL
chr07,Bn32436,96616901,98890253,2273352,TN
chr07,Bn32437,31285468,85798011,54512543,RLP
chr07,Bn32438,60600337,76959622,16359285,RLK
chr07,Bn32439,77662176,81118232,3456056,TNL
chr07,Bn32440,48316702,75696385,27379683,RLP
chr07,Bn32441,87915490,91224863,3309373,RLP
chr07,Bn32442,24708707,33524469,8815762,TNL
chr07,Bn32443,91316275,94906151,3589876,TN
chr07,Bn32444,2308261,49766960,47458699,RLP
chr07,Bn32445,74112224,75084304,972080,TNL
chr07,Bn32446,74647218,84142541,9495323,CNL
chr07,Bn32447,16577889,60815142,44237253,NBS
chr07,Bn32448,49079562,85861765,36782203,RLK
chr07,Bn32449,83182383,85902319,2719936,TNL
chr07,Bn32450,85291785,95428309,10136524,TN
chr07,Bn32451,38088114,89968552,51880438,CNL
chr07,Bn32452,27585459,97364091,69778632,NBS
chr07,Bn32453,10571376,21630652,11059276,TNL
chr07,Bn32454,21808501,33255694,11447193,NBS
chr07,Bn32455,52804752,56403614,3598862,RLK
chr07,Bn32456,20067294,22139080,2071786,RLK
chr07,Bn32457,95626635,98430599,2803964,CNL
chr07,Bn32458,35729217,88033382,52304165,TNL
chr07,Bn32459,61152693,97030200,35877507,CN
chr07,Bn32460,76448137,98712551,22264414,NBS
chr07,Bn32461,73650839,94681500,21030661,CN
chr07,Bn32462,37383357,63034054,25650697,CNL
chr07,Bn32463,17334927,96766902,79431975,CN
chr07,Bn32464,74533139,98896043,24362904,CN
chr07,Bn32465,96775695,97498163,722468,RLK
chr07,Bn32466,96408460,99784539,3376079,TNL
chr07,Bn32467,18930738,23126786,4196048,CN
chr07,Bn32468,93233859,97535895,4302036,CNL
chr07,Bn32469,66643709,77887313,11243604,RLP
chr07,Bn32470,64607000,90415436,25808436,NBS
chr07,Bn32471,49404284,89723196,40318912,RLP
chr07,Bn32472,54731217,65994681,11263464,RLK
chr07,Bn32473,61611551,83940972,22329421,TNL
chr07,Bn32474,16499831,60666402,44166571,TN
chr07,Bn32475,48165727,60512098,12346371,RLP
chr07,Bn32476,94507170,99558295,5051125,CNL
chr07,Bn32477,55992899,70207451,14214552,CNL
chr07,Bn32478,32904252,93721779,60817527,TN
chr07,Bn32479,59319232,69444805,10125573,RLK
chr07,Bn32480,94877925,95545873,667948,CN
chr07,Bn32481,49314188,56290417,6976229,RLK
chr07,Bn32482,88724270,98128052,9403782,TNL
chr07,Bn32483,8241065,40833234,32592169,TN
chr07,Bn32484,78564430,80877543,2313113,TNL
chr07,Bn32485,65240365,97527570,32287205,NBS
chr07,Bn32486,41908716,48430734,6522018,CNL
chr07,Bn32487,52251885,52697212,445327,CNL
chr07,Bn32488,69749465,87969833,18220368,CN
chr07,Bn32489,73762385,82420982,8658597,CN
chr07,Bn32490,59332015,59890356,558341,CNL
chr07,Bn32491,22291712,55729375,33437663,TN
chr07,Bn32492,21265503,83778589,62513086,TNL
chr07,Bn32493,52422157,83495053,31072896,NBS
chr07,Bn32494,64783604,66301279,1517675,RLK
chr07,Bn32495,20366741,80700921,60334180,CNL
chr07,Bn32496,42708430,94942224,52233794,RLP
chr07,Bn32497,82036958,83143185,1106227,RLK
chr07,Bn32498,85878348,99489384,13611036,TN
chr07,Bn32499,30728114,61973627,31245513,TNL
chr07,Bn32500,10105642,64868994,54763352,NBS
chr07,Bn32501,51936672,90251436,38314764,RLK
chr07,Bn32502,10415255,13629665,3214410,TNL
chr07,Bn32503,21593486,65370224,43776738,NBS
chr07,Bn32504,24086580,88199978,64113398,CNL
chr07,Bn32505,71218221,73712057,2493836,RLP
chr07,Bn32506,28677311,61223822,32546511,TN
chr07,Bn32507,58939847,93477172,34537325,CNL
chr07,Bn32508,95126431,98874526,3748095,TN
chr07,Bn32509,16963595,41571991,24608396,NBS
chr07,Bn32510,6076701,27764926,21688225,NBS
chr07,Bn32511,13791581,28976358,15184777,TN
chr07,Bn32512,72634733,91588230,18953497,CNL
chr07,Bn32513,60884773,70440976,9556203,CNL
chr07,Bn32514,20753304,30118414,9365110,CNL
chr07,Bn32515,5979994,40639997,34660003,RLP
chr07,Bn32516,48538038,77145498,28607460,RLK
chr07,Bn32517,74052049,77539863,3487814,CN
chr07,Bn32518,89726844,91535932,1809088,TNL
chr07,Bn32519,77508382,93263959,15755577,TN
chr07,Bn32520,20761696,60925059,40163363,CNL
chr07,Bn32521,75974579,87159663,11185084,TN
chr07,Bn32522,9591935,70938217,61346282,RLK
chr07,Bn32523,35649076,76422471,40773395,RLK
chr07,Bn32524,12531021,44131002,31599981,RLK
chr07,Bn32525,25284123,36995131,11711008,RLK
chr07,Bn32526,48505581,70089838,21584257,TN
chr07,Bn32527,43224217,97566157,54341940,CNL
chr07,Bn32528,42025982,98544355,56518373,RLK
chr07,Bn32529,17882098,49853126,31971028,CN
chr07,Bn32530,70928417,74809463,3881046,TN
chr07,Bn32531,12439632,38023758,25584126,CNL
chr07,Bn32532,59963557,67876693,7913136,RLK
chr07,Bn32533,14928084,90747551,75819467,CNL
chr07,Bn32534,89981689,93474621,3492932,RLP
chr07,Bn32535,60901533,69263829,8362296,CNL
chr07,Bn32536,16041821,88270323,72228502,TNL
chr07,Bn32537,42583193,87949198,45366005,CNL
chr07,Bn32538,15519158,94578002,79058844,CN
chr07,Bn32539,31437061,98323989,66886928,CNL
chr07,Bn32540,50289041,95668675,45379634,RLP
chr07,Bn32541,64920351,97022108,32101757,TN
chr07,Bn32542,13573604,32743651,19170047,TN
chr07,Bn32543,84542202,99512553,14970351,CN
chr07,Bn32544,70174405,82514481,12340076,CN
chr07,Bn32545,31068976,69065838,37996862,NBS
chr07,Bn32546,98342055,99388271,1046216,RLP
chr07,Bn32547,35262554,46814512,11551958,CN
chr07,Bn32548,64728580,66021641,1293061,TNL
chr07,Bn32549,42269460,58378434,16108974,TNL
chr07,Bn32550,14868390,95696311,80827921,TNL
chr07,Bn32551,86201975,90044019,3842044,CNL
chr07,Bn32552,25038525,84933783,59895258,TN
chr07,Bn32553,36135390,67420049,31284659,TN
chr07,Bn32554,98493291,98909521,416230,TNL
chr07,Bn32555,94329738,98133729,3803991,TN
chr07,Bn32556,10247136,17980478,7733342,TNL
chr07,Bn32557,22054788,53194506,31139718,NBS
chr07,Bn32558,21953711,99174840,77221129,CN
chr07,Bn32559,27768133,28721977,953844,TNL
chr07,Bn32560,73840976,81662365,7821389,TN
chr07,Bn32561,96951406,98816025,1864619,TN
chr07,Bn32562,57887278,93946051,36058773,TNL
chr07,Bn32563,72631548,92779627,20148079,NBS
chr07,Bn32564,26112077,78010728,51898651,TNL
chr07,Bn32565,7612201,80103089,72490888,CNL
chr07,Bn32566,21894545,92407930,70513385,CN
chr07,Bn32567,33457539,91351812,57894273,TN
chr07,Bn32568,28588457,74366397,45777940,CN
chr07,Bn32569,73892604,92176746,18284142,CN
chr07,Bn32570,83642524,95130078,11487554,TN
chr07,Bn32571,30369806,33132365,2762559,TN
chr07,Bn32572,73482002,79399792,5917790,NBS
chr07,Bn32573,70786025,84142040,13356015,CN
chr07,Bn32574,4821203,7908176,3086973,RLK
chr07,Bn32575,34358202,70342217,35984015,CNL
chr07,Bn32576,94245040,94301934,56894,RLP
chr07,Bn32577,81882852,82135516,252664,TNL
chr07,Bn32578,71398926,76958850,5559924,CNL
chr07,Bn32579,9774360,39188443,29414083,TNL
chr07,Bn32580,47369713,98725677,51355964,CN
chr07,Bn32581,72026341,81636500,9610159,CN
chr07,Bn32582,71247045,99309202,28062157,RLP
chr07,Bn32583,77570795,84482836,6912041,RLP
chr07,Bn32584,3050093,99890672,96840579,CN
chr07,Bn32585,60748413,86425648,25677235,NBS
chr07,Bn32586,49171082,85431195,36260113,NBS
chr07,Bn32587,11975163,55023490,43048327,RLP
chr07,Bn32588,26214629,85617234,59402605,RLP
chr07,Bn32589,36925184,95974115,59048931,TN
chr07,Bn32590,23119140,59059800,35940660,NBS
chr07,Bn32591,27480395,41018026,13537631,CNL
chr07,Bn32592,14121851,67559017,53437166,TN
chr07,Bn32593,74128875,85726429,11597554,RLP
chr07,Bn32594,51342935,98039345,46696410,NBS
chr07,Bn32595,3276706,49521779,46245073,NBS
chr07,Bn32596,14199732,69248192,55048460,NBS
chr07,Bn32597,60273111,66219012,5945901,RLP
chr07,Bn32598,6853730,53309782,46456052,RLP
chr07,Bn32599,22350623,87691027,65340404,TN
chr07,Bn32600,89519176,92400368,2881192,NBS
chr07,Bn32601,45991754,99732112,53740358,RLP
chr07,Bn32602,5448676,21255558,15806882,TNL
chr07,Bn32603,54955958,96912358,41956400,CN
chr07,Bn32604,16521289,82955169,66433880,TNL
chr07,Bn32605,2865548,64535585,61670037,RLK
chr07,Bn32606,9831332,12020262,2188930,TN
chr07,Bn32607,28420415,54642335,26221920,TN
chr07,Bn32608,20456567,43414153,22957586,CN
chr07,Bn32609,9349680,26528413,17178733,TNL
chr07,Bn32610,46856248,71820928,24964680,CN
chr07,Bn32611,15745729,62799946,47054217,CN
chr07,Bn32612,85491425,96440804,10949379,RLP
chr07,Bn32613,19167588,65631131,46463543,CN
chr07,Bn32614,17069435,34731825,17662390,NBS
chr07,Bn32615,31803695,73738663,41934968,CNL
chr07,Bn32616,73457517,97663932,24206415,CN
chr07,Bn32617,13499805,96856080,83356275,RLK
chr07,Bn32618,13130178,56923837,43793659,CN
chr07,Bn32619,32342829,99257916,66915087,RLK
chr07,Bn32620,98450662,99975192,1524530,TN
chr07,Bn32621,16308858,95540594,79231736,RLP
chr07,Bn32622,37815428,75186458,37371030,NBS
chr07,Bn32623,88656077,99352339,10696262,TNL
chr07,Bn32624,93961790,96336007,2374217,CNL
chr07,Bn32625,73640784,89085278,15444494,RLP
chr07,Bn32626,76211143,85634950,9423807,TNL
chr07,Bn32627,44584951,61269451,16684500,CN
chr07,Bn32628,4125591,23710679,19585088,TNL
chr07,Bn32629,30316351,55395387,25079036,NBS
chr07,Bn32630,65134008,74236429,9102421,CN
chr07,Bn32631,65597823,72409340,6811517,TN
chr07,Bn32632,95326487,95664202,337715,TNL
chr07,Bn32633,98549688,99064650,514962,RLK
chr07,Bn32634,50564722,69460253,18895531,NBS
chr07,Bn32635,54348271,56168788,1820517,CN
chr07,Bn32636,63643231,86207779,22564548,TN
chr07,Bn32637,63004563,75229852,12225289,CNL
chr07,Bn32638,88007305,99766403,11759098,CN
chr07,Bn32639,37008979,41425768,4416789,CN
chr07,Bn32640,96877446,98792476,1915030,TN
chr07,Bn32641,16762064,51864086,35102022,RLP
chr07,Bn32642,54587550,61657267,7069717,TNL
chr07,Bn32643,40190685,77257059,37066374,RLP
chr07,Bn32644,33938089,83553365,49615276,TN
chr07,Bn32645,71160371,85653628,14493257,RLK
chr07,Bn32646,7089133,56638596,49549463,NBS
chr07,Bn32647,8150970,60465498,52314528,CNL
chr07,Bn32648,45827979,72430886,26602907,RLP
chr07,Bn32649,60687185,90116293,29429108,RLK
chr07,Bn32650,75245598,89248535,14002937,NBS
chr07,Bn32651,18760817,55597802,36836985,RLK
chr07,Bn32652,96213808,96519190,305382,RLP
chr07,Bn32653,25361838,89950145,64588307,CNL
chr07,Bn32654,46135775,85277731,39141956,RLP
chr07,Bn32655,59756057,95943054,36186997,CN
chr07,Bn32656,36509887,75739703,39229816,TN
chr07,Bn32657,87540230,93179854,5639624,RLP
chr07,Bn32658,42719133,56107695,13388562,TN
chr07,Bn32659,31165370,86314602,55149232,CN
chr07,Bn32660,10309295,98045106,87735811,CNL
chr07,Bn32661,98963096,99819757,856661,TNL
chr07,Bn32662,48642365,84253968,35611603,CNL
chr07,Bn32663,54287382,67388985,13101603,TNL
chr07,Bn32664,82586837,91898498,9311661,NBS
chr07,Bn32665,81652296,91073460,9421164,CN
chr07,Bn32666,61295264,83250877,21955613,TNL
chr07,Bn32667,53526854,86685467,33158613,NBS
chr07,Bn32668,83352395,84011910,659515,RLK
chr07,Bn32669,16270699,99327732,83057033,TNL
chr07,Bn32670,59736094,72767642,13031548,TN
chr07,Bn32671,24689408,30887984,6198576,TN
chr07,Bn32672,54087082,91869433,37782351,TNL
chr07,Bn32673,61253459,89362484,28109025,NBS
chr07,Bn32674,84749024,89699707,4950683,TNL
chr07,Bn32675,48859730,66446190,17586460,NBS
chr07,Bn32676,62624509,63256788,632279,NBS
chr07,Bn32677,94570104,99828544,5258440,CNL
chr07,Bn32678,37712370,82327174,44614804,CNL
chr07,Bn32679,18464038,36414846,17950808,RLK
chr07,Bn32680,26756751,42639351,15882600,CN
chr07,Bn32681,21070210,38075256,17005046,TN
chr07,Bn32682,49765933,62247284,12481351,RLP
chr07,Bn32683,22475649,88000583,65524934,NBS
chr07,Bn32684,49418461,79268130,29849669,TN
chr07,Bn32685,11782783,93123652,81340869,CN
chr07,Bn32686,43831336,62007878,18176542,CNL
chr07,Bn32687,43069143,69637655,26568512,RLP
chr07,Bn32688,78980512,80347126,1366614,NBS
chr07,Bn32689,76628976,93804291,17175315,TN
chr07,Bn32690,77368889,92249548,14880659,NBS
chr07,Bn32691,83532785,93114562,9581777,RLP
chr07,Bn32692,56170314,72304615,16134301,CN
chr07,Bn32693,15071719,18327195,3255476,TN
chr07,Bn32694,84652425,89750090,5097665,TNL
chr07,Bn32695,52020385,89102531,37082146,CNL
chr07,Bn32696,52116495,99859092,47742597,TNL
chr07,Bn32697,17584542,99140362,81555820,CNL
chr07,Bn32698,8699806,27497274,18797468,NBS
chr07,Bn32699,30118404,88057061,57938657,TNL
chr07,Bn32700,92287893,92527094,239201,CNL
chr07,Bn32701,37946215,62688754,24742539,RLK
chr07,Bn32702,35439118,93335217,57896099,TNL
chr07,Bn32703,42772711,47960118,5187407,NBS
chr07,Bn32704,20598682,59022198,38423516,CN
chr07,Bn32705,62928167,89246785,26318618,TN
chr07,Bn32706,54911637,92306858,37395221,TN
chr07,Bn32707,54206253,96882527,42676274,TN
chr07,Bn32708,84263878,96430246,12166368,RLP
chr07,Bn32709,2604914,33736708,31131794,TN
chr07,Bn32710,80204222,94132311,13928089,TN
chr07,Bn32711,51231917,62078933,10847016,RLP
chr07,Bn32712,46832208,90571559,43739351,TNL
chr07,Bn32713,19921720,65221345,45299625,TNL
chr07,Bn32714,15465693,66270899,50805206,NBS
chr07,Bn32715,35264876,56296187,21031311,CNL
chr07,Bn32716,10566283,21342268,10775985,NBS
chr07,Bn32717,88688966,98381816,9692850,RLK
chr07,Bn32718,22595827,61970391,39374564,TNL
chr07,Bn32719,18039566,54856567,36817001,CN
chr07,Bn32720,34901016,42808496,7907480,RLP
chr07,Bn32721,36011361,83473351,47461990,RLP
chr07,Bn32722,37485599,60841843,23356244,TNL
chr07,Bn32723,78513006,99884933,21371927,TN
chr07,Bn32724,81334543,81456220,121677,TNL
chr07,Bn32725,9729924,69321319,59591395,TNL
chr07,Bn32726,42785962,79699629,36913667,NBS
chr07,Bn32727,12220009,13687549,1467540,CN
chr07,Bn32728,20507304,88469223,67961919,NBS
chr07,Bn32729,59015681,83712752,24697071,CNL
chr07,Bn32730,6657910,78158944,71501034,TN
chr07,Bn32731,3519053,48400429,44881376,RLP
chr07,Bn32732,89326271,96858265,7531994,TN
chr07,Bn32733,22163493,98971832,76808339,RLP
chr07,Bn32734,48677661,93228975,44551314,TN
chr07,Bn32735,62654455,96276482,33622027,RLK
chr07,Bn32736,94951030,96713071,1762041,RLK
chr07,Bn32737,93270715,94076906,806191,CNL
chr07,Bn32738,5785731,10171320,4385589,RLK
chr07,Bn32739,90620247,91548707,928460,CNL
chr07,Bn32740,69485385,81428670,11943285,TN
chr07,Bn32741,83672400,84418998,746598,RLK
chr07,Bn32742,80447667,90679578,10231911,RLP
chr07,Bn32743,74345932,86013099,11667167,NBS
chr07,Bn32744,38188396,91606847,53418451,NBS
chr07,Bn32745,37665078,66591499,28926421,NBS
chr07,Bn32746,1891308,54089224,52197916,RLK
chr07,Bn32747,45328780,62665286,17336506,CNL
chr07,Bn32748,24559424,33567091,9007667,RLK
chr07,Bn32749,96690922,96954173,263251,RLP
chr07,Bn32750,18794211,42286274,23492063,TNL
chr07,Bn32751,38236136,92605516,54369380,TN
chr07,Bn32752,97971082,99959617,1988535,TN
chr07,Bn32753,31110904,96563142,65452238,RLK
chr07,Bn32754,32710864,50577317,17866453,TNL
chr07,Bn32755,99181968,99992530,810562,TNL
chr07,Bn32756,18995987,57752327,38756340,NBS
chr07,Bn32757,73885661,78564898,4679237,NBS
chr07,Bn32758,39900852,89830016,49929164,NBS
chr07,Bn32759,54226124,76513211,22287087,RLP
chr07,Bn32760,99890001,99985253,95252,CN
chr07,Bn32761,68889697,88484598,19594901,TN
chr07,Bn32762,94508302,96517856,2009554,NBS
chr07,Bn32763,71157215,74188902,3031687,TNL
chr07,Bn32764,71833300,83588518,11755218,RLK
chr07,Bn32765,88154750,89663243,1508493,TN
chr07,Bn32766,39384782,70154565,30769783,CN
chr07,Bn32767,60815006,73285067,12470061,RLP
chr07,Bn32768,11845080,64880686,53035606,RLK
chr07,Bn32769,20128861,58745748,38616887,NBS
chr07,Bn32770,86955852,99852795,12896943,CN
chr07,Bn32771,80664138,94438583,13774445,TNL
chr07,Bn32772,56885040,76739036,19853996,RLK
chr07,Bn32773,21548028,27688426,6140398,RLP
chr07,Bn32774,46480334,80806919,34326585,NBS
chr07,Bn32775,82222736,91254098,9031362,TNL
chr07,Bn32776,15780940,80409066,64628126,NBS
chr07,Bn32777,13313731,93970540,80656809,RLK
chr07,Bn32778,52505949,62821611,10315662,CNL
chr07,Bn32779,45246613,88892706,43646093,RLK
chr07,Bn32780,40968101,79334442,38366341,RLK
chr07,Bn32781,17553432,67612152,50058720,NBS
chr07,Bn32782,9070395,66216443,57146048,TN
chr07,Bn32783,21839210,55262510,33423300,RLK
chr07,Bn32784,90193274,91413489,1220215,CN
chr07,Bn32785,37738964,45777860,8038896,NBS
chr07,Bn32786,67038164,96072946,29034782,TNL
chr07,Bn32787,99739977,99967795,227818,TNL
chr07,Bn32788,68386294,80222099,11835805,CNL
chr07,Bn32789,42705556,45259407,2553851,CNL
chr07,Bn32790,68860273,97826391,28966118,RLK
chr07,Bn32791,37147757,39684380,2536623,RLP
chr07,Bn32792,4596131,39937852,35341721,RLK
chr07,Bn32793,2196148,80491239,78295091,CNL
chr07,Bn32794,28830274,59753744,30923470,RLP
chr07,Bn32795,67355641,76862588,9506947,TN
chr07,Bn32796,9672786,87453056,77780270,NBS
chr07,Bn32797,62675269,82349599,19674330,RLK
chr07,Bn32798,25767831,66996139,41228308,RLP
chr07,Bn32799,78415583,93845183,15429600,RLK
chr07,Bn32800,58302945,62117497,3814552,CN
chr07,Bn32801,67961521,91561987,23600466,RLK
chr07,Bn32802,27859058,73209022,45349964,CN
chr07,Bn32803,37738315,57422948,19684633,CN
chr07,Bn32804,4395324,29288922,24893598,NBS
chr07,Bn32805,41771729,90860766,49089037,TN
chr07,Bn32806,79537935,83043717,3505782,RLK
chr07,Bn32807,13951346,76815934,62864588,NBS
chr07,Bn32808,62369531,71557470,9187939,TN
chr07,Bn32809,77417637,92952574,15534937,TNL
chr07,Bn32810,83119403,88158897,5039494,NBS
chr07,Bn32811,68235321,96282418,28047097,RLP
chr07,Bn32812,47350947,47701700,350753,TNL
chr07,Bn32813,8993817,88538280,79544463,RLP
chr07,Bn32814,16253325,45621311,29367986,TN
chr07,Bn32815,18319910,44065145,25745235,NBS
chr07,Bn32816,82513356,99386057,16872701,NBS
chr07,Bn32817,56006079,70570206,14564127,TN
chr07,Bn32818,37954154,86860462,48906308,TN
chr07,Bn32819,75465390,91645630,16180240,CN
chr07,Bn32820,78202279,90723527,12521248,NBS
chr07,Bn32821,27537285,47550581,20013296,CN
chr07,Bn32822,46551016,61728432,15177416,TN
chr07,Bn32823,24998858,80602764,55603906,CN
chr07,Bn32824,1227671,25841504,24613833,CN
chr07,Bn32825,53227257,89831508,36604251,CN
chr07,Bn32826,77414096,98846137,21432041,RLK
chr07,Bn32827,10142514,51004495,40861981,RLP
chr07,Bn32828,18709882,93780708,75070826,CN
chr07,Bn32829,36978790,74454972,37476182,TN
chr07,Bn32830,21222512,44568167,23345655,RLP
chr07,Bn32831,41699782,88484477,46784695,RLP
chr07,Bn32832,47623217,65671941,18048724,TN
chr07,Bn32833,5392569,35100868,29708299,CN
chr07,Bn32834,81937254,92734422,10797168,CNL
chr07,Bn32835,92343948,98151435,5807487,NBS
chr07,Bn32836,83221804,95774491,12552687,TNL
chr07,Bn32837,68565465,82047500,13482035,NBS
chr07,Bn32838,23114558,51294676,28180118,TN
chr07,Bn32839,63233489,99037096,35803607,TN
chr07,Bn32840,81349062,82120716,771654,CN
chr07,Bn32841,20910289,88004111,67093822,CNL
chr07,Bn32842,50753012,66526721,15773709,RLK
chr07,Bn32843,2144823,13021280,10876457,CN
chr07,Bn32844,36330485,73419481,37088996,RLP
chr07,Bn32845,23228153,84736352,61508199,NBS
chr07,Bn32846,60117397,90655988,30538591,TNL
chr07,Bn32847,2366649,22633020,20266371,TN
chr07,Bn32848,39017706,41551359,2533653,NBS
chr07,Bn32849,59865722,85631035,25765313,CNL
chr07,Bn32850,54055076,73787133,19732057,CNL
chr07,Bn32851,77798806,83105505,5306699,CNL
chr07,Bn32852,89577124,98624983,9047859,CNL
chr07,Bn32853,53446137,57936932,4490795,TN
chr07,Bn32854,97955497,98838865,883368,NBS
chr07,Bn32855,43129504,55528109,12398605,TNL
chr07,Bn32856,5487372,86067847,80580475,TN
chr07,Bn32857,94927369,98983331,4055962,TN
chr07,Bn32858,2694167,4941851,2247684,CNL
chr07,Bn32859,46238166,57807446,11569280,RLP
chr07,Bn32860,96559245,99194306,2635061,TN
chr07,Bn32861,61549666,62393458,843792,CN
chr07,Bn32862,84146828,92514556,8367728,CNL
chr07,Bn32863,60274970,69569900,9294930,RLK
chr07,Bn32864,78363188,83106931,4743743,TN
chr07,Bn32865,85023286,95002458,9979172,RLK
chr07,Bn32866,49617498,52845779,3228281,RLK
chr07,Bn32867,81261234,96927064,15665830,CN
chr07,Bn32868,84735691,91487156,6751465,TNL
chr07,Bn32869,25962089,67734177,41772088,RLK
chr07,Bn32870,98654133,98786854,132721,TN
chr07,Bn32871,74182799,84519169,10336370,CN
chr07,Bn32872,44528573,81045230,36516657,TNL
chr07,Bn32873,17568746,89614207,72045461,RLP
chr07,Bn32874,38765360,38857150,91790,TNL
chr07,Bn32875,13640607,95527090,81886483,NBS
chr07,Bn32876,87004182,95282742,8278560,CN
chr07,Bn32877,65285481,70703311,5417830,CN
chr07,Bn32878,34043593,74354220,40310627,CN
chr07,Bn32879,78995844,94170153,15174309,NBS
chr07,Bn32880,17067025,34034845,16967820,CN
chr07,Bn32881,64162123,99690744,35528621,TNL
chr07,Bn32882,30635860,40279416,9643556,CN
chr07,Bn32883,45292705,98399352,53106647,CN
chr07,Bn32884,89902511,92877424,2974913,TN
chr07,Bn32885,75993010,81919961,5926951,TN
chr07,Bn32886,5797776,17321188,11523412,NBS
chr07,Bn32887,73246951,78615166,5368215,CN
chr07,Bn32888,21063135,95254671,74191536,RLP
chr07,Bn32889,11513411,67171063,55657652,NBS
chr07,Bn32890,82162852,95179878,13017026,CN
chr07,Bn32891,44840236,86492644,41652408,TN
chr07,Bn32892,20152485,69221557,49069072,RLP
chr07,Bn32893,80171391,80565893,394502,RLP
chr07,Bn32894,30870350,80409498,49539148,CNL
chr07,Bn32895,3275630,96438551,93162921,CNL
chr07,Bn32896,97637173,99128976,1491803,NBS
chr07,Bn32897,89305763,95995745,6689982,TNL
chr07,Bn32898,16254216,87141601,70887385,RLK
chr07,Bn32899,25789128,82255838,56466710,CNL
chr07,Bn32900,35812756,92336616,56523860,CNL
chr07,Bn32901,95604042,99352879,3748837,TNL
chr07,Bn32902,36308339,60721304,24412965,RLP
chr07,Bn32903,18884550,22947626,4063076,CN
chr07,Bn32904,87959426,99360635,11401209,TN
chr07,Bn32905,3545259,71076668,67531409,NBS
chr07,Bn32906,94739333,96306480,1567147,CNL
chr07,Bn32907,48809402,51117370,2307968,RLK
chr07,Bn32908,60830948,98020155,37189207,CNL
chr07,Bn32909,24362595,60033485,35670890,TN
chr07,Bn32910,99991344,99994239,2895,NBS
chr07,Bn32911,35418447,70881028,35462581,TNL
chr07,Bn32912,28269074,96377123,68108049,TN
chr07,Bn32913,77028754,83305929,6277175,RLK
chr07,Bn32914,8818734,10733815,1915081,TNL
chr07,Bn32915,70937133,83396517,12459384,RLK
chr07,Bn32916,19669813,52496983,32827170,NBS
chr07,Bn32917,10501608,97257504,86755896,RLK
chr07,Bn32918,79680697,80447349,766652,RLK
chr07,Bn32919,21570976,34440771,12869795,RLP
chr07,Bn32920,7436935,96165809,88728874,TN
chr07,Bn32921,67039591,77064708,10025117,CN
chr07,Bn32922,13399244,50766115,37366871,NBS
chr07,Bn32923,86144656,93763904,7619248,CNL
chr07,Bn32924,41723387,88131492,46408105,RLP
chr07,Bn32925,5832224,65135923,59303699,TN
chr07,Bn32926,74857097,82608729,7751632,RLK
chr07,Bn32927,63529726,97793064,34263338,RLK
chr07,Bn32928,8970532,40007635,31037103,RLK
chr07,Bn32929,64906364,77986999,13080635,RLK
chr07,Bn32930,5781422,58137366,52355944,NBS
chr07,Bn32931,53136404,61284977,8148573,RLK
chr07,Bn32932,69277771,88206919,18929148,RLK
chr07,Bn32933,93640603,96027257,2386654,TNL
chr07,Bn32934,56957909,68513234,11555325,CN
chr07,Bn32935,23267420,78295104,55027684,TN
chr07,Bn32936,32206884,50446699,18239815,CN
chr07,Bn32937,42189930,73473569,31283639,CN
chr07,Bn32938,26770821,97802376,71031555,RLP
chr07,Bn32939,33678716,76643817,42965101,TN
chr07,Bn32940,32494003,67825680,35331677,CN
chr07,Bn32941,79770751,85433327,5662576,RLK
chr07,Bn32942,52635648,79615271,26979623,CNL
chr07,Bn32943,53747362,67073045,13325683,TNL
chr07,Bn32944,85568449,92417351,6848902,RLK
chr07,Bn32945,38115039,96067584,57952545,RLK
chr07,Bn32946,81639670,83569772,1930102,NBS
chr07,Bn32947,40568725,59729014,19160289,CN
chr07,Bn32948,3984613,5866026,1881413,TN
chr07,Bn32949,58925782,77178149,18252367,TN
chr07,Bn32950,64544046,65002880,458834,TN
chr07,Bn32951,18999518,71842731,52843213,RLK
chr07,Bn32952,61886807,89692205,27805398,RLK
chr07,Bn32953,47678754,48819755,1141001,RLK
chr07,Bn32954,73705922,77471812,3765890,CN
chr07,Bn32955,39295947,46997939,7701992,RLK
chr07,Bn32956,2302003,46690954,44388951,CNL
chr07,Bn32957,25806531,74456459,48649928,TN
chr07,Bn32958,56858152,66201059,9342907,CNL
chr07,Bn32959,44304278,55167019,10862741,CN
chr07,Bn32960,47558785,70313508,22754723,CNL
chr07,Bn32961,59432989,77128238,17695249,CN
chr07,Bn32962,64052553,68992762,4940209,RLP
chr07,Bn32963,40030931,98981175,58950244,NBS
chr07,Bn32964,60683306,85030696,24347390,TNL
chr07,Bn32965,32423855,50047915,17624060,CNL
chr07,Bn32966,57206169,70493999,13287830,NBS
chr07,Bn32967,63428863,70401426,6972563,TN
chr07,Bn32968,79393197,95854643,16461446,TN
chr07,Bn32969,61267037,90070583,28803546,CNL
chr07,Bn32970,18226950,34191800,15964850,CNL
chr07,Bn32971,42219477,72657189,30437712,CNL
chr07,Bn32972,46953620,76660879,29707259,NBS
chr07,Bn32973,85237305,96357552,11120247,NBS
chr07,Bn32974,24228892,61706406,37477514,NBS
chr07,Bn32975,97661827,99246427,1584600,CN
chr07,Bn32976,23517826,68691703,45173877,CNL
chr07,Bn32977,93239713,93809204,569491,RLK
chr07,Bn32978,1005287,81566191,80560904,TNL
chr07,Bn32979,34799428,54988168,20188740,TN
chr07,Bn32980,5161219,66049023,60887804,TN
chr07,Bn32981,60884272,92640004,31755732,CN
chr07,Bn32982,65407461,67832648,2425187,NBS
chr07,Bn32983,78960194,87331182,8370988,NBS
chr07,Bn32984,5966151,16094665,10128514,TN
chr07,Bn32985,27522230,80492122,52969892,TN
chr07,Bn32986,70364195,72716690,2352495,TNL
chr07,Bn32987,76800306,96749493,19949187,TN
chr07,Bn32988,34059185,96419808,62360623,TN
chr07,Bn32989,67102663,99106251,32003588,TN
chr07,Bn32990,54133694,80721567,26587873,TN
chr07,Bn32991,82234207,87587290,5353083,CNL
chr07,Bn32992,55815388,98877938,43062550,TNL
chr07,Bn32993,37477976,64015312,26537336,RLP
chr07,Bn32994,60944268,76247525,15303257,CNL
chr07,Bn32995,11243972,23986363,12742391,CN
chr07,Bn32996,22748908,74117153,51368245,TNL
chr07,Bn32997,52344355,81183318,28838963,RLP
chr07,Bn32998,66392832,72807065,6414233,NBS
chr07,Bn32999,55852869,77854525,22001656,CN
chr07,Bn33000,69285075,95933241,26648166,RLK
chr07,Bn33001,78887989,89442594,10554605,NBS
chr07,Bn33002,39416031,52085680,12669649,CN
chr07,Bn33003,97755946,98625060,869114,CNL
chr07,Bn33004,65301352,88040365,22739013,RLK
chr07,Bn33005,82493949,95974110,13480161,CNL
chr07,Bn33006,83446506,84128018,681512,CNL
chr07,Bn33007,59556665,88030233,28473568,NBS
chr07,Bn33008,74611553,83785847,9174294,TNL
chr07,Bn33009,44032220,94754775,50722555,NBS
chr07,Bn33010,48226454,60303693,12077239,RLP
chr07,Bn33011,75088168,96063464,20975296,RLP
chr07,Bn33012,2927522,84186161,81258639,RLP
chr07,Bn33013,81318848,96646319,15327471,RLP
chr07,Bn33014,98743150,99975624,1232474,RLK
chr07,Bn33015,72826713,95264700,22437987,TN
chr07,Bn33016,8760762,56577778,47817016,TNL
chr07,Bn33017,62253970,73769996,11516026,CNL
chr07,Bn33018,38330363,53958814,15628451,RLP
chr07,Bn33019,8643728,55135826,46492098,CNL
chr07,Bn33020,76159315,90371224,14211909,TNL
chr07,Bn33021,73164459,97349229,24184770,CN
chr07,Bn33022,82105686,85516280,3410594,RLP
chr07,Bn33023,77383582,93180789,15797207,RLK
chr07,Bn33024,10576798,71019507,60442709,TN
chr07,Bn33025,18353520,25854515,7500995,TNL
chr07,Bn33026,52571397,68423477,15852080,TNL
chr07,Bn33027,40627385,98381548,57754163,NBS
chr07,Bn33028,70514787,90991331,20476544,RLK
chr07,Bn33029,85308927,94106049,8797122,TNL
chr07,Bn33030,30100236,57004299,26904063,CN
chr07,Bn33031,12526294,29888778,17362484,RLK
chr07,Bn33032,21051224,77627862,56576638,TNL
chr07,Bn33033,16109747,67760438,51650691,CN
chr07,Bn33034,17957092,17961222,4130,NBS
chr07,Bn33035,76854234,97445519,20591285,CNL
chr07,Bn33036,37765846,54778735,17012889,TNL
chr07,Bn33037,24380054,61836235,37456181,TN
chr07,Bn33038,69772231,94112049,24339818,CN
chr07,Bn33039,55476179,95933397,40457218,CN
chr07,Bn33040,41170712,70454596,29283884,CN
chr07,Bn33041,1100208,67211094,66110886,TN
chr07,Bn33042,43131637,65403104,22271467,CNL
chr07,Bn33043,77388775,86097715,8708940,RLK
chr07,Bn33044,71354370,82839771,11485401,CNL
chr07,Bn33045,11159939,16942665,5782726,TN
chr07,Bn33046,56729834,93649853,36920019,NBS
chr07,Bn33047,85991262,98611159,12619897,CNL
chr07,Bn33048,42588640,51457179,8868539,NBS
chr07,Bn33049,57832073,69812579,11980506,RLK
chr07,Bn33050,76701344,85795830,9094486,RLP
chr07,Bn33051,55612667,87940821,32328154,CNL
chr07,Bn33052,72381339,81616123,9234784,CN
chr07,Bn33053,10455235,51435280,40980045,CN
chr07,Bn33054,76903236,90270259,13367023,TNL
chr07,Bn33055,12375396,69808844,57433448,NBS
chr07,Bn33056,23656154,36475387,12819233,RLP
chr07,Bn33057,3823193,53724985,49901792,RLK
chr07,Bn33058,90472375,93179880,2707505,CNL
chr07,Bn33059,36527629,96041106,59513477,CNL
chr07,Bn33060,46401973,54643416,8241443,CNL
chr07,Bn33061,36934461,63114997,26180536,TN
chr07,Bn33062,42794666,94149397,51354731,TN
chr07,Bn33063,17778163,89726081,71947918,CN
chr07,Bn33064,79288340,81489102,2200762,TNL
chr07,Bn33065,31346642,83324780,51978138,TN
chr07,Bn33066,66713841,88066665,21352824,RLP
chr07,Bn33067,30470803,39119989,8649186,CN
chr07,Bn33068,53535473,81928856,28393383,NBS
chr07,Bn33069,17803674,19431935,1628261,RLK
chr07,Bn33070,44199533,58889674,14690141,NBS
chr07,Bn33071,43257987,57532313,14274326,TNL
chr07,Bn33072,85121631,96044134,10922503,RLK
chr07,Bn33073,48423413,96498876,48075463,TN
chr07,Bn33074,36577315,68216582,31639267,NBS
chr07,Bn33075,93235588,94215495,979907,NBS
chr07,Bn33076,53438372,59762574,6324202,NBS
chr07,Bn33077,22279695,38353357,16073662,NBS
chr07,Bn33078,4199250,34225867,30026617,CN
chr07,Bn33079,13219045,59362009,46142964,TN
chr07,Bn33080,6609912,99255129,92645217,NBS
chr07,Bn33081,14614858,51827774,37212916,NBS
chr07,Bn33082,54530634,80387832,25857198,CNL
chr07,Bn33083,76511108,83566373,7055265,CN
chr07,Bn33084,88228110,88565536,337426,RLK
chr07,Bn33085,56767677,62225192,5457515,CNL
chr07,Bn33086,19395442,19909211,513769,CN
chr07,Bn33087,86199270,89017007,2817737,CNL
chr07,Bn33088,48705910,75228759,26522849,RLP
chr07,Bn33089,46628467,96518209,49889742,CN
chr07,Bn33090,22369868,83982813,61612945,TN
chr07,Bn33091,71364947,91876665,20511718,TN
chr07,Bn33092,37961383,80318313,42356930,CN
chr07,Bn33093,41962773,94582324,52619551,CNL
chr07,Bn33094,59940189,84745772,24805583,RLP
chr07,Bn33095,35562363,74287189,38724826,NBS
chr07,Bn33096,37627771,52629225,15001454,TNL
chr07,Bn33097,5330782,46301317,40970535,CN
chr07,Bn33098,78098994,85075148,6976154,CN
chr07,Bn33099,25080633,77086729,52006096,CN
chr07,Bn33100,66238857,87524802,21285945,CNL
chr07,Bn33101,42450598,60545235,18094637,NBS
chr07,Bn33102,28751842,65839858,37088016,NBS
chr07,Bn33103,66278168,70965888,4687720,CN
chr07,Bn33104,7593976,81646737,74052761,CN
chr07,Bn33105,14858271,73598391,58740120,TNL
chr07,Bn33106,35223247,41022667,5799420,RLK
chr07,Bn33107,13200711,99067470,85866759,CNL
chr07,Bn33108,21538876,87924914,66386038,CN
chr07,Bn33109,11842015,36601797,24759782,NBS
chr07,Bn33110,25283526,63432910,38149384,RLP
chr07,Bn33111,39269099,98365674,59096575,RLP
chr07,Bn33112,26853338,97448722,70595384,TN
chr07,Bn33113,51469002,74499112,23030110,CNL
chr07,Bn33114,47173011,86630481,39457470,RLK
chr07,Bn33115,31739533,47550485,15810952,RLK
chr07,Bn33116,54758290,86578627,31820337,CN
chr07,Bn33117,39600099,65729011,26128912,TNL
chr07,Bn33118,80017785,87656930,7639145,CNL
chr07,Bn33119,35452371,74327676,38875305,CN
chr07,Bn33120,47313046,59933813,12620767,RLK
chr07,Bn33121,39066583,70268341,31201758,NBS
chr07,Bn33122,7399277,82091075,74691798,NBS
chr07,Bn33123,14483544,94742628,80259084,CNL
chr07,Bn33124,86081013,95987803,9906790,TN
chr07,Bn33125,7382985,78349982,70966997,RLK
chr07,Bn33126,16643756,20091458,3447702,RLP
chr07,Bn33127,76167619,94428726,18261107,RLP
chr07,Bn33128,66982314,96115731,29133417,RLP
chr07,Bn33129,28739879,54054997,25315118,CN
chr07,Bn33130,65094674,91031709,25937035,CN
chr07,Bn33131,35493513,73814873,38321360,NBS
chr07,Bn33132,77183842,84521533,7337691,CN
chr07,Bn33133,77292070,90296165,13004095,RLP
chr07,Bn33134,76528888,77510902,982014,TNL
chr07,Bn33135,73201854,93371628,20169774,TNL
chr07,Bn33136,11222702,73203466,61980764,RLK
chr07,Bn33137,32803195,88797708,55994513,NBS
chr07,Bn33138,57942610,69012414,11069804,TN
chr07,Bn33139,50069004,86165642,36096638,RLK
chr07,Bn33140,76688366,84867300,8178934,TN
chr07,Bn33141,2946190,40219183,37272993,NBS
chr07,Bn33142,54425261,68396754,13971493,NBS
chr07,Bn33143,45440558,67298122,21857564,TN
chr07,Bn33144,70369037,97626564,27257527,TN
chr07,Bn33145,98911393,99336105,424712,CNL
chr07,Bn33146,43163812,97142319,53978507,CN
chr07,Bn33147,58408847,98463105,40054258,TNL
chr07,Bn33148,60414958,93620659,33205701,CNL
chr07,Bn33149,87384389,89616174,2231785,TN
chr07,Bn33150,62117384,73697811,11580427,TNL
chr07,Bn33151,51381443,90928445,39547002,CNL
chr07,Bn33152,3172339,39033324,35860985,TNL
chr07,Bn33153,86368812,91978188,5609376,NBS
chr07,Bn33154,63151751,89308534,26156783,RLK
chr07,Bn33155,25406893,97575147,72168254,NBS
chr07,Bn33156,58539014,90706247,32167233,RLP
chr07,Bn33157,92769064,98258000,5488936,NBS
chr07,Bn33158,55554119,89084034,33529915,NBS
chr07,Bn33159,24366506,36548472,12181966,RLP
chr07,Bn33160,87954772,92340639,4385867,CNL
chr07,Bn33161,18249199,23053541,4804342,RLP
chr07,Bn33162,6975821,60517688,53541867,TN
chr07,Bn33163,72608490,82326640,9718150,CNL
chr07,Bn33164,30026255,87184226,57157971,TNL
chr07,Bn33165,32403317,64756537,32353220,CNL
chr07,Bn33166,55239153,59299288,4060135,RLP
chr07,Bn33167,60412954,98368268,37955314,CNL
chr07,Bn33168,32001375,45052439,13051064,RLK
chr07,Bn33169,21190455,44294665,23104210,RLK
chr07,Bn33170,53204018,63041681,9837663,CNL
chr07,Bn33171,91773052,99823703,8050651,NBS
chr07,Bn33172,10459659,26164145,15704486,TNL
chr07,Bn33173,13197910,81032031,67834121,RLP
chr07,Bn33174,6608372,64765802,58157430,TNL
chr07,Bn33175,24081976,99122815,75040839,RLK
chr07,Bn33176,51648214,89193962,37545748,TN
chr07,Bn33177,67930608,69877422,1946814,CNL
chr07,Bn33178,94452636,96601201,2148565,CN
chr07,Bn33179,95996768,99887764,3890996,CNL
chr07,Bn33180,45037547,76178618,31141071,TNL
chr07,Bn33181,80479541,91512693,11033152,CNL
chr07,Bn33182,93143084,98257162,5114078,CN
chr07,Bn33183,85401969,85904791,502822,TN
chr07,Bn33184,85870574,87544308,1673734,CN
chr07,Bn33185,18394832,71635187,53240355,RLK
chr07,Bn33186,77691917,98614155,20922238,TNL
chr07,Bn33187,80706167,97008651,16302484,NBS
chr07,Bn33188,20505118,77397591,56892473,TNL
chr07,Bn33189,42734398,93477281,50742883,CNL
chr07,Bn33190,40158978,43288440,3129462,RLP
chr07,Bn33191,52879734,62497092,9617358,NBS
chr07,Bn33192,24657108,83706124,59049016,NBS
chr07,Bn33193,23699551,30655544,6955993,CN
chr07,Bn33194,49288703,64650379,15361676,TNL
chr07,Bn33195,20646085,66944962,46298877,CNL
chr07,Bn33196,97789839,99642009,1852170,TNL
chr07,Bn33197,81879681,83237372,1357691,CN
chr07,Bn33198,48628730,76477498,27848768,TNL
chr07,Bn33199,7795443,77168213,69372770,CN
chr07,Bn33200,91121312,95004108,3882796,TN
chr07,Bn33201,6362516,29366043,23003527,TN
chr07,Bn33202,42317652,65905757,23588105,RLK
chr07,Bn33203,51509340,76828640,25319300,RLK
chr07,Bn33204,90799421,94218079,3418658,CN
chr07,Bn33205,88656855,95250341,6593486,CNL
chr07,Bn33206,85481259,94258555,8777296,CNL
chr07,Bn33207,10638781,47364825,36726044,CNL
chr07,Bn33208,93155824,93378643,222819,NBS
chr07,Bn33209,84203604,93513851,9310247,TNL
chr07,Bn33210,81015198,81108072,92874,CNL
chr07,Bn33211,50757085,73795431,23038346,CNL
chr07,Bn33212,87302432,95941820,8639388,TNL
chr07,Bn33213,15201098,41149144,25948046,NBS
chr07,Bn33214,54881271,64895146,10013875,RLK
chr07,Bn33215,23877986,54337158,30459172,RLK
chr07,Bn33216,75243340,96320228,21076888,NBS
chr07,Bn33217,61840133,95663101,33822968,TN
chr07,Bn33218,32842546,69192646,36350100,RLP
chr07,Bn33219,14643402,33316330,18672928,TN
chr07,Bn33220,94515203,95363393,848190,NBS
chr07,Bn33221,39858798,95682282,55823484,TN
chr07,Bn33222,92617076,95151245,2534169,CN
chr07,Bn33223,52442398,90894424,38452026,CNL
chr07,Bn33224,44682804,96529111,51846307,NBS
chr07,Bn33225,79056009,88159186,9103177,CNL
chr07,Bn33226,48694875,71094372,22399497,CN
chr07,Bn33227,76488525,88779016,12290491,RLP
chr07,Bn33228,12087820,67189560,55101740,CN
chr07,Bn33229,96310687,96321601,10914,CNL
chr07,Bn33230,94999763,97389981,2390218,CN
chr07,Bn33231,66055610,91965997,25910387,RLK
chr07,Bn33232,35130432,57346651,22216219,RLK
chr07,Bn33233,67140059,77117767,9977708,CNL
chr07,Bn33234,33229017,69779829,36550812,TN
chr07,Bn33235,78854202,92951904,14097702,NBS
chr07,Bn33236,72064068,81201301,9137233,RLK
chr07,Bn33237,83633110,84249023,615913,CNL
chr07,Bn33238,42018953,81054607,39035654,TNL
chr07,Bn33239,16704209,41224396,24520187,RLK
chr07,Bn33240,83908058,96188518,12280460,RLK
chr07,Bn33241,58640704,64424666,5783962,TN
chr07,Bn33242,48326744,76447679,28120935,RLK
chr07,Bn33243,4788878,18215745,13426867,NBS
chr07,Bn33244,30514066,56073387,25559321,CNL
chr07,Bn33245,6831196,29194214,22363018,RLK
chr07,Bn33246,66026503,83706120,17679617,RLK
chr07,Bn33247,54284493,81629689,27345196,CN
chr07,Bn33248,18220466,70280340,52059874,CN
chr07,Bn33249,65371219,72125304,6754085,TNL
chr07,Bn33250,21747455,65746043,43998588,RLP
chr07,Bn33251,79317595,99830728,20513133,TNL
chr07,Bn33252,70061682,90982123,20920441,CNL
chr07,Bn33253,62040761,90686329,28645568,TN
chr07,Bn33254,11218692,20093629,8874937,NBS
chr07,Bn33255,73518332,89543377,16025045,TNL
chr07,Bn33256,26901765,76522836,49621071,TNL
chr07,Bn33257,94886397,99757237,4870840,CN
chr07,Bn33258,42299171,84315381,42016210,RLK
chr07,Bn33259,79918019,91354917,11436898,CNL
chr07,Bn33260,91788607,95771638,3983031,TN
chr07,Bn33261,75529057,83182280,7653223,NBS
chr07,Bn33262,98501086,99194303,693217,TNL
chr07,Bn33263,25211875,89246914,64035039,TNL
chr07,Bn33264,64128052,96884784,32756732,CNL
chr07,Bn33265,10588116,95293984,84705868,TN
chr07,Bn33266,48003673,58019444,10015771,RLK
chr07,Bn33267,85687871,99361706,13673835,RLP
chr07,Bn33268,60832442,93288400,32455958,RLP
chr07,Bn33269,54971529,80447205,25475676,RLP
chr07,Bn33270,83565891,98277760,14711869,RLK
chr07,Bn33271,65081135,89578950,24497815,CN
chr07,Bn33272,95538466,99336054,3797588,NBS
chr07,Bn33273,40067252,69516556,29449304,RLP
chr07,Bn33274,26360662,67727378,41366716,CN
chr07,Bn33275,73709499,89906405,16196906,RLK
chr07,Bn33276,15914167,16921727,1007560,RLK
chr07,Bn33277,80366527,95875328,15508801,RLP
chr07,Bn33278,13694225,31444088,17749863,TN
chr07,Bn33279,13619299,35705130,22085831,CNL
chr07,Bn33280,71858341,86145113,14286772,CNL
chr07,Bn33281,79921798,96367811,16446013,NBS
chr07,Bn33282,3355514,52784754,49429240,NBS
chr07,Bn33283,86285687,89270622,2984935,RLK
chr07,Bn33284,29237278,52931184,23693906,RLP
chr07,Bn33285,84947269,96817425,11870156,RLP
chr07,Bn33286,8919151,80178766,71259615,CN
chr07,Bn33287,73744655,80561147,6816492,TNL
chr07,Bn33288,11794705,22703887,10909182,RLK
chr07,Bn33289,94453624,99201961,4748337,CN
chr07,Bn33290,92408725,97012175,4603450,CN
chr07,Bn33291,57474855,98364762,40889907,NBS
chr07,Bn33292,56306455,95203849,38897394,RLP
chr07,Bn33293,84048607,84376476,327869,CNL
chr07,Bn33294,44672571,71416515,26743944,RLP
chr07,Bn33295,42083348,56880928,14797580,TNL
chr07,Bn33296,43715797,61732896,18017099,TNL
chr07,Bn33297,56313601,93310924,36997323,NBS
chr07,Bn33298,50514980,70671637,20156657,TN
chr07,Bn33299,16507728,33997024,17489296,NBS
chr07,Bn33300,33398737,65404581,32005844,TNL
chr07,Bn33301,11837250,28541054,16703804,TN
chr07,Bn33302,45347711,83782671,38434960,TNL
chr07,Bn33303,67288895,81490470,14201575,CNL
chr07,Bn33304,68635031,98357625,29722594,TNL
chr07,Bn33305,37846872,72431025,34584153,CNL
chr07,Bn33306,19821062,98370348,78549286,NBS
chr07,Bn33307,70789534,83315946,12526412,CN
chr07,Bn33308,61648897,78377689,16728792,RLP
chr07,Bn33309,60554746,87424385,26869639,CN
chr07,Bn33310,3877700,49342004,45464304,RLK
chr07,Bn33311,1475927,52191526,50715599,RLK
chr07,Bn33312,42865422,78554770,35689348,NBS
chr07,Bn33313,90577187,96803586,6226399,CNL
chr07,Bn33314,49526333,79028582,29502249,TN
chr07,Bn33315,27702988,77169178,49466190,NBS
chr07,Bn33316,10818398,46945459,36127061,TN
chr07,Bn33317,81071108,88345505,7274397,NBS
chr07,Bn33318,2863063,67111811,64248748,NBS
chr07,Bn33319,26554690,70813030,44258340,RLK
chr07,Bn33320,34279985,48419301,14139316,CNL
chr07,Bn33321,49331956,70347623,21015667,TNL
chr07,Bn33322,75051232,94969342,19918110,RLK
chr07,Bn33323,69228547,77775960,8547413,CNL
chr07,Bn33324,87603520,91533680,3930160,TNL
chr07,Bn33325,30584676,45160366,14575690,TNL
chr07,Bn33326,51614700,94338798,42724098,CNL
chr07,Bn33327,19306900,26135849,6828949,RLP
chr07,Bn33328,89879181,90015358,136177,TN
chr07,Bn33329,45724337,71410651,25686314,CNL
chr07,Bn33330,36807996,40726851,3918855,RLP
chr07,Bn33331,8991807,27624202,18632395,TN
chr07,Bn33332,20572480,61815097,41242617,RLK
chr07,Bn33333,3327962,12940241,9612279,TNL
chr07,Bn33334,29387367,81681236,52293869,CNL
chr07,Bn33335,20034914,72224546,52189632,RLP
chr07,Bn33336,34401509,46959769,12558260,RLP
chr07,Bn33337,67451994,84487761,17035767,CNL
chr07,Bn33338,81286319,82436111,1149792,TN
chr07,Bn33339,72195684,79208419,7012735,TNL
chr07,Bn33340,22641833,45941192,23299359,CNL
chr07,Bn33341,3957197,11094081,7136884,RLK
chr07,Bn33342,71718629,87070880,15352251,TNL
chr07,Bn33343,31334506,59328845,27994339,RLP
chr07,Bn33344,19442005,20781052,1339047,CNL
chr07,Bn33345,30623531,35845834,5222303,CNL
chr07,Bn33346,17652525,47473824,29821299,TN
chr07,Bn33347,28557986,36729955,8171969,RLP
chr07,Bn33348,63665317,92474062,28808745,TNL
chr07,Bn33349,43011365,66248200,23236835,CN
chr07,Bn33350,88100499,89116585,1016086,RLP
chr07,Bn33351,9211358,59760402,50549044,RLP
chr07,Bn33352,67680705,86655035,18974330,TNL
chr07,Bn33353,78994027,83521006,4526979,CNL
chr07,Bn33354,52778146,77098223,24320077,NBS
chr07,Bn33355,85148264,89838032,4689768,CN
chr07,Bn33356,11916354,21587390,9671036,CN
chr07,Bn33357,44389273,72569558,28180285,RLK
chr07,Bn33358,95109162,95469388,360226,TNL
chr07,Bn33359,84205854,93919826,9713972,RLP
chr07,Bn33360,89702964,93345042,3642078,NBS
chr07,Bn33361,58730222,87101697,28371475,TNL
chr07,Bn33362,39957895,85656145,45698250,TNL
chr07,Bn33363,51505389,98067293,46561904,TNL
chr07,Bn33364,7259812,36941365,29681553,CNL
chr07,Bn33365,49738535,85950995,36212460,CNL
chr07,Bn33366,13176399,18171807,4995408,TN
chr07,Bn33367,84191224,92346859,8155635,RLK
chr07,Bn33368,85635418,91621358,5985940,TNL
chr07,Bn33369,9152636,34014466,24861830,CN
chr07,Bn33370,16524642,34527995,18003353,RLK
chr07,Bn33371,62023833,64279705,2255872,CN
chr07,Bn33372,18022293,96543739,78521446,NBS
chr07,Bn33373,98992589,99257996,265407,CNL
chr07,Bn33374,35339643,93408492,58068849,TNL
chr07,Bn33375,64304601,77237310,12932709,CNL
chr07,Bn33376,67237593,72930838,5693245,TNL
chr07,Bn33377,75737003,96959650,21222647,CN
chr07,Bn33378,41637678,86166454,44528776,CN
chr07,Bn33379,27160038,97443872,70283834,CN
chr07,Bn33380,3381817,81401328,78019511,TNL
chr07,Bn33381,40275956,86061451,45785495,CNL
chr07,Bn33382,35180876,36091560,910684,CN
chr07,Bn33383,86834615,92597289,5762674,RLK
chr07,Bn33384,43858649,97297060,53438411,NBS
chr07,Bn33385,39942438,85614001,45671563,CN
chr07,Bn33386,80601368,83567351,2965983,TNL
chr07,Bn33387,98190259,98377306,187047,CNL
chr07,Bn33388,96895184,99691436,2796252,CNL
chr07,Bn33389,87616846,93110613,5493767,CNL
chr07,Bn33390,41232428,85010269,43777841,RLP
chr07,Bn33391,52206723,53256140,1049417,RLP
chr07,Bn33392,43947623,73862333,29914710,RLK
chr07,Bn33393,94098461,98570323,4471862,RLP
chr07,Bn33394,21525940,93457727,71931787,NBS
chr07,Bn33395,23382271,96005911,72623640,RLK
chr07,Bn33396,80666437,90975267,10308830,RLP
chr07,Bn33397,72044746,97661795,25617049,TNL
chr07,Bn33398,89975861,95308671,5332810,RLP
chr07,Bn33399,98081948,98640033,558085,NBS
chr07,Bn33400,98886780,98966533,79753,CNL
chr07,Bn33401,4908222,8128666,3220444,RLP
chr07,Bn33402,48780127,54299416,5519289,NBS
chr07,Bn33403,61667726,71659030,9991304,CNL
chr07,Bn33404,86584684,99161427,12576743,TN
chr07,Bn33405,97269233,99122819,1853586,TN
chr07,Bn33406,4662019,44007297,39345278,TNL
chr07,Bn33407,49323984,73403607,24079623,CN
chr07,Bn33408,18349760,47532719,29182959,TNL
chr07,Bn33409,87015261,90922774,3907513,RLK
chr07,Bn33410,12828921,64148954,51320033,CN
chr07,Bn33411,67206784,67326736,119952,CN
chr07,Bn33412,25168683,40586419,15417736,CN
chr07,Bn33413,92886895,97278882,4391987,NBS
chr07,Bn33414,95572626,97847795,2275169,RLP
chr07,Bn33415,59693906,68400400,8706494,CNL
chr07,Bn33416,61943420,90086172,28142752,CNL
chr07,Bn33417,45137167,50161760,5024593,TNL
chr07,Bn33418,81003756,88791148,7787392,TNL
chr07,Bn33419,39483537,50258313,10774776,RLP
chr07,Bn33420,1181452,13856302,12674850,RLP
chr07,Bn33421,55188598,57091791,1903193,NBS
chr07,Bn33422,93234400,94216207,981807,TN
chr07,Bn33423,74958160,85964224,11006064,RLK
chr07,Bn33424,15001154,15793014,791860,CNL
chr07,Bn33425,31705750,38042747,6336997,TN
chr07,Bn33426,19823666,82325395,62501729,TNL
chr07,Bn33427,99894608,99981791,87183,CN
chr07,Bn33428,36934234,75600275,38666041,CNL
chr07,Bn33429,62081238,97081876,35000638,TN
chr07,Bn33430,57013020,67441282,10428262,TN
chr07,Bn33431,62354286,88016052,25661766,TNL
chr07,Bn33432,26299407,99126936,72827529,NBS
chr07,Bn33433,45793023,58374668,12581645,CNL
chr07,Bn33434,69680787,79660604,9979817,CN
chr07,Bn33435,41550622,93105520,51554898,CN
chr07,Bn33436,80959919,91958261,10998342,TN
chr07,Bn33437,45974219,50602873,4628654,NBS
chr07,Bn33438,29017047,41357137,12340090,CNL
chr07,Bn33439,14611659,44308161,29696502,RLK
chr07,Bn33440,88109602,96443525,8333923,RLK
chr07,Bn33441,60193973,67560320,7366347,CNL
chr07,Bn33442,9511240,55053402,45542162,CNL
chr07,Bn33443,95056746,97197710,2140964,RLK
chr07,Bn33444,21768916,48812764,27043848,TN
chr07,Bn33445,11492990,71067394,59574404,TN
chr07,Bn33446,71941957,78180005,6238048,CNL
chr07,Bn33447,41170699,91929248,50758549,TNL
chr07,Bn33448,55733885,83179221,27445336,CN
chr07,Bn33449,71723771,89785554,18061783,RLK
chr07,Bn33450,33860133,47702161,13842028,TNL
chr07,Bn33451,97194789,99783718,2588929,CN
chr07,Bn33452,46505006,54625060,8120054,NBS
chr07,Bn33453,92607319,94167465,1560146,CNL
chr07,Bn33454,23687518,96221558,72534040,RLK
chr07,Bn33455,77311319,88143744,10832425,RLK
chr07,Bn33456,90914100,93383476,2469376,TN
chr07,Bn33457,31896448,87336332,55439884,CNL
chr07,Bn33458,40577643,60047172,19469529,TN
chr07,Bn33459,11820943,96675009,84854066,TN
chr07,Bn33460,28359272,85781399,57422127,RLK
chr07,Bn33461,76921748,86541715,9619967,TN
chr07,Bn33462,85434546,93955581,8521035,CN
chr07,Bn33463,97752444,99197271,1444827,TN
chr07,Bn33464,81389732,88874930,7485198,CNL
chr07,Bn33465,1769161,27401870,25632709,TNL
chr07,Bn33466,55675530,85549168,29873638,CNL
chr07,Bn33467,2581587,89436700,86855113,TN
chr07,Bn33468,99375568,99455204,79636,CN
chr07,Bn33469,41366240,60374110,19007870,TNL
chr07,Bn33470,69181947,96924780,27742833,RLK
chr07,Bn33471,19657229,48936642,29279413,RLK
chr07,Bn33472,71928117,75940554,4012437,RLP
chr07,Bn33473,74663809,96763134,22099325,CNL
chr07,Bn33474,86929603,95177622,8248019,CNL
chr07,Bn33475,45939639,80358344,34418705,CNL
chr07,Bn33476,14120558,90926185,76805627,TN
chr07,Bn33477,26034970,90458462,64423492,RLK
chr07,Bn33478,24942555,93682566,68740011,RLP
chr07,Bn33479,3407500,7073482,3665982,CNL
chr07,Bn33480,59355756,80806909,21451153,RLP
chr07,Bn33481,42967354,76598528,33631174,CNL
chr07,Bn33482,77227289,99339103,22111814,NBS
chr07,Bn33483,97274154,97747115,472961,TN
chr07,Bn33484,98405123,99390662,985539,TNL
chr07,Bn33485,78557618,93353268,14795650,CNL
chr07,Bn33486,87599850,96637150,9037300,NBS
chr07,Bn33487,72452796,85790551,13337755,NBS
chr07,Bn33488,32460519,83434739,50974220,CNL
chr07,Bn33489,49966226,76459478,26493252,CN
chr07,Bn33490,53676343,75345867,21669524,NBS
chr07,Bn33491,91396535,92534568,1138033,TN
chr07,Bn33492,22173605,69066787,46893182,TNL
chr07,Bn33493,83522471,93119600,9597129,CNL
chr07,Bn33494,27002909,84075534,57072625,CN
chr07,Bn33495,8421981,64856202,56434221,CN
chr07,Bn33496,7046665,83570326,76523661,RLK
chr07,Bn33497,57633972,70454101,12820129,TN
chr07,Bn33498,48919310,94144280,45224970,RLK
chr07,Bn33499,87812070,91548056,3735986,NBS
chr07,Bn33500,88009692,95886301,7876609,CN
chr07,Bn33501,80413446,96871287,16457841,TNL
chr07,Bn33502,7947871,37956605,30008734,TNL
chr07,Bn33503,5665543,57416222,51750679,CN
chr07,Bn33504,5072745,17953432,12880687,TN
chr07,Bn33505,71888295,72567492,679197,TN
chr07,Bn33506,94116620,95339689,1223069,TNL
chr07,Bn33507,90908888,99720822,8811934,RLK
chr07,Bn33508,90847072,97356716,6509644,CNL
chr07,Bn33509,53909797,61223572,7313775,RLK
chr07,Bn33510,98780221,99360586,580365,CNL
chr07,Bn33511,32182475,97594137,65411662,CN
chr07,Bn33512,25372393,35607813,10235420,TNL
chr07,Bn33513,46794062,54174219,7380157,CN
chr07,Bn33514,56818528,77777441,20958913,TNL
chr07,Bn33515,31935381,41750584,9815203,CN
chr07,Bn33516,28401532,85522417,57120885,CN
chr07,Bn33517,36958989,94295140,57336151,CN
chr07,Bn33518,17111504,33850382,16738878,TNL
chr07,Bn33519,56607727,60957854,4350127,TNL
chr07,Bn33520,22621604,54765816,32144212,CNL
chr07,Bn33521,83672183,99750886,16078703,TN
chr07,Bn33522,32903928,33559242,655314,CN
chr07,Bn33523,83633973,85421120,1787147,TNL
chr07,Bn33524,38167709,85735593,47567884,TN
chr07,Bn33525,90169688,94785159,4615471,CN
chr07,Bn33526,78253109,78740032,486923,CNL
chr07,Bn33527,76534563,78023563,1489000,RLP
chr07,Bn33528,77595600,87748686,10153086,CN
chr07,Bn33529,5884180,59769248,53885068,CN
chr07,Bn33530,76174136,98227556,22053420,CNL
chr07,Bn33531,93929151,96373012,2443861,TNL
chr07,Bn33532,58798186,68932762,10134576,RLP
chr07,Bn33533,57879710,87947925,30068215,TNL
chr07,Bn33534,21681034,44230483,22549449,NBS
chr07,Bn33535,27306427,42206587,14900160,CN
chr07,Bn33536,82969377,91292326,8322949,RLP
chr07,Bn33537,4871561,34765299,29893738,CN
chr07,Bn33538,52395689,76572257,24176568,CN
chr07,Bn33539,80207970,85711690,5503720,CN
chr07,Bn33540,19452828,47148561,27695733,TN
chr07,Bn33541,81993800,85249950,3256150,TN
chr07,Bn33542,75056031,96283349,21227318,TNL
chr07,Bn33543,57769207,60781512,3012305,CN
chr07,Bn33544,75741527,92040971,16299444,CN
chr07,Bn33545,37156884,51731387,14574503,RLK
chr07,Bn33546,48590593,69041247,20450654,TN
chr07,Bn33547,23921104,89649304,65728200,NBS
chr07,Bn33548,50834746,52257318,1422572,RLK
chr07,Bn33549,14843222,78696522,63853300,CNL
chr07,Bn33550,81658687,91026738,9368051,CN
chr07,Bn33551,61860065,73775228,11915163,CN
chr07,Bn33552,36503135,64629506,28126371,CNL
chr07,Bn33553,10004475,76114461,66109986,NBS
chr07,Bn33554,1519443,28489051,26969608,NBS
chr07,Bn33555,31094384,56415374,25320990,RLP
chr07,Bn33556,98619110,99696259,1077149,TN
chr07,Bn33557,32555697,95175647,62619950,CNL
chr07,Bn33558,5381561,71583367,66201806,NBS
chr07,Bn33559,33590351,78409849,44819498,TN
chr07,Bn33560,66077885,96785207,30707322,TN
chr07,Bn33561,99964257,99973078,8821,TN
chr07,Bn33562,32321622,74087011,41765389,NBS
chr07,Bn33563,49579915,62167984,12588069,TN
chr07,Bn33564,14609410,99746997,85137587,RLK
chr07,Bn33565,94827243,95284257,457014,CN
chr07,Bn33566,69599255,96283973,26684718,CN
chr07,Bn33567,37180596,90840076,53659480,RLK
chr07,Bn33568,98893666,99153345,259679,CNL
chr07,Bn33569,17089370,81171410,64082040,TN
chr07,Bn33570,70126845,78170903,8044058,CNL
chr07,Bn33571,25748358,51776684,26028326,RLK
chr07,Bn33572,18991131,32269870,13278739,TNL
chr07,Bn33573,60703039,86898276,26195237,TNL
chr07,Bn33574,6641629,90537207,83895578,NBS
chr07,Bn33575,92928365,95713940,2785575,CNL
chr07,Bn33576,59079628,88595467,29515839,TN
chr07,Bn33577,25218629,87024130,61805501,TN
chr07,Bn33578,36875627,37724349,848722,CN
chr07,Bn33579,58386839,84561189,26174350,NBS
chr07,Bn33580,62509258,94122549,31613291,CN
chr07,Bn33581,18611912,84901834,66289922,CNL
chr07,Bn33582,91843829,99153641,7309812,RLP
chr07,Bn33583,56468775,91766956,35298181,TN
chr07,Bn33584,56131449,92367986,36236537,CNL
chr07,Bn33585,84564758,89035297,4470539,RLK
chr07,Bn33586,7151345,28446820,21295475,CNL
chr07,Bn33587,17065135,91820358,74755223,CNL
chr07,Bn33588,70505013,90042763,19537750,NBS
chr07,Bn33589,15946992,95214138,79267146,TN
chr07,Bn33590,69921484,84034965,14113481,TNL
chr07,Bn33591,74012388,90837519,16825131,CNL
chr07,Bn33592,10881142,71924776,61043634,NBS
chr07,Bn33593,9928839,92013793,82084954,TN
chr07,Bn33594,18721588,64258349,45536761,TN
chr07,Bn33595,63592842,92912164,29319322,TNL
chr07,Bn33596,72734637,85595526,12860889,CNL
chr07,Bn33597,57930048,66303701,8373653,TN
chr07,Bn33598,89293188,90300436,1007248,RLK
chr07,Bn33599,88828773,89202041,373268,CN
chr07,Bn33600,16776956,90837310,74060354,TN
chr07,Bn33601,40676692,42929744,2253052,TNL
chr07,Bn33602,99648058,99896201,248143,CNL
chr07,Bn33603,11891157,57197850,45306693,RLK
chr07,Bn33604,26640295,53320799,26680504,CNL
chr07,Bn33605,91871999,94555719,2683720,CNL
chr07,Bn33606,40586143,95318396,54732253,CN
chr07,Bn33607,6457681,9955091,3497410,TNL
chr07,Bn33608,71737435,95210127,23472692,NBS
chr07,Bn33609,32201359,55073150,22871791,TN
chr07,Bn33610,57685996,62149926,4463930,CN
chr07,Bn33611,39441006,41356423,1915417,CN
chr07,Bn33612,6583920,68762939,62179019,CN
chr07,Bn33613,13107145,51564477,38457332,CNL
chr07,Bn33614,1484963,39612881,38127918,TN
chr07,Bn33615,32534692,70001832,37467140,TNL
chr07,Bn33616,84789859,92934016,8144157,RLP
chr07,Bn33617,78133565,95891283,17757718,RLP
chr07,Bn33618,98380070,99780879,1400809,NBS
chr07,Bn33619,97770082,98754396,984314,NBS
chr07,Bn33620,82380068,84772148,2392080,TNL
chr07,Bn33621,10683278,29332870,18649592,RLK
chr07,Bn33622,6708963,63336445,56627482,CN
chr07,Bn33623,12968222,63455272,50487050,RLP
chr07,Bn33624,69200517,78079121,8878604,RLP
chr07,Bn33625,66038034,94969205,28931171,NBS
chr07,Bn33626,84327515,99142469,14814954,CNL
chr07,Bn33627,37571243,86238707,48667464,RLP
chr07,Bn33628,87305163,95154083,7848920,RLP
chr07,Bn33629,76705912,99452987,22747075,RLP
chr07,Bn33630,95135302,95841467,706165,TN
chr07,Bn33631,91003325,95416877,4413552,CN
chr07,Bn33632,90693581,92580770,1887189,NBS
chr07,Bn33633,90119244,93398297,3279053,RLP
chr07,Bn33634,67915272,82999799,15084527,RLK
chr07,Bn33635,65483755,79272046,13788291,CNL
chr07,Bn33636,69698493,84142048,14443555,CN
chr07,Bn33637,83625937,99900970,16275033,RLK
chr07,Bn33638,50792462,91083776,40291314,RLP
chr07,Bn33639,68063404,86839408,18776004,RLK
chr07,Bn33640,26017831,68799215,42781384,CNL
chr07,Bn33641,3276544,8908503,5631959,NBS
chr07,Bn33642,93758707,98443149,4684442,TNL
chr07,Bn33643,69879649,85705878,15826229,TNL
chr07,Bn33644,71981744,85949687,13967943,RLP
chr07,Bn33645,63309508,99621956,36312448,NBS
chr07,Bn33646,90190915,96660713,6469798,RLP
chr07,Bn33647,6020950,37043013,31022063,CNL
chr07,Bn33648,73316294,97409942,24093648,RLP
chr07,Bn33649,99663029,99873712,210683,TN
chr07,Bn33650,92504729,92923845,419116,CNL
chr07,Bn33651,67043474,75458504,8415030,RLK
chr07,Bn33652,62578426,72434320,9855894,NBS
chr07,Bn33653,32171444,92386511,60215067,NBS
chr07,Bn33654,39348170,86544976,47196806,TN
chr07,Bn33655,20229461,26993642,6764181,TN
chr07,Bn33656,75113617,83044416,7930799,CNL
chr07,Bn33657,79709383,95415687,15706304,CNL
chr07,Bn33658,21200254,48207048,27006794,RLK
chr07,Bn33659,51845208,85586352,33741144,TN
chr07,Bn33660,59355654,79767557,20411903,RLP
chr07,Bn33661,62835311,66709352,3874041,TN
chr07,Bn33662,42943280,73261602,30318322,RLK
chr07,Bn33663,96163330,98476967,2313637,CN
chr07,Bn33664,36401894,82047705,45645811,TNL
chr07,Bn33665,23783915,43570019,19786104,NBS
chr07,Bn33666,25631814,28309834,2678020,CN
chr07,Bn33667,58167860,67253945,9086085,TN
chr07,Bn33668,78469832,93435381,14965549,RLP
chr07,Bn33669,60999774,77874309,16874535,CN
chr07,Bn33670,87859178,96665784,8806606,RLK
chr07,Bn33671,94199416,95444636,1245220,TNL
chr07,Bn33672,90329417,95806032,5476615,RLK
chr07,Bn33673,65936832,89031539,23094707,TN
chr07,Bn33674,89754817,94411192,4656375,RLK
chr07,Bn33675,77218988,97342760,20123772,CN
chr07,Bn33676,93148612,93937111,788499,CN
chr07,Bn33677,24655766,50556549,25900783,TNL
chr07,Bn33678,36218586,51628627,15410041,CNL
chr07,Bn33679,84973875,96171250,11197375,TNL
chr07,Bn33680,59603015,95297069,35694054,CN
chr07,Bn33681,24614513,37423519,12809006,CN
chr07,Bn33682,26184282,68896511,42712229,TNL
chr07,Bn33683,88072080,98782544,10710464,RLP
chr07,Bn33684,71523511,85819866,14296355,CN
chr07,Bn33685,33036291,91447803,58411512,CN
chr07,Bn33686,86570985,97617454,11046469,CNL
chr07,Bn33687,84640603,90164573,5523970,RLP
chr07,Bn33688,21085012,76273644,55188632,RLK
chr07,Bn33689,66469692,86825166,20355474,TN
chr07,Bn33690,85299733,97964057,12664324,CNL
chr07,Bn33691,55925294,96445118,40519824,CN
chr07,Bn33692,53875993,55915455,2039462,RLP
chr07,Bn33693,54221377,73972535,19751158,NBS
chr07,Bn33694,28944559,50147230,21202671,TNL
chr07,Bn33695,28199664,46809058,18609394,CN
chr07,Bn33696,5333171,80508706,75175535,CN
chr07,Bn33697,95899304,99399873,3500569,TN
chr07,Bn33698,16705709,74816618,58110909,CN
chr07,Bn33699,96392125,97408587,1016462,NBS
chr07,Bn33700,73578292,92802346,19224054,RLK
chr07,Bn33701,98184513,99347064,1162551,TNL
chr07,Bn33702,87479484,97200021,9720537,TN
chr07,Bn33703,67334155,89556015,22221860,TNL
chr07,Bn33704,54311633,78868930,24557297,TN
chr07,Bn33705,90795864,95437172,4641308,CNL
chr07,Bn33706,21404408,32556123,11151715,CN
chr07,Bn33707,97877092,98461443,584351,CNL
chr07,Bn33708,60992787,81620870,20628083,RLK
chr07,Bn33709,99734706,99900567,165861,TNL
chr07,Bn33710,11050356,85468307,74417951,CNL
chr07,Bn33711,18125584,34390256,16264672,RLK
chr07,Bn33712,82059552,89913944,7854392,NBS
chr07,Bn33713,11992657,47587675,35595018,TN
chr07,Bn33714,16173338,93618225,77444887,TNL
chr07,Bn33715,72504857,98820458,26315601,TNL
chr07,Bn33716,52501411,98601205,46099794,NBS
chr07,Bn33717,33853989,62288756,28434767,CNL
chr07,Bn33718,39132747,53155040,14022293,RLK
chr07,Bn33719,29179776,88176379,58996603,TN
chr07,Bn33720,29311840,61776490,32464650,CN
chr07,Bn33721,6538578,81871068,75332490,RLK
chr07,Bn33722,34652016,39577590,4925574,RLP
chr07,Bn33723,46123818,53209965,7086147,RLK
chr07,Bn33724,55038319,84197317,29158998,CNL
chr07,Bn33725,4352972,87721767,83368795,NBS
chr07,Bn33726,57626606,70157414,12530808,TN
chr07,Bn33727,20755771,34001326,13245555,CN
chr07,Bn33728,14730437,30654868,15924431,TNL
chr07,Bn33729,31836784,89445792,57609008,TNL
chr07,Bn33730,25073582,79066802,53993220,RLP
chr07,Bn33731,20206426,51776207,31569781,CN
chr07,Bn33732,44522092,53887009,9364917,TNL
chr07,Bn33733,11260537,84463373,73202836,TNL
chr07,Bn33734,36959549,51632670,14673121,RLP
chr07,Bn33735,76724563,95420516,18695953,RLP
chr07,Bn33736,7992144,22557040,14564896,TN
chr07,Bn33737,16821098,18274303,1453205,RLP
chr07,Bn33738,93075428,95765373,2689945,CNL
chr07,Bn33739,41116591,69460690,28344099,CNL
chr07,Bn33740,83356642,96044858,12688216,CN
chr07,Bn33741,46442138,64909726,18467588,TN
chr07,Bn33742,21069520,37956618,16887098,NBS
chr07,Bn33743,5765288,63388092,57622804,TN
chr07,Bn33744,8418319,23925848,15507529,CNL
chr07,Bn33745,60409242,77994844,17585602,RLK
chr07,Bn33746,30252614,83714738,53462124,CNL
chr07,Bn33747,34612746,65687264,31074518,TNL
chr07,Bn33748,4045769,61259811,57214042,CNL
chr07,Bn33749,36704707,69176029,32471322,CNL
chr07,Bn33750,79722007,98689299,18967292,RLK
chr07,Bn33751,74604633,87577804,12973171,RLK
chr07,Bn33752,52027664,93541986,41514322,CNL
chr07,Bn33753,95848666,96582304,733638,CNL
chr07,Bn33754,90346560,94447578,4101018,CNL
chr07,Bn33755,14713280,33345198,18631918,RLK
chr07,Bn33756,94170483,94775253,604770,TN
chr07,Bn33757,95739461,96839716,1100255,TNL
chr07,Bn33758,20482211,25120557,4638346,RLP
chr07,Bn33759,54214536,81632456,27417920,NBS
chr07,Bn33760,42203121,81178560,38975439,RLP
chr07,Bn33761,27500855,52379387,24878532,TN
chr07,Bn33762,94402605,99420017,5017412,TN
chr07,Bn33763,28060946,55122984,27062038,CNL
chr07,Bn33764,96751447,98303756,1552309,CNL
chr07,Bn33765,7836264,13788731,5952467,CN
chr07,Bn33766,20118219,86356548,66238329,RLP
chr07,Bn33767,72476383,99143402,26667019,TN
chr07,Bn33768,4816404,17566334,12749930,CN
chr07,Bn33769,2954984,70108063,67153079,TN
chr07,Bn33770,20791678,89656501,68864823,CNL
chr07,Bn33771,3573605,26370006,22796401,RLK
chr07,Bn33772,77690439,99108855,21418416,RLP
chr07,Bn33773,44016606,66640973,22624367,CNL
chr07,Bn33774,52383962,73020961,20636999,RLP
chr07,Bn33775,31097834,73879309,42781475,RLP
chr07,Bn33776,2579291,69355480,66776189,CN
chr07,Bn33777,79681739,98516409,18834670,RLK
chr07,Bn33778,29938153,99613637,69675484,CNL
chr07,Bn33779,79863872,95019940,15156068,CNL
chr07,Bn33780,90754947,96837518,6082571,RLP
chr07,Bn33781,24924336,43012787,18088451,TN
chr07,Bn33782,29618293,54906245,25287952,CNL
chr07,Bn33783,2107825,84315898,82208073,CNL
chr07,Bn33784,93974231,97596730,3622499,TN
chr07,Bn33785,44703901,46246006,1542105,CN
chr07,Bn33786,57160335,83554678,26394343,RLP
chr07,Bn33787,56710933,59590765,2879832,RLK
chr07,Bn33788,55173299,85710261,30536962,NBS
chr07,Bn33789,26598876,81638207,55039331,CN
chr07,Bn33790,86697160,98321184,11624024,CNL
chr07,Bn33791,97281525,97658777,377252,CNL
chr07,Bn33792,87205568,98695202,11489634,RLK
chr07,Bn33793,45918370,47536567,1618197,RLK
chr07,Bn33794,58889155,85445143,26555988,TNL
chr07,Bn33795,55913217,63042336,7129119,NBS
chr07,Bn33796,46932568,87187717,40255149,TNL
chr07,Bn33797,95082007,98872318,3790311,RLP
chr07,Bn33798,64913804,67582481,2668677,RLP
chr07,Bn33799,64432182,98585022,34152840,TN
chr07,Bn33800,51697848,89179184,37481336,NBS
chr07,Bn33801,27277148,29344505,2067357,CN
chr07,Bn33802,26866964,70978105,44111141,TN
chr07,Bn33803,93846285,95300501,1454216,TNL
chr07,Bn33804,2910348,41942415,39032067,CNL
chr07,Bn33805,75409437,79982098,4572661,TNL
chr07,Bn33806,4610492,98263353,93652861,TN
chr07,Bn33807,21458297,81915413,60457116,TN
chr07,Bn33808,47045084,63561240,16516156,CN
chr07,Bn33809,98325470,98745150,419680,TN
chr07,Bn33810,72027801,98165330,26137529,RLP
chr07,Bn33811,5080495,99428996,94348501,RLK
chr07,Bn33812,3347194,79884731,76537537,RLK
chr07,Bn33813,38934456,95550459,56616003,RLK
chr07,Bn33814,16759273,98105561,81346288,RLK
chr07,Bn33815,18565535,44711235,26145700,TN
chr07,Bn33816,61510277,73013863,11503586,CNL
chr07,Bn33817,62940775,88697348,25756573,CN
chr07,Bn33818,88011493,89072357,1060864,RLP
chr07,Bn33819,69836589,89131405,19294816,RLP
chr07,Bn33820,27188641,80020717,52832076,NBS
chr07,Bn33821,5529927,96094092,90564165,NBS
chr07,Bn33822,21357138,80245969,58888831,NBS
chr07,Bn33823,97702891,99388678,1685787,CNL
chr07,Bn33824,9551958,99996268,90444310,TN
chr07,Bn33825,54401961,72566116,18164155,RLK
chr07,Bn33826,22775757,39806196,17030439,TNL
chr07,Bn33827,15590325,48813953,33223628,CNL
chr07,Bn33828,57535378,71399916,13864538,NBS
chr07,Bn33829,97582387,99334345,1751958,TN
chr07,Bn33830,59114474,78398308,19283834,CNL
chr07,Bn33831,88165304,88274014,108710,RLP
chr07,Bn33832,89925879,94368187,4442308,TN
chr07,Bn33833,15500286,40560291,25060005,RLP
chr07,Bn33834,4909415,20508927,15599512,RLP
chr07,Bn33835,69691481,75321466,5629985,TN
chr07,Bn33836,35336759,81494434,46157675,TN
chr07,Bn33837,5485170,68610607,63125437,TNL
chr07,Bn33838,29781463,86712695,56931232,TNL
chr07,Bn33839,20201188,82542533,62341345,CNL
chr07,Bn33840,18127673,85442864,67315191,RLP
chr07,Bn33841,29802422,88841325,59038903,RLK
chr07,Bn33842,63055784,69832762,6776978,TN
chr07,Bn33843,84360949,90582189,6221240,CNL
chr07,Bn33844,14063569,39139045,25075476,CNL
chr07,Bn33845,31726361,94444492,62718131,CN
chr07,Bn33846,41049425,88803369,47753944,RLK
chr07,Bn33847,37791499,99385124,61593625,RLP
chr07,Bn33848,35749637,50027805,14278168,RLP
chr07,Bn33849,32224467,96970427,64745960,RLK
chr07,Bn33850,78633444,92255866,13622422,TNL
chr07,Bn33851,59422140,91075844,31653704,TNL
chr07,Bn33852,77465953,80646714,3180761,RLP
chr07,Bn33853,45334525,52229162,6894637,TN
chr07,Bn33854,59051549,76275962,17224413,RLP
chr07,Bn33855,6199636,46142916,39943280,RLP
chr07,Bn33856,19454521,66194054,46739533,CNL
chr07,Bn33857,93763506,95454747,1691241,RLP
chr07,Bn33858,10493500,61635401,51141901,CNL
chr07,Bn33859,69427415,83813673,14386258,RLP
chr07,Bn33860,3122103,46702104,43580001,CNL
chr07,Bn33861,56542670,82645405,26102735,CNL
chr07,Bn33862,38399491,70101819,31702328,TNL
chr07,Bn33863,78744601,91161180,12416579,RLK
chr07,Bn33864,19713762,77974682,58260920,RLP
chr07,Bn33865,85438596,86541478,1102882,TNL
chr07,Bn33866,98463973,99272668,808695,RLP
chr07,Bn33867,89861648,92788629,2926981,RLK
chr07,Bn33868,10010348,91421722,81411374,TNL
chr07,Bn33869,96147553,99822959,3675406,TNL
chr07,Bn33870,30280021,62736790,32456769,NBS
chr07,Bn33871,74123566,82832838,8709272,NBS
chr07,Bn33872,92327872,95039188,2711316,CN
chr07,Bn33873,53677665,78537960,24860295,TN
chr07,Bn33874,99549697,99985314,435617,CNL
chr07,Bn33875,55200424,57648184,2447760,TNL
chr07,Bn33876,38144658,44660100,6515442,TN
chr07,Bn33877,43114050,59496695,16382645,TNL
chr07,Bn33878,67922676,93869491,25946815,RLK
chr07,Bn33879,41666604,56354475,14687871,RLK
chr07,Bn33880,52467649,82293694,29826045,RLP
chr07,Bn33881,50441744,87411422,36969678,CN
chr07,Bn33882,13632798,56400164,42767366,TN
chr07,Bn33883,36648557,47781475,11132918,TN
chr07,Bn33884,27173690,86338207,59164517,TNL
chr07,Bn33885,98850406,99009538,159132,NBS
chr07,Bn33886,14484827,87497959,73013132,CN
chr07,Bn33887,57894361,80688540,22794179,NBS
chr07,Bn33888,70129300,95357797,25228497,TNL
chr07,Bn33889,20159844,73321580,53161736,CN
chr07,Bn33890,71999714,85460747,13461033,CN
chr07,Bn33891,69638418,76279513,6641095,NBS
chr07,Bn33892,63538240,80214775,16676535,TN
chr07,Bn33893,75632168,85869361,10237193,CNL
chr07,Bn33894,74027556,97145497,23117941,RLP
chr07,Bn33895,6848454,78145334,71296880,RLK
chr07,Bn33896,2040257,87384410,85344153,RLP
chr07,Bn33897,40486946,94541360,54054414,TNL
chr07,Bn33898,56908495,90971758,34063263,TNL
chr07,Bn33899,75889762,92009864,16120102,CN
chr07,Bn33900,52734637,82551583,29816946,TN
chr07,Bn33901,32398494,80943202,48544708,TN
chr07,Bn33902,40266496,99506157,59239661,RLP
chr07,Bn33903,88228593,95996020,7767427,RLP
chr07,Bn33904,34390081,57387120,22997039,TN
chr07,Bn33905,33943574,40795072,6851498,RLP
chr07,Bn33906,31386328,42101157,10714829,RLP
chr07,Bn33907,45573871,56293633,10719762,TNL
chr07,Bn33908,65037647,77115339,12077692,NBS
chr07,Bn33909,99453256,99993249,539993,RLK
chr07,Bn33910,53249995,93505862,40255867,TNL
chr07,Bn33911,7572225,50760523,43188298,CNL
chr07,Bn33912,91845024,92212326,367302,RLK
chr07,Bn33913,77003041,90464402,13461361,TNL
chr07,Bn33914,11099867,89236064,78136197,NBS
chr07,Bn33915,95022445,97043200,2020755,TN
chr07,Bn33916,49489018,73260462,23771444,CN
chr07,Bn33917,62899148,84668462,21769314,CNL
chr07,Bn33918,7604208,34066088,26461880,TN
chr07,Bn33919,60590958,98062854,37471896,RLP
chr07,Bn33920,23529422,72327612,48798190,TNL
chr07,Bn33921,25084373,66786316,41701943,NBS
chr07,Bn33922,60621958,94758068,34136110,NBS
chr07,Bn33923,13862399,24202257,10339858,RLP
chr07,Bn33924,90709953,96395683,5685730,RLK
chr07,Bn33925,8204808,30639863,22435055,RLP
chr07,Bn33926,38046357,50580217,12533860,RLP
chr07,Bn33927,96625182,96984215,359033,TN
chr07,Bn33928,29771020,95243171,65472151,RLK
chr07,Bn33929,25511936,32262475,6750539,CN
chr07,Bn33930,96559496,99059334,2499838,TNL
chr07,Bn33931,11758697,29564422,17805725,NBS
chr07,Bn33932,81026362,82137854,1111492,CNL
chr07,Bn33933,29304583,64157301,34852718,RLK
chr07,Bn33934,13924974,19018289,5093315,TN
chr07,Bn33935,18905849,96526432,77620583,NBS
chr07,Bn33936,53238934,81881523,28642589,RLP
chr07,Bn33937,82073600,93315804,11242204,NBS
chr07,Bn33938,7378121,94730964,87352843,CNL
chr07,Bn33939,98846720,99891995,1045275,TNL
chr07,Bn33940,77198436,82188784,4990348,CNL
chr07,Bn33941,65374641,98866072,33491431,RLK
chr07,Bn33942,18897938,79793140,60895202,NBS
chr07,Bn33943,17737337,57726892,39989555,TNL
chr07,Bn33944,62743213,89121157,26377944,CNL
chr07,Bn33945,35541154,88591966,53050812,CN
chr07,Bn33946,32149588,41789100,9639512,CN
chr07,Bn33947,91741105,99001404,7260299,RLP
chr07,Bn33948,24540211,99725900,75185689,TN
chr07,Bn33949,18134191,81477912,63343721,CN
chr07,Bn33950,27023973,58713923,31689950,CN
chr07,Bn33951,52499607,94058205,41558598,TN
chr07,Bn33952,62682344,71246872,8564528,NBS
chr07,Bn33953,20565824,47952588,27386764,NBS
chr07,Bn33954,13657673,32461591,18803918,RLK
chr07,Bn33955,34018497,74541584,40523087,TNL
chr07,Bn33956,14994898,36453944,21459046,RLP
chr07,Bn33957,68649591,80224032,11574441,TNL
chr07,Bn33958,21488088,51068655,29580567,RLK
chr07,Bn33959,79022826,94569448,15546622,NBS
chr07,Bn33960,24225516,57527902,33302386,NBS
chr07,Bn33961,99930938,99959288,28350,NBS
chr07,Bn33962,51629127,93220032,41590905,TNL
chr07,Bn33963,89329972,92756470,3426498,CNL
chr07,Bn33964,10009752,96516683,86506931,TN
chr07,Bn33965,47951952,48219935,267983,TNL
chr07,Bn33966,51335802,94698092,43362290,CN
chr07,Bn33967,92671445,93088707,417262,NBS
chr07,Bn33968,56416854,75698537,19281683,TN
chr07,Bn33969,26848986,54218272,27369286,RLP
chr07,Bn33970,67519689,76526950,9007261,RLK
chr07,Bn33971,34841948,65972702,31130754,TNL
chr07,Bn33972,88112403,98257708,10145305,TN
chr07,Bn33973,98789888,99047682,257794,RLP
chr07,Bn33974,51230243,69610636,18380393,CNL
chr07,Bn33975,31264970,69333642,38068672,RLP
chr07,Bn33976,6578952,81179607,74600655,RLK
chr07,Bn33977,56053917,80835774,24781857,CNL
chr07,Bn33978,39585849,59857015,20271166,CNL
chr07,Bn33979,75779880,80165104,4385224,RLP
chr07,Bn33980,7463586,17650456,10186870,RLP
chr07,Bn33981,43181005,74736024,31555019,CNL
chr07,Bn33982,66810419,84128853,17318434,TN
chr07,Bn33983,24529051,28781854,4252803,TNL
chr07,Bn33984,82110735,93718997,11608262,CNL
chr07,Bn33985,11932956,98866944,86933988,TNL
chr07,Bn33986,39410634,77743151,38332517,NBS
chr07,Bn33987,62911977,78061677,15149700,NBS
chr07,Bn33988,46424105,95767707,49343602,TNL
chr07,Bn33989,26863522,71305501,44441979,CN
chr07,Bn33990,16713563,96768132,80054569,TNL
chr07,Bn33991,16730657,43362351,26631694,TNL
chr07,Bn33992,66818206,75637348,8819142,NBS
chr07,Bn33993,25811169,69136156,43324987,CNL
chr07,Bn33994,9071249,25674730,16603481,TNL
chr07,Bn33995,45021440,99875510,54854070,TN
chr07,Bn33996,79469260,83822775,4353515,NBS
chr07,Bn33997,73582944,95396810,21813866,CNL
chr07,Bn33998,80979344,83882982,2903638,TNL
chr07,Bn33999,82131793,97067228,14935435,RLK
chr07,Bn34000,89686910,94819022,5132112,RLP
chr07,Bn34001,44833926,95440865,50606939,RLP
chr07,Bn34002,76014184,80473301,4459117,RLK
chr07,Bn34003,10860381,15186283,4325902,RLP
chr07,Bn34004,6427592,11160113,4732521,NBS
chr07,Bn34005,51309609,96746654,45437045,RLK
chr07,Bn34006,38569696,38830746,261050,NBS
chr07,Bn34007,78953369,93294886,14341517,CN
chr07,Bn34008,70736681,85959687,15223006,NBS
chr07,Bn34009,42887483,82014187,39126704,TN
chr07,Bn34010,76823753,89668861,12845108,CN
chr07,Bn34011,22126625,82974700,60848075,CN
chr07,Bn34012,61286999,63678017,2391018,TN
chr07,Bn34013,2123582,10742577,8618995,TNL
chr07,Bn34014,21888943,50360783,28471840,CN
chr07,Bn34015,91288648,95853564,4564916,CN
chr07,Bn34016,95627914,99008704,3380790,RLP
chr07,Bn34017,77892822,95907277,18014455,TNL
chr07,Bn34018,77452206,83967269,6515063,TN
chr07,Bn34019,53527197,54138612,611415,TN
chr07,Bn34020,67489559,70953285,3463726,RLP
chr07,Bn34021,80022607,92530085,12507478,TNL
chr07,Bn34022,79628933,80406333,777400,TN
chr07,Bn34023,77772831,87353569,9580738,RLP
chr07,Bn34024,32919167,99624859,66705692,RLP
chr07,Bn34025,50570850,79802969,29232119,CN
chr07,Bn34026,78829155,94226991,15397836,CN
chr07,Bn34027,34158494,35781736,1623242,CN
chr07,Bn34028,3736098,75663068,71926970,TN
chr07,Bn34029,5263940,21414870,16150930,RLP
chr07,Bn34030,46840541,86266294,39425753,TN
chr07,Bn34031,38797257,78923487,40126230,NBS
chr07,Bn34032,6156445,79809728,73653283,CN
chr07,Bn34033,39075911,62457003,23381092,CNL
chr07,Bn34034,7581299,38952539,31371240,CNL
chr07,Bn34035,46596413,94776748,48180335,TN
chr07,Bn34036,53289000,98402070,45113070,RLP
chr07,Bn34037,15030585,62715917,47685332,TN
chr07,Bn34038,26553374,65208196,38654822,TN
chr07,Bn34039,15852423,25117618,9265195,RLK
chr07,Bn34040,48923415,69620194,20696779,RLP
chr07,Bn34041,77339067,93531005,16191938,TN
chr07,Bn34042,66860630,77483491,10622861,RLP
chr07,Bn34043,98803944,99777234,973290,NBS
chr07,Bn34044,5100745,97241057,92140312,NBS
chr07,Bn34045,91414377,97005817,5591440,TNL
chr07,Bn34046,24363697,47955779,23592082,NBS
chr07,Bn34047,15345786,50482774,35136988,TN
chr07,Bn34048,44719516,75781129,31061613,CN
chr07,Bn34049,54990476,78087027,23096551,TN
chr07,Bn34050,40788703,85556509,44767806,RLK
chr07,Bn34051,76004429,78931650,2927221,CN
chr07,Bn34052,20019993,81466771,61446778,NBS
chr07,Bn34053,25445593,89085644,63640051,CN
chr07,Bn34054,33462389,91670391,58208002,TNL
chr07,Bn34055,97981134,98666528,685394,NBS
chr07,Bn34056,58756442,85334340,26577898,CN
chr07,Bn34057,38049993,89560537,51510544,CNL
chr07,Bn34058,39196124,59248464,20052340,CN
chr07,Bn34059,25324844,99562663,74237819,TN
chr07,Bn34060,89804377,91904263,2099886,NBS
chr07,Bn34061,35210605,97583550,62372945,TNL
chr07,Bn34062,20376420,93144353,72767933,CNL
chr07,Bn34063,87276792,88340221,1063429,CN
chr07,Bn34064,35741076,60171510,24430434,NBS
chr07,Bn34065,81326143,84038586,2712443,TNL
chr07,Bn34066,98373260,99558426,1185166,CNL
chr07,Bn34067,31950834,71488363,39537529,NBS
chr07,Bn34068,7603459,41110003,33506544,RLP
chr07,Bn34069,43831685,90071988,46240303,RLK
chr07,Bn34070,19649743,81002390,61352647,CNL
chr07,Bn34071,54952763,59559287,4606524,CNL
chr07,Bn34072,17488351,55566273,38077922,TNL
chr07,Bn34073,82875371,99848433,16973062,RLP
chr07,Bn34074,41400087,54662468,13262381,NBS
chr07,Bn34075,43684514,60726470,17041956,NBS
chr07,Bn34076,63123768,98559133,35435365,CNL
chr07,Bn34077,28513830,56442179,27928349,TNL
chr07,Bn34078,35917132,47974657,12057525,NBS
chr07,Bn34079,88694374,91849047,3154673,CN
chr07,Bn34080,75384534,98656454,23271920,CN
chr07,Bn34081,80559060,90759257,10200197,RLK
chr07,Bn34082,18975126,86144749,67169623,TN
chr07,Bn34083,86221683,93074930,6853247,TNL
chr07,Bn34084,39051421,42756519,3705098,CNL
chr07,Bn34085,19266555,22422748,3156193,NBS
chr07,Bn34086,72174238,99802387,27628149,TNL
chr07,Bn34087,6311716,98427635,92115919,CN
chr07,Bn34088,87799281,88741232,941951,RLP
chr07,Bn34089,63256623,98242045,34985422,RLK
chr07,Bn34090,99118255,99434758,316503,TNL
chr07,Bn34091,84856972,87655158,2798186,TNL
chr07,Bn34092,61556399,70141988,8585589,RLP
chr07,Bn34093,98516081,99983188,1467107,RLK
chr07,Bn34094,12157071,39673881,27516810,TN
chr07,Bn34095,43162241,92870775,49708534,NBS
chr07,Bn34096,59335774,69116135,9780361,RLK
chr07,Bn34097,95425275,96324050,898775,CN
chr07,Bn34098,20747523,52852804,32105281,TN
chr07,Bn34099,16198824,30280009,14081185,TN
chr07,Bn34100,13754575,55415820,41661245,CNL
chr07,Bn34101,85740282,87621734,1881452,RLK
chr07,Bn34102,18370378,71111553,52741175,CNL
chr07,Bn34103,64319584,68521105,4201521,TN
chr07,Bn34104,68144290,89391622,21247332,CNL
chr07,Bn34105,50662186,79460934,28798748,RLK
chr07,Bn34106,94971007,99030405,4059398,TN
chr07,Bn34107,61623062,68693348,7070286,RLP
chr07,Bn34108,25501763,47388245,21886482,TN
chr07,Bn34109,83559466,86932161,3372695,RLK
chr07,Bn34110,86484944,91331620,4846676,TNL
chr07,Bn34111,59848567,82841038,22992471,NBS
chr07,Bn34112,65568243,92892329,27324086,RLP
chr07,Bn34113,50471598,89753303,39281705,CN
chr07,Bn34114,65927135,86474815,20547680,RLP
chr07,Bn34115,68737299,90096413,21359114,RLK
chr07,Bn34116,14283630,43730942,29447312,CN
chr07,Bn34117,47548983,54162357,6613374,TNL
chr07,Bn34118,96969164,99742040,2772876,NBS
chr07,Bn34119,29621293,45730010,16108717,TNL
chr07,Bn34120,64952555,95874316,30921761,RLP
chr07,Bn34121,86490091,96249780,9759689,NBS
chr07,Bn34122,2382108,89796754,87414646,TNL
chr07,Bn34123,85991113,93893440,7902327,RLP
chr07,Bn34124,38791860,92728691,53936831,CN
chr07,Bn34125,12432713,87792452,75359739,NBS
chr07,Bn34126,75747796,93523472,17775676,TNL
chr07,Bn34127,36385888,97379632,60993744,CNL
chr07,Bn34128,69586806,82775174,13188368,CNL
chr07,Bn34129,4559628,67412206,62852578,NBS
chr07,Bn34130,56023145,88364704,32341559,TNL
chr07,Bn34131,74140184,86130109,11989925,TN
chr07,Bn34132,53885126,97324382,43439256,CNL
chr07,Bn34133,25164242,33338836,8174594,TN
chr07,Bn34134,95974510,98535245,2560735,TNL
chr07,Bn34135,27423731,70438794,43015063,TN
chr07,Bn34136,52830271,88728727,35898456,CNL
chr07,Bn34137,46444630,50936708,4492078,TNL
chr07,Bn34138,36930659,40710590,3779931,NBS
chr07,Bn34139,53260391,83882595,30622204,RLP
chr07,Bn34140,42724620,60186650,17462030,TN
chr07,Bn34141,21114143,46111767,24997624,RLK
chr07,Bn34142,86721249,97548567,10827318,TNL
chr07,Bn34143,40624036,95106731,54482695,NBS
chr07,Bn34144,89437710,90202183,764473,TNL
chr07,Bn34145,35816377,38263699,2447322,TN
chr07,Bn34146,24740673,79730695,54990022,NBS
chr07,Bn34147,56775717,94874327,38098610,RLK
chr07,Bn34148,43526041,68178690,24652649,NBS
chr07,Bn34149,41561164,48759433,7198269,RLP
chr07,Bn34150,51881990,83065638,31183648,NBS
chr07,Bn34151,88013724,98938872,10925148,CNL
chr07,Bn34152,4319100,78900545,74581445,CNL
chr07,Bn34153,37373348,81492032,44118684,NBS
chr07,Bn34154,70199456,74703738,4504282,TN
chr07,Bn34155,58685415,71801217,13115802,NBS
chr07,Bn34156,79929645,86217997,6288352,RLP
chr07,Bn34157,75166666,89251536,14084870,CNL
chr07,Bn34158,63165074,72836595,9671521,CNL
chr07,Bn34159,15341270,63948720,48607450,CN
chr07,Bn34160,64911136,98683398,33772262,CNL
chr07,Bn34161,33718175,96038430,62320255,RLP
chr07,Bn34162,30119140,50563238,20444098,CN
chr07,Bn34163,74974056,87319003,12344947,NBS
chr07,Bn34164,74226878,86969050,12742172,CN
chr07,Bn34165,68497993,76766447,8268454,RLK
chr07,Bn34166,40945312,77416753,36471441,NBS
chr07,Bn34167,5513259,79602160,74088901,CNL
chr07,Bn34168,1404633,68851519,67446886,TN
chr07,Bn34169,14212927,15093090,880163,NBS
chr07,Bn34170,67313582,84368478,17054896,RLK
chr07,Bn34171,51498782,82468201,30969419,CNL
chr07,Bn34172,4678199,32113868,27435669,TN
chr07,Bn34173,78834846,91289651,12454805,CNL
chr07,Bn34174,42278581,87858015,45579434,RLP
chr07,Bn34175,52927666,71381866,18454200,CNL
chr07,Bn34176,61748761,82839959,21091198,RLK
chr07,Bn34177,29557460,43714515,14157055,TN
chr07,Bn34178,97480026,97784169,304143,TNL
chr07,Bn34179,79924452,84751527,4827075,NBS
chr07,Bn34180,15018863,24038179,9019316,TNL
chr07,Bn34181,33860433,94520781,60660348,RLK
chr07,Bn34182,13695196,41390865,27695669,CN
chr07,Bn34183,41823382,46737566,4914184,TNL
chr07,Bn34184,78058859,82425687,4366828,RLP
chr07,Bn34185,57414399,67667943,10253544,TN
chr07,Bn34186,72036131,91945637,19909506,RLP
chr07,Bn34187,94019797,96835703,2815906,CN
chr07,Bn34188,92320962,95456850,3135888,RLK
chr07,Bn34189,88369159,98142283,9773124,RLK
chr07,Bn34190,19155228,99727490,80572262,TNL
chr07,Bn34191,50137993,55951712,5813719,CN
chr07,Bn34192,11103945,31846280,20742335,RLK
chr07,Bn34193,60533379,79436595,18903216,TN
chr07,Bn34194,99265225,99604687,339462,NBS
chr07,Bn34195,97096867,99811735,2714868,CNL
chr07,Bn34196,54428700,91427721,36999021,RLP
chr07,Bn34197,24645017,48125581,23480564,CNL
chr07,Bn34198,11885437,58618336,46732899,CNL
chr07,Bn34199,40245598,41683827,1438229,RLP
chr07,Bn34200,76116192,88159314,12043122,RLP
chr07,Bn34201,1878395,50586349,48707954,TN
chr07,Bn34202,82048542,85520172,3471630,TN
chr07,Bn34203,10786969,52845395,42058426,NBS
chr07,Bn34204,23583138,85203447,61620309,TN
chr07,Bn34205,30179032,83173035,52994003,RLP
chr07,Bn34206,1652911,79243985,77591074,TNL
chr07,Bn34207,58703560,78130815,19427255,TN
chr07,Bn34208,41478118,83834192,42356074,TN
chr07,Bn34209,18569071,92888278,74319207,TN
chr07,Bn34210,80655817,84983280,4327463,RLK
chr07,Bn34211,65131538,68220550,3089012,RLP
chr07,Bn34212,57498506,87072501,29573995,TNL
chr07,Bn34213,58037194,90121963,32084769,RLP
chr07,Bn34214,89916616,98679616,8763000,NBS
chr07,Bn34215,34874152,52118639,17244487,CN
chr07,Bn34216,58065258,67696409,9631151,TN
chr07,Bn34217,40129774,57741456,17611682,TNL
chr07,Bn34218,45028646,56227675,11199029,TNL
chr07,Bn34219,16789585,93410072,76620487,CN
chr07,Bn34220,73586044,83098934,9512890,RLK
chr07,Bn34221,86480040,99406603,12926563,NBS
chr07,Bn34222,46217575,77406885,31189310,NBS
chr07,Bn34223,99322710,99584864,262154,TNL
chr07,Bn34224,4759352,65728045,60968693,CN
chr07,Bn34225,80605139,87597702,6992563,NBS
chr07,Bn34226,2247781,37446369,35198588,RLP
chr07,Bn34227,8524472,59194945,50670473,RLP
chr07,Bn34228,65382509,93734970,28352461,CN
chr07,Bn34229,16767334,89277679,72510345,TNL
chr07,Bn34230,36863056,39121155,2258099,NBS
chr07,Bn34231,43073547,86084082,43010535,RLK
chr07,Bn34232,6177315,43782004,37604689,RLK
chr07,Bn34233,75003797,75098350,94553,RLP
chr07,Bn34234,50727169,64236212,13509043,CN
chr07,Bn34235,47567195,85422471,37855276,NBS
chr07,Bn34236,96086686,97659075,1572389,CN
chr07,Bn34237,67495947,71873740,4377793,RLP
chr07,Bn34238,48595489,61938935,13343446,RLK
chr07,Bn34239,84235293,93167268,8931975,CNL
chr07,Bn34240,70700665,73084069,2383404,RLP
chr07,Bn34241,85526040,93644859,8118819,TNL
chr07,Bn34242,41589042,80427436,38838394,NBS
chr07,Bn34243,63322239,82930612,19608373,RLK
chr07,Bn34244,21048774,80164080,59115306,CNL
chr07,Bn34245,4290465,99096202,94805737,NBS
chr07,Bn34246,42172339,77880373,35708034,TNL
chr07,Bn34247,74933598,83839495,8905897,NBS
chr07,Bn34248,52386649,77267794,24881145,TN
chr07,Bn34249,73240931,99936339,26695408,TN
chr07,Bn34250,89402033,97640920,8238887,CNL
chr07,Bn34251,53443956,66688978,13245022,TN
chr07,Bn34252,28214888,99348839,71133951,NBS
chr07,Bn34253,74427285,75982887,1555602,NBS
chr07,Bn34254,35279927,83375147,48095220,TN
chr07,Bn34255,66599119,84084428,17485309,RLP
chr07,Bn34256,43577633,78923255,35345622,NBS
chr07,Bn34257,60676109,81023996,20347887,TNL
chr07,Bn34258,60992925,90873808,29880883,NBS
chr07,Bn34259,53862802,85753994,31891192,TNL
chr07,Bn34260,13225545,55967274,42741729,CNL
chr07,Bn34261,68092404,73948214,5855810,RLK
chr07,Bn34262,43258949,66174598,22915649,TNL
chr07,Bn34263,17667403,97753430,80086027,RLP
chr07,Bn34264,15539676,94156704,78617028,NBS
chr07,Bn34265,36609209,96942523,60333314,TNL
chr07,Bn34266,1687083,51363451,49676368,RLK
chr07,Bn34267,7713193,81793636,74080443,RLP
chr07,Bn34268,13843315,97446289,83602974,CN
chr07,Bn34269,33853166,68852165,34998999,CN
chr07,Bn34270,20101545,65295315,45193770,TNL
chr07,Bn34271,89079604,99148680,10069076,TN
chr07,Bn34272,1038105,99276537,98238432,RLP
chr07,Bn34273,1856224,90141190,88284966,TNL
chr07,Bn34274,21410565,81027223,59616658,RLP
chr07,Bn34275,26661748,57397882,30736134,RLK
chr07,Bn34276,71367623,83949603,12581980,TN
chr07,Bn34277,70221978,95535710,25313732,CN
chr07,Bn34278,68193261,73117213,4923952,RLK
chr07,Bn34279,30767210,56340293,25573083,TNL
chr07,Bn34280,3621269,39067328,35446059,NBS
chr07,Bn34281,16807800,78497041,61689241,TNL
chr07,Bn34282,27655889,30337812,2681923,CN
chr07,Bn34283,4215319,9250072,5034753,CN
chr07,Bn34284,25786517,94713908,68927391,RLP
chr07,Bn34285,60551155,61019348,468193,RLK
chr07,Bn34286,37339427,93035115,55695688,TNL
chr07,Bn34287,52712866,81438501,28725635,RLK
chr07,Bn34288,96979200,98721274,1742074,TNL
chr07,Bn34289,25070759,78329818,53259059,TNL
chr07,Bn34290,69193064,79162275,9969211,RLP
chr07,Bn34291,88872580,96873167,8000587,RLK
chr07,Bn34292,13331653,99170950,85839297,TN
chr07,Bn34293,70832640,98504982,27672342,TN
chr07,Bn34294,95125530,99978783,4853253,CNL
chr07,Bn34295,42621410,86084746,43463336,CNL
chr07,Bn34296,20455865,70016852,49560987,TNL
chr07,Bn34297,43449745,52135164,8685419,CN
chr07,Bn34298,33042561,71801515,38758954,TN
chr07,Bn34299,63769116,94240358,30471242,TN
chr07,Bn34300,11480192,39709482,28229290,TNL
chr07,Bn34301,65906921,72368253,6461332,CN
chr07,Bn34302,69174798,91849266,22674468,TNL
chr07,Bn34303,98722755,99081554,358799,RLP
chr07,Bn34304,2961317,77549474,74588157,NBS
chr07,Bn34305,59823824,94839310,35015486,TN
chr07,Bn34306,87283955,90143835,2859880,RLP
chr07,Bn34307,4007509,52801563,48794054,CNL
chr07,Bn34308,58510434,80582893,22072459,TN
chr07,Bn34309,62290816,97406086,35115270,NBS
chr07,Bn34310,9991184,41940392,31949208,NBS
chr07,Bn34311,56305072,98917106,42612034,CN
chr07,Bn34312,70994286,78134546,7140260,CN
chr07,Bn34313,22096421,22191937,95516,CNL
chr07,Bn34314,42550740,86962583,44411843,RLK
chr07,Bn34315,93492792,98448220,4955428,RLK
chr07,Bn34316,99600480,99739187,138707,NBS
chr07,Bn34317,61965149,77198321,15233172,RLP
chr07,Bn34318,47388359,99107238,51718879,RLK
chr07,Bn34319,19786953,74007604,54220651,RLP
chr07,Bn34320,35885164,96866574,60981410,NBS
chr07,Bn34321,76737848,83015891,6278043,RLK
chr07,Bn34322,97014731,99574143,2559412,TNL
chr07,Bn34323,99292326,99692102,399776,TNL
chr07,Bn34324,39443688,74481537,35037849,NBS
chr07,Bn34325,24968523,96361909,71393386,RLK
chr07,Bn34326,4925714,55315857,50390143,RLK
chr07,Bn34327,72015888,84840193,12824305,CNL
chr07,Bn34328,6618388,70119826,63501438,CNL
chr07,Bn34329,6483010,99720414,93237404,TNL
chr07,Bn34330,60962601,78614191,17651590,CN
chr07,Bn34331,7010640,44560425,37549785,CN
chr07,Bn34332,49561469,88977833,39416364,CN
chr07,Bn34333,25375861,90173964,64798103,CNL
chr07,Bn34334,43767108,71960533,28193425,CNL
chr07,Bn34335,64628483,78669180,14040697,RLK
chr07,Bn34336,95667776,98564211,2896435,CN
chr07,Bn34337,44015180,93219764,49204584,RLP
chr07,Bn34338,70632559,85804864,15172305,RLK
chr07,Bn34339,74874800,85978472,11103672,TNL
chr07,Bn34340,30919026,75006024,44086998,NBS
chr07,Bn34341,53574641,80967098,27392457,CNL
chr07,Bn34342,60671994,87327077,26655083,RLP
chr07,Bn34343,71292216,83087384,11795168,NBS
chr07,Bn34344,71756175,91864418,20108243,CNL
chr07,Bn34345,81182887,97345034,16162147,TNL
chr07,Bn34346,34485212,97574842,63089630,RLP
chr07,Bn34347,5002469,63373456,58370987,CN
chr07,Bn34348,57683331,61864730,4181399,RLP
chr07,Bn34349,91759500,92818639,1059139,RLP
chr07,Bn34350,96722061,97406916,684855,RLK
chr07,Bn34351,52360695,63425465,11064770,RLK
chr07,Bn34352,89621202,90531979,910777,RLP
chr07,Bn34353,3348068,93141776,89793708,NBS
chr07,Bn34354,38650050,78711650,40061600,RLP
chr07,Bn34355,42274414,58906924,16632510,TN
chr07,Bn34356,27353680,49578923,22225243,NBS
chr07,Bn34357,37084620,48979426,11894806,NBS
chr07,Bn34358,74136544,94720658,20584114,RLK
chr07,Bn34359,7631038,21838823,14207785,CNL
chr07,Bn34360,33031757,63716487,30684730,RLP
chr07,Bn34361,51353198,63514757,12161559,NBS
chr07,Bn34362,59773617,79625618,19852001,RLP
chr07,Bn34363,92371239,99968794,7597555,NBS
chr07,Bn34364,78904117,81776199,2872082,NBS
chr07,Bn34365,19314503,57488834,38174331,CN
chr07,Bn34366,26414467,71962555,45548088,TNL
chr07,Bn34367,25894288,42693659,16799371,TNL
chr07,Bn34368,58096026,63230319,5134293,NBS
chr07,Bn34369,86770437,90736861,3966424,CNL
chr07,Bn34370,18105467,46886148,28780681,CNL
chr07,Bn34371,50487731,94495601,44007870,CNL
chr07,Bn34372,44467235,81249203,36781968,CN
chr07,Bn34373,16476212,66572256,50096044,RLK
chr07,Bn34374,51568090,87502345,35934255,TN
chr07,Bn34375,15546743,72705842,57159099,RLK
chr07,Bn34376,37252084,42850556,5598472,RLP
chr07,Bn34377,73123096,95227165,22104069,TNL
chr07,Bn34378,43058098,43135630,77532,CN
chr07,Bn34379,6360880,33546634,27185754,CNL
chr07,Bn34380,33385115,91786213,58401098,RLP
chr07,Bn34381,9650043,64195853,54545810,TN
chr07,Bn34382,92033357,99550200,7516843,RLK
chr07,Bn34383,13152804,63156585,50003781,TNL
chr07,Bn34384,27783524,35198392,7414868,NBS
chr07,Bn34385,11122984,57857202,46734218,TN
chr07,Bn34386,66268219,89978674,23710455,TNL
chr07,Bn34387,47230317,48741650,1511333,RLK
chr07,Bn34388,77097472,96469000,19371528,NBS
chr07,Bn34389,79862269,99878648,20016379,RLK
chr07,Bn34390,69153127,97178050,28024923,RLP
chr07,Bn34391,97941350,98113321,171971,TN
chr07,Bn34392,4720801,13498910,8778109,CN
chr07,Bn34393,18202256,75492341,57290085,RLP
chr07,Bn34394,75098829,89521050,14422221,CN
chr07,Bn34395,13406021,59951722,46545701,CNL
chr07,Bn34396,32436725,37989737,5553012,CNL
chr07,Bn34397,91154730,99492164,8337434,TN
chr07,Bn34398,17315242,77488092,60172850,CN
chr07,Bn34399,90788823,99610065,8821242,RLP
chr07,Bn34400,12458256,70346477,57888221,TN
chr07,Bn34401,21663118,47928590,26265472,RLP
chr07,Bn34402,72784301,77549417,4765116,RLP
chr07,Bn34403,33523478,38994069,5470591,CN
chr07,Bn34404,64714147,98823855,34109708,CNL
chr07,Bn34405,13949002,72723915,58774913,CNL
chr07,Bn34406,66796563,84393830,17597267,CN
chr07,Bn34407,52187694,73904540,21716846,TN
chr07,Bn34408,60007917,94246765,34238848,CNL
chr07,Bn34409,78941174,80353300,1412126,CNL
chr07,Bn34410,36003250,84694572,48691322,RLP
chr07,Bn34411,57521681,89545543,32023862,TNL
chr07,Bn34412,59198434,71908738,12710304,CNL
chr07,Bn34413,76192847,94165568,17972721,RLP
chr07,Bn34414,34017477,93316761,59299284,TNL
chr07,Bn34415,26098933,64956604,38857671,TN
chr07,Bn34416,86657089,87728116,1071027,RLP
chr07,Bn34417,42440032,93119399,50679367,TNL
chr07,Bn34418,52573076,87066835,34493759,TNL
chr07,Bn34419,12848091,32267964,19419873,RLK
chr07,Bn34420,20105503,87997603,67892100,CNL
chr07,Bn34421,58609819,92699868,34090049,RLK
chr07,Bn34422,15366793,86829673,71462880,TNL
chr07,Bn34423,61540750,69880533,8339783,RLK
chr07,Bn34424,43368193,93838382,50470189,NBS
chr07,Bn34425,12055227,18782927,6727700,CNL
chr07,Bn34426,56730500,86895690,30165190,CN
chr07,Bn34427,29808769,31347263,1538494,TN
chr07,Bn34428,91651767,95372871,3721104,RLP
chr07,Bn34429,89953155,96904568,6951413,RLK
chr07,Bn34430,43839698,46237100,2397402,RLK
chr07,Bn34431,13089822,35212819,22122997,CNL
chr07,Bn34432,39204266,87108830,47904564,NBS
chr07,Bn34433,30582979,44334844,13751865,TNL
chr07,Bn34434,33876819,79923937,46047118,TN
chr07,Bn34435,47962418,58708846,10746428,NBS
chr07,Bn34436,48296154,63456528,15160374,RLK
chr07,Bn34437,33733080,70498168,36765088,RLP
chr07,Bn34438,97172560,99976685,2804125,NBS
chr07,Bn34439,8412518,83137912,74725394,TN
chr07,Bn34440,30439259,75192292,44753033,RLK
chr07,Bn34441,99181159,99882955,701796,TNL
chr07,Bn34442,65751523,86592673,20841150,RLK
chr07,Bn34443,41096633,77469647,36373014,TNL
chr07,Bn34444,41671543,51357136,9685593,CNL
chr07,Bn34445,37504540,95816996,58312456,TN
chr07,Bn34446,87842930,97599245,9756315,RLP
chr07,Bn34447,23080430,60324130,37243700,TN
chr07,Bn34448,42736837,74347651,31610814,CN
chr07,Bn34449,83170550,83863276,692726,RLK
chr07,Bn34450,28141357,53675111,25533754,RLK
chr07,Bn34451,8801350,93816018,85014668,RLP
chr07,Bn34452,84580253,90864257,6284004,NBS
chr07,Bn34453,54184796,56370668,2185872,CNL
chr07,Bn34454,51667202,77722548,26055346,NBS
chr07,Bn34455,68864457,76491457,7627000,TN
chr07,Bn34456,44659494,50761512,6102018,CN
chr07,Bn34457,63100876,96593163,33492287,CNL
chr07,Bn34458,79583761,89469044,9885283,RLP
chr07,Bn34459,22009387,42173046,20163659,RLP
chr07,Bn34460,55079794,97835532,42755738,NBS
chr07,Bn34461,68241928,87995137,19753209,NBS
chr07,Bn34462,29640606,30353001,712395,RLK
chr07,Bn34463,1998877,22466105,20467228,NBS
chr07,Bn34464,16186097,55036108,38850011,CN
chr07,Bn34465,95121864,97800800,2678936,TN
chr07,Bn34466,18261879,94801333,76539454,TNL
chr07,Bn34467,27495291,77402298,49907007,CNL
chr07,Bn34468,35750998,43176263,7425265,CN
chr07,Bn34469,40532512,46739699,6207187,RLP
chr07,Bn34470,78940626,99717319,20776693,RLP
chr07,Bn34471,76801955,91099198,14297243,TN
chr07,Bn34472,72326264,72743712,417448,NBS
chr07,Bn34473,66613746,77446387,10832641,RLK
chr07,Bn34474,59328881,95583039,36254158,RLP
chr07,Bn34475,20145451,37073690,16928239,TN
chr07,Bn34476,94500038,96314656,1814618,TNL
chr07,Bn34477,1259501,61128402,59868901,CN
chr07,Bn34478,55304933,85356996,30052063,TN
chr07,Bn34479,43634497,90641754,47007257,CN
chr07,Bn34480,12050659,40004200,27953541,CN
chr07,Bn34481,35565293,49003863,13438570,CN
chr07,Bn34482,14042073,51552989,37510916,RLP
chr07,Bn34483,40952228,82990076,42037848,RLP
chr07,Bn34484,44270761,84617643,40346882,RLK
chr07,Bn34485,31746968,90417750,58670782,CNL
chr07,Bn34486,41852460,49230062,7377602,TNL
chr07,Bn34487,28992579,74442124,45449545,TN
chr07,Bn34488,76229848,93244635,17014787,CN
chr07,Bn34489,72878841,79095072,6216231,NBS
chr07,Bn34490,54286757,72857690,18570933,RLP
chr07,Bn34491,53655547,96691323,43035776,NBS
chr07,Bn34492,95323178,97784013,2460835,TNL
chr07,Bn34493,74656547,98046235,23389688,TNL
chr07,Bn34494,51134606,52291746,1157140,NBS
chr07,Bn34495,67022665,82164665,15142000,CN
chr07,Bn34496,9978207,10101052,122845,RLK
chr07,Bn34497,1217585,71574625,70357040,NBS
chr07,Bn34498,21124730,62063313,40938583,NBS
chr07,Bn34499,67040854,85264277,18223423,CN
chr07,Bn34500,89275453,93937881,4662428,TN
chr07,Bn34501,44842057,67386786,22544729,RLK
chr07,Bn34502,6937162,50710725,43773563,RLP
chr07,Bn34503,30745975,93857002,63111027,CN
chr07,Bn34504,50558579,67879146,17320567,TNL
chr07,Bn34505,80172935,92474049,12301114,TNL
chr07,Bn34506,18472362,45369312,26896950,NBS
chr07,Bn34507,72649453,82171428,9521975,CN
chr07,Bn34508,15653830,68916934,53263104,TN
chr07,Bn34509,54346382,96543326,42196944,CNL
chr07,Bn34510,76602990,87987139,11384149,TN
chr07,Bn34511,22769216,71641654,48872438,RLP
chr07,Bn34512,14021263,86278250,72256987,NBS
chr07,Bn34513,11354344,66642040,55287696,CN
chr07,Bn34514,14580024,94877509,80297485,CN
chr07,Bn34515,25171582,30707850,5536268,CNL
chr07,Bn34516,23259654,33175690,9916036,TN
chr07,Bn34517,34080758,86492091,52411333,RLP
chr07,Bn34518,25695573,84644054,58948481,RLK
chr07,Bn34519,44833229,98128447,53295218,TNL
chr07,Bn34520,51517578,80384199,28866621,NBS
chr07,Bn34521,15773275,66950598,51177323,CN
chr07,Bn34522,80024567,87955364,7930797,RLK
chr07,Bn34523,77873352,93073966,15200614,TNL
chr07,Bn34524,65991089,85560392,19569303,RLP
chr07,Bn34525,93422102,97723212,4301110,TN
chr07,Bn34526,19080869,36119927,17039058,TN
chr07,Bn34527,46561529,60448364,13886835,TNL
chr07,Bn34528,85207360,91136842,5929482,NBS
chr07,Bn34529,80107886,95739767,15631881,TN
chr07,Bn34530,28128852,98345532,70216680,TNL
chr07,Bn34531,85964768,98449460,12484692,NBS
chr07,Bn34532,50836469,64950448,14113979,RLP
chr07,Bn34533,41466785,53290239,11823454,NBS
chr07,Bn34534,78515655,91707198,13191543,TNL
chr07,Bn34535,89848822,92503369,2654547,TNL
chr07,Bn34536,36806391,45539033,8732642,RLK
chr07,Bn34537,94821666,97177844,2356178,CN
chr07,Bn34538,54969337,97811973,42842636,CNL
chr07,Bn34539,1172740,13694582,12521842,TN
chr07,Bn34540,87713557,91133445,3419888,RLK
chr07,Bn34541,10070838,94337692,84266854,CNL
chr07,Bn34542,52798895,85075452,32276557,TNL
chr07,Bn34543,51975880,70915477,18939597,RLK
chr07,Bn34544,50362941,91917467,41554526,RLP
chr07,Bn34545,50410971,61731577,11320606,CNL
chr07,Bn34546,92899992,95177339,2277347,TNL
chr07,Bn34547,76318234,86813314,10495080,NBS
chr07,Bn34548,17703725,53621857,35918132,CNL
chr07,Bn34549,87335786,93881021,6545235,RLK
chr07,Bn34550,55151331,86636437,31485106,RLK
chr07,Bn34551,79511301,95385049,15873748,NBS
chr07,Bn34552,90467264,92720058,2252794,CNL
chr07,Bn34553,74857194,77553652,2696458,NBS
chr07,Bn34554,19458231,33978516,14520285,CN
chr07,Bn34555,56874833,87203319,30328486,CNL
chr07,Bn34556,64406229,71816894,7410665,RLP
chr07,Bn34557,6753696,49895864,43142168,TNL
chr07,Bn34558,39419780,61625565,22205785,NBS
chr07,Bn34559,64348131,85723957,21375826,RLP
chr07,Bn34560,2858030,13241587,10383557,CN
chr07,Bn34561,93395196,97727918,4332722,TNL
chr07,Bn34562,52488733,87378018,34889285,CNL
chr07,Bn34563,97691239,99945720,2254481,TNL
chr07,Bn34564,41977744,70390658,28412914,NBS
chr07,Bn34565,14412577,22678185,8265608,CN
chr07,Bn34566,16633107,89530926,72897819,TN
chr07,Bn34567,49176420,84806867,35630447,CNL
chr07,Bn34568,19447457,82885582,63438125,NBS
chr07,Bn34569,98317435,98720089,402654,RLP
chr07,Bn34570,70823541,81590350,10766809,TNL
chr07,Bn34571,19294060,39226646,19932586,CNL
chr07,Bn34572,78077733,96752217,18674484,CNL
chr07,Bn34573,36760426,47141698,10381272,TN
chr07,Bn34574,1840047,90579277,88739230,NBS
chr07,Bn34575,7229954,14545548,7315594,RLP
chr07,Bn34576,64266849,96421035,32154186,CN
chr07,Bn34577,38040563,80510980,42470417,CN
chr07,Bn34578,78408065,88535201,10127136,RLP
chr07,Bn34579,65583533,72679217,7095684,CNL
chr07,Bn34580,34427677,67569619,33141942,CNL
chr07,Bn34581,9483349,22250917,12767568,NBS
chr07,Bn34582,50027700,79474776,29447076,TN
chr07,Bn34583,80191414,93542608,13351194,TN
chr07,Bn34584,38365307,66672242,28306935,CN
chr07,Bn34585,70609199,98503600,27894401,TN
chr07,Bn34586,87309239,98253235,10943996,CNL
chr07,Bn34587,46087570,97364294,51276724,RLP
chr07,Bn34588,68829625,99449601,30619976,NBS
chr07,Bn34589,76466681,88685109,12218428,RLP
chr07,Bn34590,35955827,99913113,63957286,CN
chr07,Bn34591,17420901,68253104,50832203,NBS
chr07,Bn34592,69969001,86490939,16521938,RLK
chr07,Bn34593,17676679,39411379,21734700,NBS
chr07,Bn34594,18586587,36508467,17921880,CNL
chr07,Bn34595,12638190,54856066,42217876,TNL
chr07,Bn34596,66149268,95680945,29531677,TN
chr07,Bn34597,33018239,86871228,53852989,TNL
chr07,Bn34598,13261170,85663821,72402651,RLK
chr07,Bn34599,23154636,40679141,17524505,RLK
chr07,Bn34600,12712099,83307943,70595844,TNL
chr07,Bn34601,83729024,93888305,10159281,NBS
chr07,Bn34602,7100856,30144650,23043794,RLP
chr07,Bn34603,67096046,85117494,18021448,CN
chr07,Bn34604,88573183,90043975,1470792,CN
chr07,Bn34605,98862227,98906479,44252,RLP
chr07,Bn34606,68756166,80545523,11789357,RLK
chr07,Bn34607,74338933,98752507,24413574,CN
chr07,Bn34608,37662025,71669239,34007214,RLP
chr07,Bn34609,71632046,95486372,23854326,RLK
chr07,Bn34610,89565866,92844530,3278664,NBS
chr07,Bn34611,8615284,58642370,50027086,CN
chr07,Bn34612,90514145,97112160,6598015,RLP
chr07,Bn34613,71061066,77963252,6902186,RLK
chr07,Bn34614,40872523,84591061,43718538,NBS
chr07,Bn34615,3539815,52722925,49183110,CNL
chr07,Bn34616,11747114,20635492,8888378,CNL
chr07,Bn34617,83989615,94795692,10806077,TNL
chr07,Bn34618,73314790,99040661,25725871,NBS
chr07,Bn34619,62948605,95016357,32067752,CN
chr07,Bn34620,34487208,42315278,7828070,CN
chr07,Bn34621,42536882,67875569,25338687,TN
chr07,Bn34622,23561016,58357002,34795986,CNL
chr07,Bn34623,49582429,88418362,38835933,CN
chr07,Bn34624,13908403,52680426,38772023,CNL
chr07,Bn34625,9227439,80978809,71751370,NBS
chr07,Bn34626,66175314,85596923,19421609,TNL
chr07,Bn34627,21169551,54546326,33376775,RLK
chr07,Bn34628,8634995,61866021,53231026,CN
chr07,Bn34629,53766783,65314766,11547983,NBS
chr07,Bn34630,55050318,57596824,2546506,RLK
chr07,Bn34631,87626080,90183623,2557543,TN
chr07,Bn34632,61623503,85350911,23727408,CNL
chr07,Bn34633,46540087,74058441,27518354,CNL
chr07,Bn34634,32255444,66199333,33943889,TNL
chr07,Bn34635,59061981,81371215,22309234,CNL
chr07,Bn34636,65489309,65677940,188631,TN
chr07,Bn34637,55831591,99426049,43594458,NBS
chr07,Bn34638,43753931,45199849,1445918,TN
chr07,Bn34639,4830508,92703790,87873282,TNL
chr07,Bn34640,83042670,89043970,6001300,TN
chr07,Bn34641,52791082,66525241,13734159,TNL
chr07,Bn34642,34463109,63629358,29166249,RLK
chr07,Bn34643,10424103,17825808,7401705,RLK
chr07,Bn34644,44116721,64412474,20295753,CNL
chr07,Bn34645,27907761,96125733,68217972,NBS
chr07,Bn34646,19417979,20555625,1137646,RLP
chr07,Bn34647,65931241,81326296,15395055,NBS
chr07,Bn34648,13286258,43995062,30708804,CNL
chr07,Bn34649,99671311,99926973,255662,CN
chr07,Bn34650,85923297,94464889,8541592,CN
chr07,Bn34651,14832945,58509702,43676757,TNL
chr07,Bn34652,57011044,67681435,10670391,NBS
chr07,Bn34653,22196821,95725220,73528399,TNL
chr07,Bn34654,17048606,97772594,80723988,CN
chr07,Bn34655,89683442,92527079,2843637,RLP
chr07,Bn34656,29158124,39193659,10035535,TNL
chr08,Bn34657,67436840,71050672,3613832,TNL
chr08,Bn34658,84920450,92896500,7976050,TN
chr08,Bn34659,18065304,32982093,14916789,CN
chr08,Bn34660,41152889,67080126,25927237,RLP
chr08,Bn34661,40946357,46938450,5992093,NBS
chr08,Bn34662,39870735,52570042,12699307,RLK
chr08,Bn34663,44825478,51381230,6555752,RLP
chr08,Bn34664,92472815,94029952,1557137,CN
chr08,Bn34665,20852582,99457295,78604713,CNL
chr08,Bn34666,22049945,74932318,52882373,TNL
chr08,Bn34667,45303642,78530280,33226638,CNL
chr08,Bn34668,79236265,85621696,6385431,CNL
chr08,Bn34669,19932506,86164123,66231617,NBS
chr08,Bn34670,30000686,48334941,18334255,RLK
chr08,Bn34671,78901903,86454393,7552490,RLP
chr08,Bn34672,19177823,80105057,60927234,TN
chr08,Bn34673,11465119,74288009,62822890,CNL
chr08,Bn34674,80053104,88784950,8731846,RLP
chr08,Bn34675,8946724,67079182,58132458,CN
chr08,Bn34676,1877328,63870912,61993584,CNL
chr08,Bn34677,35250210,47405278,12155068,RLP
chr08,Bn34678,53780730,94600437,40819707,RLK
chr08,Bn34679,72323312,78976717,6653405,TNL
chr08,Bn34680,54414737,81438595,27023858,RLK
chr08,Bn34681,67826957,91892711,24065754,NBS
chr08,Bn34682,54795955,88626851,33830896,RLK
chr08,Bn34683,41285260,86057357,44772097,TN
chr08,Bn34684,38316290,67761865,29445575,TN
chr08,Bn34685,15073960,21420518,6346558,CN
chr08,Bn34686,99389402,99732964,343562,CN
chr08,Bn34687,16489518,26862629,10373111,NBS
chr08,Bn34688,83602009,85983257,2381248,CNL
chr08,Bn34689,67359796,82757560,15397764,TN
chr08,Bn34690,44853964,52177444,7323480,RLK
chr08,Bn34691,17512538,49466825,31954287,RLK
chr08,Bn34692,76401562,82029200,5627638,CN
chr08,Bn34693,32061717,38975876,6914159,RLP
chr08,Bn34694,57661188,84797399,27136211,NBS
chr08,Bn34695,43111277,68345232,25233955,CNL
chr08,Bn34696,82465956,89276732,6810776,TN
chr08,Bn34697,94497965,98560985,4063020,CNL
chr08,Bn34698,57128116,65991677,8863561,RLK
chr08,Bn34699,66466226,83273468,16807242,RLP
chr08,Bn34700,52853237,53061729,208492,TN
chr08,Bn34701,68959921,86366290,17406369,TNL
chr08,Bn34702,70837701,97675419,26837718,RLP
chr08,Bn34703,67741858,95171468,27429610,TN
chr08,Bn34704,3377792,61030458,57652666,RLK
chr08,Bn34705,28820408,39046817,10226409,CNL
chr08,Bn34706,71340029,89593456,18253427,RLK
chr08,Bn34707,38824354,80343305,41518951,TN
chr08,Bn34708,11921951,81634210,69712259,CN
chr08,Bn34709,5402497,41984851,36582354,RLP
chr08,Bn34710,44678265,80355570,35677305,TN
chr08,Bn34711,89443527,98734811,9291284,TN
chr08,Bn34712,57453693,85656501,28202808,NBS
chr08,Bn34713,60825592,61633107,807515,RLP
chr08,Bn34714,78907682,97340034,18432352,NBS
chr08,Bn34715,60190164,62358065,2167901,CN
chr08,Bn34716,82888455,96702321,13813866,NBS
chr08,Bn34717,71921029,96418458,24497429,TN
chr08,Bn34718,74351885,92030741,17678856,RLK
chr08,Bn34719,36274748,71830859,35556111,NBS
chr08,Bn34720,48445083,77232170,28787087,NBS
chr08,Bn34721,72407026,73799255,1392229,CNL
chr08,Bn34722,79301870,83482469,4180599,CNL
chr08,Bn34723,52066222,92190477,40124255,CN
chr08,Bn34724,60520577,81679021,21158444,NBS
chr08,Bn34725,6011074,58704917,52693843,RLK
chr08,Bn34726,80110383,80165768,55385,CN
chr08,Bn34727,81519759,84584121,3064362,CN
chr08,Bn34728,76591957,84020538,7428581,RLK
chr08,Bn34729,19500281,27137043,7636762,TNL
chr08,Bn34730,39314898,59789876,20474978,TN
chr08,Bn34731,19118000,23804467,4686467,RLK
chr08,Bn34732,32754587,90177366,57422779,TN
chr08,Bn34733,23416635,76567481,53150846,RLP
chr08,Bn34734,7401608,59691062,52289454,TNL
chr08,Bn34735,76819212,94754827,17935615,NBS
chr08,Bn34736,13051874,53830084,40778210,TNL
chr08,Bn34737,41931704,50862637,8930933,CN
chr08,Bn34738,26428210,40015213,13587003,TN
chr08,Bn34739,24355519,72795141,48439622,NBS
chr08,Bn34740,49582652,53640750,4058098,NBS
chr08,Bn34741,17218118,71628898,54410780,RLK
chr08,Bn34742,54158806,74369105,20210299,RLP
chr08,Bn34743,71100862,78475950,7375088,TN
chr08,Bn34744,99945159,99995656,50497,CN
chr08,Bn34745,61261434,78008693,16747259,RLK
chr08,Bn34746,33471656,45423126,11951470,RLK
chr08,Bn34747,76145577,89981460,13835883,CN
chr08,Bn34748,58032523,98145486,40112963,CN
chr08,Bn34749,59859713,62806175,2946462,CN
chr08,Bn34750,39757004,69397764,29640760,TN
chr08,Bn34751,70232874,80481883,10249009,TN
chr08,Bn34752,57026995,62880513,5853518,RLP
chr08,Bn34753,77383150,97150323,19767173,TN
chr08,Bn34754,34933105,74368299,39435194,CNL
chr08,Bn34755,77495491,98093238,20597747,RLK
chr08,Bn34756,73997984,92874973,18876989,NBS
chr08,Bn34757,50640066,59540721,8900655,TNL
chr08,Bn34758,95299041,95611721,312680,TNL
chr08,Bn34759,83781348,85048146,1266798,RLK
chr08,Bn34760,71031474,90866136,19834662,CN
chr08,Bn34761,87273431,98808128,11534697,TNL
chr08,Bn34762,68118100,76152321,8034221,RLK
chr08,Bn34763,36791201,74203950,37412749,TNL
chr08,Bn34764,66118546,74012062,7893516,CN
chr08,Bn34765,80856781,95967349,15110568,RLK
chr08,Bn34766,90879008,92175016,1296008,RLP
chr08,Bn34767,70025383,93847079,23821696,RLP
chr08,Bn34768,95157969,96881088,1723119,CN
chr08,Bn34769,66567767,72343787,5776020,CN
chr08,Bn34770,90608587,94343720,3735133,TN
chr08,Bn34771,62486400,94861469,32375069,CNL
chr08,Bn34772,40141266,84674965,44533699,NBS
chr08,Bn34773,93633836,97221046,3587210,TN
chr08,Bn34774,91783218,94502960,2719742,CN
chr08,Bn34775,10582940,47555387,36972447,CN
chr08,Bn34776,56713492,72517372,15803880,TNL
chr08,Bn34777,50123862,55973920,5850058,TN
chr08,Bn34778,25462609,67659065,42196456,RLP
chr08,Bn34779,3575556,92857010,89281454,NBS
chr08,Bn34780,23832430,75037965,51205535,RLP
chr08,Bn34781,89976930,90459524,482594,TN
chr08,Bn34782,89956702,95531978,5575276,NBS
chr08,Bn34783,29500374,60600711,31100337,RLK
chr08,Bn34784,76314295,87556888,11242593,CN
chr08,Bn34785,67953301,71417906,3464605,CN
chr08,Bn34786,30164844,57476954,27312110,RLK
chr08,Bn34787,89620991,90454153,833162,RLK
chr08,Bn34788,25302094,70779706,45477612,RLP
chr08,Bn34789,10942564,41442794,30500230,TN
chr08,Bn34790,29173713,80498196,51324483,TNL
chr08,Bn34791,48249524,54796848,6547324,CN
chr08,Bn34792,96076697,99251942,3175245,RLP
chr08,Bn34793,16518351,86290609,69772258,CNL
chr08,Bn34794,44280086,89165082,44884996,TN
chr08,Bn34795,72816972,82071835,9254863,RLP
chr08,Bn34796,1365484,58267534,56902050,CNL
chr08,Bn34797,80561267,87666781,7105514,RLP
chr08,Bn34798,84187233,98615902,14428669,CNL
chr08,Bn34799,99037187,99909166,871979,RLK
chr08,Bn34800,42710876,61422543,18711667,TN
chr08,Bn34801,55640416,96843275,41202859,TNL
chr08,Bn34802,23022102,52742194,29720092,CNL
chr08,Bn34803,1256167,64136462,62880295,TN
chr08,Bn34804,6223883,26826650,20602767,TNL
chr08,Bn34805,98253287,98884574,631287,RLP
chr08,Bn34806,99981007,99984177,3170,NBS
chr08,Bn34807,47397047,80898556,33501509,CN
chr08,Bn34808,95990069,96741536,751467,NBS
chr08,Bn34809,16281254,53811120,37529866,TNL
chr08,Bn34810,52353456,85103072,32749616,NBS
chr08,Bn34811,17014369,35607385,18593016,TN
chr08,Bn34812,48931930,50070035,1138105,TN
chr08,Bn34813,83814805,96567300,12752495,NBS
chr08,Bn34814,16235173,50999551,34764378,RLK
chr08,Bn34815,50540659,66253532,15712873,CN
chr08,Bn34816,44048921,82325832,38276911,TNL
chr08,Bn34817,99958684,99966383,7699,RLP
chr08,Bn34818,40747091,98075656,57328565,TN
chr08,Bn34819,30493819,56654114,26160295,CNL
chr08,Bn34820,78191744,96286817,18095073,NBS
chr08,Bn34821,67044777,89640907,22596130,RLK
chr08,Bn34822,15801915,70605806,54803891,TNL
chr08,Bn34823,78746633,91120941,12374308,RLP
chr08,Bn34824,74366121,74918826,552705,RLK
chr08,Bn34825,51334949,79397056,28062107,NBS
chr08,Bn34826,83517171,92028932,8511761,RLP
chr08,Bn34827,49626147,71524986,21898839,TN
chr08,Bn34828,15046997,16363667,1316670,RLK
chr08,Bn34829,22688089,73887796,51199707,TN
chr08,Bn34830,58717340,61916514,3199174,CN
chr08,Bn34831,32118318,70554095,38435777,CNL
chr08,Bn34832,94438824,99958911,5520087,CNL
chr08,Bn34833,70287362,73055834,2768472,RLK
chr08,Bn34834,87620581,96023898,8403317,NBS
chr08,Bn34835,71824392,97639915,25815523,TNL
chr08,Bn34836,23243439,52723653,29480214,CN
chr08,Bn34837,36706791,37275879,569088,TN
chr08,Bn34838,6710031,30692772,23982741,RLP
chr08,Bn34839,96387679,96459951,72272,TN
chr08,Bn34840,4862158,74663035,69800877,RLP
chr08,Bn34841,5579654,87743152,82163498,TN
chr08,Bn34842,24975326,68953832,43978506,RLP
chr08,Bn34843,29549728,70388750,40839022,CNL
chr08,Bn34844,10603807,62316859,51713052,NBS
chr08,Bn34845,33901162,37957894,4056732,TNL
chr08,Bn34846,18847411,90616061,71768650,TNL
chr08,Bn34847,54209932,89654298,35444366,RLP
chr08,Bn34848,88383563,96762603,8379040,RLK
chr08,Bn34849,59185026,74655820,15470794,CNL
chr08,Bn34850,31362308,83363821,52001513,RLK
chr08,Bn34851,11651832,84550262,72898430,CNL
chr08,Bn34852,14099172,21282978,7183806,TNL
chr08,Bn34853,72621069,94994399,22373330,RLP
chr08,Bn34854,97247288,99223816,1976528,CNL
chr08,Bn34855,43228188,95296171,52067983,RLP
chr08,Bn34856,39320017,82559543,43239526,CNL
chr08,Bn34857,87625304,94829599,7204295,RLK
chr08,Bn34858,65505454,75142483,9637029,TNL
chr08,Bn34859,9684871,54743118,45058247,TNL
chr08,Bn34860,47765921,80585603,32819682,TNL
chr08,Bn34861,71378987,83031278,11652291,CNL
chr08,Bn34862,36523748,58945800,22422052,RLK
chr08,Bn34863,53970071,94190682,40220611,NBS
chr08,Bn34864,30803112,57997704,27194592,RLP
chr08,Bn34865,32371701,94413230,62041529,TNL
chr08,Bn34866,61185659,73330626,12144967,RLP
chr08,Bn34867,85820859,94883233,9062374,CN
chr08,Bn34868,10352357,73201243,62848886,RLK
chr08,Bn34869,71481233,72813453,1332220,CNL
chr08,Bn34870,14989254,43934540,28945286,CNL
chr08,Bn34871,33003821,89927820,56923999,RLP
chr08,Bn34872,4138323,69676847,65538524,CNL
chr08,Bn34873,90269875,94244887,3975012,TNL
chr08,Bn34874,71849354,86812724,14963370,CN
chr08,Bn34875,53047058,85197462,32150404,CNL
chr08,Bn34876,86002083,96084801,10082718,TNL
chr08,Bn34877,48211460,60972242,12760782,TN
chr08,Bn34878,73979668,99182451,25202783,TNL
chr08,Bn34879,93698787,97672859,3974072,NBS
chr08,Bn34880,57468392,77545412,20077020,TNL
chr08,Bn34881,93730773,94781563,1050790,CN
chr08,Bn34882,34983765,67092821,32109056,RLK
chr08,Bn34883,73911548,84183641,10272093,TN
chr08,Bn34884,82579503,96001575,13422072,RLK
chr08,Bn34885,12009595,76981356,64971761,NBS
chr08,Bn34886,76821727,92554769,15733042,TN
chr08,Bn34887,74019953,90824566,16804613,CN
chr08,Bn34888,6349288,29962366,23613078,CNL
chr08,Bn34889,42680852,91890876,49210024,CN
chr08,Bn34890,38239078,55039045,16799967,RLK
chr08,Bn34891,37058769,97762860,60704091,CN
chr08,Bn34892,84782072,85860271,1078199,CNL
chr08,Bn34893,38701111,53515076,14813965,TNL
chr08,Bn34894,14018817,79299849,65281032,NBS
chr08,Bn34895,10104122,14267671,4163549,TNL
chr08,Bn34896,52831337,81130469,28299132,CNL
chr08,Bn34897,6324522,12691073,6366551,RLP
chr08,Bn34898,88010717,88717505,706788,RLP
chr08,Bn34899,34242683,36695620,2452937,TN
chr08,Bn34900,87763511,93663554,5900043,RLK
chr08,Bn34901,58607089,86439301,27832212,TNL
chr08,Bn34902,90701347,99875454,9174107,CNL
chr08,Bn34903,37259060,85426946,48167886,CNL
chr08,Bn34904,82772563,96885554,14112991,RLK
chr08,Bn34905,14542889,15151412,608523,TN
chr08,Bn34906,42766537,73973919,31207382,TNL
chr08,Bn34907,90084300,97042105,6957805,RLP
chr08,Bn34908,81929964,82164564,234600,TNL
chr08,Bn34909,13821448,39305406,25483958,TN
chr08,Bn34910,31984931,97133704,65148773,TNL
chr08,Bn34911,42790180,73193224,30403044,RLK
chr08,Bn34912,81090640,93508553,12417913,RLK
chr08,Bn34913,91246313,94850814,3604501,RLK
chr08,Bn34914,48897961,66383506,17485545,TNL
chr08,Bn34915,14557923,67442042,52884119,TNL
chr08,Bn34916,80992480,88157675,7165195,NBS
chr08,Bn34917,28464820,42315152,13850332,RLK
chr08,Bn34918,38855698,75928751,37073053,RLP
chr08,Bn34919,90613383,91045577,432194,RLP
chr08,Bn34920,40212143,67433187,27221044,TN
chr08,Bn34921,67763886,84971501,17207615,CN
chr08,Bn34922,12917608,49071348,36153740,CN
chr08,Bn34923,11531559,66187069,54655510,TNL
chr08,Bn34924,32580096,78483328,45903232,TNL
chr08,Bn34925,50454119,80264304,29810185,CN
chr08,Bn34926,73686741,91260876,17574135,TNL
chr08,Bn34927,88784108,92317267,3533159,CN
chr08,Bn34928,98639108,99278401,639293,CN
chr08,Bn34929,69451164,96805797,27354633,TNL
chr08,Bn34930,68447124,72592098,4144974,CNL
chr08,Bn34931,5856891,50007776,44150885,CN
chr08,Bn34932,53795362,56829298,3033936,TN
chr08,Bn34933,75766843,85043302,9276459,TNL
chr08,Bn34934,98016183,98654594,638411,RLP
chr08,Bn34935,97033535,97929954,896419,RLK
chr08,Bn34936,53213097,95777926,42564829,TNL
chr08,Bn34937,21700513,49063260,27362747,TN
chr08,Bn34938,50241152,52161931,1920779,NBS
chr08,Bn34939,48962085,96912607,47950522,RLK
chr08,Bn34940,79814085,92596450,12782365,NBS
chr08,Bn34941,14366255,33423668,19057413,TNL
chr08,Bn34942,84190668,90918139,6727471,RLK
chr08,Bn34943,43244875,72853894,29609019,RLP
chr08,Bn34944,85358112,94127532,8769420,RLK
chr08,Bn34945,78476972,84036688,5559716,CN
chr08,Bn34946,19608508,99789482,80180974,RLP
chr08,Bn34947,44394740,58516668,14121928,TN
chr08,Bn34948,52596131,90118301,37522170,RLK
chr08,Bn34949,21494217,50068801,28574584,NBS
chr08,Bn34950,78031664,86385245,8353581,CNL
chr08,Bn34951,86779377,92554228,5774851,NBS
chr08,Bn34952,76308449,85149455,8841006,TNL
chr08,Bn34953,25288390,65769109,40480719,RLK
chr08,Bn34954,44253513,72321767,28068254,TN
chr08,Bn34955,69072752,69461624,388872,TNL
chr08,Bn34956,50943416,72643211,21699795,TNL
chr08,Bn34957,51662691,77789243,26126552,CN
chr08,Bn34958,47882610,73457468,25574858,CNL
chr08,Bn34959,9567628,10378549,810921,TNL
chr08,Bn34960,57601608,77438366,19836758,TN
chr08,Bn34961,60219114,81038247,20819133,TN
chr08,Bn34962,95687003,99803069,4116066,NBS
chr08,Bn34963,16625075,48507170,31882095,CNL
chr08,Bn34964,8787768,57982546,49194778,CN
chr08,Bn34965,55392350,85356312,29963962,CN
chr08,Bn34966,78908070,87186683,8278613,RLP
chr08,Bn34967,38221513,91757679,53536166,NBS
chr08,Bn34968,43541763,79044953,35503190,NBS
chr08,Bn34969,98937602,99622482,684880,NBS
chr08,Bn34970,74302780,91535550,17232770,CNL
chr08,Bn34971,50225540,89109062,38883522,RLK
chr08,Bn34972,30119164,44974160,14854996,TN
chr08,Bn34973,63697227,64986187,1288960,RLK
chr08,Bn34974,63974259,86944498,22970239,CNL
chr08,Bn34975,81631050,99966731,18335681,RLP
chr08,Bn34976,6172201,96957698,90785497,CN
chr08,Bn34977,25563145,26730585,1167440,RLK
chr08,Bn34978,72492407,91825298,19332891,CNL
chr08,Bn34979,20999981,67911542,46911561,CN
chr08,Bn34980,74976878,98550671,23573793,RLK
chr08,Bn34981,4855665,93641908,88786243,CN
chr08,Bn34982,62522747,76911758,14389011,TNL
chr08,Bn34983,58282119,71012279,12730160,CN
chr08,Bn34984,14457050,15759234,1302184,RLP
chr08,Bn34985,11476843,94900994,83424151,CNL
chr08,Bn34986,41749056,41822395,73339,RLP
chr08,Bn34987,88489325,96381347,7892022,RLK
chr08,Bn34988,46657260,84434915,37777655,CNL
chr08,Bn34989,54904020,63476833,8572813,TN
chr08,Bn34990,62631390,70428475,7797085,RLP
chr08,Bn34991,55438042,97920422,42482380,RLP
chr08,Bn34992,83853598,96978683,13125085,CNL
chr08,Bn34993,89506510,98889299,9382789,CNL
chr08,Bn34994,16945016,87507621,70562605,NBS
chr08,Bn34995,28761666,39818032,11056366,CNL
chr08,Bn34996,94579024,96241591,1662567,RLK
chr08,Bn34997,57576710,60570876,2994166,NBS
chr08,Bn34998,26776267,59690165,32913898,TNL
chr08,Bn34999,61354727,84262711,22907984,CN
chr08,Bn35000,29912518,98322336,68409818,TN
chr08,Bn35001,21155393,45111273,23955880,RLK
chr08,Bn35002,68106942,95338599,27231657,TNL
chr08,Bn35003,55792234,60437978,4645744,TNL
chr08,Bn35004,57189500,94287204,37097704,CNL
chr08,Bn35005,70564832,71432323,867491,RLK
chr08,Bn35006,87787924,89764662,1976738,RLP
chr08,Bn35007,27256303,85630322,58374019,RLK
chr08,Bn35008,43148721,56483859,13335138,CNL
chr08,Bn35009,19458938,95875105,76416167,TNL
chr08,Bn35010,63645411,79406578,15761167,NBS
chr08,Bn35011,2973642,41087877,38114235,CN
chr08,Bn35012,66017849,69962185,3944336,CNL
chr08,Bn35013,61310186,95478819,34168633,CNL
chr08,Bn35014,79334279,83078832,3744553,RLK
chr08,Bn35015,50775332,84912338,34137006,RLP
chr08,Bn35016,63252205,77244292,13992087,RLK
chr08,Bn35017,27123463,43652822,16529359,NBS
chr08,Bn35018,17357665,18073082,715417,RLP
chr08,Bn35019,27855623,44896296,17040673,TN
chr08,Bn35020,59821435,69088574,9267139,TNL
chr08,Bn35021,85230655,96987420,11756765,TNL
chr08,Bn35022,81544354,87613426,6069072,TNL
chr08,Bn35023,45081213,70427417,25346204,NBS
chr08,Bn35024,74537511,88841899,14304388,RLP
chr08,Bn35025,34469639,49387796,14918157,CN
chr08,Bn35026,34557395,67469499,32912104,NBS
chr08,Bn35027,90518847,93273722,2754875,TN
chr08,Bn35028,99259681,99290719,31038,TN
chr08,Bn35029,73815298,82715573,8900275,RLP
chr08,Bn35030,47659375,56735707,9076332,TNL
chr08,Bn35031,75183488,93084001,17900513,TNL
chr08,Bn35032,43106824,76915857,33809033,TN
chr08,Bn35033,15485360,72600250,57114890,NBS
chr08,Bn35034,88438134,90665711,2227577,NBS
chr08,Bn35035,37909481,85876488,47967007,RLP
chr08,Bn35036,26745544,68775089,42029545,NBS
chr08,Bn35037,58448857,87534307,29085450,RLK
chr08,Bn35038,16650955,45273921,28622966,NBS
chr08,Bn35039,79841014,92694653,12853639,CN
chr08,Bn35040,12747092,54631727,41884635,TNL
chr08,Bn35041,21963647,95800992,73837345,RLK
chr08,Bn35042,89451030,99547393,10096363,CN
chr08,Bn35043,85909530,89947554,4038024,CN
chr08,Bn35044,12705494,39480347,26774853,CN
chr08,Bn35045,35303545,73024525,37720980,TN
chr08,Bn35046,16969864,74092627,57122763,TN
chr08,Bn35047,1339671,38407901,37068230,CN
chr08,Bn35048,42374355,50032657,7658302,CNL
chr08,Bn35049,12422679,73806440,61383761,NBS
chr08,Bn35050,29763626,95083874,65320248,TNL
chr08,Bn35051,3298107,97212554,93914447,NBS
chr08,Bn35052,64167712,68275436,4107724,RLK
chr08,Bn35053,58499688,63891803,5392115,CNL
chr08,Bn35054,50438446,94308762,43870316,TNL
chr08,Bn35055,25595199,78346579,52751380,TN
chr08,Bn35056,21492298,93649993,72157695,RLK
chr08,Bn35057,52994356,56343180,3348824,NBS
chr08,Bn35058,80814869,90972054,10157185,TN
chr08,Bn35059,22534968,54276955,31741987,RLK
chr08,Bn35060,86011636,87716984,1705348,TNL
chr08,Bn35061,48585172,84520704,35935532,NBS
chr08,Bn35062,90302090,95536747,5234657,TN
chr08,Bn35063,46916648,62935096,16018448,TN
chr08,Bn35064,67102207,97997459,30895252,TNL
chr08,Bn35065,68290529,68803435,512906,TNL
chr08,Bn35066,31668724,36257522,4588798,RLP
chr08,Bn35067,5133850,99567919,94434069,CN
chr08,Bn35068,84874768,89700621,4825853,TNL
chr08,Bn35069,13559093,18693730,5134637,TNL
chr08,Bn35070,91337624,95884246,4546622,TN
chr08,Bn35071,17498194,90492365,72994171,RLP
chr08,Bn35072,2141183,65406563,63265380,TNL
chr08,Bn35073,73528452,78667735,5139283,CN
chr08,Bn35074,83957135,96557349,12600214,TNL
chr08,Bn35075,1757171,96614373,94857202,CNL
chr08,Bn35076,44812346,61641051,16828705,TN
chr08,Bn35077,32132196,65274794,33142598,TNL
chr08,Bn35078,47701504,90003465,42301961,TNL
chr08,Bn35079,74594633,85395679,10801046,CN
chr08,Bn35080,37497745,93757938,56260193,CNL
chr08,Bn35081,49686941,59907568,10220627,NBS
chr08,Bn35082,92485709,99929007,7443298,RLK
chr08,Bn35083,75958550,98481207,22522657,TNL
chr08,Bn35084,85731695,96224652,10492957,RLP
chr08,Bn35085,76299361,99807794,23508433,RLP
chr08,Bn35086,71737600,84113177,12375577,CNL
chr08,Bn35087,83891358,89754134,5862776,RLP
chr08,Bn35088,56244182,61215439,4971257,RLP
chr08,Bn35089,47208484,54086377,6877893,NBS
chr08,Bn35090,54405191,76708690,22303499,NBS
chr08,Bn35091,49297544,59056088,9758544,TNL
chr08,Bn35092,58443329,77324215,18880886,RLP
chr08,Bn35093,83389295,85576849,2187554,CN
chr08,Bn35094,94597331,96875960,2278629,RLP
chr08,Bn35095,52847197,67356595,14509398,TNL
chr08,Bn35096,33392243,47876831,14484588,NBS
chr08,Bn35097,86934200,90904794,3970594,TN
chr08,Bn35098,43460785,69066071,25605286,CNL
chr08,Bn35099,72087887,98239172,26151285,CN
chr08,Bn35100,1964888,18705618,16740730,CNL
chr08,Bn35101,22774932,28468471,5693539,TN
chr08,Bn35102,84685654,86084084,1398430,TNL
chr08,Bn35103,78759744,93984898,15225154,CN
chr08,Bn35104,88592713,88643873,51160,NBS
chr08,Bn35105,48364667,79044766,30680099,CN
chr08,Bn35106,69938818,76882455,6943637,CN
chr08,Bn35107,45719240,51746691,6027451,RLP
chr08,Bn35108,43913426,72717676,28804250,NBS
chr08,Bn35109,78581168,99095614,20514446,CNL
chr08,Bn35110,49243584,98129015,48885431,RLP
chr08,Bn35111,40839882,41261668,421786,CNL
chr08,Bn35112,82485453,95533925,13048472,CN
chr08,Bn35113,77419265,96247029,18827764,TN
chr08,Bn35114,48676975,49422183,745208,RLP
chr08,Bn35115,69078899,96870904,27792005,RLP
chr08,Bn35116,48267802,81601128,33333326,NBS
chr08,Bn35117,19602595,54196790,34594195,TN
chr08,Bn35118,22136333,64026740,41890407,TN
chr08,Bn35119,93365014,97206395,3841381,RLK
chr08,Bn35120,87172817,93908285,6735468,RLP
chr08,Bn35121,31564846,58431639,26866793,TNL
chr08,Bn35122,96158578,98496611,2338033,TN
chr08,Bn35123,79360831,97745793,18384962,CNL
chr08,Bn35124,38687083,97074976,58387893,RLK
chr08,Bn35125,67915189,90032810,22117621,CNL
chr08,Bn35126,60039831,98274578,38234747,TNL
chr08,Bn35127,63592461,84647228,21054767,TN
chr08,Bn35128,26811485,43235369,16423884,CNL
chr08,Bn35129,61372478,85156594,23784116,TN
chr08,Bn35130,5577132,32011716,26434584,RLP
chr08,Bn35131,21182131,38799474,17617343,CN
chr08,Bn35132,5544948,62623983,57079035,CNL
chr08,Bn35133,78856040,81240928,2384888,CNL
chr08,Bn35134,82636717,93631764,10995047,TNL
chr08,Bn35135,57975121,98840524,40865403,CNL
chr08,Bn35136,82133269,96576879,14443610,CNL
chr08,Bn35137,29205810,78637071,49431261,CNL
chr08,Bn35138,1006975,27216000,26209025,CN
chr08,Bn35139,34908467,87801511,52893044,RLK
chr08,Bn35140,13739368,62301803,48562435,RLP
chr08,Bn35141,28867448,35843357,6975909,NBS
chr08,Bn35142,87358181,96046502,8688321,RLP
chr08,Bn35143,27570083,99867335,72297252,RLK
chr08,Bn35144,17250382,41982139,24731757,RLK
chr08,Bn35145,44064497,46534653,2470156,CNL
chr08,Bn35146,63990257,84536782,20546525,CN
chr08,Bn35147,30201268,85545127,55343859,RLP
chr08,Bn35148,9736988,43219792,33482804,CN
chr08,Bn35149,63344300,70636640,7292340,RLP
chr08,Bn35150,21393181,58176120,36782939,CN
chr08,Bn35151,54155883,80886296,26730413,CN
chr08,Bn35152,58193040,83648516,25455476,RLK
chr08,Bn35153,80994907,97823668,16828761,TNL
chr08,Bn35154,5375019,26084506,20709487,CNL
chr08,Bn35155,83104717,86157352,3052635,RLK
chr08,Bn35156,58474274,70314257,11839983,CN
chr08,Bn35157,23004814,54908023,31903209,CNL
chr08,Bn35158,75583265,89593195,14009930,CNL
chr08,Bn35159,79788798,92970001,13181203,CNL
chr08,Bn35160,60362844,98145360,37782516,TN
chr08,Bn35161,3549977,89417605,85867628,RLP
chr08,Bn35162,9990934,16565485,6574551,CN
chr08,Bn35163,19356370,44114583,24758213,RLK
chr08,Bn35164,28889505,73772770,44883265,RLK
chr08,Bn35165,56551783,74591367,18039584,TNL
chr08,Bn35166,42675196,83861852,41186656,TNL
chr08,Bn35167,54608596,94196759,39588163,RLK
chr08,Bn35168,94922048,96363700,1441652,TN
chr08,Bn35169,99095208,99660950,565742,CN
chr08,Bn35170,52386354,78232601,25846247,CN
chr08,Bn35171,9393448,77735073,68341625,NBS
chr08,Bn35172,70686576,93156270,22469694,CNL
chr08,Bn35173,83562803,99165412,15602609,RLP
chr08,Bn35174,6454442,53849438,47394996,NBS
chr08,Bn35175,38915198,50104719,11189521,RLK
chr08,Bn35176,30932895,76802191,45869296,CN
chr08,Bn35177,60787092,61480905,693813,TN
chr08,Bn35178,5597370,74116147,68518777,TNL
chr08,Bn35179,93130284,99116441,5986157,CN
chr08,Bn35180,75547041,99833919,24286878,TN
chr08,Bn35181,76358981,80527346,4168365,TN
chr08,Bn35182,37207696,38296522,1088826,NBS
chr08,Bn35183,78521832,83728206,5206374,CNL
chr08,Bn35184,6589190,10127783,3538593,TN
chr08,Bn35185,97623516,97671628,48112,TN
chr08,Bn35186,49568277,94258693,44690416,TNL
chr08,Bn35187,30447039,48033919,17586880,RLK
chr08,Bn35188,86539449,88456324,1916875,RLP
chr08,Bn35189,71733577,72220551,486974,RLP
chr08,Bn35190,55270703,77877312,22606609,RLK
chr08,Bn35191,38198677,75917360,37718683,CN
chr08,Bn35192,43348927,71837810,28488883,CNL
chr08,Bn35193,26932553,98135116,71202563,CN
chr08,Bn35194,47269917,70127979,22858062,TNL
chr08,Bn35195,67054826,77172176,10117350,TN
chr08,Bn35196,36329818,69212816,32882998,RLP
chr08,Bn35197,48446015,95644487,47198472,TNL
chr08,Bn35198,99753400,99866189,112789,RLP
chr08,Bn35199,40670599,67198042,26527443,TN
chr08,Bn35200,42140716,72896779,30756063,TNL
chr08,Bn35201,23024650,57690576,34665926,TNL
chr08,Bn35202,17238543,40199725,22961182,RLK
chr08,Bn35203,61318313,65164991,3846678,NBS
chr08,Bn35204,72726898,82617143,9890245,TNL
chr08,Bn35205,91483159,95211491,3728332,NBS
chr08,Bn35206,1210664,95792765,94582101,RLP
chr08,Bn35207,52772207,63799491,11027284,TNL
chr08,Bn35208,68030657,85414184,17383527,NBS
chr08,Bn35209,92363398,97485884,5122486,NBS
chr08,Bn35210,11850263,87948164,76097901,TNL
chr08,Bn35211,8814716,39199414,30384698,CNL
chr08,Bn35212,40010348,75439803,35429455,TN
chr08,Bn35213,86159698,96106547,9946849,CNL
chr08,Bn35214,81227181,94575530,13348349,NBS
chr08,Bn35215,62744649,71323932,8579283,NBS
chr08,Bn35216,62287645,81447311,19159666,CNL
chr08,Bn35217,45899251,76210105,30310854,NBS
chr08,Bn35218,37299293,72158581,34859288,RLK
chr08,Bn35219,11934368,93561880,81627512,NBS
chr08,Bn35220,40193737,93641213,53447476,RLP
chr08,Bn35221,49465304,66546478,17081174,RLP
chr08,Bn35222,40983026,78110010,37126984,CNL
chr08,Bn35223,1836917,20058322,18221405,TNL
chr08,Bn35224,72665775,92282169,19616394,RLK
chr08,Bn35225,41323152,46314167,4991015,NBS
chr08,Bn35226,59680419,81029163,21348744,RLK
chr08,Bn35227,32471515,78245577,45774062,TNL
chr08,Bn35228,55023302,93215224,38191922,CNL
chr08,Bn35229,51873734,78651402,26777668,RLK
chr08,Bn35230,85480212,95493643,10013431,CN
chr08,Bn35231,99341856,99461651,119795,TN
chr08,Bn35232,86737569,96354559,9616990,RLP
chr08,Bn35233,49422413,50516447,1094034,TN
chr08,Bn35234,75878707,86368235,10489528,RLK
chr08,Bn35235,52684953,65043429,12358476,CNL
chr08,Bn35236,27037011,71163352,44126341,NBS
chr08,Bn35237,23897270,61416993,37519723,CN
chr08,Bn35238,9457890,92051654,82593764,RLP
chr08,Bn35239,7774259,73850766,66076507,NBS
chr08,Bn35240,55885868,69707785,13821917,NBS
chr08,Bn35241,55114365,66028653,10914288,NBS
chr08,Bn35242,56272173,77447140,21174967,RLK
chr08,Bn35243,14977819,83689272,68711453,TNL
chr08,Bn35244,74608382,83277143,8668761,CN
chr08,Bn35245,27914431,47398077,19483646,CN
chr08,Bn35246,71045165,86568433,15523268,NBS
chr08,Bn35247,25419691,73762815,48343124,RLP
chr08,Bn35248,68174224,72886283,4712059,RLP
chr08,Bn35249,80477952,82181873,1703921,RLP
chr08,Bn35250,25627043,37663013,12035970,CN
chr08,Bn35251,12009518,68869952,56860434,RLP
chr08,Bn35252,40163935,80139434,39975499,NBS
chr08,Bn35253,58568174,96434896,37866722,CN
chr08,Bn35254,26761017,59531782,32770765,TNL
chr08,Bn35255,78407016,78610613,203597,TN
chr08,Bn35256,12492418,64521835,52029417,RLK
chr08,Bn35257,52361203,57251419,4890216,RLK
chr08,Bn35258,21529688,71159114,49629426,CN
chr08,Bn35259,48297664,76073161,27775497,CN
chr08,Bn35260,54269359,86396499,32127140,CNL
chr08,Bn35261,58761026,96717256,37956230,CNL
chr08,Bn35262,20855766,49289623,28433857,CN
chr08,Bn35263,44062751,68735102,24672351,RLK
chr08,Bn35264,99488590,99543193,54603,TN
chr08,Bn35265,99083939,99463657,379718,RLP
chr08,Bn35266,48800939,79315701,30514762,TN
chr08,Bn35267,52500022,52722056,222034,CNL
chr08,Bn35268,93767811,95515265,1747454,TNL
chr08,Bn35269,22597694,50105516,27507822,TNL
chr08,Bn35270,63621071,84326269,20705198,RLK
chr08,Bn35271,24726243,37024652,12298409,RLP
chr08,Bn35272,13976886,82672405,68695519,NBS
chr08,Bn35273,53456462,89138156,35681694,CNL
chr08,Bn35274,31508839,83023758,51514919,TN
chr08,Bn35275,57934226,61519281,3585055,RLK
chr08,Bn35276,34299658,52449345,18149687,RLP
chr08,Bn35277,75587479,86547707,10960228,CNL
chr08,Bn35278,21413966,87714967,66301001,CNL
chr08,Bn35279,49723730,53195687,3471957,CNL
chr08,Bn35280,9217749,51644707,42426958,NBS
chr08,Bn35281,47212585,91941085,44728500,RLK
chr08,Bn35282,11175791,91694746,80518955,RLP
chr08,Bn35283,50499430,67169761,16670331,TNL
chr08,Bn35284,26102974,46919420,20816446,CN
chr08,Bn35285,10186944,55967456,45780512,CN
chr08,Bn35286,30823212,90212548,59389336,CN
chr08,Bn35287,82665479,92903635,10238156,CN
chr08,Bn35288,38238611,43138498,4899887,RLK
chr08,Bn35289,23927530,30115890,6188360,RLK
chr08,Bn35290,71536471,76001554,4465083,RLP
chr08,Bn35291,7190310,81828849,74638539,CNL
chr08,Bn35292,73504046,87229809,13725763,RLP
chr08,Bn35293,90019188,92650801,2631613,TN
chr08,Bn35294,50036891,80657254,30620363,RLK
chr08,Bn35295,44271602,55994061,11722459,CNL
chr08,Bn35296,79362494,98664633,19302139,CN
chr08,Bn35297,89040351,93716181,4675830,TN
chr08,Bn35298,42327353,99694948,57367595,NBS
chr08,Bn35299,37830052,42481059,4651007,NBS
chr08,Bn35300,85947225,90250446,4303221,RLP
chr08,Bn35301,82734331,97508976,14774645,RLK
chr08,Bn35302,27154487,61633163,34478676,CN
chr08,Bn35303,68916962,70999507,2082545,CNL
chr08,Bn35304,93731448,97784951,4053503,NBS
chr08,Bn35305,88192037,92853416,4661379,TN
chr08,Bn35306,9230091,92100850,82870759,TNL
chr08,Bn35307,90337454,97541804,7204350,CNL
chr08,Bn35308,13492186,55425074,41932888,TN
chr08,Bn35309,13370264,67179294,53809030,CN
chr08,Bn35310,33013766,65685610,32671844,NBS
chr08,Bn35311,13947970,54309360,40361390,TNL
chr08,Bn35312,51794204,56331547,4537343,CN
chr08,Bn35313,69933698,92881061,22947363,RLK
chr08,Bn35314,85669224,90617488,4948264,NBS
chr08,Bn35315,51122120,73691378,22569258,TN
chr08,Bn35316,71274687,96417939,25143252,TN
chr08,Bn35317,79173149,90648802,11475653,CN
chr08,Bn35318,68226588,90965871,22739283,TNL
chr08,Bn35319,32922500,51856899,18934399,RLP
chr08,Bn35320,81920973,97579384,15658411,RLK
chr08,Bn35321,29352888,89452132,60099244,CNL
chr08,Bn35322,27954839,80476830,52521991,CN
chr08,Bn35323,47720072,77330361,29610289,TN
chr08,Bn35324,53947985,67706820,13758835,RLP
chr08,Bn35325,75547966,85144143,9596177,TNL
chr08,Bn35326,52289820,72803329,20513509,RLK
chr08,Bn35327,67622871,75979185,8356314,CNL
chr08,Bn35328,23085279,92358055,69272776,NBS
chr08,Bn35329,85445370,89417823,3972453,RLK
chr08,Bn35330,61287228,91542494,30255266,NBS
chr08,Bn35331,8359462,61334866,52975404,RLP
chr08,Bn35332,36601638,79125320,42523682,TN
chr08,Bn35333,38557520,75551663,36994143,RLK
chr08,Bn35334,68176819,78294543,10117724,CN
chr08,Bn35335,58990412,78649778,19659366,CN
chr08,Bn35336,3703735,73523095,69819360,RLP
chr08,Bn35337,16076282,61260050,45183768,TNL
chr08,Bn35338,28094498,48150907,20056409,CN
chr08,Bn35339,24632168,25071505,439337,TN
chr08,Bn35340,19899549,34450351,14550802,NBS
chr08,Bn35341,91074921,95336784,4261863,TN
chr08,Bn35342,31919327,77470632,45551305,RLK
chr08,Bn35343,25137561,78974060,53836499,RLP
chr08,Bn35344,23061128,70131074,47069946,NBS
chr08,Bn35345,75977913,91252992,15275079,TNL
chr08,Bn35346,29703890,70797195,41093305,TN
chr08,Bn35347,81327733,82336820,1009087,TNL
chr08,Bn35348,78298958,82165087,3866129,NBS
chr08,Bn35349,35444941,72197871,36752930,CN
chr08,Bn35350,16616636,57183664,40567028,TNL
chr08,Bn35351,74351122,77204463,2853341,TNL
chr08,Bn35352,5073542,45021159,39947617,CN
chr08,Bn35353,95716825,99129126,3412301,RLK
chr08,Bn35354,74258697,77642692,3383995,TNL
chr08,Bn35355,34575356,97219136,62643780,RLP
chr08,Bn35356,71098653,97546249,26447596,RLK
chr08,Bn35357,81560471,96727907,15167436,NBS
chr08,Bn35358,62211218,71799311,9588093,CN
chr08,Bn35359,16525438,54631592,38106154,NBS
chr08,Bn35360,28424840,66668537,38243697,NBS
chr08,Bn35361,37495141,44558393,7063252,NBS
chr08,Bn35362,64038552,81078926,17040374,TNL
chr08,Bn35363,65474310,80970170,15495860,CN
chr08,Bn35364,6312054,30844626,24532572,CN
chr08,Bn35365,93009626,98444976,5435350,NBS
chr08,Bn35366,25013186,35323627,10310441,TNL
chr08,Bn35367,55022993,66916583,11893590,CN
chr08,Bn35368,27842239,29240307,1398068,TNL
chr08,Bn35369,15762230,65055261,49293031,RLK
chr08,Bn35370,36801776,82786048,45984272,RLP
chr08,Bn35371,54217519,90648440,36430921,NBS
chr08,Bn35372,56680373,73855630,17175257,RLP
chr08,Bn35373,13610911,64886602,51275691,RLP
chr08,Bn35374,34993598,79435961,44442363,CN
chr08,Bn35375,76972723,99393550,22420827,TN
chr08,Bn35376,83825632,96641286,12815654,CNL
chr08,Bn35377,2246989,70562986,68315997,TN
chr08,Bn35378,54807355,98221772,43414417,CN
chr08,Bn35379,35943152,90072161,54129009,RLK
chr08,Bn35380,39683840,50184078,10500238,RLK
chr08,Bn35381,37365769,90682628,53316859,CNL
chr08,Bn35382,90476008,95543096,5067088,TNL
chr08,Bn35383,88964041,97783065,8819024,RLK
chr08,Bn35384,97315229,99244998,1929769,NBS
chr08,Bn35385,71774604,81080792,9306188,TNL
chr08,Bn35386,7561922,76341962,68780040,RLP
chr08,Bn35387,28474307,61571765,33097458,RLP
chr08,Bn35388,93850593,95774598,1924005,RLK
chr08,Bn35389,36538395,57103806,20565411,CNL
chr08,Bn35390,98938942,99621590,682648,RLK
chr08,Bn35391,20432755,31294620,10861865,RLK
chr08,Bn35392,65504810,72757788,7252978,RLP
chr08,Bn35393,76007674,87297969,11290295,RLP
chr08,Bn35394,46163274,81160358,34997084,TN
chr08,Bn35395,16685111,59307212,42622101,CNL
chr08,Bn35396,22900865,85609019,62708154,RLK
chr08,Bn35397,22690227,79724195,57033968,RLP
chr08,Bn35398,11222213,41457730,30235517,NBS
chr08,Bn35399,66293339,80703170,14409831,CNL
chr08,Bn35400,20263224,99928612,79665388,CN
chr08,Bn35401,99052845,99741852,689007,CNL
chr08,Bn35402,90621231,99503651,8882420,CNL
chr08,Bn35403,9794099,40082080,30287981,TNL
chr08,Bn35404,98241944,99655577,1413633,TNL
chr08,Bn35405,29136020,66950177,37814157,CNL
chr08,Bn35406,85760855,97773890,12013035,TNL
chr08,Bn35407,45031536,70823511,25791975,RLP
chr08,Bn35408,3058956,76090853,73031897,NBS
chr08,Bn35409,37018029,54830312,17812283,TN
chr08,Bn35410,91587057,92977516,1390459,TN
chr08,Bn35411,9543088,99533154,89990066,NBS
chr08,Bn35412,90740086,95458542,4718456,RLK
chr08,Bn35413,47786671,98009655,50222984,CN
chr08,Bn35414,89304288,95143175,5838887,NBS
chr08,Bn35415,41220254,75142756,33922502,NBS
chr08,Bn35416,99187250,99736234,548984,RLP
chr08,Bn35417,78668469,99703372,21034903,CNL
chr08,Bn35418,24494138,30443295,5949157,TNL
chr08,Bn35419,28222094,70737733,42515639,CN
chr08,Bn35420,71440456,84533289,13092833,RLK
chr08,Bn35421,28122798,74102414,45979616,CN
chr08,Bn35422,12978322,90669115,77690793,CNL
chr08,Bn35423,63763937,85309998,21546061,CN
chr08,Bn35424,71276423,73599941,2323518,NBS
chr08,Bn35425,28151570,42642450,14490880,NBS
chr08,Bn35426,20663204,78457672,57794468,NBS
chr08,Bn35427,92820186,99296937,6476751,RLK
chr08,Bn35428,77646240,80817264,3171024,RLK
chr08,Bn35429,74528980,78500029,3971049,NBS
chr08,Bn35430,55558656,59709338,4150682,RLP
chr08,Bn35431,69295720,79461885,10166165,CN
chr08,Bn35432,49272077,98987021,49714944,CNL
chr08,Bn35433,22923401,29043025,6119624,RLK
chr08,Bn35434,2439161,65208255,62769094,TN
chr08,Bn35435,59127629,85604262,26476633,TN
chr08,Bn35436,83846448,96360887,12514439,TNL
chr08,Bn35437,53464716,63111412,9646696,CN
chr08,Bn35438,10871762,11428439,556677,CNL
chr08,Bn35439,82244217,85366482,3122265,NBS
chr08,Bn35440,24715316,59138318,34423002,TN
chr08,Bn35441,7761572,77008404,69246832,TNL
chr08,Bn35442,50477092,75594370,25117278,RLK
chr08,Bn35443,37135855,57237352,20101497,NBS
chr08,Bn35444,91875412,99336586,7461174,CNL
chr08,Bn35445,91800753,99325293,7524540,CN
chr08,Bn35446,86787037,88260599,1473562,NBS
chr08,Bn35447,12762341,15667685,2905344,NBS
chr08,Bn35448,63212739,71783519,8570780,RLP
chr08,Bn35449,66740726,97448298,30707572,CN
chr08,Bn35450,16960197,44304285,27344088,RLP
chr08,Bn35451,99510383,99845955,335572,NBS
chr08,Bn35452,4858649,28107383,23248734,TNL
chr08,Bn35453,89321107,89645483,324376,NBS
chr08,Bn35454,94726135,96872539,2146404,RLK
chr08,Bn35455,34709355,87701476,52992121,CN
chr08,Bn35456,3261860,92486800,89224940,TN
chr08,Bn35457,3459911,61210130,57750219,TN
chr08,Bn35458,62271097,82308236,20037139,NBS
chr08,Bn35459,79041406,96402303,17360897,RLK
chr08,Bn35460,18273031,31569544,13296513,TN
chr08,Bn35461,50234764,75871448,25636684,CNL
chr08,Bn35462,84845270,87723987,2878717,CN
chr08,Bn35463,77227640,89074763,11847123,RLK
chr08,Bn35464,40265580,74845940,34580360,RLP
chr08,Bn35465,49842638,84691213,34848575,RLK
chr08,Bn35466,88030024,93367049,5337025,TN
chr08,Bn35467,11853649,85043115,73189466,TNL
chr08,Bn35468,21659777,36256687,14596910,CNL
chr08,Bn35469,54634140,92487044,37852904,RLP
chr08,Bn35470,75327336,78783494,3456158,RLK
chr08,Bn35471,72438532,75142558,2704026,TNL
chr08,Bn35472,60701885,93341454,32639569,CN
chr08,Bn35473,49478144,63747701,14269557,RLP
chr08,Bn35474,22034742,37362746,15328004,RLK
chr08,Bn35475,47436461,57351694,9915233,NBS
chr08,Bn35476,1486728,43187217,41700489,CNL
chr08,Bn35477,19236337,53162760,33926423,RLK
chr08,Bn35478,55255885,88766931,33511046,RLK
chr08,Bn35479,70559306,86946753,16387447,NBS
chr08,Bn35480,96328685,99611833,3283148,RLK
chr08,Bn35481,74795891,83759504,8963613,RLP
chr08,Bn35482,3944221,12681780,8737559,CNL
chr08,Bn35483,41162398,56856510,15694112,CNL
chr08,Bn35484,61947839,90739289,28791450,TN
chr08,Bn35485,51877157,61545649,9668492,CN
chr08,Bn35486,67576523,75907987,8331464,TN
chr08,Bn35487,82453663,97022396,14568733,CNL
chr08,Bn35488,17886997,79609203,61722206,RLP
chr08,Bn35489,1830383,73963563,72133180,TNL
chr08,Bn35490,24326497,40693779,16367282,RLK
chr08,Bn35491,3256009,28850525,25594516,RLP
chr08,Bn35492,23723420,47452359,23728939,TN
chr08,Bn35493,4804803,43585976,38781173,CN
chr08,Bn35494,48071881,57900148,9828267,TN
chr08,Bn35495,99990929,99999864,8935,TNL
chr08,Bn35496,18157169,61286400,43129231,NBS
chr08,Bn35497,95523551,95731240,207689,TN
chr08,Bn35498,62831584,79339092,16507508,NBS
chr08,Bn35499,29514239,44287268,14773029,TN
chr08,Bn35500,10659738,17047807,6388069,RLP
chr08,Bn35501,85302836,96019834,10716998,TNL
chr08,Bn35502,92242575,99776651,7534076,RLK
chr08,Bn35503,41149469,51239295,10089826,CN
chr08,Bn35504,55172673,56639151,1466478,TN
chr08,Bn35505,76595620,77456961,861341,CNL
chr08,Bn35506,95116095,96885425,1769330,RLP
chr08,Bn35507,78783730,86636922,7853192,CNL
chr08,Bn35508,37441071,48414333,10973262,CN
chr08,Bn35509,37376484,43926316,6549832,CNL
chr08,Bn35510,7730537,24824792,17094255,TN
chr08,Bn35511,3348881,61156461,57807580,CNL
chr08,Bn35512,70276721,91272143,20995422,TNL
chr08,Bn35513,77135983,91845899,14709916,RLP
chr08,Bn35514,96670825,99573210,2902385,CNL
chr08,Bn35515,82661566,95240827,12579261,TNL
chr08,Bn35516,15157932,16191049,1033117,CNL
chr08,Bn35517,91932908,95094516,3161608,TN
chr08,Bn35518,69103031,79339510,10236479,NBS
chr08,Bn35519,93447534,94623336,1175802,CNL
chr08,Bn35520,26076730,59953049,33876319,NBS
chr08,Bn35521,40835517,62860179,22024662,NBS
chr08,Bn35522,50055690,78652684,28596994,RLK
chr08,Bn35523,5692870,95654898,89962028,NBS
chr08,Bn35524,2383661,87540809,85157148,RLP
chr08,Bn35525,12439367,53311087,40871720,CN
chr08,Bn35526,48862611,78149293,29286682,TNL
chr08,Bn35527,58726196,74586147,15859951,RLP
chr08,Bn35528,51093047,72554492,21461445,CNL
chr08,Bn35529,58349391,74988821,16639430,RLP
chr08,Bn35530,24139299,95657784,71518485,NBS
chr08,Bn35531,24394397,58973735,34579338,RLK
chr08,Bn35532,50547269,82789721,32242452,RLK
chr08,Bn35533,81373664,92852957,11479293,TN
chr08,Bn35534,38320957,86686614,48365657,CNL
chr08,Bn35535,58702769,91682761,32979992,TN
chr08,Bn35536,29964937,97306536,67341599,CNL
chr08,Bn35537,18922325,52169256,33246931,TNL
chr08,Bn35538,39131057,64793183,25662126,RLK
chr08,Bn35539,94824070,98251618,3427548,CNL
chr08,Bn35540,52749920,57236684,4486764,TNL
chr08,Bn35541,51805827,71008078,19202251,CNL
chr08,Bn35542,38086796,78755957,40669161,TNL
chr08,Bn35543,37574238,82030633,44456395,NBS
chr08,Bn35544,26999021,61591494,34592473,TNL
chr08,Bn35545,92365296,98278475,5913179,NBS
chr08,Bn35546,78032164,79391365,1359201,CNL
chr08,Bn35547,78718549,90333995,11615446,CN
chr08,Bn35548,29383898,65858470,36474572,TNL
chr08,Bn35549,24373048,29570819,5197771,RLP
chr08,Bn35550,72357514,98851579,26494065,CNL
chr08,Bn35551,86008607,93791751,7783144,CN
chr08,Bn35552,38360767,90592250,52231483,RLP
chr08,Bn35553,6394486,15140448,8745962,CN
chr08,Bn35554,68492520,68905632,413112,TNL
chr08,Bn35555,36555813,45798121,9242308,CNL
chr08,Bn35556,93450383,93618321,167938,TNL
chr08,Bn35557,88769300,95854198,7084898,CNL
chr08,Bn35558,95372227,98161541,2789314,TNL
chr08,Bn35559,49087433,84674413,35586980,TNL
chr08,Bn35560,87531957,94969053,7437096,TN
chr08,Bn35561,11770714,95458082,83687368,NBS
chr08,Bn35562,38889068,79991592,41102524,TNL
chr08,Bn35563,33598701,65340903,31742202,TN
chr08,Bn35564,63808638,76988402,13179764,TN
chr08,Bn35565,35433224,47871592,12438368,TN
chr08,Bn35566,85238865,90817591,5578726,TNL
chr08,Bn35567,51899133,85946148,34047015,CNL
chr08,Bn35568,62586496,84974408,22387912,CNL
chr08,Bn35569,76901641,86720682,9819041,TN
chr08,Bn35570,25339529,99552033,74212504,NBS
chr08,Bn35571,35811828,84277924,48466096,CN
chr08,Bn35572,73960915,81958049,7997134,CN
chr08,Bn35573,22960187,72716731,49756544,TNL
chr08,Bn35574,37662400,83648699,45986299,RLP
chr08,Bn35575,8051755,52234976,44183221,TNL
chr08,Bn35576,74244871,91074664,16829793,NBS
chr08,Bn35577,73792787,93098039,19305252,RLK
chr08,Bn35578,45911580,87261446,41349866,NBS
chr08,Bn35579,20278951,76675965,56397014,TNL
chr08,Bn35580,40870033,43659292,2789259,TN
chr08,Bn35581,55587868,97849738,42261870,CN
chr08,Bn35582,9677406,48683223,39005817,TNL
chr08,Bn35583,59340229,63982298,4642069,TNL
chr08,Bn35584,76639210,86323586,9684376,RLK
chr08,Bn35585,75300411,91298906,15998495,CNL
chr08,Bn35586,31651045,90618049,58967004,TNL
chr08,Bn35587,34420184,62626184,28206000,TNL
chr08,Bn35588,62441533,80073245,17631712,TN
chr08,Bn35589,83888628,92092062,8203434,CN
chr08,Bn35590,81725242,98304237,16578995,RLP
chr08,Bn35591,28375298,60440478,32065180,RLP
chr08,Bn35592,86313317,91583368,5270051,RLK
chr08,Bn35593,71388721,88134130,16745409,RLP
chr08,Bn35594,75182647,76219672,1037025,TNL
chr08,Bn35595,14899573,93512754,78613181,NBS
chr08,Bn35596,36397409,85252971,48855562,NBS
chr08,Bn35597,41427090,78989766,37562676,CN
chr08,Bn35598,44710605,89947848,45237243,RLP
chr08,Bn35599,88067571,95490556,7422985,TNL
chr08,Bn35600,93232319,95743783,2511464,TNL
chr08,Bn35601,38523586,87174013,48650427,RLK
chr08,Bn35602,82195036,88981957,6786921,RLP
chr08,Bn35603,45715599,68063164,22347565,TNL
chr08,Bn35604,36126607,80508249,44381642,CN
chr08,Bn35605,95624187,99925016,4300829,TN
chr08,Bn35606,35648380,72914382,37266002,RLP
chr08,Bn35607,40805350,49496166,8690816,CNL
chr08,Bn35608,15539930,24282551,8742621,CN
chr08,Bn35609,91240356,92766893,1526537,CNL
chr08,Bn35610,1476270,16252805,14776535,TNL
chr08,Bn35611,79284324,86264571,6980247,CNL
chr08,Bn35612,91575353,98934463,7359110,RLP
chr08,Bn35613,61290478,78227150,16936672,TN
chr08,Bn35614,25647134,59923935,34276801,TN
chr08,Bn35615,88993527,89222712,229185,CNL
chr08,Bn35616,56283005,96267848,39984843,RLK
chr08,Bn35617,72188584,78402366,6213782,NBS
chr08,Bn35618,52522812,88829465,36306653,CNL
chr08,Bn35619,3650414,69066626,65416212,NBS
chr08,Bn35620,10551036,35169753,24618717,NBS
chr08,Bn35621,40102697,85782623,45679926,CN
chr08,Bn35622,91511685,91880548,368863,CN
chr08,Bn35623,62835400,68089658,5254258,TN
chr08,Bn35624,40236459,46281818,6045359,TN
chr08,Bn35625,32132218,92163987,60031769,CNL
chr08,Bn35626,37379147,73938740,36559593,CNL
chr08,Bn35627,46987190,56416784,9429594,RLK
chr08,Bn35628,14069797,87777148,73707351,TNL
chr08,Bn35629,39013294,63743222,24729928,TNL
chr08,Bn35630,76343972,97951679,21607707,CN
chr08,Bn35631,28681254,98614553,69933299,TNL
chr08,Bn35632,62148070,99465345,37317275,CNL
chr08,Bn35633,62155596,96991575,34835979,CN
chr08,Bn35634,94039193,98831533,4792340,NBS
chr08,Bn35635,97877713,98161651,283938,CNL
chr08,Bn35636,58676497,76950234,18273737,RLK
chr08,Bn35637,90305320,93637297,3331977,RLP
chr08,Bn35638,34188963,79180956,44991993,TN
chr08,Bn35639,56807274,95115793,38308519,RLP
chr08,Bn35640,60527583,96739188,36211605,CN
chr08,Bn35641,41403862,84448081,43044219,TN
chr08,Bn35642,18105122,24715486,6610364,CNL
chr08,Bn35643,94416723,95082116,665393,RLK
chr08,Bn35644,56138602,72933900,16795298,TN
chr08,Bn35645,23500124,64829941,41329817,TN
chr08,Bn35646,56737012,85531396,28794384,TN
chr08,Bn35647,30560943,35568299,5007356,CNL
chr08,Bn35648,22688015,31538387,8850372,CNL
chr08,Bn35649,4022875,86846482,82823607,RLP
chr08,Bn35650,62224259,84933483,22709224,NBS
chr08,Bn35651,71356672,84557438,13200766,RLP
chr08,Bn35652,77342719,85406865,8064146,RLP
chr08,Bn35653,32519020,61692022,29173002,CN
chr08,Bn35654,64379658,81724545,17344887,TNL
chr08,Bn35655,86919066,98870401,11951335,CNL
chr08,Bn35656,18104587,42257748,24153161,CN
chr08,Bn35657,68686047,75373398,6687351,NBS
chr08,Bn35658,92078754,94138368,2059614,TN
chr08,Bn35659,14225813,69672099,55446286,NBS
chr08,Bn35660,12919560,68417197,55497637,RLP
chr08,Bn35661,21562382,68000542,46438160,NBS
chr08,Bn35662,15081593,18121016,3039423,TN
chr08,Bn35663,72883822,87337554,14453732,RLK
chr08,Bn35664,45842299,59268330,13426031,CN
chr08,Bn35665,87735750,89104626,1368876,TN
chr08,Bn35666,34451173,42554031,8102858,TN
chr08,Bn35667,11999181,73949352,61950171,RLK
chr08,Bn35668,1842214,73093946,71251732,NBS
chr08,Bn35669,12410616,90620488,78209872,CN
chr08,Bn35670,56922150,88985065,32062915,CNL
chr08,Bn35671,8591914,47794590,39202676,TN
chr08,Bn35672,39097446,89640670,50543224,RLP
chr08,Bn35673,61329994,92311091,30981097,NBS
chr08,Bn35674,76206965,93565719,17358754,NBS
chr08,Bn35675,38523835,86113825,47589990,RLP
chr08,Bn35676,16686962,65398913,48711951,TN
chr08,Bn35677,36340523,70711411,34370888,CN
chr08,Bn35678,32689709,38338153,5648444,TN
chr08,Bn35679,30837437,61746842,30909405,RLK
chr08,Bn35680,77982524,84791700,6809176,NBS
chr08,Bn35681,31720345,47363071,15642726,CN
chr08,Bn35682,63911851,67873137,3961286,TN
chr08,Bn35683,66699069,86713584,20014515,NBS
chr08,Bn35684,12011329,19740168,7728839,RLK
chr08,Bn35685,23232627,42322942,19090315,TNL
chr08,Bn35686,40674544,63677336,23002792,RLP
chr08,Bn35687,43006271,71151020,28144749,CNL
chr08,Bn35688,35635949,41387110,5751161,TN
chr08,Bn35689,80181594,95196008,15014414,TNL
chr08,Bn35690,84464178,96903956,12439778,RLK
chr08,Bn35691,75808773,78669287,2860514,TNL
chr08,Bn35692,37826102,38386170,560068,TN
chr08,Bn35693,49948952,87840339,37891387,RLP
chr08,Bn35694,47992952,79635513,31642561,TN
chr08,Bn35695,59468033,92463557,32995524,CN
chr08,Bn35696,78392489,93959766,15567277,CN
chr08,Bn35697,79234511,96456275,17221764,CNL
chr08,Bn35698,59315480,75490288,16174808,RLP
chr08,Bn35699,26633386,76489288,49855902,CNL
chr08,Bn35700,47512496,94245824,46733328,RLK
chr08,Bn35701,84791398,90897181,6105783,CN
chr08,Bn35702,99459141,99911348,452207,RLP
chr08,Bn35703,90734002,92009488,1275486,CNL
chr08,Bn35704,90808811,97086283,6277472,RLP
chr08,Bn35705,4396940,47821242,43424302,TNL
chr08,Bn35706,85836073,90283350,4447277,TN
chr08,Bn35707,28836723,46534189,17697466,CNL
chr08,Bn35708,22228182,36038393,13810211,RLK
chr08,Bn35709,14751525,40813660,26062135,CNL
chr08,Bn35710,3304628,87959095,84654467,CNL
chr08,Bn35711,40056605,59439183,19382578,CNL
chr08,Bn35712,20385535,59447677,39062142,TN
chr08,Bn35713,6664290,55869844,49205554,TNL
chr08,Bn35714,53608001,63856851,10248850,CN
chr08,Bn35715,52949696,69479442,16529746,RLK
chr08,Bn35716,84621101,86451027,1829926,NBS
chr08,Bn35717,17808151,65791058,47982907,RLP
chr08,Bn35718,38540748,96156734,57615986,RLK
chr08,Bn35719,60585741,78327174,17741433,CNL
chr08,Bn35720,13823530,93997630,80174100,RLK
chr08,Bn35721,71283157,80641398,9358241,NBS
chr08,Bn35722,6523370,80069517,73546147,TN
chr08,Bn35723,59018090,75491328,16473238,NBS
chr08,Bn35724,18432768,91644584,73211816,CNL
chr08,Bn35725,39232617,98781373,59548756,RLK
chr08,Bn35726,32813118,37739781,4926663,TN
chr08,Bn35727,39761052,97660636,57899584,CN
chr08,Bn35728,84971939,85397369,425430,NBS
chr08,Bn35729,80357950,83464930,3106980,CN
chr08,Bn35730,60256384,61240577,984193,RLP
chr08,Bn35731,22890103,98339887,75449784,CN
chr08,Bn35732,46996541,50668030,3671489,TN
chr08,Bn35733,4446174,95008551,90562377,NBS
chr08,Bn35734,44161054,60089557,15928503,TN
chr08,Bn35735,53155923,71688744,18532821,CN
chr08,Bn35736,46770273,50153942,3383669,RLK
chr08,Bn35737,73590044,98507096,24917052,CNL
chr08,Bn35738,20483845,30365544,9881699,RLK
chr08,Bn35739,74009993,99854218,25844225,TNL
chr08,Bn35740,44545682,69522329,24976647,TN
chr08,Bn35741,31267103,58010876,26743773,CN
chr08,Bn35742,91256995,98327399,7070404,TNL
chr08,Bn35743,92113041,97207838,5094797,TNL
chr08,Bn35744,50158091,99305429,49147338,NBS
chr08,Bn35745,57545365,80733658,23188293,CNL
chr08,Bn35746,84944075,85539594,595519,RLK
chr08,Bn35747,28867656,73533931,44666275,CNL
chr08,Bn35748,30927943,69942391,39014448,RLK
chr08,Bn35749,79466031,98446740,18980709,TNL
chr08,Bn35750,16228292,54413475,38185183,NBS
chr08,Bn35751,65341738,89947778,24606040,TNL
chr08,Bn35752,38891751,64025804,25134053,TNL
chr08,Bn35753,36207199,98673993,62466794,NBS
chr08,Bn35754,35615850,64173663,28557813,TN
chr08,Bn35755,55340854,93430023,38089169,TNL
chr08,Bn35756,86537123,88081707,1544584,CNL
chr08,Bn35757,48828246,59627661,10799415,RLK
chr08,Bn35758,89072749,95310827,6238078,TN
chr08,Bn35759,31288435,37201282,5912847,CNL
chr08,Bn35760,66749976,80955949,14205973,CN
chr08,Bn35761,57788275,95770977,37982702,NBS
chr08,Bn35762,59683090,90285712,30602622,RLK
chr08,Bn35763,71069572,92239531,21169959,CN
chr08,Bn35764,83725451,92901751,9176300,CN
chr08,Bn35765,96787941,97766230,978289,CNL
chr08,Bn35766,53093382,86012964,32919582,TN
chr08,Bn35767,61529024,75469676,13940652,TN
chr08,Bn35768,66895919,96416426,29520507,CN
chr08,Bn35769,85924475,96525728,10601253,RLK
chr08,Bn35770,71907811,76891269,4983458,TNL
chr08,Bn35771,19412062,34069345,14657283,RLP
chr08,Bn35772,52037941,54441084,2403143,NBS
chr08,Bn35773,65945363,76756118,10810755,RLP
chr08,Bn35774,77199810,82804196,5604386,RLK
chr08,Bn35775,95361165,96035838,674673,TNL
chr08,Bn35776,23380807,45548101,22167294,TN
chr08,Bn35777,75715205,96304623,20589418,TNL
chr08,Bn35778,52449334,69887855,17438521,NBS
chr08,Bn35779,25322019,53766500,28444481,CN
chr08,Bn35780,57742487,60229335,2486848,NBS
chr08,Bn35781,50655680,83815602,33159922,TN
chr08,Bn35782,78700871,86927526,8226655,CN
chr08,Bn35783,89407021,89782453,375432,NBS
chr08,Bn35784,43410645,94809492,51398847,NBS
chr08,Bn35785,23650618,84978449,61327831,NBS
chr08,Bn35786,41524687,76069178,34544491,CN
chr08,Bn35787,60356479,79381233,19024754,TN
chr08,Bn35788,76304333,96161166,19856833,CN
chr08,Bn35789,77791470,88030312,10238842,NBS
chr08,Bn35790,76759002,93721662,16962660,TN
chr08,Bn35791,22687807,24812962,2125155,RLP
chr08,Bn35792,28944206,88318696,59374490,TN
chr08,Bn35793,14019491,82368848,68349357,NBS
chr08,Bn35794,41802801,59574962,17772161,RLK
chr08,Bn35795,66018615,73258388,7239773,RLK
chr08,Bn35796,50513119,81234249,30721130,RLK
chr08,Bn35797,80903482,86763950,5860468,TN
chr08,Bn35798,47397885,83142143,35744258,CN
chr08,Bn35799,13826865,40996418,27169553,RLK
chr08,Bn35800,68806274,88754140,19947866,TNL
chr08,Bn35801,38310285,44201359,5891074,NBS
chr08,Bn35802,54147417,80500526,26353109,TNL
chr08,Bn35803,74172775,81818294,7645519,NBS
chr08,Bn35804,80342839,83215094,2872255,TN
chr08,Bn35805,78876323,93048635,14172312,TNL
chr08,Bn35806,53931113,90012634,36081521,CN
chr08,Bn35807,22768532,35315951,12547419,RLK
chr08,Bn35808,3316674,69045999,65729325,NBS
chr08,Bn35809,58247794,96143719,37895925,TN
chr08,Bn35810,29818767,81832780,52014013,CN
chr08,Bn35811,35742449,57129231,21386782,TNL
chr08,Bn35812,75927887,92004803,16076916,CNL
chr08,Bn35813,65251244,70697611,5446367,TN
chr08,Bn35814,27572043,63756179,36184136,TN
chr08,Bn35815,99417928,99706572,288644,CNL
chr08,Bn35816,25678925,40883511,15204586,TN
chr08,Bn35817,59238282,77372538,18134256,RLK
chr08,Bn35818,60134254,75445664,15311410,TN
chr08,Bn35819,13936259,37318134,23381875,RLP
chr08,Bn35820,94882539,97746121,2863582,TN
chr08,Bn35821,67303679,89592834,22289155,CN
chr08,Bn35822,51065677,55208994,4143317,TNL
chr08,Bn35823,6845701,54009746,47164045,NBS
chr08,Bn35824,35487381,59710210,24222829,RLP
chr08,Bn35825,23941830,30092236,6150406,CNL
chr08,Bn35826,92249761,99440771,7191010,TN
chr08,Bn35827,47194175,64278219,17084044,TN
chr08,Bn35828,47163928,91201738,44037810,CN
chr08,Bn35829,20265135,25981631,5716496,RLP
chr08,Bn35830,38502287,79490693,40988406,NBS
chr08,Bn35831,46490058,87345720,40855662,RLP
chr08,Bn35832,84661948,88923494,4261546,RLP
chr08,Bn35833,43123044,58810811,15687767,CN
chr08,Bn35834,70304908,73146515,2841607,TN
chr08,Bn35835,75994717,91942737,15948020,NBS
chr08,Bn35836,61897815,94320657,32422842,RLP
chr08,Bn35837,1298599,93893897,92595298,TNL
chr08,Bn35838,78921386,88068138,9146752,CN
chr08,Bn35839,24147854,68791653,44643799,CN
chr08,Bn35840,9025418,48949184,39923766,CNL
chr08,Bn35841,6165768,8355326,2189558,TNL
chr08,Bn35842,40862670,67910376,27047706,NBS
chr08,Bn35843,39982015,86980190,46998175,NBS
chr08,Bn35844,60929009,96835724,35906715,TNL
chr08,Bn35845,85160888,89653362,4492474,RLK
chr08,Bn35846,26077159,53896091,27818932,NBS
chr08,Bn35847,28873951,99733647,70859696,NBS
chr08,Bn35848,92296791,98229223,5932432,CN
chr08,Bn35849,62343340,68379006,6035666,CN
chr08,Bn35850,32868682,50829400,17960718,RLK
chr08,Bn35851,78043987,99961192,21917205,RLP
chr08,Bn35852,81213443,96923072,15709629,TNL
chr08,Bn35853,48916242,84842491,35926249,CN
chr08,Bn35854,47944131,69572197,21628066,TN
chr08,Bn35855,48427990,82563664,34135674,CNL
chr08,Bn35856,77686536,88875710,11189174,RLP
chr08,Bn35857,26734288,35061820,8327532,RLK
chr08,Bn35858,64570114,86085535,21515421,TNL
chr08,Bn35859,35762851,95173121,59410270,TNL
chr08,Bn35860,98369176,98761563,392387,TNL
chr08,Bn35861,48305524,75379365,27073841,TNL
chr08,Bn35862,90417108,91621062,1203954,RLP
chr08,Bn35863,6038791,38188158,32149367,RLP
chr08,Bn35864,85436568,86856276,1419708,CN
chr08,Bn35865,73784671,98132960,24348289,RLP
chr08,Bn35866,18007890,84518582,66510692,NBS
chr08,Bn35867,34308973,54175371,19866398,CN
chr08,Bn35868,98505963,98654467,148504,TNL
chr08,Bn35869,60161550,83110965,22949415,RLP
chr08,Bn35870,36262459,90354039,54091580,TN
chr08,Bn35871,44657628,58212279,13554651,CN
chr08,Bn35872,75056398,86559460,11503062,TNL
chr08,Bn35873,80874779,96327696,15452917,TNL
chr08,Bn35874,3800527,35368675,31568148,CN
chr08,Bn35875,27073393,84674943,57601550,CNL
chr08,Bn35876,37515039,90448670,52933631,TNL
chr08,Bn35877,45022313,88599095,43576782,NBS
chr08,Bn35878,65245778,79360714,14114936,RLK
chr08,Bn35879,94076906,94542319,465413,RLK
chr08,Bn35880,90802029,92092079,1290050,CNL
chr08,Bn35881,61298842,98872873,37574031,RLK
chr08,Bn35882,13738815,55025898,41287083,NBS
chr08,Bn35883,64077499,65899774,1822275,TNL
chr08,Bn35884,28535909,59312033,30776124,RLP
chr08,Bn35885,48194332,90992298,42797966,RLK
chr08,Bn35886,49737322,81352359,31615037,NBS
chr08,Bn35887,80525628,97574360,17048732,TN
chr08,Bn35888,3538071,11676124,8138053,TNL
chr08,Bn35889,67028265,74243925,7215660,TNL
chr08,Bn35890,77951737,84660901,6709164,RLK
chr08,Bn35891,37634899,68059753,30424854,CN
chr08,Bn35892,16970341,94914072,77943731,RLK
chr08,Bn35893,2206511,54873249,52666738,TNL
chr08,Bn35894,93403418,95868064,2464646,TN
chr08,Bn35895,92165018,94457187,2292169,TN
chr08,Bn35896,93497461,98517193,5019732,NBS
chr08,Bn35897,56272061,92884997,36612936,CNL
chr08,Bn35898,34393936,96985714,62591778,NBS
chr08,Bn35899,80016646,85078321,5061675,TNL
chr08,Bn35900,53824019,79736893,25912874,CNL
chr08,Bn35901,47429689,73007230,25577541,RLP
chr08,Bn35902,11681334,44243696,32562362,CNL
chr08,Bn35903,60630273,71754418,11124145,TNL
chr08,Bn35904,24725795,49108775,24382980,TNL
chr08,Bn35905,49092429,82731544,33639115,TNL
chr08,Bn35906,68490002,70455977,1965975,CN
chr08,Bn35907,92761294,94735230,1973936,RLK
chr08,Bn35908,50810888,70541196,19730308,CN
chr08,Bn35909,2159636,88778672,86619036,CN
chr08,Bn35910,27448159,98441342,70993183,CN
chr08,Bn35911,42230222,68533523,26303301,CNL
chr08,Bn35912,31037235,56937449,25900214,RLK
chr08,Bn35913,24468991,38437724,13968733,CN
chr08,Bn35914,45063326,48600637,3537311,TN
chr08,Bn35915,35139833,49684256,14544423,NBS
chr08,Bn35916,73622974,93097076,19474102,CN
chr08,Bn35917,51065204,66716338,15651134,NBS
chr08,Bn35918,59793214,82917179,23123965,TN
chr08,Bn35919,22713073,43932468,21219395,CN
chr08,Bn35920,54632094,60568634,5936540,NBS
chr08,Bn35921,17158317,46881982,29723665,CNL
chr08,Bn35922,68408187,91377324,22969137,CNL
chr08,Bn35923,61454061,62357243,903182,RLP
chr08,Bn35924,5095096,66011374,60916278,RLK
chr08,Bn35925,21106569,64502801,43396232,TN
chr08,Bn35926,56129530,94007971,37878441,TNL
chr08,Bn35927,55770694,65527776,9757082,CN
chr08,Bn35928,82606828,90596774,7989946,CN
chr08,Bn35929,17426259,31670084,14243825,TNL
chr08,Bn35930,46283027,66228760,19945733,NBS
chr08,Bn35931,53959252,58599932,4640680,TN
chr08,Bn35932,14304752,20256228,5951476,RLP
chr08,Bn35933,66432376,68453725,2021349,TNL
chr08,Bn35934,80915810,89313023,8397213,CNL
chr08,Bn35935,16132469,32439025,16306556,RLP
chr08,Bn35936,21129592,32924572,11794980,TN
chr08,Bn35937,2150732,6867569,4716837,RLK
chr08,Bn35938,81914867,88451663,6536796,TNL
chr08,Bn35939,63929471,80263634,16334163,NBS
chr08,Bn35940,57739132,58184760,445628,RLK
chr08,Bn35941,32678588,93130941,60452353,TNL
chr08,Bn35942,14538260,43464340,28926080,TNL
chr08,Bn35943,66371576,79816136,13444560,TN
chr08,Bn35944,87165672,98412667,11246995,RLP
chr08,Bn35945,12021509,19317128,7295619,CN
chr08,Bn35946,15479258,67854116,52374858,CN
chr08,Bn35947,81765880,87863797,6097917,RLP
chr09,Bn35948,97530407,98088667,558260,CN
chr09,Bn35949,34663805,46226870,11563065,CNL
chr09,Bn35950,54334064,79380964,25046900,NBS
chr09,Bn35951,16473012,69881118,53408106,CN
chr09,Bn35952,70363818,88212780,17848962,CNL
chr09,Bn35953,9566416,84743139,75176723,RLK
chr09,Bn35954,87836640,93544629,5707989,TNL
chr09,Bn35955,17212756,58315344,41102588,CN
chr09,Bn35956,31067654,92927666,61860012,CNL
chr09,Bn35957,36521555,73845898,37324343,TNL
chr09,Bn35958,15491976,40972083,25480107,CN
chr09,Bn35959,32339671,65305546,32965875,TN
chr09,Bn35960,16739795,46756306,30016511,RLK
chr09,Bn35961,24441484,72683086,48241602,TNL
chr09,Bn35962,49130779,89747771,40616992,TN
chr09,Bn35963,99251042,99826450,575408,RLP
chr09,Bn35964,54161583,64716332,10554749,RLK
chr09,Bn35965,63892204,66657928,2765724,TN
chr09,Bn35966,31877749,36961163,5083414,TN
chr09,Bn35967,5240018,67425044,62185026,RLP
chr09,Bn35968,78777653,99365453,20587800,CNL
chr09,Bn35969,57520913,77451280,19930367,RLP
chr09,Bn35970,4536563,96465579,91929016,NBS
chr09,Bn35971,21285950,46292274,25006324,CNL
chr09,Bn35972,76987128,88638295,11651167,CN
chr09,Bn35973,19067245,53327850,34260605,CN
chr09,Bn35974,56747304,72406399,15659095,TNL
chr09,Bn35975,53437391,65420529,11983138,TN
chr09,Bn35976,80869217,86531991,5662774,TNL
chr09,Bn35977,97686352,98342900,656548,CNL
chr09,Bn35978,94940240,95441961,501721,RLK
chr09,Bn35979,60739781,73189281,12449500,CNL
chr09,Bn35980,72956399,85545022,12588623,NBS
chr09,Bn35981,54645875,58758701,4112826,RLK
chr09,Bn35982,84554306,87842755,3288449,TN
chr09,Bn35983,41941407,72836194,30894787,TNL
chr09,Bn35984,25656089,52794225,27138136,TNL
chr09,Bn35985,76704606,96308280,19603674,RLP
chr09,Bn35986,78797415,93922015,15124600,CNL
chr09,Bn35987,15540427,22606245,7065818,CN
chr09,Bn35988,67881191,78119746,10238555,CN
chr09,Bn35989,98223406,98721289,497883,RLP
chr09,Bn35990,71820765,79536649,7715884,RLK
chr09,Bn35991,20057173,41547772,21490599,CNL
chr09,Bn35992,82391731,92610728,10218997,NBS
chr09,Bn35993,90662889,92682532,2019643,CNL
chr09,Bn35994,60368142,99833593,39465451,CN
chr09,Bn35995,77860183,98031788,20171605,CNL
chr09,Bn35996,59592424,68643161,9050737,CNL
chr09,Bn35997,67730431,91702529,23972098,CN
chr09,Bn35998,55983754,66773474,10789720,NBS
chr09,Bn35999,56368762,75825546,19456784,TNL
chr09,Bn36000,75547039,82906382,7359343,RLP
chr09,Bn36001,43686802,70691256,27004454,RLK
chr09,Bn36002,61235024,84596148,23361124,NBS
chr09,Bn36003,62429750,77009585,14579835,CN
chr09,Bn36004,5792594,22342752,16550158,RLK
chr09,Bn36005,83813718,88315958,4502240,TN
chr09,Bn36006,11995429,36911938,24916509,RLP
chr09,Bn36007,32010803,84090642,52079839,CNL
chr09,Bn36008,51970360,86012715,34042355,NBS
chr09,Bn36009,11398608,38342877,26944269,CN
chr09,Bn36010,14268832,95123290,80854458,RLP
chr09,Bn36011,67460186,96497508,29037322,TN
chr09,Bn36012,27220620,30754317,3533697,RLK
chr09,Bn36013,48622686,53866116,5243430,CNL
chr09,Bn36014,24972365,48188118,23215753,CN
chr09,Bn36015,7794621,61898851,54104230,TNL
chr09,Bn36016,7180889,43801524,36620635,RLP
chr09,Bn36017,15162748,31661856,16499108,RLK
chr09,Bn36018,12460809,57381471,44920662,CNL
chr09,Bn36019,45415704,79021389,33605685,TN
chr09,Bn36020,86631744,97508942,10877198,TN
chr09,Bn36021,94045829,96932901,2887072,RLP
chr09,Bn36022,82896113,84582907,1686794,NBS
chr09,Bn36023,64680059,95905046,31224987,TNL
chr09,Bn36024,70488276,83563696,13075420,RLK
chr09,Bn36025,53902132,96127844,42225712,RLK
chr09,Bn36026,49293121,83479368,34186247,CN
chr09,Bn36027,88816243,92477248,3661005,RLK
chr09,Bn36028,34465289,69371569,34906280,CN
chr09,Bn36029,15292256,41603706,26311450,CNL
chr09,Bn36030,69879550,72861695,2982145,NBS
chr09,Bn36031,95789677,99706942,3917265,CN
chr09,Bn36032,78251136,87269762,9018626,CNL
chr09,Bn36033,45874129,59020130,13146001,CNL
chr09,Bn36034,3446324,80500742,77054418,TNL
chr09,Bn36035,46962438,62543067,15580629,CNL
chr09,Bn36036,72656110,87070722,14414612,RLP
chr09,Bn36037,74381093,91231437,16850344,TN
chr09,Bn36038,98729412,99346628,617216,NBS
chr09,Bn36039,41419063,73969897,32550834,RLP
chr09,Bn36040,3648462,9321009,5672547,CN
chr09,Bn36041,98970119,99534205,564086,TN
chr09,Bn36042,57672094,76410178,18738084,CN
chr09,Bn36043,54943496,67429392,12485896,RLP
chr09,Bn36044,82307136,92307135,9999999,CNL
chr09,Bn36045,70300902,96419255,26118353,RLP
chr09,Bn36046,96514465,97696308,1181843,TNL
chr09,Bn36047,59701703,99272428,39570725,TNL
chr09,Bn36048,76296805,85835734,9538929,CNL
chr09,Bn36049,69115752,75327800,6212048,RLP
chr09,Bn36050,6002500,34784921,28782421,RLP
chr09,Bn36051,80211573,85158689,4947116,CNL
chr09,Bn36052,51080266,73723653,22643387,TNL
chr09,Bn36053,91566110,94676328,3110218,RLK
chr09,Bn36054,25598953,55208456,29609503,TN
chr09,Bn36055,57242223,66891831,9649608,TN
chr09,Bn36056,55241444,84597181,29355737,CNL
chr09,Bn36057,59833196,90847494,31014298,RLK
chr09,Bn36058,54045969,66101612,12055643,CN
chr09,Bn36059,1091224,2204749,1113525,RLK
chr09,Bn36060,21341526,32691899,11350373,RLP
chr09,Bn36061,46438451,95726504,49288053,RLP
chr09,Bn36062,6346049,31161282,24815233,NBS
chr09,Bn36063,79845843,95704850,15859007,RLK
chr09,Bn36064,36454602,60784252,24329650,CN
chr09,Bn36065,22630388,84152064,61521676,NBS
chr09,Bn36066,5657914,96413964,90756050,RLP
chr09,Bn36067,22239536,88925456,66685920,RLP
chr09,Bn36068,46353861,67645920,21292059,TNL
chr09,Bn36069,8717369,98694724,89977355,CNL
chr09,Bn36070,72959719,81126915,8167196,CNL
chr09,Bn36071,54904645,75026144,20121499,NBS
chr09,Bn36072,13928481,49892521,35964040,RLK
chr09,Bn36073,46016724,96647460,50630736,CNL
chr09,Bn36074,2135729,39533927,37398198,RLK
chr09,Bn36075,7028782,52872055,45843273,TN
chr09,Bn36076,32798957,95132655,62333698,NBS
chr09,Bn36077,4967863,31719626,26751763,RLP
chr09,Bn36078,86597194,89979820,3382626,RLK
chr09,Bn36079,54789222,59582349,4793127,NBS
chr09,Bn36080,29688725,73104874,43416149,NBS
chr09,Bn36081,50505619,56609991,6104372,NBS
chr09,Bn36082,77871800,82372816,4501016,RLK
chr09,Bn36083,35782487,63867481,28084994,RLK
chr09,Bn36084,86491384,98166647,11675263,TN
chr09,Bn36085,55745395,89612259,33866864,RLP
chr09,Bn36086,81174073,83088731,1914658,RLK
chr09,Bn36087,1042656,44502922,43460266,RLK
chr09,Bn36088,37472681,81713547,44240866,CN
chr09,Bn36089,59615372,62456597,2841225,TN
chr09,Bn36090,52304574,55016966,2712392,RLP
chr09,Bn36091,62483239,70377056,7893817,NBS
chr09,Bn36092,79136986,87483808,8346822,TNL
chr09,Bn36093,34733208,35032833,299625,TNL
chr09,Bn36094,28579276,79782310,51203034,TNL
chr09,Bn36095,4174970,34494852,30319882,NBS
chr09,Bn36096,63170689,93233604,30062915,CN
chr09,Bn36097,2075093,64569526,62494433,NBS
chr09,Bn36098,47705376,92150376,44445000,RLP
chr09,Bn36099,94762376,99421164,4658788,NBS
chr09,Bn36100,80079429,84406307,4326878,RLP
chr09,Bn36101,15215256,35823977,20608721,CN
chr09,Bn36102,41646117,64071668,22425551,TNL
chr09,Bn36103,66748058,87613942,20865884,NBS
chr09,Bn36104,39724695,91489966,51765271,NBS
chr09,Bn36105,40634566,72241404,31606838,CN
chr09,Bn36106,1153839,33749598,32595759,TN
chr09,Bn36107,3037404,20461926,17424522,CN
chr09,Bn36108,50188831,98518501,48329670,RLP
chr09,Bn36109,63174381,81042934,17868553,TN
chr09,Bn36110,99908211,99930498,22287,RLP
chr09,Bn36111,41373797,99646838,58273041,CN
chr09,Bn36112,59095425,70360178,11264753,TN
chr09,Bn36113,8748470,70515604,61767134,TNL
chr09,Bn36114,37639507,69494346,31854839,CN
chr09,Bn36115,17435649,52208286,34772637,TNL
chr09,Bn36116,53813748,61433946,7620198,TNL
chr09,Bn36117,76414353,91000856,14586503,NBS
chr09,Bn36118,28066133,67677353,39611220,NBS
chr09,Bn36119,76500497,92591129,16090632,TN
chr09,Bn36120,14992844,88423419,73430575,TN
chr09,Bn36121,2556626,16522776,13966150,CNL
chr09,Bn36122,19577101,31833990,12256889,TN
chr09,Bn36123,86898703,87047977,149274,TN
chr09,Bn36124,23966191,83045979,59079788,RLK
chr09,Bn36125,10019726,10579477,559751,CN
chr09,Bn36126,85633084,86932014,1298930,CNL
chr09,Bn36127,95774486,96265894,491408,TNL
chr09,Bn36128,51882289,96993552,45111263,RLP
chr09,Bn36129,29960102,96693011,66732909,NBS
chr09,Bn36130,62753289,84457861,21704572,RLK
chr09,Bn36131,49413457,81717504,32304047,TN
chr09,Bn36132,73757595,97181604,23424009,TN
chr09,Bn36133,15995519,55327049,39331530,CN
chr09,Bn36134,94371936,95256992,885056,NBS
chr09,Bn36135,42590393,56639058,14048665,TNL
chr09,Bn36136,47356314,90004378,42648064,TN
chr09,Bn36137,78554593,79683223,1128630,NBS
chr09,Bn36138,61445525,69197293,7751768,RLK
chr09,Bn36139,74870518,97194688,22324170,RLK
chr09,Bn36140,9723618,66601787,56878169,RLK
chr09,Bn36141,57917407,77362938,19445531,NBS
chr09,Bn36142,19244655,93543496,74298841,RLP
chr09,Bn36143,96242371,96242888,517,CN
chr09,Bn36144,46226128,87349437,41123309,CN
chr09,Bn36145,15197306,73953169,58755863,CN
chr09,Bn36146,51889144,66105458,14216314,CNL
chr09,Bn36147,84381944,92123121,7741177,NBS
chr09,Bn36148,41128081,94460329,53332248,TN
chr09,Bn36149,77497592,83352379,5854787,RLP
chr09,Bn36150,60577359,77413402,16836043,CNL
chr09,Bn36151,16228928,23005331,6776403,NBS
chr09,Bn36152,33998490,98169516,64171026,TN
chr09,Bn36153,54833108,83236842,28403734,TN
chr09,Bn36154,1075808,2617076,1541268,NBS
chr09,Bn36155,99660552,99690016,29464,NBS
chr09,Bn36156,53167689,65159364,11991675,RLK
chr09,Bn36157,24524936,71838783,47313847,RLP
chr09,Bn36158,51526959,52746102,1219143,RLP
chr09,Bn36159,52263247,63249780,10986533,RLP
chr09,Bn36160,30030982,42645526,12614544,RLP
chr09,Bn36161,29668384,53902972,24234588,RLK
chr09,Bn36162,65150483,67226669,2076186,RLK
chr09,Bn36163,35586972,80844434,45257462,RLP
chr09,Bn36164,11659290,59947792,48288502,RLP
chr09,Bn36165,65655734,94158527,28502793,CN
chr09,Bn36166,2599195,70466464,67867269,RLP
chr09,Bn36167,97315794,99711566,2395772,CN
chr09,Bn36168,65885377,77139521,11254144,TNL
chr09,Bn36169,93364296,97423063,4058767,CNL
chr09,Bn36170,85688103,90966638,5278535,NBS
chr09,Bn36171,51884446,55994512,4110066,TN
chr09,Bn36172,37829070,64211467,26382397,CN
chr09,Bn36173,89599076,92211652,2612576,NBS
chr09,Bn36174,62820879,75354397,12533518,CN
chr09,Bn36175,40306358,70048203,29741845,RLP
chr09,Bn36176,58103552,77276779,19173227,TNL
chr09,Bn36177,43011574,77000590,33989016,TNL
chr09,Bn36178,73092817,87882683,14789866,RLP
chr09,Bn36179,29501434,47721867,18220433,CNL
chr09,Bn36180,75137401,79939216,4801815,TNL
chr09,Bn36181,54453198,77937104,23483906,CNL
chr09,Bn36182,42520327,90457676,47937349,CNL
chr09,Bn36183,48746108,52034067,3287959,CN
chr09,Bn36184,20020622,31331204,11310582,NBS
chr09,Bn36185,98054191,98988269,934078,NBS
chr09,Bn36186,10949948,40129424,29179476,CN
chr09,Bn36187,77989142,83583540,5594398,RLK
chr09,Bn36188,78728073,93886991,15158918,TNL
chr09,Bn36189,90811560,98929406,8117846,RLP
chr09,Bn36190,62274123,69892089,7617966,NBS
chr09,Bn36191,73815787,98784533,24968746,CN
chr09,Bn36192,31954046,82267000,50312954,RLK
chr09,Bn36193,71236874,86512987,15276113,RLK
chr09,Bn36194,47851228,67009062,19157834,CN
chr09,Bn36195,73565435,88264778,14699343,NBS
chr09,Bn36196,65114512,76918643,11804131,RLK
chr09,Bn36197,78393928,94424928,16031000,NBS
chr09,Bn36198,21957464,30310367,8352903,RLP
chr09,Bn36199,73272306,93903685,20631379,NBS
chr09,Bn36200,1883812,70317732,68433920,RLK
chr09,Bn36201,96413560,98083123,1669563,TN
chr09,Bn36202,5417063,95839296,90422233,TNL
chr09,Bn36203,34367271,36517142,2149871,NBS
chr09,Bn36204,34788230,78573721,43785491,CNL
chr09,Bn36205,68388557,71272139,2883582,TNL
chr09,Bn36206,86374526,93582184,7207658,RLP
chr09,Bn36207,48884829,94765093,45880264,TN
chr09,Bn36208,95440916,99340146,3899230,TNL
chr09,Bn36209,70356242,98080314,27724072,NBS
chr09,Bn36210,31663843,67272627,35608784,RLP
chr09,Bn36211,13851174,38088820,24237646,TN
chr09,Bn36212,90395887,98071408,7675521,CN
chr09,Bn36213,20725658,43812590,23086932,TN
chr09,Bn36214,28708179,92434874,63726695,TNL
chr09,Bn36215,41854016,53001197,11147181,TN
chr09,Bn36216,44236347,60074956,15838609,CN
chr09,Bn36217,39926217,94901339,54975122,CN
chr09,Bn36218,44798458,56756677,11958219,NBS
chr09,Bn36219,22309187,76986907,54677720,RLK
chr09,Bn36220,40490549,47724220,7233671,CN
chr09,Bn36221,52688231,93274137,40585906,RLP
chr09,Bn36222,64671513,87618691,22947178,TN
chr09,Bn36223,32852403,39275505,6423102,NBS
chr09,Bn36224,69185424,69412940,227516,CNL
chr09,Bn36225,65841765,95241126,29399361,RLP
chr09,Bn36226,2764176,66399271,63635095,CNL
chr09,Bn36227,10705472,50707651,40002179,RLP
chr09,Bn36228,11111689,11160220,48531,CN
chr09,Bn36229,16999054,77894718,60895664,NBS
chr09,Bn36230,9662501,57091915,47429414,CN
chr09,Bn36231,49757760,96385070,46627310,RLP
chr09,Bn36232,62296603,92832042,30535439,TNL
chr09,Bn36233,32485336,94985743,62500407,TNL
chr09,Bn36234,75942165,78492725,2550560,CNL
chr09,Bn36235,9210047,17022499,7812452,CNL
chr09,Bn36236,26249749,40519256,14269507,RLP
chr09,Bn36237,93107368,95495848,2388480,RLP
chr09,Bn36238,67716358,74697811,6981453,CN
chr09,Bn36239,92225640,97666724,5441084,RLK
chr09,Bn36240,67438911,81313430,13874519,NBS
chr09,Bn36241,92862375,94966571,2104196,RLP
chr09,Bn36242,61096261,93595367,32499106,RLP
chr09,Bn36243,82227892,99815995,17588103,RLK
chr09,Bn36244,9318344,41494512,32176168,RLK
chr09,Bn36245,30964827,81296788,50331961,CNL
chr09,Bn36246,29019264,29717323,698059,NBS
chr09,Bn36247,98106768,99864013,1757245,CNL
chr09,Bn36248,62164882,68859094,6694212,RLK
chr09,Bn36249,79751233,99115388,19364155,TN
chr09,Bn36250,7445106,40668127,33223021,RLP
chr09,Bn36251,88982763,93599367,4616604,TN
chr09,Bn36252,62508135,71994005,9485870,TNL
chr09,Bn36253,75409563,97482830,22073267,CN
chr09,Bn36254,26334624,32333373,5998749,NBS
chr09,Bn36255,43868319,93183084,49314765,CN
chr09,Bn36256,62264962,92492160,30227198,CN
chr09,Bn36257,80363195,92036429,11673234,RLK
chr09,Bn36258,75931512,92661863,16730351,CN
chr09,Bn36259,26437225,78286142,51848917,CNL
chr09,Bn36260,19758429,29825867,10067438,RLK
chr09,Bn36261,29491550,83930267,54438717,CN
chr09,Bn36262,98081879,99032948,951069,CNL
chr09,Bn36263,89685264,95071366,5386102,TNL
chr09,Bn36264,33276945,51719349,18442404,CNL
chr09,Bn36265,32986574,69718429,36731855,CN
chr09,Bn36266,37701100,37778717,77617,TN
chr09,Bn36267,31651332,84418023,52766691,RLP
chr09,Bn36268,58645891,94270847,35624956,RLP
chr09,Bn36269,14453974,46955024,32501050,TNL
chr09,Bn36270,26210397,35986496,9776099,CNL
chr09,Bn36271,24888103,99192200,74304097,RLP
chr09,Bn36272,16349499,24728494,8378995,TN
chr09,Bn36273,54627032,66447907,11820875,TNL
chr09,Bn36274,71635308,92411648,20776340,NBS
chr09,Bn36275,56624360,98670079,42045719,CN
chr09,Bn36276,83313261,85352705,2039444,RLK
chr09,Bn36277,75102027,82759478,7657451,TNL
chr09,Bn36278,92804213,99942117,7137904,CNL
chr09,Bn36279,34433266,62510937,28077671,RLK
chr09,Bn36280,12132207,20063311,7931104,CN
chr09,Bn36281,15856745,33471731,17614986,CNL
chr09,Bn36282,72518894,76830101,4311207,CNL
chr09,Bn36283,9979118,10598970,619852,RLK
chr09,Bn36284,1655532,15511548,13856016,RLK
chr09,Bn36285,94827088,98134040,3306952,TNL
chr09,Bn36286,18366391,90074144,71707753,NBS
chr09,Bn36287,44130534,94733696,50603162,CN
chr09,Bn36288,39793773,56283421,16489648,NBS
chr09,Bn36289,58473910,72380556,13906646,TNL
chr09,Bn36290,84335298,89383340,5048042,CN
chr09,Bn36291,82751734,86213623,3461889,TNL
chr09,Bn36292,92643764,97911473,5267709,CN
chr09,Bn36293,80341979,84330946,3988967,CNL
chr09,Bn36294,94291087,96893722,2602635,NBS
chr09,Bn36295,94435531,97666100,3230569,CNL
chr09,Bn36296,26663638,44968652,18305014,RLP
chr09,Bn36297,14851188,31739284,16888096,RLP
chr09,Bn36298,59316888,78163085,18846197,CN
chr09,Bn36299,39173112,89937561,50764449,CNL
chr09,Bn36300,5654555,88185136,82530581,RLK
chr09,Bn36301,63506301,69999639,6493338,CN
chr09,Bn36302,92372083,98951006,6578923,CNL
chr09,Bn36303,40535613,43059943,2524330,CN
chr09,Bn36304,76827244,86121539,9294295,TN
chr09,Bn36305,91320597,95738255,4417658,CN
chr09,Bn36306,27195447,31231111,4035664,NBS
chr09,Bn36307,96400258,96917963,517705,CNL
chr09,Bn36308,14442614,33271665,18829051,NBS
chr09,Bn36309,5453247,46960004,41506757,TNL
chr09,Bn36310,81749289,93094239,11344950,TNL
chr09,Bn36311,45530835,66343872,20813037,RLP
chr09,Bn36312,4713959,51190560,46476601,RLK
chr09,Bn36313,3710990,38149635,34438645,RLP
chr09,Bn36314,20812035,57396877,36584842,CNL
chr09,Bn36315,7256609,84279893,77023284,TNL
chr09,Bn36316,81054917,91098254,10043337,RLP
chr09,Bn36317,29672087,80533968,50861881,TNL
chr09,Bn36318,57466151,68777995,11311844,CN
chr09,Bn36319,54775849,59455739,4679890,NBS
chr09,Bn36320,29214638,70481997,41267359,CN
chr09,Bn36321,86618421,98978556,12360135,TN
chr09,Bn36322,78274257,88535668,10261411,NBS
chr09,Bn36323,62618170,96856910,34238740,TNL
chr09,Bn36324,66907220,92817633,25910413,CNL
chr09,Bn36325,6271517,31388153,25116636,NBS
chr09,Bn36326,88851818,89178060,326242,RLK
chr09,Bn36327,58218810,85274125,27055315,RLK
chr09,Bn36328,76304999,78439147,2134148,RLK
chr09,Bn36329,59947780,60185979,238199,RLP
chr09,Bn36330,66254955,83859825,17604870,TNL
chr09,Bn36331,35775244,87577479,51802235,TN
chr09,Bn36332,90142173,94928871,4786698,NBS
chr09,Bn36333,47763181,51893811,4130630,CN
chr09,Bn36334,16403383,33433603,17030220,NBS
chr09,Bn36335,77525037,84253929,6728892,TNL
chr09,Bn36336,21958629,73664988,51706359,RLK
chr09,Bn36337,79058179,88263157,9204978,NBS
chr09,Bn36338,92249474,93115785,866311,TNL
chr09,Bn36339,20589684,94645553,74055869,RLK
chr09,Bn36340,35588238,63538924,27950686,RLK
chr09,Bn36341,38118492,93686097,55567605,NBS
chr09,Bn36342,76186911,95170419,18983508,RLK
chr09,Bn36343,57713537,99666984,41953447,CNL
chr09,Bn36344,17272635,81577390,64304755,CNL
chr09,Bn36345,52569331,66175132,13605801,CNL
chr09,Bn36346,47671937,67850453,20178516,CNL
chr09,Bn36347,70123603,80134398,10010795,RLK
chr09,Bn36348,66610459,83172065,16561606,TN
chr09,Bn36349,65733252,66201293,468041,CNL
chr09,Bn36350,37542274,42860613,5318339,RLK
chr09,Bn36351,45575334,86706789,41131455,TN
chr09,Bn36352,74700270,97509785,22809515,TNL
chr09,Bn36353,39661032,84147960,44486928,RLP
chr09,Bn36354,78452974,99261924,20808950,RLP
chr09,Bn36355,20904593,32157907,11253314,CNL
chr09,Bn36356,82689559,89010496,6320937,TN
chr09,Bn36357,91000993,99589053,8588060,TN
chr09,Bn36358,13834783,28065074,14230291,CNL
chr09,Bn36359,23649667,26975427,3325760,RLK
chr09,Bn36360,90693564,98265500,7571936,TN
chr09,Bn36361,95222535,97162205,1939670,TN
chr09,Bn36362,35973480,48113602,12140122,CNL
chr09,Bn36363,90546043,95166502,4620459,NBS
chr09,Bn36364,21144928,69604589,48459661,TN
chr09,Bn36365,56041559,57855685,1814126,TN
chr09,Bn36366,5895905,29983186,24087281,RLP
chr09,Bn36367,81674974,90313258,8638284,TNL
chr09,Bn36368,91543852,97183939,5640087,TNL
chr09,Bn36369,33855538,75031356,41175818,TN
chr09,Bn36370,20016630,49942674,29926044,RLP
chr09,Bn36371,3800131,20307095,16506964,TNL
chr09,Bn36372,38972613,56830678,17858065,TNL
chr09,Bn36373,86425296,90584685,4159389,NBS
chr09,Bn36374,95003589,99657297,4653708,RLP
chr09,Bn36375,11610085,21351369,9741284,CNL
chr09,Bn36376,5671129,45884374,40213245,CNL
chr09,Bn36377,17341159,63681182,46340023,RLP
chr09,Bn36378,87330410,98592576,11262166,CNL
chr09,Bn36379,5110837,44474943,39364106,RLP
chr09,Bn36380,37295388,98975518,61680130,CN
chr09,Bn36381,72509703,76895622,4385919,CNL
chr09,Bn36382,99289216,99893785,604569,RLP
chr09,Bn36383,17095260,30347899,13252639,RLP
chr09,Bn36384,61020669,63706861,2686192,TN
chr09,Bn36385,90030725,91378259,1347534,TN
chr09,Bn36386,22664314,58301248,35636934,CNL
chr09,Bn36387,62138860,84991023,22852163,RLP
chr09,Bn36388,77506844,83892626,6385782,RLK
chr09,Bn36389,78358399,85287841,6929442,CNL
chr09,Bn36390,81360128,95756561,14396433,RLK
chr09,Bn36391,82684582,86409746,3725164,CN
chr09,Bn36392,45668675,61166935,15498260,NBS
chr09,Bn36393,63668570,91673532,28004962,NBS
chr09,Bn36394,45914154,59008479,13094325,TN
chr09,Bn36395,6305065,75364865,69059800,RLP
chr09,Bn36396,27003519,62129259,35125740,TN
chr09,Bn36397,24081569,73368422,49286853,TNL
chr09,Bn36398,26965649,74155807,47190158,CNL
chr09,Bn36399,9700593,87185997,77485404,CNL
chr09,Bn36400,75275944,89760411,14484467,CN
chr09,Bn36401,18655096,82410708,63755612,RLP
chr09,Bn36402,31817084,64376383,32559299,NBS
chr09,Bn36403,3723957,69210684,65486727,TNL
chr09,Bn36404,24387847,41970314,17582467,NBS
chr09,Bn36405,28443935,77463407,49019472,CNL
chr09,Bn36406,60295260,60918244,622984,RLK
chr09,Bn36407,65884857,72990273,7105416,RLP
chr09,Bn36408,86081507,89100349,3018842,TNL
chr09,Bn36409,96694273,97037407,343134,TNL
chr09,Bn36410,48119632,79887095,31767463,CNL
chr09,Bn36411,95129985,99143020,4013035,TNL
chr09,Bn36412,80530042,95459564,14929522,RLK
chr09,Bn36413,51033882,98029895,46996013,RLP
chr09,Bn36414,70348828,76641458,6292630,RLP
chr09,Bn36415,19031652,85883865,66852213,CNL
chr09,Bn36416,43696548,45353143,1656595,CNL
chr09,Bn36417,43224794,71022692,27797898,CN
chr09,Bn36418,58367587,90676137,32308550,CN
chr09,Bn36419,91596329,95581874,3985545,RLK
chr09,Bn36420,13066392,96179047,83112655,CN
chr09,Bn36421,37634960,64910027,27275067,TN
chr09,Bn36422,26418496,33902859,7484363,NBS
chr09,Bn36423,65305519,67086580,1781061,RLP
chr09,Bn36424,13256869,41652060,28395191,NBS
chr09,Bn36425,1638787,53919048,52280261,TNL
chr09,Bn36426,28942129,42271711,13329582,RLP
chr09,Bn36427,71370965,86102360,14731395,CN
chr09,Bn36428,84934217,89817346,4883129,RLK
chr09,Bn36429,40921166,70021642,29100476,TN
chr09,Bn36430,43939526,54539564,10600038,CNL
chr09,Bn36431,99323996,99470230,146234,CNL
chr09,Bn36432,70021486,73961396,3939910,NBS
chr09,Bn36433,74146871,77641769,3494898,RLP
chr09,Bn36434,42676797,96844471,54167674,RLP
chr09,Bn36435,45453821,46272733,818912,TNL
chr09,Bn36436,65402149,91192089,25789940,NBS
chr09,Bn36437,41610466,72018742,30408276,TNL
chr09,Bn36438,68272163,94722647,26450484,RLK
chr09,Bn36439,60303830,82569760,22265930,RLP
chr09,Bn36440,3712350,19016642,15304292,NBS
chr09,Bn36441,55483043,71219965,15736922,CNL
chr09,Bn36442,59175161,96527686,37352525,RLK
chr09,Bn36443,14147187,89591290,75444103,TN
chr09,Bn36444,26917235,75678899,48761664,NBS
chr09,Bn36445,64421794,84210038,19788244,CN
chr09,Bn36446,21438348,56551570,35113222,TN
chr09,Bn36447,61607166,73630287,12023121,CN
chr09,Bn36448,79655622,93572799,13917177,CNL
chr09,Bn36449,78480349,82120670,3640321,RLP
chr09,Bn36450,87373343,94357989,6984646,RLP
chr09,Bn36451,86851994,93813317,6961323,CNL
chr09,Bn36452,39409026,40982251,1573225,NBS
chr09,Bn36453,9646261,63322047,53675786,CNL
chr09,Bn36454,13880025,77656864,63776839,TNL
chr09,Bn36455,28755147,94609449,65854302,TN
chr09,Bn36456,85856396,95293259,9436863,RLP
chr09,Bn36457,22948799,64589639,41640840,RLK
chr09,Bn36458,22864073,88459271,65595198,TNL
chr09,Bn36459,73571999,95420578,21848579,CNL
chr09,Bn36460,60410157,67782846,7372689,CNL
chr09,Bn36461,31222941,70992472,39769531,TN
chr09,Bn36462,56435626,84594079,28158453,TN
chr09,Bn36463,63179608,96180231,33000623,CN
chr09,Bn36464,63735863,90181208,26445345,CNL
chr09,Bn36465,44457566,97397878,52940312,RLK
chr09,Bn36466,15441622,97396561,81954939,RLP
chr09,Bn36467,31209455,38051950,6842495,TN
chr09,Bn36468,98184773,99801559,1616786,TN
chr09,Bn36469,62343561,76032063,13688502,CNL
chr09,Bn36470,95039004,95198541,159537,CNL
chr09,Bn36471,51117258,94955779,43838521,RLP
chr09,Bn36472,71969481,73584352,1614871,TNL
chr09,Bn36473,54579755,98456976,43877221,TNL
chr09,Bn36474,97514369,99334279,1819910,TNL
chr09,Bn36475,6769642,74970785,68201143,CN
chr09,Bn36476,86599277,87353438,754161,NBS
chr09,Bn36477,53365284,92478688,39113404,CNL
chr09,Bn36478,47237576,88995874,41758298,TN
chr09,Bn36479,53443175,54329419,886244,TNL
chr09,Bn36480,38361377,61356084,22994707,RLK
chr09,Bn36481,43197206,54969439,11772233,CN
chr09,Bn36482,81853161,86884739,5031578,RLK
chr09,Bn36483,30147957,37710311,7562354,TNL
chr09,Bn36484,22388023,40626276,18238253,RLP
chr09,Bn36485,11660022,13364647,1704625,NBS
chr09,Bn36486,39525798,46614540,7088742,RLK
chr09,Bn36487,47329735,80239022,32909287,RLK
chr09,Bn36488,19540755,36395771,16855016,TNL
chr09,Bn36489,22237587,45455659,23218072,RLP
chr09,Bn36490,94836819,95766634,929815,RLP
chr09,Bn36491,74656730,92304584,17647854,RLK
chr09,Bn36492,34186443,49850230,15663787,TNL
chr09,Bn36493,55013356,89426667,34413311,TNL
chr09,Bn36494,64931428,77399107,12467679,RLP
chr09,Bn36495,49345950,61423354,12077404,TN
chr09,Bn36496,33606487,92347689,58741202,RLK
chr09,Bn36497,57226322,70014505,12788183,TN
chr09,Bn36498,84248437,84367774,119337,CN
chr09,Bn36499,45918816,98948017,53029201,NBS
chr09,Bn36500,44748090,61635960,16887870,RLP
chr09,Bn36501,65689471,79930189,14240718,RLK
chr09,Bn36502,3339904,82020884,78680980,CNL
chr09,Bn36503,88130884,97267619,9136735,NBS
chr09,Bn36504,94247911,96038756,1790845,RLK
chr09,Bn36505,95885343,99902565,4017222,RLK
chr09,Bn36506,19124323,71165881,52041558,RLP
chr09,Bn36507,74278766,74723080,444314,CN
chr09,Bn36508,62841755,69511770,6670015,NBS
chr09,Bn36509,96287259,99201096,2913837,NBS
chr09,Bn36510,84470395,93706264,9235869,CN
chr09,Bn36511,83219983,97304826,14084843,TNL
chr09,Bn36512,42070293,58331079,16260786,CNL
chr09,Bn36513,6540986,45336828,38795842,TN
chr09,Bn36514,30762186,56383184,25620998,CN
chr09,Bn36515,52111731,67713889,15602158,CN
chr09,Bn36516,7346826,81895902,74549076,RLP
chr09,Bn36517,4309377,88079833,83770456,TNL
chr09,Bn36518,18131728,65899072,47767344,CNL
chr09,Bn36519,36934516,77669118,40734602,TNL
chr09,Bn36520,25247992,29063869,3815877,RLK
chr09,Bn36521,74953538,86689131,11735593,RLP
chr09,Bn36522,24069587,30072823,6003236,RLP
chr09,Bn36523,97833432,98712509,879077,TN
chr09,Bn36524,99465334,99520330,54996,NBS
chr09,Bn36525,26798152,58120252,31322100,NBS
chr09,Bn36526,82870220,99225182,16354962,RLP
chr09,Bn36527,67726626,70711266,2984640,CN
chr09,Bn36528,31648134,99971159,68323025,RLP
chr09,Bn36529,42540292,44211542,1671250,TN
chr09,Bn36530,31834619,70445596,38610977,RLK
chr09,Bn36531,28996794,45675052,16678258,NBS
chr09,Bn36532,91156055,99259106,8103051,CNL
chr09,Bn36533,54419716,77786743,23367027,CN
chr09,Bn36534,45226970,87141628,41914658,RLK
chr09,Bn36535,14016633,78566831,64550198,CN
chr09,Bn36536,25305792,44083723,18777931,RLP
chr09,Bn36537,77025704,91570116,14544412,RLK
chr09,Bn36538,75665028,79231619,3566591,CN
chr09,Bn36539,25101241,61781908,36680667,CNL
chr09,Bn36540,42285935,83903295,41617360,TNL
chr09,Bn36541,23615064,92855708,69240644,CNL
chr09,Bn36542,23166213,92417696,69251483,NBS
chr09,Bn36543,26189154,33159702,6970548,TNL
chr09,Bn36544,23867889,89445774,65577885,CN
chr09,Bn36545,71797133,80335474,8538341,NBS
chr09,Bn36546,81754388,93553070,11798682,TN
chr09,Bn36547,29463194,54661659,25198465,RLK
chr09,Bn36548,47678334,58483416,10805082,CN
chr09,Bn36549,88566294,96624086,8057792,NBS
chr09,Bn36550,59432167,83034028,23601861,NBS
chr09,Bn36551,59532831,93890318,34357487,CN
chr09,Bn36552,78328135,88012544,9684409,TNL
chr09,Bn36553,28272899,61397224,33124325,CN
chr09,Bn36554,95667606,96779114,1111508,CNL
chr09,Bn36555,60186257,70217734,10031477,CNL
chr09,Bn36556,38183462,71469279,33285817,CN
chr09,Bn36557,26615634,27521491,905857,TN
chr09,Bn36558,75699554,98271089,22571535,RLK
chr09,Bn36559,65217989,66422607,1204618,RLK
chr09,Bn36560,45847717,97997068,52149351,RLP
chr09,Bn36561,21902026,51057940,29155914,RLP
chr09,Bn36562,41167658,60221201,19053543,RLP
chr09,Bn36563,67214125,78131105,10916980,RLP
chr09,Bn36564,25122152,82006678,56884526,NBS
chr09,Bn36565,37631849,63950262,26318413,RLP
chr09,Bn36566,3773008,59648087,55875079,TNL
chr09,Bn36567,54816633,70216929,15400296,NBS
chr09,Bn36568,9869872,36669439,26799567,RLK
chr09,Bn36569,95158985,95477048,318063,TN
chr09,Bn36570,40731856,92435450,51703594,NBS
chr09,Bn36571,41360404,59966946,18606542,CN
chr09,Bn36572,92712531,96854803,4142272,RLK
chr09,Bn36573,14097041,24904637,10807596,RLP
chr09,Bn36574,69466307,97408080,27941773,RLK
chr09,Bn36575,33940508,67785484,33844976,TNL
chr09,Bn36576,54056156,63353346,9297190,CNL
chr09,Bn36577,4888101,40536873,35648772,NBS
chr09,Bn36578,28518317,75826844,47308527,CNL
chr09,Bn36579,51295075,88860612,37565537,CNL
chr09,Bn36580,38482653,51169887,12687234,TN
chr09,Bn36581,74585297,86921047,12335750,TN
chr09,Bn36582,10280590,50714007,40433417,TNL
chr09,Bn36583,48148733,50636336,2487603,RLP
chr09,Bn36584,87593316,90481582,2888266,RLP
chr09,Bn36585,31587706,57906771,26319065,TN
chr09,Bn36586,44005748,54724928,10719180,RLK
chr09,Bn36587,51741706,80883678,29141972,RLP
chr09,Bn36588,32639076,41823058,9183982,NBS
chr09,Bn36589,69857649,80523189,10665540,NBS
chr09,Bn36590,40439068,74289649,33850581,CN
chr09,Bn36591,58749047,83411668,24662621,TN
chr09,Bn36592,35979368,82433555,46454187,CNL
chr09,Bn36593,94302020,99943474,5641454,TNL
chr09,Bn36594,28582522,90460032,61877510,TN
chr09,Bn36595,40212450,89761597,49549147,RLP
chr09,Bn36596,1016868,24744709,23727841,NBS
chr09,Bn36597,96976959,98295389,1318430,NBS
chr09,Bn36598,77380955,99748838,22367883,NBS
chr09,Bn36599,40062274,64094250,24031976,RLK
chr09,Bn36600,93817527,97712634,3895107,RLP
chr09,Bn36601,98388472,98749255,360783,CNL
chr09,Bn36602,27339732,89818786,62479054,RLK
chr09,Bn36603,53552004,66668799,13116795,CN
chr09,Bn36604,3650523,41250800,37600277,TNL
chr09,Bn36605,55960942,69529414,13568472,TNL
chr09,Bn36606,36483274,74400083,37916809,TN
chr09,Bn36607,8867714,71079793,62212079,TNL
chr09,Bn36608,67149206,86457664,19308458,CN
chr09,Bn36609,49495364,71717694,22222330,NBS
chr09,Bn36610,81143406,97496557,16353151,RLK
chr09,Bn36611,21738609,26857828,5119219,TNL
chr09,Bn36612,46793601,83893493,37099892,RLP
chr09,Bn36613,34294608,54911488,20616880,NBS
chr09,Bn36614,11006373,13732903,2726530,TN
chr09,Bn36615,36474647,74745873,38271226,RLP
chr09,Bn36616,80350764,89572628,9221864,NBS
chr09,Bn36617,2226497,57865032,55638535,NBS
chr09,Bn36618,32223745,56032960,23809215,NBS
chr09,Bn36619,8883631,34171539,25287908,TNL
chr09,Bn36620,86849394,99953049,13103655,CNL
chr09,Bn36621,67802181,69092456,1290275,CN
chr09,Bn36622,90131093,95353462,5222369,RLK
chr09,Bn36623,61296609,88647139,27350530,TN
chr09,Bn36624,10115076,49648272,39533196,NBS
chr09,Bn36625,18028440,92109898,74081458,CNL
chr09,Bn36626,80114659,82198341,2083682,TN
chr09,Bn36627,15571161,31401832,15830671,RLP
chr09,Bn36628,33015987,75645595,42629608,TNL
chr09,Bn36629,1895313,10542980,8647667,RLP
chr09,Bn36630,43832894,97387532,53554638,TNL
chr09,Bn36631,76961556,88178577,11217021,CN
chr09,Bn36632,85944218,95425784,9481566,NBS
chr09,Bn36633,26687895,34288364,7600469,CN
chr09,Bn36634,69637728,88669437,19031709,RLK
chr09,Bn36635,30324347,54360442,24036095,RLK
chr09,Bn36636,6044671,73222273,67177602,RLK
chr09,Bn36637,30291536,51788825,21497289,RLK
chr09,Bn36638,21940407,52458585,30518178,RLP
chr09,Bn36639,83493200,96553567,13060367,RLP
chr09,Bn36640,30582208,78377807,47795599,CN
chr09,Bn36641,66652916,90837094,24184178,RLK
chr09,Bn36642,60442629,62971147,2528518,TN
chr09,Bn36643,20695388,27482775,6787387,RLP
chr09,Bn36644,25694818,72059436,46364618,RLP
chr09,Bn36645,75933931,88326315,12392384,RLP
chr09,Bn36646,32701326,49858860,17157534,TNL
chr09,Bn36647,90930386,98599937,7669551,TN
chr09,Bn36648,71103684,75190078,4086394,TN
chr09,Bn36649,19182700,87325137,68142437,RLK
chr09,Bn36650,9895867,13957049,4061182,CN
chr09,Bn36651,31559217,54819561,23260344,CN
chr09,Bn36652,3482554,92945505,89462951,CN
chr09,Bn36653,66851878,84687664,17835786,TNL
chr09,Bn36654,17627734,83672302,66044568,CNL
chr09,Bn36655,38642787,74212782,35569995,TN
chr09,Bn36656,8756180,32428223,23672043,CNL
chr09,Bn36657,36671465,60396893,23725428,RLP
chr09,Bn36658,89978340,91839494,1861154,CNL
chr09,Bn36659,92500277,93562887,1062610,NBS
chr09,Bn36660,93267476,98005207,4737731,TNL
chr09,Bn36661,50258497,97355880,47097383,NBS
chr09,Bn36662,14887151,18974112,4086961,CNL
chr09,Bn36663,5351463,57905433,52553970,TN
chr09,Bn36664,74382156,97063251,22681095,TN
chr09,Bn36665,47050003,59727314,12677311,CNL
chr09,Bn36666,31067562,51385881,20318319,RLP
chr09,Bn36667,47486499,55788820,8302321,NBS
chr09,Bn36668,87162189,89693714,2531525,TNL
chr09,Bn36669,54664827,86257933,31593106,RLK
chr09,Bn36670,8335162,16648839,8313677,NBS
chr09,Bn36671,94334726,95749856,1415130,NBS
chr09,Bn36672,91444289,99799703,8355414,TN
chr09,Bn36673,72912716,97387728,24475012,RLK
chr09,Bn36674,92505786,95043065,2537279,CNL
chr09,Bn36675,17662257,47774753,30112496,RLK
chr09,Bn36676,95022089,97167785,2145696,TNL
chr09,Bn36677,71825247,87975053,16149806,CN
chr09,Bn36678,21269126,75757809,54488683,RLK
chr09,Bn36679,7834239,61263816,53429577,NBS
chr09,Bn36680,51588861,75049993,23461132,CNL
chr09,Bn36681,92579619,98829184,6249565,RLK
chr09,Bn36682,90039007,93407706,3368699,NBS
chr09,Bn36683,48355364,91945545,43590181,CNL
chr09,Bn36684,22016889,98531744,76514855,CN
chr09,Bn36685,74859197,84169379,9310182,CNL
chr09,Bn36686,31630624,72200968,40570344,CN
chr09,Bn36687,94943685,97828057,2884372,CNL
chr09,Bn36688,5371525,75885151,70513626,CN
chr09,Bn36689,46806992,83498545,36691553,CNL
chr09,Bn36690,93470696,99545582,6074886,NBS
chr09,Bn36691,87252681,98004060,10751379,TNL
chr09,Bn36692,79643396,96327471,16684075,TN
chr09,Bn36693,29201281,47415459,18214178,CN
chr09,Bn36694,32268197,91161911,58893714,NBS
chr09,Bn36695,45059963,94553359,49493396,TNL
chr09,Bn36696,52514590,55682212,3167622,RLP
chr09,Bn36697,72789090,73810918,1021828,NBS
chr09,Bn36698,54083100,82470410,28387310,CNL
chr09,Bn36699,5413579,30180392,24766813,CNL
chr09,Bn36700,42850395,90558507,47708112,CN
chr09,Bn36701,10167885,39396380,29228495,TN
chr09,Bn36702,51172865,87124573,35951708,TN
chr09,Bn36703,59473793,74739346,15265553,TN
chr09,Bn36704,8315507,73566819,65251312,TNL
chr09,Bn36705,38398420,72613058,34214638,TN
chr09,Bn36706,52722793,71656495,18933702,RLP
chr09,Bn36707,89644892,93873435,4228543,NBS
chr09,Bn36708,11752548,79278726,67526178,TNL
chr09,Bn36709,9218508,53385139,44166631,TNL
chr09,Bn36710,21441137,31542988,10101851,NBS
chr09,Bn36711,29214574,58669770,29455196,CNL
chr09,Bn36712,5826908,30362964,24536056,RLP
chr09,Bn36713,90767202,93102043,2334841,RLP
chr09,Bn36714,27163994,67383334,40219340,TNL
chr09,Bn36715,28945167,98013689,69068522,CN
chr09,Bn36716,66791513,69002021,2210508,NBS
chr09,Bn36717,35561654,45034220,9472566,CN
chr09,Bn36718,42650367,82874580,40224213,NBS
chr09,Bn36719,47677318,84667724,36990406,CNL
chr09,Bn36720,64432473,82095739,17663266,CNL
chr09,Bn36721,26131879,74437647,48305768,RLK
chr09,Bn36722,19917806,75444629,55526823,RLP
chr09,Bn36723,3322795,41508977,38186182,CN
chr09,Bn36724,30062479,79623314,49560835,NBS
chr09,Bn36725,70843270,80794599,9951329,CNL
chr09,Bn36726,92878736,94699527,1820791,RLP
chr09,Bn36727,34566015,71192111,36626096,TN
chr09,Bn36728,69960031,74604934,4644903,RLK
chr09,Bn36729,97984996,98872610,887614,TNL
chr09,Bn36730,21351523,82967287,61615764,CNL
chr09,Bn36731,84417216,97499490,13082274,CN
chr09,Bn36732,66015345,79466110,13450765,RLK
chr09,Bn36733,41875185,48824791,6949606,RLK
chr09,Bn36734,36145160,89765191,53620031,CN
chr09,Bn36735,85346122,99530051,14183929,CN
chr09,Bn36736,51521827,71623872,20102045,RLP
chr09,Bn36737,74284576,99992154,25707578,CNL
chr09,Bn36738,38010098,53935213,15925115,CNL
chr09,Bn36739,58178411,87047904,28869493,CNL
chr09,Bn36740,99693159,99974474,281315,RLK
chr09,Bn36741,51566550,73838966,22272416,TN
chr09,Bn36742,63095839,70409288,7313449,RLP
chr09,Bn36743,34990054,92635027,57644973,NBS
chr09,Bn36744,23163078,82102979,58939901,RLP
chr09,Bn36745,59650671,93384655,33733984,NBS
chr09,Bn36746,83526994,89195513,5668519,TNL
chr09,Bn36747,76248027,97716937,21468910,TNL
chr09,Bn36748,5315660,8715856,3400196,CNL
chr09,Bn36749,20364219,34626359,14262140,RLP
chr09,Bn36750,61773289,80422194,18648905,RLP
chr09,Bn36751,6194046,85854614,79660568,RLK
chr09,Bn36752,57346095,80274471,22928376,RLK
chr09,Bn36753,69071439,92091112,23019673,RLP
chr09,Bn36754,60483378,95752538,35269160,RLK
chr09,Bn36755,61422194,94098350,32676156,RLK
chr09,Bn36756,40781328,63405061,22623733,TNL
chr09,Bn36757,49014143,70243627,21229484,NBS
chr09,Bn36758,25321609,79669908,54348299,TN
chr09,Bn36759,84538970,87850536,3311566,CNL
chr09,Bn36760,1809955,80395245,78585290,RLK
chr09,Bn36761,76653772,81739943,5086171,RLK
chr09,Bn36762,11919935,55599580,43679645,RLK
chr09,Bn36763,6070070,68755198,62685128,TN
chr09,Bn36764,9037773,23962436,14924663,TN
chr09,Bn36765,55260193,58508550,3248357,TNL
chr09,Bn36766,56509156,70909620,14400464,RLK
chr09,Bn36767,6471891,13524593,7052702,NBS
chr09,Bn36768,72270425,83124435,10854010,CN
chr09,Bn36769,25171748,67045485,41873737,RLK
chr09,Bn36770,69804048,77191594,7387546,TN
chr09,Bn36771,27718425,64301362,36582937,TNL
chr09,Bn36772,5889767,33980298,28090531,TNL
chr09,Bn36773,91318099,99793111,8475012,TN
chr09,Bn36774,76500994,91653025,15152031,CNL
chr09,Bn36775,72378960,86068622,13689662,RLK
chr09,Bn36776,63506448,90604246,27097798,RLP
chr09,Bn36777,52038528,96402341,44363813,TNL
chr09,Bn36778,75683956,87552344,11868388,TNL
chr09,Bn36779,2389043,16094478,13705435,RLP
chr09,Bn36780,7632385,48267816,40635431,CNL
chr09,Bn36781,68816555,96228971,27412416,NBS
chr09,Bn36782,10734514,88217100,77482586,RLP
chr09,Bn36783,69749686,74849898,5100212,NBS
chr09,Bn36784,42321588,46202997,3881409,TNL
chr09,Bn36785,69181234,84599555,15418321,CNL
chr09,Bn36786,42761529,46960977,4199448,TNL
chr09,Bn36787,84854435,98788393,13933958,TN
chr09,Bn36788,32188505,53612816,21424311,NBS
chr09,Bn36789,22080382,26727317,4646935,RLK
chr09,Bn36790,82493481,96546420,14052939,CNL
chr09,Bn36791,13611727,25026487,11414760,NBS
chr09,Bn36792,21141799,22185216,1043417,RLP
chr09,Bn36793,16510833,87126789,70615956,RLK
chr09,Bn36794,55811514,80121736,24310222,TN
chr09,Bn36795,21154245,64813081,43658836,CNL
chr09,Bn36796,74191860,93709581,19517721,TN
chr09,Bn36797,50579219,67274991,16695772,TNL
chr09,Bn36798,29401785,94320836,64919051,RLP
chr09,Bn36799,86825661,91383259,4557598,RLK
chr09,Bn36800,15339152,76615650,61276498,CNL
chr09,Bn36801,74584686,87525421,12940735,RLK
chr09,Bn36802,49415670,95426500,46010830,TN
chr09,Bn36803,47233734,58228527,10994793,TN
chr09,Bn36804,33458718,40681317,7222599,RLK
chr09,Bn36805,35814698,38785007,2970309,CNL
chr09,Bn36806,19333379,43535353,24201974,NBS
chr09,Bn36807,23631871,50922414,27290543,RLK
chr09,Bn36808,58792317,81728856,22936539,RLK
chr09,Bn36809,78766668,81928174,3161506,NBS
chr09,Bn36810,3632884,17496361,13863477,RLK
chr09,Bn36811,54298877,57342587,3043710,TN
chr09,Bn36812,37091175,91852201,54761026,TN
chr09,Bn36813,93622573,95962734,2340161,RLP
chr09,Bn36814,25284808,38379711,13094903,CN
chr09,Bn36815,77000762,90481814,13481052,RLK
chr09,Bn36816,87264161,97480184,10216023,CN
chr09,Bn36817,76666963,94196731,17529768,CN
chr09,Bn36818,5975904,43278992,37303088,CN
chr09,Bn36819,72389989,91998040,19608051,CNL
chr09,Bn36820,59807864,78088027,18280163,CN
chr09,Bn36821,12168412,18004918,5836506,TN
chr09,Bn36822,16203906,40650499,24446593,RLK
chr09,Bn36823,11908176,54445500,42537324,CNL
chr09,Bn36824,33328366,96657505,63329139,TN
chr09,Bn36825,87582256,92387601,4805345,NBS
chr09,Bn36826,89828617,90350650,522033,NBS
chr09,Bn36827,56135730,79418510,23282780,CNL
chr09,Bn36828,63948547,70645557,6697010,CN
chr09,Bn36829,7206724,36268051,29061327,TN
chr09,Bn36830,29827580,62140835,32313255,TNL
chr09,Bn36831,59765518,62325324,2559806,CNL
chr09,Bn36832,48925979,51694822,2768843,CN
chr09,Bn36833,80465548,98388109,17922561,CNL
chr09,Bn36834,47620065,54155819,6535754,TN
chr09,Bn36835,8880606,80616494,71735888,CN
chr09,Bn36836,67243593,91992483,24748890,TN
chr09,Bn36837,50632201,52529746,1897545,CN
chr09,Bn36838,38478360,81613513,43135153,CNL
chr09,Bn36839,79792005,82172363,2380358,TNL
chr09,Bn36840,67732417,74592733,6860316,CNL
chr09,Bn36841,38914062,67059121,28145059,CNL
chr09,Bn36842,67662369,68359883,697514,CNL
chr09,Bn36843,56168768,68737195,12568427,CN
chr09,Bn36844,26539485,46703083,20163598,NBS
chr09,Bn36845,59397170,82559879,23162709,NBS
chr09,Bn36846,53249004,55356036,2107032,TNL
chr09,Bn36847,84634407,84666820,32413,TN
chr09,Bn36848,19832954,87157472,67324518,TNL
chr09,Bn36849,34095369,75127879,41032510,NBS
chr09,Bn36850,60118646,64942352,4823706,NBS
chr09,Bn36851,59254404,75695227,16440823,RLK
chr09,Bn36852,62437084,79561650,17124566,TNL
chr09,Bn36853,17999166,47926830,29927664,CN
chr09,Bn36854,24035372,81237822,57202450,RLP
chr09,Bn36855,92391010,95926332,3535322,CN
chr09,Bn36856,2143382,37679299,35535917,RLP
chr09,Bn36857,80594575,99353650,18759075,NBS
chr09,Bn36858,45411689,51658485,6246796,TN
chr09,Bn36859,7102007,96371201,89269194,TN
chr09,Bn36860,41019604,85260394,44240790,TNL
chr09,Bn36861,68371107,78117920,9746813,RLK
chr09,Bn36862,20388902,95274526,74885624,CNL
chr09,Bn36863,14837713,93294645,78456932,RLK
chr09,Bn36864,50023719,82178899,32155180,TN
chr09,Bn36865,94782146,98950158,4168012,TNL
chr09,Bn36866,53294389,58484819,5190430,TN
chr09,Bn36867,39440959,52623409,13182450,TNL
chr09,Bn36868,52342812,67487589,15144777,CNL
chr09,Bn36869,50482497,58544846,8062349,CNL
chr09,Bn36870,8835027,71982203,63147176,RLP
chr09,Bn36871,55995246,94574306,38579060,RLK
chr09,Bn36872,87035508,89059445,2023937,RLK
chr09,Bn36873,27304699,59620749,32316050,CN
chr09,Bn36874,83481894,94902452,11420558,RLP
chr09,Bn36875,93648685,96161501,2512816,CN
chr09,Bn36876,36939052,59776642,22837590,RLK
chr09,Bn36877,3593862,57344144,53750282,RLK
chr09,Bn36878,7058548,29451102,22392554,RLK
chr09,Bn36879,76480885,96768434,20287549,CNL
chr09,Bn36880,77346439,92927338,15580899,TNL
chr09,Bn36881,33336070,53701654,20365584,TNL
chr09,Bn36882,1489420,85102511,83613091,RLP
chr09,Bn36883,38308473,77280769,38972296,CNL
chr09,Bn36884,25072930,43888224,18815294,CN
chr09,Bn36885,22106219,91802499,69696280,TN
chr09,Bn36886,82722472,83301463,578991,RLP
chr09,Bn36887,80786233,90890902,10104669,TN
chr09,Bn36888,50119508,67161542,17042034,TNL
chr09,Bn36889,34793341,35098371,305030,RLP
chr09,Bn36890,19201350,21338184,2136834,CN
chr09,Bn36891,94334610,94848634,514024,NBS
chr09,Bn36892,56893131,87993285,31100154,NBS
chr09,Bn36893,48186807,68909716,20722909,NBS
chr09,Bn36894,54522496,69190216,14667720,CNL
chr09,Bn36895,42650913,70924191,28273278,RLP
chr09,Bn36896,80323890,90393426,10069536,CN
chr09,Bn36897,87021387,89785795,2764408,CNL
chr09,Bn36898,4619558,90092663,85473105,NBS
chr09,Bn36899,49549466,72506871,22957405,NBS
chr09,Bn36900,16265428,16842989,577561,TNL
chr09,Bn36901,70504973,99918843,29413870,CNL
chr09,Bn36902,14694019,95285442,80591423,TN
chr09,Bn36903,61610583,62880909,1270326,RLK
chr09,Bn36904,47946479,63483462,15536983,NBS
chr09,Bn36905,10004448,64748412,54743964,RLK
chr09,Bn36906,20368206,52562875,32194669,RLK
chr09,Bn36907,78289799,81237359,2947560,NBS
chr09,Bn36908,19787190,26231689,6444499,CNL
chr09,Bn36909,94276947,97672171,3395224,NBS
chr09,Bn36910,21109346,84126805,63017459,CNL
chr09,Bn36911,81715729,98212230,16496501,CNL
chr09,Bn36912,95439583,97277708,1838125,TN
chr09,Bn36913,53672839,62158428,8485589,TN
chr09,Bn36914,35392502,78216315,42823813,NBS
chr09,Bn36915,24331665,93450457,69118792,TN
chr09,Bn36916,67224078,69401222,2177144,CN
chr09,Bn36917,33631430,81414824,47783394,RLK
chr09,Bn36918,1213608,72720727,71507119,TNL
chr09,Bn36919,49125199,74952121,25826922,RLK
chr09,Bn36920,3937583,11491543,7553960,TN
chr09,Bn36921,90158736,92778758,2620022,RLK
chr09,Bn36922,33669160,51558728,17889568,TNL
chr09,Bn36923,99601877,99639519,37642,RLK
chr09,Bn36924,9415936,82502617,73086681,TNL
chr09,Bn36925,80463624,86567113,6103489,CNL
chr09,Bn36926,16737186,74064952,57327766,RLK
chr09,Bn36927,39140348,39578421,438073,RLP
chr09,Bn36928,44017979,99653391,55635412,CNL
chr09,Bn36929,91877520,92542298,664778,NBS
chr09,Bn36930,65659659,77698136,12038477,CNL
chr09,Bn36931,20048652,67692592,47643940,TN
chr09,Bn36932,25202502,65656971,40454469,RLK
chr09,Bn36933,40837819,86070091,45232272,RLK
chr09,Bn36934,84768875,92271792,7502917,CN
chr09,Bn36935,10252169,25686457,15434288,CN
chr09,Bn36936,9636301,63797616,54161315,CNL
chr09,Bn36937,8490535,87716220,79225685,TN
chr09,Bn36938,14954986,30733753,15778767,TN
chr09,Bn36939,68480482,86529097,18048615,TN
chr09,Bn36940,93618202,97033717,3415515,TN
chr09,Bn36941,87846797,92957714,5110917,NBS
chr09,Bn36942,86103887,99888570,13784683,NBS
chr09,Bn36943,95705456,99029119,3323663,RLK
chr09,Bn36944,77113505,85050563,7937058,TN
chr09,Bn36945,36613352,60265437,23652085,TN
chr09,Bn36946,25926774,98346133,72419359,TNL
chr09,Bn36947,73250879,86315415,13064536,NBS
chr09,Bn36948,92678740,96878376,4199636,CN
chr09,Bn36949,29722352,76732053,47009701,CNL
chr09,Bn36950,11244676,45284908,34040232,RLP
chr09,Bn36951,53889502,54909545,1020043,TNL
chr09,Bn36952,33038455,71895468,38857013,CNL
chr09,Bn36953,91583614,95641758,4058144,NBS
chr09,Bn36954,66188808,94919666,28730858,RLP
chr09,Bn36955,57977607,85414652,27437045,TNL
chr09,Bn36956,2906636,8176089,5269453,TN
chr09,Bn36957,81501520,89784620,8283100,TN
chr09,Bn36958,96210478,98216801,2006323,CN
chr09,Bn36959,70299561,94150531,23850970,CN
chr09,Bn36960,34014808,48413878,14399070,TNL
chr09,Bn36961,50144877,83772309,33627432,NBS
chr09,Bn36962,83385181,84940364,1555183,CN
chr09,Bn36963,85908660,96437807,10529147,CNL
chr09,Bn36964,76912590,77499909,587319,TNL
chr09,Bn36965,98592965,98626808,33843,TNL
chr09,Bn36966,95962126,97661560,1699434,TN
chr09,Bn36967,38676481,96962975,58286494,CN
chr09,Bn36968,37472219,75353406,37881187,NBS
chr09,Bn36969,94195837,96008433,1812596,CNL
chr09,Bn36970,83769494,84004141,234647,CNL
chr09,Bn36971,58357891,70196680,11838789,TNL
chr09,Bn36972,18410507,94914573,76504066,TN
chr09,Bn36973,44805911,82968895,38162984,CN
chr09,Bn36974,33709177,35038803,1329626,RLK
chr09,Bn36975,58386481,86026683,27640202,RLK
chr09,Bn36976,60561442,84561259,23999817,RLK
chr09,Bn36977,30421034,96653006,66231972,RLP
chr09,Bn36978,39350841,51952860,12602019,CN
chr09,Bn36979,69521429,72821754,3300325,RLK
chr09,Bn36980,43700915,96147255,52446340,RLK
chr09,Bn36981,62407197,83714226,21307029,TN
chr09,Bn36982,58655745,94897953,36242208,CNL
chr09,Bn36983,50526964,74271466,23744502,CNL
chr09,Bn36984,40016575,68886994,28870419,NBS
chr09,Bn36985,48190427,95384406,47193979,TNL
chr09,Bn36986,67973999,92867863,24893864,RLK
chr09,Bn36987,54204281,76932762,22728481,RLK
chr09,Bn36988,45620090,77047693,31427603,CNL
chr09,Bn36989,14103112,66645268,52542156,CN
chr09,Bn36990,19836578,29177028,9340450,RLP
chr09,Bn36991,62104864,77763490,15658626,TN
chr09,Bn36992,99392989,99417582,24593,NBS
chr09,Bn36993,19255356,19612121,356765,TN
chr09,Bn36994,92459374,94748651,2289277,CNL
chr09,Bn36995,97345564,98343548,997984,TNL
chr09,Bn36996,53329872,88515402,35185530,RLP
chr09,Bn36997,82207945,82993269,785324,TN
chr09,Bn36998,54203918,74706390,20502472,CN
chr09,Bn36999,4819911,20586976,15767065,TN
chr09,Bn37000,18522471,83048885,64526414,NBS
chr09,Bn37001,14102460,45513184,31410724,CNL
chr09,Bn37002,96585350,99664677,3079327,NBS
chr09,Bn37003,5612942,61972529,56359587,RLP
chr09,Bn37004,78287538,92504892,14217354,TN
chr09,Bn37005,13457124,81265139,67808015,TNL
chr09,Bn37006,12448580,41356158,28907578,TNL
chr09,Bn37007,55451181,70015382,14564201,TN
chr09,Bn37008,47074647,92585016,45510369,TN
chr09,Bn37009,86382565,87534898,1152333,TNL
chr09,Bn37010,86335992,89830517,3494525,TNL
chr09,Bn37011,99106328,99840592,734264,TN
chr09,Bn37012,58477307,73031926,14554619,TN
chr09,Bn37013,44842548,91752026,46909478,TNL
chr09,Bn37014,7475764,39605968,32130204,RLK
chr09,Bn37015,95579875,98483581,2903706,RLK
chr09,Bn37016,13578870,57242568,43663698,RLK
chr09,Bn37017,37592568,58909322,21316754,RLK
chr09,Bn37018,83368660,83463271,94611,RLP
chr09,Bn37019,29284323,62763357,33479034,CNL
chr09,Bn37020,10325160,31179007,20853847,RLK
chr09,Bn37021,93597670,93613792,16122,CNL
chr09,Bn37022,23130934,84332692,61201758,TNL
chr09,Bn37023,93804873,98859309,5054436,CNL
chr09,Bn37024,10171361,90000933,79829572,RLP
chr09,Bn37025,85560707,95805723,10245016,TNL
chr09,Bn37026,84448224,91711008,7262784,TNL
chr09,Bn37027,70435298,76027713,5592415,NBS
chr09,Bn37028,68817755,92213763,23396008,RLP
chr09,Bn37029,44155787,76988569,32832782,RLP
chr09,Bn37030,50336488,65795917,15459429,CN
chr09,Bn37031,96915939,97541319,625380,RLK
chr09,Bn37032,46561110,72727452,26166342,CN
chr09,Bn37033,64846982,97797953,32950971,RLK
chr09,Bn37034,69409707,90165072,20755365,RLK
chr09,Bn37035,88861604,96518188,7656584,RLP
chr09,Bn37036,99404350,99471834,67484,TNL
chr09,Bn37037,55898216,64910189,9011973,TNL
chr09,Bn37038,15210205,18144316,2934111,RLK
chr09,Bn37039,23247761,47197160,23949399,CNL
chr09,Bn37040,96515215,97728690,1213475,CNL
chr09,Bn37041,92753805,97920264,5166459,TNL
chr09,Bn37042,77852314,96057085,18204771,CNL
chr09,Bn37043,54512395,97483184,42970789,RLP
chr09,Bn37044,69291256,92911979,23620723,TNL
chr09,Bn37045,53602382,66834387,13232005,TNL
chr09,Bn37046,81588247,99390727,17802480,TNL
chr09,Bn37047,12706539,47180234,34473695,CNL
chr09,Bn37048,32975666,93075593,60099927,CN
chr09,Bn37049,47282435,86615764,39333329,NBS
chr09,Bn37050,81202544,83214430,2011886,NBS
chr09,Bn37051,10795777,35950174,25154397,NBS
chr09,Bn37052,48168241,91861830,43693589,TN
chr09,Bn37053,31663864,36707671,5043807,RLP
chr09,Bn37054,19269918,58060015,38790097,TNL
chr09,Bn37055,46180567,82409503,36228936,CNL
chr09,Bn37056,80367197,99068190,18700993,NBS
chr09,Bn37057,50558670,87815162,37256492,TNL
chr09,Bn37058,64253261,83645670,19392409,RLK
chr09,Bn37059,76455420,82839110,6383690,RLK
chr09,Bn37060,72437051,98751117,26314066,NBS
chr09,Bn37061,18591590,68851568,50259978,CN
chr09,Bn37062,1552101,72713374,71161273,CNL
chr09,Bn37063,64992081,77537551,12545470,CN
chr09,Bn37064,44564743,98018049,53453306,RLP
chr09,Bn37065,10085179,65486494,55401315,CNL
chr09,Bn37066,69158784,91839774,22680990,CNL
chr09,Bn37067,72166623,83747062,11580439,RLK
chr09,Bn37068,95194340,98606939,3412599,TNL
chr09,Bn37069,34403301,74308501,39905200,TN
chr09,Bn37070,13843412,95856661,82013249,RLK
chr09,Bn37071,22811142,27743099,4931957,CNL
chr09,Bn37072,41283602,94324759,53041157,RLK
chr09,Bn37073,68887703,81541657,12653954,RLP
chr09,Bn37074,55334705,78293718,22959013,RLP
chr09,Bn37075,77900644,82238094,4337450,TNL
chr09,Bn37076,9449742,26332808,16883066,CN
chr09,Bn37077,44206371,86478508,42272137,RLK
chr09,Bn37078,86503637,98447548,11943911,TN
chr09,Bn37079,98280510,98678776,398266,CN
chr09,Bn37080,58085480,67359756,9274276,RLK
chr09,Bn37081,64610199,96374655,31764456,CN
chr09,Bn37082,92286412,96615788,4329376,TNL
chr09,Bn37083,88730007,98258434,9528427,RLK
chr09,Bn37084,25933681,45688351,19754670,TNL
chr09,Bn37085,70137134,73466712,3329578,RLK
chr09,Bn37086,47743585,76044619,28301034,TNL
chr09,Bn37087,69190116,79916670,10726554,NBS
chr09,Bn37088,89414370,90632639,1218269,TNL
chr09,Bn37089,50201775,55820479,5618704,RLP
chr09,Bn37090,22314896,62444799,40129903,CNL
chr09,Bn37091,15339388,38331596,22992208,RLP
chr09,Bn37092,44626925,66997595,22370670,RLP
chr09,Bn37093,2676305,12552948,9876643,NBS
chr09,Bn37094,25434994,95766968,70331974,NBS
chr09,Bn37095,3867214,56369293,52502079,TNL
chr09,Bn37096,23874213,41253397,17379184,TN
chr09,Bn37097,93154144,96235961,3081817,NBS
chr09,Bn37098,87793133,99340932,11547799,CNL
chr09,Bn37099,89022501,98993335,9970834,TNL
chr09,Bn37100,69621781,73866013,4244232,TNL
chr09,Bn37101,55984070,91545058,35560988,TN
chr09,Bn37102,4419105,30658572,26239467,TNL
chr09,Bn37103,86818547,95001584,8183037,CN
chr09,Bn37104,24626112,55447390,30821278,NBS
chr09,Bn37105,43195453,53530685,10335232,TNL
chr09,Bn37106,67715504,76013429,8297925,TN
chr09,Bn37107,74546348,94051481,19505133,NBS
chr09,Bn37108,25090671,77770671,52680000,TNL
chr09,Bn37109,76548189,82018325,5470136,CNL
chr09,Bn37110,34679598,43179421,8499823,NBS
chr09,Bn37111,11739519,12638775,899256,TN
chr09,Bn37112,36494474,71274717,34780243,TNL
chr09,Bn37113,58666877,84037061,25370184,CN
chr09,Bn37114,14703208,38153839,23450631,CN
chr09,Bn37115,77349920,98024000,20674080,RLP
chr09,Bn37116,89368604,99675332,10306728,CN
chr09,Bn37117,78900282,99773216,20872934,RLP
chr09,Bn37118,84483104,84947189,464085,CNL
chr09,Bn37119,94317339,96685774,2368435,RLP
chr09,Bn37120,61964104,71221757,9257653,CN
chr09,Bn37121,59062132,61133615,2071483,RLK
chr09,Bn37122,3996284,11866205,7869921,NBS
chr09,Bn37123,98261562,98542854,281292,CNL
chr09,Bn37124,24606210,77258261,52652051,CNL
chr09,Bn37125,25655599,55042528,29386929,CNL
chr09,Bn37126,71681370,93250678,21569308,TNL
chr09,Bn37127,55878477,86330295,30451818,RLP
chr09,Bn37128,27926992,74172049,46245057,TNL
chr09,Bn37129,98847503,99364556,517053,NBS
chr09,Bn37130,3168955,99849404,96680449,CN
chr09,Bn37131,96320264,96559426,239162,TNL
chr09,Bn37132,47213044,79576406,32363362,RLP
chr09,Bn37133,11881459,62067247,50185788,CN
chr09,Bn37134,83543004,89906693,6363689,TN
chr09,Bn37135,61116360,68271003,7154643,NBS
chr09,Bn37136,91378823,96419285,5040462,RLK
chr09,Bn37137,69797964,71175914,1377950,NBS
chr09,Bn37138,97172537,99012376,1839839,TNL
chr09,Bn37139,42758301,66359951,23601650,TN
chr09,Bn37140,99566322,99710210,143888,CN
chr09,Bn37141,56692754,88312032,31619278,CN
chr09,Bn37142,49401290,82494420,33093130,CN
chr09,Bn37143,17096792,67069814,49973022,RLP
chr09,Bn37144,27214782,99490831,72276049,CNL
chr09,Bn37145,92629242,92697745,68503,CNL
chr09,Bn37146,55269892,65661562,10391670,TNL
chr09,Bn37147,67772701,69003915,1231214,CN
chr09,Bn37148,88488526,98846395,10357869,TN
chr09,Bn37149,62348652,71099784,8751132,TNL
chr09,Bn37150,11480547,35906313,24425766,CN
chr09,Bn37151,68208758,91980161,23771403,TN
chr09,Bn37152,94012476,98620987,4608511,RLK
chr09,Bn37153,53937143,94442962,40505819,NBS
chr09,Bn37154,4519975,64773769,60253794,TNL
chr09,Bn37155,19536787,68794281,49257494,NBS
chr09,Bn37156,57690391,91321661,33631270,CN
chr09,Bn37157,84012153,86282040,2269887,TNL
chr09,Bn37158,39962312,78672807,38710495,RLK
chr09,Bn37159,94531132,95299809,768677,TN
chr09,Bn37160,70079125,70243275,164150,RLK
chr09,Bn37161,68570277,93771341,25201064,TNL
chr09,Bn37162,22277318,67425293,45147975,RLK
chr09,Bn37163,9079705,53800638,44720933,RLK
chr09,Bn37164,20010294,20910142,899848,TN
chr09,Bn37165,35991090,52213824,16222734,NBS
chr09,Bn37166,8067554,70197126,62129572,CNL
chr09,Bn37167,7964477,41065897,33101420,RLP
chr09,Bn37168,12188955,89730472,77541517,NBS
chr09,Bn37169,63377147,99468355,36091208,TNL
chr09,Bn37170,40766138,75547356,34781218,TN
chr09,Bn37171,83922374,87980611,4058237,NBS
chr09,Bn37172,31247969,64824732,33576763,CNL
chr09,Bn37173,31226464,69477952,38251488,TN
chr09,Bn37174,32332027,53490141,21158114,CN
chr09,Bn37175,35951515,87625321,51673806,NBS
chr09,Bn37176,9273102,16421274,7148172,TN
chr09,Bn37177,13015863,87295808,74279945,RLK
chr09,Bn37178,74065134,82586521,8521387,TNL
chr09,Bn37179,30924449,95578403,64653954,TNL
chr09,Bn37180,82935784,83824784,889000,CN
chr09,Bn37181,9722463,57301652,47579189,CN
chr09,Bn37182,47881530,90603785,42722255,CN
chr09,Bn37183,41998286,70107890,28109604,CN
chr09,Bn37184,80016624,95888682,15872058,CN
chr09,Bn37185,77067330,94366003,17298673,CNL
chr09,Bn37186,8202851,68192353,59989502,RLK
chr09,Bn37187,50025697,92549176,42523479,TN
chr09,Bn37188,92777514,96041741,3264227,RLK
chr09,Bn37189,28236639,61808973,33572334,CNL
chr09,Bn37190,67860383,93568127,25707744,CN
chr09,Bn37191,45448274,64687840,19239566,CN
chr09,Bn37192,99935105,99957949,22844,NBS
chr09,Bn37193,2470090,92865505,90395415,NBS
chr09,Bn37194,19120623,23951204,4830581,TN
chr09,Bn37195,90183857,98525280,8341423,TNL
chr09,Bn37196,24336855,65330964,40994109,RLP
chr09,Bn37197,16006780,42833464,26826684,CN
chr09,Bn37198,40053268,66499675,26446407,NBS
chr09,Bn37199,24121303,84694798,60573495,RLP
chr09,Bn37200,39008894,97263393,58254499,CN
chr09,Bn37201,86028329,92942795,6914466,CN
chr09,Bn37202,85628167,86295603,667436,CN
chr09,Bn37203,84130560,88159766,4029206,RLK
chr09,Bn37204,88953022,94254828,5301806,CN
chr09,Bn37205,2312010,92697456,90385446,TN
chr09,Bn37206,59452021,87674036,28222015,CNL
chr09,Bn37207,4997717,49971503,44973786,TNL
chr09,Bn37208,79380197,80462440,1082243,RLK
chr09,Bn37209,32516071,46793917,14277846,TN
chr09,Bn37210,5756743,16643272,10886529,RLP
chr09,Bn37211,1107349,79127992,78020643,CNL
chr09,Bn37212,97174384,99607554,2433170,TN
chr09,Bn37213,57303459,72841080,15537621,TNL
chr09,Bn37214,36223648,92242155,56018507,TNL
chr09,Bn37215,26632780,66154507,39521727,RLP
chr09,Bn37216,94258405,95485817,1227412,TN
chr09,Bn37217,86277340,94745347,8468007,TN
chr09,Bn37218,58442102,63253794,4811692,CNL
chr09,Bn37219,92321477,93207475,885998,CN
chr09,Bn37220,58752516,98555087,39802571,TN
chr09,Bn37221,62210359,64182677,1972318,TN
chr09,Bn37222,72324557,95674455,23349898,TN
chr09,Bn37223,50641740,53531139,2889399,CNL
chr09,Bn37224,92507390,98015423,5508033,TN
chr09,Bn37225,71870514,86854780,14984266,CN
chr09,Bn37226,96749596,97784901,1035305,TN
chr09,Bn37227,76020569,81507266,5486697,TNL
chr09,Bn37228,34086837,87194262,53107425,RLP
chr09,Bn37229,71948288,79056888,7108600,CNL
chr09,Bn37230,77216562,77714959,498397,RLK
chr09,Bn37231,85992398,89265150,3272752,RLP
chr09,Bn37232,47589553,77780929,30191376,RLK
chr09,Bn37233,15626420,67684212,52057792,TNL
chr09,Bn37234,47991880,54742912,6751032,NBS
chr09,Bn37235,65114251,80410003,15295752,TNL
chr09,Bn37236,87280195,92798262,5518067,CN
chr09,Bn37237,67208584,76537828,9329244,RLK
chr09,Bn37238,24398845,74804786,50405941,TNL
chr09,Bn37239,76456368,90353625,13897257,RLP
chr09,Bn37240,69562052,83314822,13752770,CN
chr09,Bn37241,96995122,98776842,1781720,NBS
chr09,Bn37242,95091712,99936955,4845243,NBS
chr09,Bn37243,28961761,81090506,52128745,CN
chr09,Bn37244,44963034,76560044,31597010,CNL
chr09,Bn37245,22071796,44992820,22921024,CN
chr09,Bn37246,20733403,72228789,51495386,RLP
chr09,Bn37247,40016074,84818878,44802804,RLP
chr09,Bn37248,75840041,98586962,22746921,TN
chr09,Bn37249,25961176,95361641,69400465,CNL
chr09,Bn37250,25840328,52787867,26947539,TN
chr09,Bn37251,50613019,69795651,19182632,TNL
chr09,Bn37252,48474480,64584503,16110023,TN
chr09,Bn37253,4640565,6013783,1373218,TNL
chr09,Bn37254,80513631,82138927,1625296,TNL
chr09,Bn37255,36460055,95327863,58867808,NBS
chr09,Bn37256,23681278,56434730,32753452,TNL
chr09,Bn37257,51494549,90812169,39317620,CNL
chr09,Bn37258,71556356,81316528,9760172,TN
chr09,Bn37259,68546775,78372685,9825910,TN
chr09,Bn37260,16606293,38611622,22005329,CN
chr09,Bn37261,41196613,86806633,45610020,RLP
chr09,Bn37262,53255962,95938159,42682197,RLK
chr09,Bn37263,33599312,74112977,40513665,CNL
chr09,Bn37264,63980299,65544722,1564423,TNL
chr09,Bn37265,65882140,85920510,20038370,RLP
chr09,Bn37266,60062964,93289014,33226050,CN
chr09,Bn37267,94862842,95786708,923866,RLK
chr09,Bn37268,24743360,46505566,21762206,NBS
chr09,Bn37269,86358047,88455963,2097916,CN
chr09,Bn37270,28071558,72915264,44843706,NBS
chr09,Bn37271,49307131,58970753,9663622,CN
chr09,Bn37272,38830885,46118132,7287247,RLP
chr09,Bn37273,66453888,84843202,18389314,RLK
chr09,Bn37274,50052852,55336692,5283840,RLP
chr09,Bn37275,26366483,57213461,30846978,TN
chr09,Bn37276,64707464,89109951,24402487,CN
chr09,Bn37277,2070988,71495316,69424328,RLP
chr09,Bn37278,76291072,93204356,16913284,CN
chr09,Bn37279,90231618,92739197,2507579,CN
chr09,Bn37280,98043461,99227733,1184272,TNL
chr09,Bn37281,79301418,89151194,9849776,TNL
chr09,Bn37282,46952279,61993993,15041714,TN
chr09,Bn37283,77583799,87405320,9821521,CNL
chr09,Bn37284,66842434,99357979,32515545,RLK
chr09,Bn37285,19210626,30877124,11666498,NBS
chr09,Bn37286,79796334,82268430,2472096,RLP
chr09,Bn37287,34861746,45841304,10979558,CNL
chr09,Bn37288,43495679,98497968,55002289,NBS
chr09,Bn37289,34648774,87581529,52932755,CNL
chr09,Bn37290,61650719,63551489,1900770,NBS
chr09,Bn37291,19768094,40034476,20266382,CN
chr09,Bn37292,42503963,63749959,21245996,TNL
chr09,Bn37293,25349879,39010196,13660317,CN
chr09,Bn37294,69389132,86330034,16940902,TN
chr09,Bn37295,38052598,60167875,22115277,RLK
chr09,Bn37296,19172905,31609269,12436364,TNL
chr09,Bn37297,65670680,91055783,25385103,RLP
chr09,Bn37298,70788305,73482270,2693965,TNL
chr09,Bn37299,75706700,96915946,21209246,TN
chr09,Bn37300,92319229,94778271,2459042,RLK
chr09,Bn37301,52568101,95288737,42720636,TNL
chr09,Bn37302,25371787,76120153,50748366,TNL
chr09,Bn37303,20165252,79097696,58932444,TNL
chr09,Bn37304,94231807,96172718,1940911,RLP
chr09,Bn37305,41698786,97846546,56147760,TNL
chr09,Bn37306,95129706,98086055,2956349,TN
chr09,Bn37307,61202037,96724393,35522356,CN
chr09,Bn37308,68237309,95076518,26839209,TN
chr09,Bn37309,61011337,87029438,26018101,CNL
chr09,Bn37310,50454029,99330712,48876683,CN
chr09,Bn37311,28661757,91465372,62803615,TN
chr09,Bn37312,55001273,76628147,21626874,NBS
chr09,Bn37313,60533185,96975271,36442086,RLK
chr09,Bn37314,71533399,77397153,5863754,TN
chr09,Bn37315,35448206,46498727,11050521,RLP
chr09,Bn37316,51700751,77925922,26225171,TNL
chr09,Bn37317,5014120,69738781,64724661,RLP
chr09,Bn37318,17844711,22649041,4804330,CN
chr09,Bn37319,58306698,82450899,24144201,TNL
chr09,Bn37320,53516720,85290449,31773729,RLK
chr09,Bn37321,18313943,90518158,72204215,CN
chr09,Bn37322,60913688,89942919,29029231,NBS
chr09,Bn37323,58226002,80447794,22221792,RLP
chr09,Bn37324,32314349,48335908,16021559,CNL
chr09,Bn37325,82019913,92334925,10315012,TN
chr09,Bn37326,39425551,42795066,3369515,RLP
chr09,Bn37327,24173541,97089219,72915678,NBS
chr09,Bn37328,87163907,91822215,4658308,TNL
chr09,Bn37329,76572322,98403921,21831599,TN
chr09,Bn37330,4088083,44951284,40863201,TNL
chr09,Bn37331,29953413,82612302,52658889,CN
chr09,Bn37332,73743419,92900882,19157463,CNL
chr09,Bn37333,76728691,85371612,8642921,CNL
chr09,Bn37334,46398363,84524364,38126001,RLK
chr09,Bn37335,28857533,47861301,19003768,RLK
chr09,Bn37336,27964360,99875429,71911069,TNL
chr09,Bn37337,95990061,97621599,1631538,CNL
chr09,Bn37338,53912072,81715168,27803096,NBS
chr09,Bn37339,44663549,47891975,3228426,RLP
chr09,Bn37340,93554955,98251477,4696522,CN
chr09,Bn37341,57105275,81466485,24361210,TNL
chr09,Bn37342,36320179,96530148,60209969,TNL
chr09,Bn37343,17390136,40241265,22851129,RLP
chr09,Bn37344,97691564,98601937,910373,CN
chr09,Bn37345,10318336,48062189,37743853,TNL
chr09,Bn37346,46320478,96805487,50485009,TN
chr09,Bn37347,82744048,84483048,1739000,RLP
chr09,Bn37348,58569248,85503526,26934278,CN
chr09,Bn37349,98898208,99417693,519485,RLK
chr09,Bn37350,54777244,76885354,22108110,CN
chr09,Bn37351,2641766,64767577,62125811,RLP
chr09,Bn37352,79121591,95286322,16164731,RLP
chr09,Bn37353,80911073,82132746,1221673,TNL
chr09,Bn37354,80238104,83090914,2852810,TN
chr09,Bn37355,33616565,87648775,54032210,RLP
chr09,Bn37356,32162067,96454436,64292369,RLK
chr09,Bn37357,40488985,50076247,9587262,CNL
chr09,Bn37358,96382269,98572282,2190013,RLK
chr09,Bn37359,58052874,72948993,14896119,NBS
chr09,Bn37360,49994669,90065802,40071133,CN
chr09,Bn37361,20642288,54624529,33982241,RLP
chr09,Bn37362,95752531,99633324,3880793,TN
chr09,Bn37363,25749856,69631857,43882001,TNL
chr09,Bn37364,21149725,24075344,2925619,RLP
chr09,Bn37365,2944226,7477861,4533635,RLK
chr09,Bn37366,62309842,76352985,14043143,NBS
chr09,Bn37367,16037366,70551546,54514180,CN
chr09,Bn37368,79376332,79550642,174310,CNL
chr09,Bn37369,96446350,97976970,1530620,NBS
chr09,Bn37370,35166171,72656723,37490552,CN
chr09,Bn37371,67560211,82265715,14705504,NBS
chr09,Bn37372,43633922,92917633,49283711,RLP
chr09,Bn37373,71821345,80858190,9036845,CNL
chr09,Bn37374,80738760,85721545,4982785,TNL
chr09,Bn37375,78067054,90287487,12220433,NBS
chr09,Bn37376,52851958,86667156,33815198,RLK
chr09,Bn37377,82141596,95625457,13483861,CN
chr09,Bn37378,80282041,88037521,7755480,CN
chr09,Bn37379,72364552,95743684,23379132,NBS
chr09,Bn37380,19374327,52960940,33586613,TNL
chr09,Bn37381,5651394,75332101,69680707,TNL
chr09,Bn37382,84578574,97628541,13049967,RLP
chr09,Bn37383,69387020,97555438,28168418,NBS
chr09,Bn37384,62139570,77026796,14887226,NBS
chr09,Bn37385,2734099,16280519,13546420,RLP
chr09,Bn37386,3226952,50492514,47265562,NBS
chr09,Bn37387,36317351,84224074,47906723,RLP
chr09,Bn37388,71808125,90339227,18531102,TNL
chr09,Bn37389,12203736,94366597,82162861,CNL
chr09,Bn37390,66123509,89116752,22993243,NBS
chr09,Bn37391,59887983,97765989,37878006,NBS
chr09,Bn37392,94831705,96293494,1461789,NBS
chr09,Bn37393,79197586,97434506,18236920,TN
chr09,Bn37394,72181533,73114434,932901,NBS
chr09,Bn37395,6485270,75605026,69119756,CNL
chr09,Bn37396,60883795,61335073,451278,RLK
chr09,Bn37397,95042439,99738109,4695670,RLK
chr09,Bn37398,14841289,69588333,54747044,CNL
chr09,Bn37399,1269239,76344078,75074839,CNL
chr09,Bn37400,43596537,77024215,33427678,CN
chr09,Bn37401,6858897,60378907,53520010,TNL
chr09,Bn37402,84005131,88779758,4774627,TNL
chr09,Bn37403,37265079,69983810,32718731,TN
chr09,Bn37404,73369631,91396046,18026415,RLP
chr09,Bn37405,1073153,10818412,9745259,RLP
chr09,Bn37406,26248225,39702821,13454596,RLP
chr09,Bn37407,89067790,97181102,8113312,CNL
chr09,Bn37408,56166731,87697757,31531026,NBS
chr09,Bn37409,69637922,70165978,528056,RLK
chr09,Bn37410,65663190,89087737,23424547,RLK
chr09,Bn37411,47504680,97114424,49609744,TNL
chr09,Bn37412,16198634,96032899,79834265,CNL
chr09,Bn37413,48698825,49213500,514675,NBS
chr09,Bn37414,81491700,86176833,4685133,NBS
chr09,Bn37415,44547127,77915831,33368704,TNL
chr09,Bn37416,53752596,91458432,37705836,RLP
chr09,Bn37417,83179284,90361640,7182356,RLP
chr09,Bn37418,56634057,85409147,28775090,NBS
chr09,Bn37419,94864169,95591180,727011,NBS
chr09,Bn37420,83983706,90055289,6071583,RLK
chr09,Bn37421,87019283,93899269,6879986,TNL
chr09,Bn37422,43070953,48280743,5209790,CNL
chr09,Bn37423,97050234,97495600,445366,NBS
chr09,Bn37424,18197333,54141730,35944397,RLP
chr09,Bn37425,23575980,42218156,18642176,NBS
chr09,Bn37426,6926037,12933231,6007194,TN
chr09,Bn37427,25634921,85374062,59739141,TNL
chr09,Bn37428,79230090,96039024,16808934,CN
chr09,Bn37429,41598319,69785185,28186866,NBS
chr09,Bn37430,30471287,37879903,7408616,CN
chr09,Bn37431,98767979,99962015,1194036,RLK
chr09,Bn37432,11111033,65444287,54333254,TN
chr09,Bn37433,30156178,62445265,32289087,RLP
chr09,Bn37434,2348279,11672102,9323823,NBS
chr09,Bn37435,23201263,90619121,67417858,RLK
chr09,Bn37436,68705796,98326519,29620723,CNL
chr09,Bn37437,84179932,99430852,15250920,CNL
chr09,Bn37438,90670730,98859787,8189057,CNL
chr09,Bn37439,29225546,34240489,5014943,CN
chr09,Bn37440,65602396,83508015,17905619,CNL
chr09,Bn37441,41674228,88218598,46544370,TNL
chr09,Bn37442,53446763,77299936,23853173,TN
chr09,Bn37443,91563690,94289523,2725833,CNL
chr09,Bn37444,48000639,77691190,29690551,TNL
chr09,Bn37445,51080005,93599393,42519388,TNL
chr09,Bn37446,97275766,98624922,1349156,RLP
chr09,Bn37447,31401671,89192757,57791086,RLP
chr09,Bn37448,88111140,90772603,2661463,CN
chr09,Bn37449,30416856,76425235,46008379,RLP
chr09,Bn37450,39713678,78116021,38402343,TN
chr09,Bn37451,9064659,10407863,1343204,RLK
chr09,Bn37452,40228986,40963256,734270,NBS
chr09,Bn37453,95682065,97800495,2118430,TNL
chr09,Bn37454,75500974,78908043,3407069,TNL
chr09,Bn37455,89998674,98869457,8870783,TNL
chr09,Bn37456,17501049,68695196,51194147,CN
chr09,Bn37457,84266771,95403207,11136436,NBS
chr09,Bn37458,55786346,98598339,42811993,RLK
chr09,Bn37459,68740050,99645239,30905189,TNL
chr09,Bn37460,38880466,74861401,35980935,RLK
chr09,Bn37461,2529910,19413214,16883304,TN
chr09,Bn37462,47239154,83715258,36476104,TN
chr09,Bn37463,96700482,96895823,195341,NBS
chr09,Bn37464,30711954,31064306,352352,TNL
chr09,Bn37465,12529937,91545610,79015673,CNL
chr09,Bn37466,84869601,89207357,4337756,TN
chr09,Bn37467,46049861,57496681,11446820,RLK
chr09,Bn37468,24986487,93622929,68636442,CN
chr09,Bn37469,3517100,91541083,88023983,TNL
chr09,Bn37470,91117468,99224136,8106668,CNL
chr09,Bn37471,22025238,96359496,74334258,TN
chr09,Bn37472,78581031,94451699,15870668,RLK
chr09,Bn37473,26027363,46446006,20418643,RLP
chr09,Bn37474,26438079,95736517,69298438,CN
chr09,Bn37475,14758079,44777361,30019282,RLP
chr09,Bn37476,7345718,32889590,25543872,CNL
chr09,Bn37477,18153009,47467821,29314812,NBS
chr09,Bn37478,36441223,53950299,17509076,CNL
chr09,Bn37479,1655005,42157904,40502899,CN
chr09,Bn37480,46930057,86786270,39856213,RLP
chr09,Bn37481,78256856,98451393,20194537,CNL
chr09,Bn37482,25852069,48576972,22724903,CN
chr09,Bn37483,97215214,98526180,1310966,TNL
chr09,Bn37484,43592222,74114669,30522447,CNL
chr09,Bn37485,45223824,65846516,20622692,RLK
chr09,Bn37486,12354199,19429231,7075032,NBS
chr09,Bn37487,35562974,82988457,47425483,TNL
chr09,Bn37488,99734823,99901231,166408,TN
chr09,Bn37489,70554564,96961520,26406956,RLP
chr09,Bn37490,10924151,59928229,49004078,NBS
chr09,Bn37491,85991620,99568532,13576912,CNL
chr09,Bn37492,5880893,93525252,87644359,NBS
chr09,Bn37493,10534820,40666420,30131600,NBS
chr09,Bn37494,18573931,82871137,64297206,CNL
chr09,Bn37495,52346616,99602478,47255862,CNL
chr09,Bn37496,31474591,68055561,36580970,RLK
chr09,Bn37497,38432652,71040650,32607998,TN
chr09,Bn37498,30874429,43494891,12620462,NBS
chr09,Bn37499,60044205,92701986,32657781,RLK
chr09,Bn37500,30721834,90500294,59778460,CN
chr09,Bn37501,25070299,35103464,10033165,NBS
chr09,Bn37502,70574684,80145246,9570562,NBS
chr09,Bn37503,66150032,95596877,29446845,RLP
chr09,Bn37504,68598096,75190495,6592399,RLK
chr09,Bn37505,55266920,75186463,19919543,RLK
chr09,Bn37506,48308015,66934952,18626937,NBS
chr09,Bn37507,23469031,48795642,25326611,NBS
chr09,Bn37508,68320626,75535173,7214547,RLP
chr09,Bn37509,66935979,81051384,14115405,NBS
chr09,Bn37510,91520056,97994241,6474185,CNL
chr09,Bn37511,82197688,92047360,9849672,TN
chr09,Bn37512,64995432,80320910,15325478,RLK
chr09,Bn37513,11969566,25377605,13408039,RLP
chr09,Bn37514,47017871,47478991,461120,TNL
chr09,Bn37515,80366944,82380363,2013419,CNL
chr09,Bn37516,2804313,12797472,9993159,CNL
chr09,Bn37517,7467768,67038910,59571142,RLP
chr09,Bn37518,98295092,99414391,1119299,TNL
chr09,Bn37519,19889802,22462754,2572952,CN
chr09,Bn37520,47658586,89255327,41596741,RLK
chr09,Bn37521,67543392,93905857,26362465,CN
chr09,Bn37522,99687253,99715586,28333,TN
chr09,Bn37523,47700954,70873726,23172772,CNL
chr09,Bn37524,2526802,46325481,43798679,TNL
chr09,Bn37525,74415789,89892272,15476483,RLP
chr09,Bn37526,27455433,60859303,33403870,TNL
chr09,Bn37527,80842604,90561844,9719240,RLK
chr09,Bn37528,20400509,65596204,45195695,NBS
chr09,Bn37529,49218767,77247661,28028894,CN
chr09,Bn37530,79943619,96834099,16890480,TNL
chr09,Bn37531,45738432,50177905,4439473,RLK
chr09,Bn37532,51721991,55542107,3820116,TN
chr09,Bn37533,22435225,45708278,23273053,NBS
chr09,Bn37534,49077993,69984727,20906734,RLP
chr09,Bn37535,81336295,97426984,16090689,TN
chr09,Bn37536,74552636,83517848,8965212,RLK
chr09,Bn37537,12543739,79925993,67382254,TNL
chr09,Bn37538,97371255,98788679,1417424,CNL
chr09,Bn37539,1705603,89457939,87752336,TNL
chr09,Bn37540,49820763,72341069,22520306,TN
chr09,Bn37541,67988878,91805167,23816289,NBS
chr09,Bn37542,83673513,96514817,12841304,RLK
chr09,Bn37543,45960024,48774282,2814258,NBS
chr09,Bn37544,1267242,98178343,96911101,RLK
chr09,Bn37545,11819072,48948187,37129115,TN
chr09,Bn37546,4928790,57320840,52392050,TN
chr09,Bn37547,10500527,90968937,80468410,TN
chr09,Bn37548,29654324,89159228,59504904,RLK
chr09,Bn37549,60899645,69954332,9054687,RLK
chr09,Bn37550,22055858,41096559,19040701,NBS
chr09,Bn37551,85269181,86096666,827485,RLP
chr09,Bn37552,79551987,85673460,6121473,RLP
chr09,Bn37553,73765286,92542038,18776752,RLP
chr09,Bn37554,1947845,16022246,14074401,RLK
chr09,Bn37555,97570359,99394621,1824262,CNL
chr09,Bn37556,77604479,86405466,8800987,TN
chr09,Bn37557,9103789,51144780,42040991,CN
chr09,Bn37558,80063103,83948266,3885163,CNL
chr09,Bn37559,90870432,95685132,4814700,TNL
chr09,Bn37560,14057651,92415197,78357546,CN
chr09,Bn37561,22654511,46374158,23719647,NBS
chr09,Bn37562,71669089,73763815,2094726,NBS
chr09,Bn37563,78051149,84957294,6906145,CN
chr09,Bn37564,38617630,75297464,36679834,NBS
chr09,Bn37565,81590866,85545402,3954536,CNL
chr09,Bn37566,49011532,62810864,13799332,NBS
chr09,Bn37567,80351206,96041794,15690588,TN
chr09,Bn37568,21441557,57444748,36003191,RLK
chr09,Bn37569,63636900,64698943,1062043,TN
chr09,Bn37570,82151825,89326321,7174496,RLK
chr09,Bn37571,15657381,16023221,365840,CN
chr09,Bn37572,12484794,37991281,25506487,TN
chr09,Bn37573,57500280,81858745,24358465,TN
chr09,Bn37574,89021787,89855306,833519,NBS
chr09,Bn37575,34724858,51631738,16906880,CN
chr09,Bn37576,60544442,83189155,22644713,CNL
chr09,Bn37577,51553140,55526872,3973732,RLK
chr09,Bn37578,54679569,55935438,1255869,TNL
chr09,Bn37579,28873169,39490575,10617406,RLP
chr09,Bn37580,10454147,50738766,40284619,TN
chr09,Bn37581,86142803,94795794,8652991,CN
chr09,Bn37582,15351660,60543310,45191650,TNL
chr09,Bn37583,93792649,95767117,1974468,RLK
chr09,Bn37584,85229535,92136958,6907423,RLK
chr09,Bn37585,80210312,91405866,11195554,TN
chr09,Bn37586,38311120,42931790,4620670,RLP
chr09,Bn37587,80189696,92652641,12462945,RLP
chr09,Bn37588,62054580,86319846,24265266,CN
chr09,Bn37589,20575773,59734643,39158870,CN
chr09,Bn37590,48821711,75372980,26551269,TNL
chr09,Bn37591,41751062,98128278,56377216,TNL
chr09,Bn37592,65673490,76114823,10441333,NBS
chr09,Bn37593,6276655,90703101,84426446,TNL
chr09,Bn37594,71127558,80191397,9063839,CNL
chr09,Bn37595,57639617,84532006,26892389,TN
chr09,Bn37596,88753124,92663183,3910059,NBS
chr09,Bn37597,30294389,65255098,34960709,RLP
chr09,Bn37598,23160997,76149313,52988316,NBS
chr09,Bn37599,20837263,64596904,43759641,TN
chr09,Bn37600,80724136,86978966,6254830,RLK
chr09,Bn37601,24706368,84849411,60143043,RLK
chr09,Bn37602,70894452,88960449,18065997,NBS
chr09,Bn37603,74738634,90741699,16003065,TNL
chr09,Bn37604,61449504,71822217,10372713,RLP
chr09,Bn37605,88895342,92390436,3495094,RLP
chr09,Bn37606,35939127,43029447,7090320,TNL
chr09,Bn37607,34823367,83857743,49034376,NBS
chr09,Bn37608,30725545,39519554,8794009,CNL
chr09,Bn37609,39992017,71194503,31202486,RLK
chr09,Bn37610,22679513,82573345,59893832,CNL
chr09,Bn37611,79028450,99248131,20219681,NBS
chr09,Bn37612,8260797,15147536,6886739,CN
chr09,Bn37613,12967709,91422148,78454439,CNL
chr09,Bn37614,53216975,80473928,27256953,TNL
chr09,Bn37615,68328262,77733370,9405108,NBS
chr09,Bn37616,67678839,67778974,100135,RLK
chr09,Bn37617,73284734,90793935,17509201,RLK
chr09,Bn37618,79145381,93125355,13979974,TNL
chr09,Bn37619,91682198,98564311,6882113,TN
chr09,Bn37620,2003270,13789641,11786371,TNL
chr09,Bn37621,31359252,94608881,63249629,RLP
chr09,Bn37622,65019819,89220653,24200834,CNL
chr09,Bn37623,25833103,94847416,69014313,CNL
chr09,Bn37624,96431173,96491983,60810,TNL
chr09,Bn37625,98867952,99865798,997846,RLP
chr09,Bn37626,73616927,80794543,7177616,CNL
chr09,Bn37627,82770328,97647161,14876833,RLK
chr09,Bn37628,7182630,66081407,58898777,NBS
chr09,Bn37629,33743044,55161044,21418000,CN
chr09,Bn37630,29825035,43141817,13316782,NBS
chr09,Bn37631,77538610,90032088,12493478,RLK
chr09,Bn37632,18630697,96717262,78086565,TN
chr09,Bn37633,94558525,96250007,1691482,TNL
chr09,Bn37634,4662595,63885353,59222758,NBS
chr09,Bn37635,26320200,37904021,11583821,NBS
chr09,Bn37636,94158347,95960627,1802280,CNL
chr09,Bn37637,3422276,36361469,32939193,CN
chr09,Bn37638,27050490,91018345,63967855,RLP
chr09,Bn37639,4458276,37531547,33073271,TN
chr09,Bn37640,66443918,78270975,11827057,RLK
chr09,Bn37641,72981038,73519972,538934,TNL
chr09,Bn37642,20383967,33186857,12802890,RLP
chr09,Bn37643,17938888,68900764,50961876,TNL
chr09,Bn37644,65577780,92952089,27374309,CN
chr09,Bn37645,7858639,88898033,81039394,CN
chr09,Bn37646,20329090,94403998,74074908,RLK
chr09,Bn37647,71395445,94202346,22806901,CNL
chr09,Bn37648,37752344,45579277,7826933,CN
chr09,Bn37649,28105496,68426614,40321118,RLP
chr09,Bn37650,82115178,91295788,9180610,CN
chr09,Bn37651,69612361,77976791,8364430,CN
chr09,Bn37652,43591477,77110416,33518939,TNL
chr09,Bn37653,33412973,45495119,12082146,RLP
chr09,Bn37654,38693896,53440765,14746869,NBS
chr09,Bn37655,34156138,42528619,8372481,TN
chr09,Bn37656,8106886,52160431,44053545,NBS
chr09,Bn37657,58431044,78681503,20250459,CN
chr09,Bn37658,75963805,76982146,1018341,TN
chr09,Bn37659,63574621,98868777,35294156,CNL
chr09,Bn37660,36428677,88513401,52084724,RLP
chr09,Bn37661,58085868,67732022,9646154,RLK
chr09,Bn37662,62719039,65201450,2482411,TN
chr09,Bn37663,4245472,25637195,21391723,CNL
chr09,Bn37664,37610727,75317609,37706882,NBS
chr09,Bn37665,9225015,40660443,31435428,TN
chr09,Bn37666,40228414,40470685,242271,RLP
chr09,Bn37667,50785122,95955453,45170331,RLP
chr09,Bn37668,57350882,81986254,24635372,NBS
chr09,Bn37669,46799497,72666596,25867099,TN
chr09,Bn37670,6297582,48740381,42442799,RLK
chr09,Bn37671,59722975,83366553,23643578,RLK
chr09,Bn37672,40553488,40770191,216703,CNL
chr09,Bn37673,30635360,73879899,43244539,NBS
chr09,Bn37674,75324238,79128780,3804542,TNL
chr09,Bn37675,40513095,41266924,753829,RLP
chr09,Bn37676,60665874,85826625,25160751,NBS
chr09,Bn37677,52952522,92851137,39898615,TNL
chr09,Bn37678,95405934,97267244,1861310,TN
chr09,Bn37679,40835483,44690828,3855345,TN
chr09,Bn37680,9408149,40761714,31353565,RLK
chr09,Bn37681,91352161,93240528,1888367,RLK
chr09,Bn37682,82098716,94068153,11969437,CNL
chr09,Bn37683,59576135,67443277,7867142,CN
chr09,Bn37684,93188993,93381372,192379,CN
chr09,Bn37685,15200104,97750972,82550868,TN
chr09,Bn37686,62433655,67386690,4953035,CN
chr09,Bn37687,97224018,98287504,1063486,TN
chr09,Bn37688,37980726,73439945,35459219,CN
chr09,Bn37689,99140132,99879987,739855,TNL
chr09,Bn37690,62553342,99650604,37097262,RLK
chr09,Bn37691,67761785,80138409,12376624,RLK
chr09,Bn37692,72238097,76143824,3905727,CNL
chr09,Bn37693,35588019,96719863,61131844,TN
chr09,Bn37694,43484235,96686833,53202598,RLK
chr09,Bn37695,52281918,72211209,19929291,RLK
chr09,Bn37696,77795035,90890914,13095879,TN
chr09,Bn37697,93254279,98519872,5265593,RLK
chr09,Bn37698,23074186,88752988,65678802,TNL
chr09,Bn37699,29883749,59137717,29253968,CNL
chr09,Bn37700,90637743,99556468,8918725,CN
chr09,Bn37701,1348724,12060003,10711279,RLK
chr09,Bn37702,43868790,66405533,22536743,RLP
chr09,Bn37703,20918444,73117802,52199358,CN
chr09,Bn37704,52257821,75639354,23381533,RLP
chr09,Bn37705,59338924,92700517,33361593,TN
chr09,Bn37706,18629136,19150545,521409,CNL
chr09,Bn37707,16028216,49560706,33532490,RLK
chr09,Bn37708,74715367,80312149,5596782,NBS
chr09,Bn37709,23822539,29429543,5607004,RLP
chr09,Bn37710,20138466,58163513,38025047,TNL
chr09,Bn37711,84482416,88841763,4359347,CN
chr09,Bn37712,96892879,99141293,2248414,TN
chr09,Bn37713,82878575,90202606,7324031,CN
chr09,Bn37714,58639529,73716545,15077016,TN
chr09,Bn37715,82756894,98223089,15466195,NBS
chr09,Bn37716,64339316,99181607,34842291,CN
chr09,Bn37717,81067022,87185271,6118249,NBS
chr09,Bn37718,20964162,97031125,76066963,CN
chr09,Bn37719,57274248,97209175,39934927,RLP
chr09,Bn37720,68460015,85706977,17246962,RLK
chr09,Bn37721,98514128,98730244,216116,NBS
chr09,Bn37722,83129844,95588399,12458555,CNL
chr09,Bn37723,11358697,75611545,64252848,TN
chr09,Bn37724,3544843,52187716,48642873,CNL
chr09,Bn37725,78817485,87251410,8433925,RLK
chr09,Bn37726,54882214,59209696,4327482,CN
chr09,Bn37727,13780811,59982830,46202019,NBS
chr09,Bn37728,28252132,29248533,996401,RLP
chr09,Bn37729,2636775,17480352,14843577,NBS
chr09,Bn37730,46711786,86068325,39356539,TN
chr09,Bn37731,49065748,83353618,34287870,RLK
chr09,Bn37732,79484388,86777341,7292953,TN
chr09,Bn37733,88024834,98752734,10727900,TN
chr09,Bn37734,1710282,53704114,51993832,TNL
chr09,Bn37735,21604665,45433093,23828428,TN
chr09,Bn37736,49559058,53487725,3928667,NBS
chr09,Bn37737,86781067,97508122,10727055,RLP
chr09,Bn37738,34218410,90199648,55981238,NBS
chr09,Bn37739,81739705,98504766,16765061,RLP
chr09,Bn37740,30171644,62782990,32611346,TN
chr09,Bn37741,62681786,92552021,29870235,RLK
chr09,Bn37742,92825982,96606374,3780392,TNL
chr09,Bn37743,90557545,99192148,8634603,RLP
chr09,Bn37744,53845093,84844866,30999773,RLK
chr09,Bn37745,76703421,88506818,11803397,TNL
chr09,Bn37746,63033077,82062946,19029869,CNL
chr09,Bn37747,74187277,92750997,18563720,RLK
chr09,Bn37748,96997416,97421490,424074,RLK
chr09,Bn37749,3971781,83713737,79741956,NBS
chr09,Bn37750,53399629,97961893,44562264,TN
chr09,Bn37751,41599809,92219988,50620179,CNL
chr09,Bn37752,34741929,80938354,46196425,RLP
chr09,Bn37753,13523273,70964501,57441228,RLK
chr09,Bn37754,80596243,91887757,11291514,RLP
chr09,Bn37755,23709324,67557893,43848569,NBS
chr09,Bn37756,21339039,82706121,61367082,TNL
chr09,Bn37757,73646545,82769492,9122947,CNL
chr09,Bn37758,85603669,89657484,4053815,CN
chr09,Bn37759,70138588,91057015,20918427,CNL
chr09,Bn37760,45254375,50892036,5637661,RLP
chr09,Bn37761,59230737,70964249,11733512,RLK
chr09,Bn37762,71101541,96344684,25243143,CNL
chr09,Bn37763,83172629,89137969,5965340,TN
chr09,Bn37764,42742404,71071837,28329433,NBS
chr09,Bn37765,63307237,78534494,15227257,TN
chr09,Bn37766,14096769,49887197,35790428,RLP
chr09,Bn37767,83113704,99281193,16167489,CN
chr09,Bn37768,94711513,95684479,972966,CN
chr09,Bn37769,86761610,87651843,890233,RLK
chr09,Bn37770,31932825,80195635,48262810,TN
chr09,Bn37771,4909887,76766662,71856775,NBS
chr09,Bn37772,58017840,68183274,10165434,CNL
chr09,Bn37773,12563897,21184308,8620411,CN
chr09,Bn37774,12547840,28749048,16201208,RLP
chr09,Bn37775,53883699,69317073,15433374,TNL
chr09,Bn37776,28685650,71442014,42756364,RLK
chr09,Bn37777,38741755,67669979,28928224,CNL
chr09,Bn37778,69227496,98320276,29092780,NBS
chr09,Bn37779,93282250,94673256,1391006,NBS
chr09,Bn37780,91924550,92112545,187995,TN
chr09,Bn37781,60938877,78676542,17737665,CN
chr09,Bn37782,97967967,98719132,751165,CN
chr09,Bn37783,34717723,46033617,11315894,TNL
chr09,Bn37784,42814127,98781627,55967500,CNL
chr09,Bn37785,2788484,94508262,91719778,RLK
chr09,Bn37786,30525925,38478634,7952709,CNL
chr09,Bn37787,56461021,73434841,16973820,RLP
chr09,Bn37788,4142959,45276302,41133343,TNL
chr09,Bn37789,10752859,10803172,50313,RLP
chr09,Bn37790,46812148,69458429,22646281,RLK
chr09,Bn37791,76542165,93296398,16754233,CN
chr09,Bn37792,48299636,66341467,18041831,RLK
chr09,Bn37793,44797977,50949783,6151806,CNL
chr09,Bn37794,1611751,69999486,68387735,TN
chr09,Bn37795,35994743,89314663,53319920,RLP
chr09,Bn37796,9993019,10325250,332231,TNL
chr09,Bn37797,85697986,89480033,3782047,NBS
chr09,Bn37798,81528542,83899806,2371264,RLP
chr09,Bn37799,19306676,43833374,24526698,TNL
chr09,Bn37800,8449886,99613575,91163689,CN
chr09,Bn37801,42582257,81131781,38549524,CNL
chr09,Bn37802,37911159,92307888,54396729,RLP
chr09,Bn37803,48350431,62274901,13924470,TNL
chr09,Bn37804,50508728,54961698,4452970,TNL
chr09,Bn37805,87744247,89091093,1346846,TN
chr09,Bn37806,57036663,74090313,17053650,TN
chr09,Bn37807,94609130,95327418,718288,TN
chr09,Bn37808,9277764,94558781,85281017,RLP
chr09,Bn37809,58389955,97450433,39060478,TNL
chr09,Bn37810,17769849,96143734,78373885,RLK
chr09,Bn37811,73663278,84234043,10570765,RLP
chr09,Bn37812,72836051,99961903,27125852,NBS
chr09,Bn37813,84687360,91025382,6338022,CNL
chr09,Bn37814,84906235,99531636,14625401,TN
chr09,Bn37815,93117130,99484056,6366926,RLK
chr09,Bn37816,90811262,99943992,9132730,TN
chr09,Bn37817,20303894,76189483,55885589,RLP
chr09,Bn37818,99192362,99301825,109463,TN
chr09,Bn37819,13400434,16648804,3248370,NBS
chr09,Bn37820,23290106,88905154,65615048,RLP
chr09,Bn37821,71063024,71099270,36246,CNL
chr09,Bn37822,50517219,74600042,24082823,TNL
chr09,Bn37823,92186635,99716130,7529495,RLK
chr09,Bn37824,20858080,47481154,26623074,CN
chr09,Bn37825,53154860,79069004,25914144,CN
chr09,Bn37826,27697939,56141944,28444005,CNL
chr09,Bn37827,57989429,74287002,16297573,RLP
chr09,Bn37828,84094290,92643930,8549640,CN
chr09,Bn37829,80121564,83018384,2896820,CNL
chr09,Bn37830,49599369,74687083,25087714,TNL
chr09,Bn37831,19311674,28636207,9324533,TNL
chr09,Bn37832,73719517,87982715,14263198,RLP
chr09,Bn37833,2606427,3376133,769706,TNL
chr09,Bn37834,1388618,99036936,97648318,CN
chr09,Bn37835,28005301,55432428,27427127,CNL
chr09,Bn37836,73444532,98267134,24822602,TNL
chr09,Bn37837,81819109,86677477,4858368,CN
chr09,Bn37838,94358078,99884401,5526323,CN
chr09,Bn37839,55600961,89073324,33472363,CNL
chr09,Bn37840,63148809,98703820,35555011,TN
chr09,Bn37841,30108561,39608886,9500325,TN
chr09,Bn37842,64590289,75624254,11033965,TNL
chr09,Bn37843,94114352,99700254,5585902,TNL
chr09,Bn37844,99053416,99293474,240058,TNL
chr09,Bn37845,94264843,96356499,2091656,RLK
chr09,Bn37846,22653659,48938308,26284649,NBS
chr09,Bn37847,60647185,72743293,12096108,CN
chr09,Bn37848,22253997,39140767,16886770,CN
chr09,Bn37849,63978428,78057199,14078771,RLK
chr09,Bn37850,32460368,84732653,52272285,CNL
chr09,Bn37851,97275662,99357380,2081718,NBS
chr09,Bn37852,45201089,48982716,3781627,CNL
chr09,Bn37853,25260847,87048368,61787521,RLK
chr09,Bn37854,31533993,64246582,32712589,TNL
chr09,Bn37855,83513060,94905425,11392365,NBS
chr09,Bn37856,1662641,75978686,74316045,CN
chr09,Bn37857,44429853,71287457,26857604,RLP
chr09,Bn37858,32764682,40048964,7284282,CN
chr09,Bn37859,93070861,93178268,107407,NBS
chr09,Bn37860,15337496,62094670,46757174,RLP
chr09,Bn37861,19761592,45714965,25953373,TN
chr09,Bn37862,70050942,85513716,15462774,CNL
chr09,Bn37863,6168242,10680685,4512443,CN
chr09,Bn37864,89905044,90101943,196899,TNL
chr09,Bn37865,4584250,57151945,52567695,TN
chr09,Bn37866,31428228,34437423,3009195,CNL
chr09,Bn37867,72475608,96874167,24398559,TN
chr09,Bn37868,90516451,91524985,1008534,TNL
chr09,Bn37869,11704116,73421998,61717882,RLP
chr09,Bn37870,99283100,99592272,309172,RLK
chr09,Bn37871,90291190,98925789,8634599,CNL
chr09,Bn37872,86461284,92471758,6010474,TNL
chr09,Bn37873,36705941,97188305,60482364,RLK
chr09,Bn37874,13709165,42463785,28754620,RLP
chr09,Bn37875,83234808,91455865,8221057,TN
chr09,Bn37876,65083763,75464839,10381076,TN
chr09,Bn37877,13869537,79025299,65155762,CNL
chr09,Bn37878,40764003,74775787,34011784,NBS
chr09,Bn37879,47844262,98910970,51066708,CNL
chr09,Bn37880,30745959,83143617,52397658,NBS
chr09,Bn37881,85757518,86839505,1081987,RLP
chr09,Bn37882,63640543,94777705,31137162,RLP
chr09,Bn37883,25605295,87571212,61965917,TNL
chr09,Bn37884,37419955,86815990,49396035,CN
chr09,Bn37885,72324442,89592836,17268394,TN
chr09,Bn37886,65596680,85270177,19673497,CNL
chr09,Bn37887,66829143,95487951,28658808,CN
chr09,Bn37888,42191357,57003138,14811781,CNL
chr09,Bn37889,70719092,89352376,18633284,RLK
chr09,Bn37890,34661131,58745338,24084207,RLK
chr09,Bn37891,76140549,88699414,12558865,RLK
chr09,Bn37892,3189066,55202025,52012959,NBS
chr09,Bn37893,4130950,50213399,46082449,NBS
chr09,Bn37894,69643753,85934756,16291003,RLP
chr09,Bn37895,32439797,87010736,54570939,CNL
chr09,Bn37896,14118280,33153339,19035059,NBS
chr09,Bn37897,44992799,56593770,11600971,NBS
chr09,Bn37898,83357845,86930189,3572344,TNL
chr09,Bn37899,83758192,97339353,13581161,CN
chr09,Bn37900,96703268,99158989,2455721,TNL
chr09,Bn37901,29639524,36101781,6462257,RLK
chr09,Bn37902,94742687,96174196,1431509,NBS
chr09,Bn37903,72809983,93967396,21157413,RLP
chr09,Bn37904,98890724,99735756,845032,TN
chr09,Bn37905,95819968,96216664,396696,CNL
chr09,Bn37906,37728919,56849660,19120741,TNL
chr09,Bn37907,15624732,70249897,54625165,CN
chr09,Bn37908,13997147,80926841,66929694,NBS
chr09,Bn37909,32715041,94411811,61696770,RLK
chr09,Bn37910,8452206,95605660,87153454,TN
chr09,Bn37911,3251419,18180941,14929522,TNL
chr09,Bn37912,8548619,74034896,65486277,TN
chr09,Bn37913,76556474,97646694,21090220,CNL
chr09,Bn37914,56487823,67364902,10877079,TN
chr09,Bn37915,12659459,38851259,26191800,TN
chr09,Bn37916,23358311,88848825,65490514,TN
chr09,Bn37917,91220035,97905039,6685004,RLP
chr09,Bn37918,73324444,79028900,5704456,RLK
chr09,Bn37919,9265947,13214528,3948581,TNL
chr09,Bn37920,81866289,87379334,5513045,RLK
chr09,Bn37921,26941083,85643122,58702039,RLP
chr09,Bn37922,11731149,40103787,28372638,CN
chr09,Bn37923,20949358,46192156,25242798,RLK
chr09,Bn37924,3472801,27893335,24420534,TNL
chr09,Bn37925,86985074,97051240,10066166,TN
chr09,Bn37926,44697369,46611433,1914064,TN
chr09,Bn37927,15684749,37079797,21395048,CNL
chr09,Bn37928,64345327,65366121,1020794,RLP
chr09,Bn37929,34110327,82688969,48578642,TNL
chr09,Bn37930,20006524,83028802,63022278,RLK
chr09,Bn37931,79459707,93421571,13961864,CN
chr09,Bn37932,10038548,10687980,649432,TNL
chr09,Bn37933,62528468,64760737,2232269,CN
chr09,Bn37934,24993841,66773649,41779808,CN
chr09,Bn37935,22674176,60144111,37469935,RLP
chr09,Bn37936,60439879,82551504,22111625,CN
chr09,Bn37937,84921233,90789504,5868271,NBS
chr09,Bn37938,85154531,87158913,2004382,CNL
chr09,Bn37939,92503510,97820719,5317209,TN
chr09,Bn37940,39562475,75765804,36203329,RLP
chr09,Bn37941,51360447,75593802,24233355,TNL
chr09,Bn37942,81926547,95279270,13352723,CNL
chr09,Bn37943,64568277,67839177,3270900,TNL
chr09,Bn37944,22451107,28932254,6481147,RLP
chr09,Bn37945,17340052,36822607,19482555,CNL
chr09,Bn37946,83789983,94547895,10757912,NBS
chr09,Bn37947,7459728,52673315,45213587,CNL
chr09,Bn37948,63910127,97184689,33274562,RLK
chr09,Bn37949,9047609,49330014,40282405,CN
chr09,Bn37950,89718054,90871276,1153222,TNL
chr09,Bn37951,34094598,49782675,15688077,CN
chr09,Bn37952,94882639,99893014,5010375,NBS
chr09,Bn37953,47318517,98155700,50837183,CN
chr09,Bn37954,92335588,95272581,2936993,CNL
chr09,Bn37955,76788496,99631434,22842938,RLK
chr09,Bn37956,63198344,74043513,10845169,NBS
chr09,Bn37957,35591161,46846406,11255245,NBS
chr09,Bn37958,13261601,42462981,29201380,TNL
chr09,Bn37959,66620188,67652704,1032516,NBS
chr09,Bn37960,80795753,88121953,7326200,RLP
chr09,Bn37961,66861006,95705912,28844906,NBS
chr09,Bn37962,48413231,85354446,36941215,CN
chr09,Bn37963,67957212,70357775,2400563,RLK
chr09,Bn37964,59246805,91129294,31882489,RLK
chr09,Bn37965,70599432,79029902,8430470,TNL
chr09,Bn37966,25577173,46076909,20499736,TN
chr09,Bn37967,11047561,48500726,37453165,NBS
chr09,Bn37968,90662880,94542143,3879263,TN
chr09,Bn37969,57606341,59096607,1490266,NBS
chr09,Bn37970,95670207,98561955,2891748,TN
chr09,Bn37971,2847650,50159216,47311566,TN
chr09,Bn37972,66004807,72616730,6611923,RLK
chr09,Bn37973,14171363,84347817,70176454,RLP
chr09,Bn37974,9911310,36538316,26627006,CNL
chr09,Bn37975,73157872,77797194,4639322,CN
chr09,Bn37976,7247805,21264896,14017091,TNL
chr09,Bn37977,49988098,70655895,20667797,RLK
chr09,Bn37978,18716543,79225547,60509004,CNL
chr09,Bn37979,89050843,92792928,3742085,RLP
chr09,Bn37980,19772108,92516402,72744294,RLK
chr09,Bn37981,26229380,57772820,31543440,TNL
chr09,Bn37982,46327074,50583306,4256232,NBS
chr09,Bn37983,53175194,77932154,24756960,CNL
chr09,Bn37984,89143296,96950861,7807565,TNL
chr09,Bn37985,52560287,94296134,41735847,RLK
chr09,Bn37986,69852220,85003400,15151180,TN
chr09,Bn37987,35922575,60522576,24600001,CNL
chr09,Bn37988,2433949,72042725,69608776,TNL
chr09,Bn37989,12981516,56799039,43817523,RLP
chr09,Bn37990,79132140,91285808,12153668,TN
chr09,Bn37991,51652114,59515862,7863748,CN
chr09,Bn37992,38386122,38497332,111210,RLK
chr09,Bn37993,64268540,72465901,8197361,TN
chr09,Bn37994,70672888,82328293,11655405,TNL
chr09,Bn37995,43168379,95200477,52032098,CN
chr09,Bn37996,10534563,54926673,44392110,CNL
chr09,Bn37997,9482855,37207654,27724799,TNL
chr09,Bn37998,84613952,90640618,6026666,TN
chr09,Bn37999,18221179,27419235,9198056,TNL
chr09,Bn38000,22164326,30055230,7890904,RLP
chr09,Bn38001,62495710,77043210,14547500,RLK
chr09,Bn38002,89019787,92115882,3096095,TN
chr09,Bn38003,49997725,93969196,43971471,NBS
chr09,Bn38004,26396638,91226331,64829693,TN
chr09,Bn38005,85121031,90774566,5653535,TNL
chr09,Bn38006,95984485,96060674,76189,TNL
chr09,Bn38007,85399245,90206563,4807318,RLK
chr09,Bn38008,67124227,78400745,11276518,TN
chr09,Bn38009,32752436,98143510,65391074,RLP
chr09,Bn38010,82065625,83347479,1281854,CNL
chr09,Bn38011,17048387,68077049,51028662,NBS
chr09,Bn38012,6390156,66778059,60387903,RLK
chr09,Bn38013,47177649,93921998,46744349,NBS
chr09,Bn38014,26990938,37300750,10309812,TNL
chr09,Bn38015,6928429,70532465,63604036,NBS
chr09,Bn38016,4145452,73020109,68874657,NBS
chr09,Bn38017,80193381,92837112,12643731,CNL
chr09,Bn38018,16253790,62617405,46363615,NBS
chr09,Bn38019,55142357,61197945,6055588,TNL
chr09,Bn38020,41771668,84279917,42508249,RLP
chr09,Bn38021,7166025,46007727,38841702,CNL
chr09,Bn38022,40520697,87045749,46525052,TNL
chr09,Bn38023,39533816,68398291,28864475,TNL
chr09,Bn38024,21055194,61740391,40685197,CNL
chr09,Bn38025,73812551,87280185,13467634,RLP
chr09,Bn38026,43856127,87145336,43289209,RLK
chr09,Bn38027,66972669,69239215,2266546,CNL
chr09,Bn38028,40770515,47210506,6439991,RLK
chr09,Bn38029,48537716,99543650,51005934,TNL
chr09,Bn38030,38121447,51491908,13370461,TNL
chr09,Bn38031,15808243,77946424,62138181,TN
chr09,Bn38032,66423371,97476109,31052738,TN
chr09,Bn38033,22087831,67979256,45891425,NBS
chr09,Bn38034,89369213,94031096,4661883,RLK
chr09,Bn38035,94572816,96418205,1845389,TNL
chr09,Bn38036,6464652,28961944,22497292,NBS
chr09,Bn38037,81470092,82877858,1407766,TNL
chr09,Bn38038,64594128,65831327,1237199,CN
chr09,Bn38039,18114631,28955563,10840932,CN
chr09,Bn38040,31999037,43865060,11866023,CNL
chr09,Bn38041,1565246,8729742,7164496,RLK
chr09,Bn38042,99693840,99822278,128438,CNL
chr09,Bn38043,5283295,21163978,15880683,TN
chr09,Bn38044,64009235,81100886,17091651,TN
chr09,Bn38045,53519695,81290592,27770897,NBS
chr09,Bn38046,12086371,87253597,75167226,NBS
chr09,Bn38047,46670048,82463139,35793091,RLP
chr09,Bn38048,90802799,91849132,1046333,CNL
chr09,Bn38049,23117970,53502836,30384866,RLP
chr09,Bn38050,5322794,14024765,8701971,RLP
chr09,Bn38051,27254261,91841813,64587552,NBS
chr09,Bn38052,40650849,46538255,5887406,RLK
chr09,Bn38053,49881971,60820982,10939011,RLP
chr09,Bn38054,89886915,96098470,6211555,RLK
chr09,Bn38055,22331553,72581476,50249923,CNL
chr09,Bn38056,10349590,94458632,84109042,TNL
chr09,Bn38057,64701163,99792144,35090981,TNL
chr09,Bn38058,18814895,69605595,50790700,RLK
chr09,Bn38059,25655886,73114983,47459097,CN
chr09,Bn38060,55995994,77034642,21038648,CN
chr09,Bn38061,74339442,87874314,13534872,CNL
chr09,Bn38062,62778980,80461736,17682756,RLK
chr09,Bn38063,56923461,93895026,36971565,RLK
chr09,Bn38064,18874771,24355472,5480701,CNL
chr09,Bn38065,9879587,37353265,27473678,NBS
chr09,Bn38066,86839894,87385118,545224,CNL
chr09,Bn38067,92866340,98450504,5584164,NBS
chr09,Bn38068,73829574,97437400,23607826,RLP
chr09,Bn38069,66902259,95234914,28332655,RLP
chr09,Bn38070,48060629,88908828,40848199,CN
chr09,Bn38071,74965792,86219774,11253982,NBS
chr09,Bn38072,74719860,85007291,10287431,TNL
chr09,Bn38073,41633740,93065184,51431444,TN
chr09,Bn38074,42256076,80289401,38033325,TNL
chr09,Bn38075,33760083,63299420,29539337,RLP
chr09,Bn38076,10735315,26572402,15837087,RLP
chr09,Bn38077,62958621,85359089,22400468,TNL
chr09,Bn38078,29014217,35922999,6908782,TN
chr09,Bn38079,7418686,61198612,53779926,RLP
chr09,Bn38080,63195794,68220128,5024334,RLP
chr09,Bn38081,42466395,54612261,12145866,RLP
chr09,Bn38082,83909647,95852041,11942394,TN
chr09,Bn38083,88634868,94037657,5402789,RLP
chr09,Bn38084,30052009,77782008,47729999,CN
chr09,Bn38085,12832432,79041408,66208976,RLP
chr09,Bn38086,95851122,96151232,300110,TNL
chr09,Bn38087,41891769,52931043,11039274,RLK
chr09,Bn38088,20877978,35899099,15021121,TNL
chr09,Bn38089,30560302,96091544,65531242,RLK
chr09,Bn38090,94002348,97828037,3825689,RLK
chr09,Bn38091,2338569,56449700,54111131,NBS
chr09,Bn38092,43911797,82258815,38347018,CN
chr09,Bn38093,3136046,24511940,21375894,TN
chr09,Bn38094,53804529,66857055,13052526,CN
chr09,Bn38095,23963103,61927412,37964309,CNL
chr09,Bn38096,93189203,95519658,2330455,RLK
chr09,Bn38097,48967931,85885557,36917626,RLP
chr09,Bn38098,86967102,87553468,586366,RLK
chr09,Bn38099,75030013,82947637,7917624,RLP
chr09,Bn38100,10711271,58187766,47476495,RLK
chr09,Bn38101,1920463,9278687,7358224,CN
chr09,Bn38102,91528834,96667798,5138964,CNL
chr09,Bn38103,92357910,92380591,22681,RLP
chr09,Bn38104,61888087,90720032,28831945,TNL
chr09,Bn38105,73828485,94729654,20901169,RLK
chr09,Bn38106,55065425,66974496,11909071,RLK
chr09,Bn38107,26005444,58834978,32829534,CNL
chr09,Bn38108,11560281,77141869,65581588,CN
chr09,Bn38109,6403768,32569281,26165513,CN
chr09,Bn38110,67257471,71137990,3880519,NBS
chr09,Bn38111,66812526,74512890,7700364,NBS
chr09,Bn38112,85072682,86193022,1120340,NBS
chr09,Bn38113,51124523,88891850,37767327,CNL
chr09,Bn38114,17186237,38056580,20870343,RLP
chr09,Bn38115,78059706,98682193,20622487,RLP
chr09,Bn38116,73408949,98447250,25038301,RLP
chr09,Bn38117,71544514,82141907,10597393,TNL
chr09,Bn38118,12106734,29373435,17266701,CN
chr09,Bn38119,26009901,28002784,1992883,CNL
chr09,Bn38120,27832518,58377954,30545436,NBS
chr09,Bn38121,99084573,99984746,900173,CNL
chr09,Bn38122,84270434,98117749,13847315,RLK
chr09,Bn38123,45985474,89977137,43991663,CNL
chr09,Bn38124,15149752,93388515,78238763,TNL
chr09,Bn38125,35084350,91051556,55967206,RLK
chr09,Bn38126,98224475,99185062,960587,CNL
chr09,Bn38127,63650492,76563421,12912929,TN
chr09,Bn38128,70193665,79976425,9782760,CNL
chr09,Bn38129,48918101,90264037,41345936,TN
chr09,Bn38130,32723297,98754846,66031549,RLK
chr09,Bn38131,71304669,90882040,19577371,RLP
chr09,Bn38132,20280048,81803640,61523592,TN
chr09,Bn38133,45693653,80844647,35150994,CNL
chr09,Bn38134,29307518,53725801,24418283,RLK
chr09,Bn38135,19895579,96076286,76180707,CNL
chr09,Bn38136,48450169,75325516,26875347,TN
chr09,Bn38137,74147414,78401416,4254002,NBS
chr09,Bn38138,89675969,99094505,9418536,TN
chr09,Bn38139,17703289,51798887,34095598,CNL
chr09,Bn38140,23109920,49347722,26237802,CNL
chr09,Bn38141,66084186,67958481,1874295,RLP
chr09,Bn38142,26874672,57883057,31008385,TN
chr09,Bn38143,27963029,52404157,24441128,TNL
chr09,Bn38144,74713040,92592898,17879858,TNL
chr09,Bn38145,57560208,98357280,40797072,NBS
chr09,Bn38146,92611156,98672828,6061672,RLK
chr09,Bn38147,35327934,43558708,8230774,TN
chr09,Bn38148,66468446,85398368,18929922,RLK
chr09,Bn38149,19391835,77243152,57851317,CNL
chr09,Bn38150,31858643,62597106,30738463,TN
chr09,Bn38151,76085122,90063665,13978543,CNL
chr09,Bn38152,43607634,91078404,47470770,TN
chr09,Bn38153,55607720,91878940,36271220,CN
chr09,Bn38154,84634510,85168033,533523,NBS
chr09,Bn38155,65999318,85934020,19934702,CNL
chr09,Bn38156,84641146,92397355,7756209,RLP
chr09,Bn38157,28782304,74505952,45723648,RLP
chr09,Bn38158,29139693,99400915,70261222,TNL
chr09,Bn38159,82465843,85421240,2955397,RLK
chr09,Bn38160,21206616,71907197,50700581,CN
chr09,Bn38161,63046665,70672099,7625434,RLK
chr09,Bn38162,16266473,59711505,43445032,NBS
chr09,Bn38163,6484760,86913358,80428598,NBS
chr09,Bn38164,88936787,88954603,17816,CN
chr09,Bn38165,27339163,42120855,14781692,CN
chr09,Bn38166,59837097,74921327,15084230,CNL
chr09,Bn38167,48694304,81594948,32900644,NBS
chr09,Bn38168,97404035,98817119,1413084,NBS
chr09,Bn38169,17810731,31379770,13569039,CN
chr09,Bn38170,38184054,46514265,8330211,TNL
chr09,Bn38171,57820871,78350449,20529578,NBS
chr09,Bn38172,67052991,72525437,5472446,RLP
chr09,Bn38173,49169931,77451571,28281640,NBS
chr09,Bn38174,40131480,62102096,21970616,RLP
chr09,Bn38175,8858594,71454363,62595769,TN
chr09,Bn38176,48993690,69267875,20274185,CNL
chr09,Bn38177,27466623,62629886,35163263,TN
chr09,Bn38178,55623022,81845253,26222231,RLK
chr09,Bn38179,83493580,91972699,8479119,NBS
chr09,Bn38180,94129892,99030579,4900687,TNL
chr09,Bn38181,50580123,74808323,24228200,RLK
chr09,Bn38182,88476427,92240479,3764052,TNL
chr09,Bn38183,76529603,99327680,22798077,RLK
chr09,Bn38184,5244085,68110608,62866523,RLK
chr09,Bn38185,80857120,91462964,10605844,TNL
chr09,Bn38186,6797376,30936687,24139311,NBS
chr09,Bn38187,54017481,90422814,36405333,CN
chr09,Bn38188,50712330,69202069,18489739,TN
chr09,Bn38189,45714189,77731173,32016984,CNL
chr09,Bn38190,49014931,85848343,36833412,CN
chr09,Bn38191,34771092,41360626,6589534,NBS
chr09,Bn38192,62390543,75302334,12911791,RLK
chr09,Bn38193,65241196,73327311,8086115,RLK
chr09,Bn38194,92498199,95550019,3051820,TN
chr09,Bn38195,48335143,80753578,32418435,TNL
chr09,Bn38196,14860086,41098784,26238698,RLP
chr09,Bn38197,60217034,83840962,23623928,RLP
chr09,Bn38198,72777401,87561440,14784039,CN
chr09,Bn38199,44313884,68376612,24062728,CNL
chr09,Bn38200,39391282,70578974,31187692,CNL
chr09,Bn38201,35645636,91329527,55683891,CNL
chr09,Bn38202,13406838,41903103,28496265,RLP
chr09,Bn38203,35193267,93252288,58059021,NBS
chr09,Bn38204,43862787,97946870,54084083,RLK
chr09,Bn38205,51804064,67376539,15572475,RLP
chr09,Bn38206,25824420,53995866,28171446,CNL
chr09,Bn38207,95949719,96205068,255349,TNL
chr09,Bn38208,3283817,90041249,86757432,TN
chr09,Bn38209,72759224,95875103,23115879,TNL
chr09,Bn38210,9568676,24964763,15396087,NBS
chr09,Bn38211,3276820,96243341,92966521,NBS
chr09,Bn38212,74013054,77094589,3081535,CNL
chr09,Bn38213,16600430,21602611,5002181,TNL
chr09,Bn38214,3005258,83868583,80863325,TN
chr09,Bn38215,17462369,84716715,67254346,CN
chr09,Bn38216,60534536,79933620,19399084,RLK
chr09,Bn38217,26903275,51483064,24579789,NBS
chr09,Bn38218,59560825,74909393,15348568,RLP
chr09,Bn38219,95556398,99906589,4350191,TNL
chr09,Bn38220,56976771,70229013,13252242,RLP
chr09,Bn38221,29883306,62059962,32176656,RLK
chr09,Bn38222,40496327,53817812,13321485,RLP
chr09,Bn38223,13147779,93518576,80370797,TN
chr09,Bn38224,87757551,96542725,8785174,CN
chr09,Bn38225,81974565,88266329,6291764,CNL
chr09,Bn38226,74069079,84476255,10407176,CNL
chr09,Bn38227,14534919,17835210,3300291,RLK
chr09,Bn38228,14476854,88314740,73837886,TNL
chr09,Bn38229,18090639,28210053,10119414,RLK
chr09,Bn38230,84193603,99016762,14823159,CNL
chr09,Bn38231,48207448,78476844,30269396,NBS
chr09,Bn38232,22619514,67960410,45340896,NBS
chr09,Bn38233,97919680,99567792,1648112,NBS
chr09,Bn38234,35490579,82541311,47050732,CNL
chr09,Bn38235,33590087,47341372,13751285,TNL
chr09,Bn38236,82374955,87390560,5015605,CN
chr09,Bn38237,64216704,70371371,6154667,RLK
chr09,Bn38238,41786194,42591155,804961,TN
chr09,Bn38239,61032743,68881068,7848325,RLP
chr09,Bn38240,70016001,83179008,13163007,TNL
chr09,Bn38241,6014228,18668061,12653833,TNL
chr09,Bn38242,95383392,96063288,679896,RLK
chr09,Bn38243,75526423,76322027,795604,RLP
chr09,Bn38244,53568903,83485665,29916762,CNL
chr09,Bn38245,43887685,66258851,22371166,CNL
chr09,Bn38246,87007440,98922586,11915146,TNL
chr09,Bn38247,8045374,15742713,7697339,NBS
chr09,Bn38248,53396491,69127644,15731153,CNL
chr09,Bn38249,16229932,63993881,47763949,CN
chr09,Bn38250,74918976,95899353,20980377,TNL
chr09,Bn38251,41379323,80581082,39201759,CNL
chr09,Bn38252,92234421,98422141,6187720,NBS
chr09,Bn38253,73533381,89853663,16320282,TNL
chr09,Bn38254,73869254,91186803,17317549,TN
chr09,Bn38255,68562429,73867359,5304930,CN
chr09,Bn38256,25577098,48824443,23247345,TN
chr09,Bn38257,85739840,87282992,1543152,RLK
chr09,Bn38258,8882073,36162482,27280409,CN
chr09,Bn38259,41879379,47181800,5302421,NBS
chr09,Bn38260,71634112,92756200,21122088,NBS
chr09,Bn38261,87910777,96487322,8576545,CN
chr09,Bn38262,14806641,84871728,70065087,RLP
chr09,Bn38263,66130426,84045227,17914801,CN
chr09,Bn38264,18978420,59592374,40613954,CN
chr09,Bn38265,69795791,81428877,11633086,RLP
chr09,Bn38266,97037221,99018385,1981164,RLK
chr09,Bn38267,96097161,96400616,303455,RLP
chr09,Bn38268,72562201,88155989,15593788,RLK
chr09,Bn38269,43539999,50839795,7299796,TNL
chr09,Bn38270,65466944,78621151,13154207,RLP
chr09,Bn38271,27816756,95728086,67911330,NBS
chr09,Bn38272,41306522,63681011,22374489,TNL
chr09,Bn38273,11044270,33368353,22324083,NBS
chr09,Bn38274,75004581,95264838,20260257,NBS
chr09,Bn38275,40703698,86073253,45369555,RLK
chr09,Bn38276,86139550,86641687,502137,RLK
chr09,Bn38277,37598441,69346636,31748195,TNL
chr09,Bn38278,67134415,94791563,27657148,CNL
chr09,Bn38279,26091625,46425082,20333457,RLK
chr09,Bn38280,36980887,38168717,1187830,NBS
chr09,Bn38281,68322355,99108243,30785888,RLP
chr09,Bn38282,40115399,43719834,3604435,CNL
chr09,Bn38283,6042165,98874809,92832644,NBS
chr09,Bn38284,65593720,71794269,6200549,CN
chr09,Bn38285,11627121,37026413,25399292,CN
chr09,Bn38286,52728939,81209706,28480767,TN
chr09,Bn38287,96501521,97275058,773537,RLP
chr09,Bn38288,52107515,72161945,20054430,TNL
chr09,Bn38289,49053942,68947379,19893437,TNL
chr09,Bn38290,94823157,95585964,762807,CNL
chr09,Bn38291,50153030,59057350,8904320,NBS
chr09,Bn38292,94185186,96443475,2258289,TN
chr09,Bn38293,9468828,22597343,13128515,CNL
chr09,Bn38294,37254205,83807860,46553655,RLK
chr09,Bn38295,89664001,99816860,10152859,RLP
chr09,Bn38296,74848877,85792249,10943372,CNL
chr09,Bn38297,27798900,49976705,22177805,RLK
chr09,Bn38298,45363627,96004654,50641027,CNL
chr09,Bn38299,81659647,97162435,15502788,CN
chr09,Bn38300,43230669,78568517,35337848,RLP
chr09,Bn38301,73666169,76207560,2541391,NBS
chr09,Bn38302,15742031,48621524,32879493,RLP
chr09,Bn38303,20361271,74979116,54617845,CNL
chr09,Bn38304,21369806,74289190,52919384,RLP
chr09,Bn38305,99004998,99296245,291247,CNL
chr09,Bn38306,2111613,8087279,5975666,CNL
chr09,Bn38307,68352657,79850256,11497599,CN
chr09,Bn38308,84003688,98824645,14820957,RLP
chr09,Bn38309,77964326,83296312,5331986,RLK
chr09,Bn38310,17222710,98205422,80982712,RLK
chr09,Bn38311,80036611,82090240,2053629,CNL
chr09,Bn38312,9132015,79531602,70399587,RLK
chr09,Bn38313,7168846,62815004,55646158,RLK
chr09,Bn38314,20613651,49366529,28752878,RLP
chr09,Bn38315,57953110,93223079,35269969,TNL
chr09,Bn38316,42615677,67249227,24633550,RLK
chr09,Bn38317,61287670,89936673,28649003,TN
chr09,Bn38318,5557185,13616427,8059242,RLK
chr09,Bn38319,59825065,74346361,14521296,TN
chr09,Bn38320,48840358,50521493,1681135,NBS
chr09,Bn38321,70512253,79111561,8599308,TN
chr09,Bn38322,73832353,76287037,2454684,CN
chr09,Bn38323,10994239,65292916,54298677,CNL
chr09,Bn38324,83522247,84282226,759979,CNL
chr09,Bn38325,18848386,70385575,51537189,CNL
chr09,Bn38326,19304858,82190486,62885628,NBS
chr09,Bn38327,59171354,71150533,11979179,RLP
chr09,Bn38328,94962514,96954917,1992403,CN
chr09,Bn38329,32934306,84847517,51913211,RLK
chr09,Bn38330,51617540,57288092,5670552,CNL
chr09,Bn38331,89751633,95350532,5598899,CNL
chr09,Bn38332,63014919,90336460,27321541,TN
chr09,Bn38333,48646915,64223496,15576581,TN
chr09,Bn38334,87376892,88390740,1013848,NBS
chr09,Bn38335,57385258,98042604,40657346,RLP
chr09,Bn38336,53511895,77436788,23924893,TNL
chr09,Bn38337,95697329,98624462,2927133,TN
chr09,Bn38338,14272537,73463971,59191434,TNL
chr09,Bn38339,90760975,99422870,8661895,RLK
chr09,Bn38340,53932491,81076714,27144223,CNL
chr09,Bn38341,31698022,57504019,25805997,RLP
chr09,Bn38342,19437418,61828002,42390584,TN
chr09,Bn38343,69583079,73525956,3942877,RLP
chr09,Bn38344,12603965,59004188,46400223,RLP
chr09,Bn38345,12991032,22250273,9259241,TNL
chr09,Bn38346,64610764,81855942,17245178,TNL
chr09,Bn38347,75043076,85369585,10326509,TNL
chr09,Bn38348,80135483,98731025,18595542,CNL
chr09,Bn38349,55812429,89518026,33705597,NBS
chr09,Bn38350,35499202,36806462,1307260,TNL
chr09,Bn38351,63887192,78084625,14197433,TN
chr09,Bn38352,65965065,89789954,23824889,CNL
chr09,Bn38353,81421698,95095892,13674194,TN
chr09,Bn38354,46516185,76837263,30321078,CN
chr09,Bn38355,48439029,64866920,16427891,CNL
chr09,Bn38356,89156348,89785807,629459,TN
chr09,Bn38357,61067611,63814646,2747035,CNL
chr09,Bn38358,39321819,99454456,60132637,CNL
chr09,Bn38359,5537689,6088664,550975,TNL
chr09,Bn38360,6448768,96164765,89715997,TN
chr09,Bn38361,16192982,27241428,11048446,RLK
chr09,Bn38362,29643277,76794819,47151542,CN
chr09,Bn38363,45846502,91091557,45245055,RLK
chr09,Bn38364,14891355,88659797,73768442,TN
chr09,Bn38365,53069006,54060771,991765,RLP
chr09,Bn38366,50169159,89836566,39667407,TNL
chr09,Bn38367,1378160,32021149,30642989,TNL
chr09,Bn38368,17338652,81393758,64055106,TNL
chr09,Bn38369,99426274,99639405,213131,NBS
chr09,Bn38370,72164886,87400440,15235554,TN
chr09,Bn38371,76991711,89552636,12560925,CNL
chr09,Bn38372,20501645,88256915,67755270,TNL
chr09,Bn38373,57315724,58573927,1258203,CNL
chr09,Bn38374,55875487,56487650,612163,CN
chr09,Bn38375,35510463,48397549,12887086,CN
chr09,Bn38376,58145997,60473640,2327643,RLK
chr09,Bn38377,66682227,75361014,8678787,RLK
chr09,Bn38378,53426057,59771734,6345677,CNL
chr09,Bn38379,2982211,59321946,56339735,TN
chr09,Bn38380,85382353,98391157,13008804,NBS
chr09,Bn38381,73056743,74640337,1583594,CN
chr09,Bn38382,90102411,91660131,1557720,TNL
chr09,Bn38383,79128189,95563007,16434818,CNL
chr09,Bn38384,27876095,69323667,41447572,RLP
chr09,Bn38385,50369263,68974623,18605360,NBS
chr09,Bn38386,25736768,29431788,3695020,CNL
chr09,Bn38387,14623720,78674927,64051207,TNL
chr09,Bn38388,72269195,96278645,24009450,CN
chr09,Bn38389,70742592,70802687,60095,NBS
chr09,Bn38390,96353754,98980299,2626545,RLP
chr09,Bn38391,87057718,88102439,1044721,RLK
chr09,Bn38392,78740924,95930890,17189966,RLK
chr09,Bn38393,5855635,47442406,41586771,TNL
chr09,Bn38394,34262389,90633034,56370645,NBS
chr09,Bn38395,98694891,98813924,119033,RLP
chr09,Bn38396,19615564,49490468,29874904,CNL
chr09,Bn38397,76761209,87455678,10694469,CNL
chr09,Bn38398,8039360,55095672,47056312,CN
chr09,Bn38399,66511219,95554216,29042997,NBS
chr09,Bn38400,41561610,47709956,6148346,CN
chr09,Bn38401,2850465,81929155,79078690,TNL
chr09,Bn38402,85192128,91734920,6542792,NBS
chr09,Bn38403,64670528,87154704,22484176,TNL
chr09,Bn38404,94486279,96812617,2326338,CNL
chr09,Bn38405,47952038,82374011,34421973,RLP
chr09,Bn38406,52352138,81826176,29474038,TN
chr09,Bn38407,98410657,99283546,872889,CNL
chr09,Bn38408,20842204,45424662,24582458,RLP
chr09,Bn38409,83996227,95685994,11689767,RLK
chr09,Bn38410,31019126,69423646,38404520,CNL
chr09,Bn38411,61777078,74859597,13082519,NBS
chr09,Bn38412,57426405,83637178,26210773,NBS
chr09,Bn38413,8680953,65419433,56738480,TNL
chr09,Bn38414,20945784,84716195,63770411,CNL
chr09,Bn38415,83602534,96373745,12771211,CNL
chr09,Bn38416,52116234,57514732,5398498,CN
chr09,Bn38417,79873602,97257905,17384303,NBS
chr09,Bn38418,70761147,90820665,20059518,TN
chr09,Bn38419,84138434,96258021,12119587,CN
chr09,Bn38420,84680816,99802103,15121287,RLP
chr09,Bn38421,13023028,73028605,60005577,TN
chr09,Bn38422,48977304,87822518,38845214,RLP
chr09,Bn38423,66819009,91556437,24737428,RLK
chr09,Bn38424,46669473,97593777,50924304,CN
chr09,Bn38425,48965145,72424052,23458907,CNL
chr09,Bn38426,59079639,97199547,38119908,TN
chr09,Bn38427,95293112,97919084,2625972,CN
chr09,Bn38428,23416025,69483189,46067164,RLK
chr09,Bn38429,18257221,42434681,24177460,RLK
chr09,Bn38430,78089908,82157292,4067384,RLK
chr09,Bn38431,9211466,55725510,46514044,RLK
chr09,Bn38432,97774054,98367126,593072,NBS
chr09,Bn38433,44782255,51839956,7057701,NBS
chr09,Bn38434,23272322,84238702,60966380,CN
chr09,Bn38435,17529474,94641353,77111879,NBS
chr09,Bn38436,71099398,92415201,21315803,CNL
chr09,Bn38437,74788080,87635076,12846996,RLP
chr09,Bn38438,85164192,85253577,89385,TNL
chr09,Bn38439,72011265,82181053,10169788,RLP
chr09,Bn38440,36777792,71935751,35157959,CNL
chr09,Bn38441,97582618,97919529,336911,TNL
chr09,Bn38442,94818765,98884469,4065704,RLP
chr09,Bn38443,36802081,59570079,22767998,RLK
chr09,Bn38444,75346362,93056586,17710224,NBS
chr09,Bn38445,27887149,36783833,8896684,TN
chr09,Bn38446,63871159,69505545,5634386,CN
chr09,Bn38447,17815444,55149203,37333759,NBS
chr09,Bn38448,88912355,97838111,8925756,CNL
chr09,Bn38449,73433131,96408519,22975388,RLP
chr09,Bn38450,61494426,86161302,24666876,RLK
chr09,Bn38451,76931316,95902476,18971160,CNL
chr09,Bn38452,30919340,98183904,67264564,NBS
chr09,Bn38453,72219712,83749193,11529481,TN
chr09,Bn38454,59944970,69502072,9557102,CN
chr09,Bn38455,82468803,98584790,16115987,RLP
chr09,Bn38456,96369355,98688197,2318842,RLK
chr09,Bn38457,49818793,75831225,26012432,TN
chr09,Bn38458,40876135,65052006,24175871,CN
chr09,Bn38459,20577883,21186402,608519,RLP
chr09,Bn38460,38499745,93889366,55389621,TN
chr09,Bn38461,98649639,99838764,1189125,RLP
chr09,Bn38462,27817048,36105376,8288328,NBS
chr09,Bn38463,28139801,78227978,50088177,TN
chr09,Bn38464,78201156,80994905,2793749,TNL
chr09,Bn38465,51989180,84269144,32279964,NBS
chr09,Bn38466,70735374,86348981,15613607,CN
chr09,Bn38467,24531749,38941268,14409519,TNL
chr09,Bn38468,86013811,98591311,12577500,CN
chr09,Bn38469,49698539,72739187,23040648,CN
chr09,Bn38470,10345304,24992991,14647687,RLK
chr09,Bn38471,61645777,85263526,23617749,TNL
chr09,Bn38472,74221590,97495798,23274208,NBS
chr09,Bn38473,81769409,88557496,6788087,CNL
chr09,Bn38474,78738631,87664285,8925654,RLK
chr09,Bn38475,22853008,27668995,4815987,TN
chr09,Bn38476,8041972,69818216,61776244,NBS
chr09,Bn38477,75246442,98429128,23182686,RLP
chr09,Bn38478,32496084,38322872,5826788,NBS
chr09,Bn38479,86583210,95279442,8696232,CN
chr09,Bn38480,41025731,51065236,10039505,CN
chr09,Bn38481,16517688,18692201,2174513,NBS
chr09,Bn38482,68751364,78898390,10147026,TN
chr09,Bn38483,7736098,10937386,3201288,TN
chr09,Bn38484,68775459,84175823,15400364,CNL
chr09,Bn38485,81584639,97903517,16318878,RLP
chr09,Bn38486,88029688,88249492,219804,RLK
chr09,Bn38487,73431447,74601207,1169760,TNL
chr09,Bn38488,62689339,78143572,15454233,NBS
chr09,Bn38489,29039979,78943565,49903586,CN
chr09,Bn38490,70100163,93814724,23714561,CN
chr09,Bn38491,97814295,99396301,1582006,RLP
chr09,Bn38492,31412081,91038826,59626745,CN
chr09,Bn38493,95430059,97704238,2274179,NBS
chr09,Bn38494,26401421,29137486,2736065,RLK
chr09,Bn38495,9358099,96452763,87094664,RLP
chr09,Bn38496,21893284,94567596,72674312,RLP
chr09,Bn38497,52246385,69531018,17284633,CN
chr09,Bn38498,55542582,59444852,3902270,RLP
chr09,Bn38499,99398682,99439552,40870,RLK
chr09,Bn38500,13193604,89939478,76745874,NBS
chr09,Bn38501,81965933,85760528,3794595,TN
chr09,Bn38502,84442035,86719258,2277223,RLP
chr09,Bn38503,40388079,42057502,1669423,CN
chr09,Bn38504,94731900,97019956,2288056,TNL
chr09,Bn38505,75178619,88359143,13180524,TNL
chr09,Bn38506,11001155,90547380,79546225,RLP
chr09,Bn38507,59057334,76506673,17449339,RLP
chr09,Bn38508,31587781,78028234,46440453,RLK
chr09,Bn38509,16195452,70818678,54623226,NBS
chr09,Bn38510,63482427,75864070,12381643,CN
chr09,Bn38511,45696965,93808929,48111964,TNL
chr09,Bn38512,48533081,62690613,14157532,TN
chr09,Bn38513,83483766,96060600,12576834,TN
chr09,Bn38514,17716837,46515984,28799147,CNL
chr09,Bn38515,24516972,65916907,41399935,TN
chr09,Bn38516,68719713,97522716,28803003,RLP
chr09,Bn38517,76693388,87422646,10729258,CN
chr09,Bn38518,58529944,63211605,4681661,CNL
chr09,Bn38519,52885047,93115659,40230612,NBS
chr09,Bn38520,99895345,99987344,91999,TN
chr09,Bn38521,36933974,44925167,7991193,CN
chr09,Bn38522,38781522,96568133,57786611,NBS
chr09,Bn38523,93657408,97446706,3789298,RLP
chr09,Bn38524,66045923,93562107,27516184,CN
chr09,Bn38525,82918748,91084254,8165506,RLP
chr09,Bn38526,73442675,80606203,7163528,CNL
chr09,Bn38527,97676026,98695567,1019541,TNL
chr09,Bn38528,94940813,96396429,1455616,NBS
chr09,Bn38529,46862641,58083133,11220492,CN
chr09,Bn38530,15548090,61159800,45611710,RLP
chr09,Bn38531,38174335,56601360,18427025,CNL
chr09,Bn38532,33429296,82798805,49369509,RLK
chr09,Bn38533,17379713,49300331,31920618,RLP
chr09,Bn38534,56550536,62815933,6265397,RLK
chr09,Bn38535,84335014,85644489,1309475,TNL
chr09,Bn38536,23507480,60763515,37256035,RLP
chr09,Bn38537,34813680,55524113,20710433,TNL
chr09,Bn38538,44946107,53043440,8097333,TN
chr09,Bn38539,31890774,45096632,13205858,RLP
chr09,Bn38540,18441115,96892862,78451747,CNL
chr09,Bn38541,11606598,77195484,65588886,RLK
chr09,Bn38542,69262268,73762228,4499960,CN
chr09,Bn38543,40221550,75041604,34820054,CN
chr09,Bn38544,67358558,89883510,22524952,RLP
chr09,Bn38545,36544723,44401105,7856382,RLK
chr09,Bn38546,4015033,76877441,72862408,TN
chr09,Bn38547,94296547,97463516,3166969,NBS
chr09,Bn38548,98468842,99330443,861601,RLP
chr09,Bn38549,87276469,93045949,5769480,TN
chr09,Bn38550,35254073,78235744,42981671,TNL
chr09,Bn38551,25048962,97026900,71977938,CN
chr09,Bn38552,79697513,91572446,11874933,CNL
chr09,Bn38553,54227168,79303118,25075950,RLP
chr09,Bn38554,44372528,68317099,23944571,TN
chr09,Bn38555,7132868,94762497,87629629,TN
chr09,Bn38556,38814651,69381332,30566681,TNL
chr09,Bn38557,41018335,62553181,21534846,CN
chr09,Bn38558,5996500,12365426,6368926,CN
chr09,Bn38559,98723026,99182212,459186,TN
chr09,Bn38560,55572120,61396497,5824377,CN
chr09,Bn38561,31787319,45139072,13351753,TNL
chr09,Bn38562,48848935,79384079,30535144,CN
chr09,Bn38563,92512268,95069814,2557546,TNL
chr09,Bn38564,61515489,64734576,3219087,TNL
chr09,Bn38565,11459664,63840733,52381069,CN
chr09,Bn38566,81339369,95928469,14589100,TN
chr09,Bn38567,94480923,98143578,3662655,RLK
chr09,Bn38568,34562668,43719952,9157284,CNL
chr09,Bn38569,71332338,71429608,97270,TNL
chr09,Bn38570,17786188,74719835,56933647,NBS
chr09,Bn38571,7662546,29604368,21941822,NBS
chr09,Bn38572,41873329,47447716,5574387,TNL
chr09,Bn38573,21272495,61554156,40281661,CN
chr09,Bn38574,93715183,97011672,3296489,TNL
chr09,Bn38575,56600861,78344532,21743671,RLP
chr09,Bn38576,28706743,56329883,27623140,NBS
chr09,Bn38577,81421631,89932359,8510728,CN
chr09,Bn38578,92369472,98519215,6149743,RLP
chr09,Bn38579,11338450,42867347,31528897,RLP
chr09,Bn38580,91319748,99606332,8286584,CN
chr09,Bn38581,58580309,65295178,6714869,NBS
chr09,Bn38582,59444522,84171072,24726550,RLP
chr09,Bn38583,97660973,98504320,843347,CNL
chr09,Bn38584,80062654,86214092,6151438,RLK
chr09,Bn38585,10113070,72404388,62291318,TN
chr09,Bn38586,78388190,98579620,20191430,CN
chr09,Bn38587,40479460,64113209,23633749,CNL
chr09,Bn38588,21218115,88543528,67325413,RLK
chr09,Bn38589,24956139,61308700,36352561,CN
chr09,Bn38590,96254204,98077814,1823610,CNL
chr09,Bn38591,72440535,93205236,20764701,NBS
chr09,Bn38592,37523844,87103232,49579388,RLP
chr09,Bn38593,85710863,91788407,6077544,CNL
chr09,Bn38594,13452926,38286793,24833867,CNL
chr09,Bn38595,91838801,97740299,5901498,NBS
chr09,Bn38596,60335069,63887563,3552494,TN
chr09,Bn38597,14963493,85644364,70680871,RLP
chr09,Bn38598,22135529,31021946,8886417,TN
chr09,Bn38599,30034217,45262382,15228165,TN
chr09,Bn38600,79939020,91064955,11125935,RLP
chr09,Bn38601,35049696,54863067,19813371,TNL
chr09,Bn38602,75625016,90500068,14875052,RLP
chr09,Bn38603,22065198,26095187,4029989,TNL
chr09,Bn38604,47078476,49320834,2242358,NBS
chr09,Bn38605,61730711,85802626,24071915,RLP
chr09,Bn38606,4759274,22223021,17463747,CN
chr09,Bn38607,17353641,47856559,30502918,RLP
chr09,Bn38608,57661157,69943974,12282817,CNL
chr09,Bn38609,31771555,81158439,49386884,TN
chr09,Bn38610,21213678,45470418,24256740,RLP
chr09,Bn38611,98363012,98828553,465541,TNL
chr09,Bn38612,80241960,96380084,16138124,CN
chr09,Bn38613,92321235,95536755,3215520,CN
chr09,Bn38614,21711785,74196356,52484571,RLK
chr09,Bn38615,56552885,61541812,4988927,CN
chr09,Bn38616,97462354,98370957,908603,TNL
chr09,Bn38617,14728107,31384203,16656096,TNL
chr09,Bn38618,41973896,43309629,1335733,RLK
chr09,Bn38619,56979425,65163186,8183761,CNL
chr09,Bn38620,87797046,99854374,12057328,CN
chr09,Bn38621,99265478,99521934,256456,TN
chr09,Bn38622,49047569,60605791,11558222,CN
chr09,Bn38623,3881389,47772784,43891395,NBS
chr09,Bn38624,73794164,90804849,17010685,RLP
chr09,Bn38625,82822056,87873556,5051500,CN
chr09,Bn38626,55652958,87726575,32073617,TNL
chr09,Bn38627,63285396,96586469,33301073,NBS
chr09,Bn38628,1731943,19327897,17595954,CNL
chr09,Bn38629,99381007,99460358,79351,CNL
chr09,Bn38630,6023370,12862181,6838811,RLP
chr09,Bn38631,77286101,91281004,13994903,RLP
chr09,Bn38632,39813895,88798599,48984704,RLP
chr09,Bn38633,99312364,99741880,429516,RLP
chr09,Bn38634,28556524,72056105,43499581,RLK
chr09,Bn38635,46656705,57300484,10643779,RLK
chr09,Bn38636,17420728,64102047,46681319,CN
chr09,Bn38637,7174502,55218181,48043679,RLK
chr09,Bn38638,11404139,28199383,16795244,RLP
chr09,Bn38639,79902819,93841800,13938981,NBS
chr09,Bn38640,95296380,97026425,1730045,CNL
chr09,Bn38641,58661717,71375791,12714074,CNL
chr09,Bn38642,8291394,97496939,89205545,CNL
chr09,Bn38643,33813475,82782291,48968816,RLK
chr09,Bn38644,1780654,56856911,55076257,CN
chr09,Bn38645,71250412,76802186,5551774,NBS
chr09,Bn38646,2489551,73346826,70857275,RLP
chr09,Bn38647,87872350,99728861,11856511,RLK
chr09,Bn38648,11142098,98807901,87665803,TNL
chr09,Bn38649,52792951,89998516,37205565,NBS
chr09,Bn38650,40368398,49327000,8958602,TN
chr09,Bn38651,85017600,95456203,10438603,CNL
chr09,Bn38652,74415200,75090805,675605,TNL
chr09,Bn38653,40842958,63682612,22839654,RLP
chr09,Bn38654,55312319,60402906,5090587,CNL
chr09,Bn38655,5766400,27984497,22218097,CNL
chr09,Bn38656,74102160,74615838,513678,CNL
chr09,Bn38657,3214014,66816532,63602518,TNL
chr09,Bn38658,1334393,62122116,60787723,TNL
chr09,Bn38659,24342383,59092363,34749980,TNL
chr09,Bn38660,8210760,53078850,44868090,TN
chr09,Bn38661,38615045,91894614,53279569,TN
chr09,Bn38662,57866813,70064505,12197692,RLP
chr09,Bn38663,52897215,87579011,34681796,CN
chr09,Bn38664,26513556,93135667,66622111,TN
chr09,Bn38665,66066651,82689491,16622840,NBS
chr09,Bn38666,75323134,76157386,834252,CNL
chr09,Bn38667,9643873,95459617,85815744,CNL
chr09,Bn38668,90373385,93553324,3179939,RLK
chr09,Bn38669,54878361,65727330,10848969,CNL
chr09,Bn38670,96507433,97964134,1456701,RLP
chr09,Bn38671,38765454,89240396,50474942,RLK
chr09,Bn38672,31242629,45022235,13779606,CNL
chr09,Bn38673,52621798,75714943,23093145,TN
chr09,Bn38674,60140816,79544588,19403772,RLK
chr09,Bn38675,43916037,82441563,38525526,RLP
chr09,Bn38676,77510796,93088389,15577593,RLP
chr09,Bn38677,67926523,74250699,6324176,CNL
chr09,Bn38678,42602629,95828703,53226074,CNL
chr09,Bn38679,8817069,24334262,15517193,TNL
chr09,Bn38680,82000069,86564323,4564254,NBS
chr09,Bn38681,54446428,86231774,31785346,TNL
chr09,Bn38682,28226272,46471069,18244797,RLK
chr09,Bn38683,6795244,40525609,33730365,TN
chr09,Bn38684,39834333,43745200,3910867,NBS
chr09,Bn38685,62821448,86896178,24074730,TN
chr09,Bn38686,98394959,98782377,387418,RLP
chr09,Bn38687,42975823,69325692,26349869,NBS
chr09,Bn38688,68148267,69562228,1413961,CNL
chr09,Bn38689,66752166,97050243,30298077,RLP
chr09,Bn38690,68187231,96273189,28085958,RLP
chr09,Bn38691,63599619,69696268,6096649,TNL
chr09,Bn38692,41523293,81360523,39837230,TNL
chr09,Bn38693,64659447,85744004,21084557,CNL
chr09,Bn38694,56305716,96194562,39888846,NBS
chr09,Bn38695,25575007,77554021,51979014,TNL
chr09,Bn38696,69037911,76704459,7666548,NBS
chr09,Bn38697,61652711,94399555,32746844,TNL
chr09,Bn38698,17929882,73654873,55724991,TN
chr09,Bn38699,82855860,83150141,294281,RLK
chr09,Bn38700,15080825,66065513,50984688,TNL
chr09,Bn38701,63409021,94206562,30797541,TN
chr09,Bn38702,63184567,88110107,24925540,RLK
chr09,Bn38703,69224845,80713267,11488422,NBS
chr09,Bn38704,90095116,92845242,2750126,CN
chr09,Bn38705,56255772,57010970,755198,TNL
chr09,Bn38706,88535241,96758698,8223457,TNL
chr09,Bn38707,20702725,79794117,59091392,NBS
chr09,Bn38708,12771880,45041227,32269347,TNL
chr09,Bn38709,57237406,65587779,8350373,RLK
chr09,Bn38710,34702200,85197816,50495616,CN
chr09,Bn38711,20544853,69772718,49227865,TN
chr09,Bn38712,19497839,21464082,1966243,RLP
chr09,Bn38713,62874694,98586054,35711360,CNL
chr09,Bn38714,32211998,84927540,52715542,RLP
chr09,Bn38715,93095580,93898695,803115,RLK
chr09,Bn38716,27558399,91213636,63655237,CNL
chr09,Bn38717,34097351,84529249,50431898,NBS
chr09,Bn38718,27740721,36143201,8402480,NBS
chr09,Bn38719,34481257,71639806,37158549,TNL
chr09,Bn38720,78731869,95135237,16403368,CN
chr09,Bn38721,55838003,68862259,13024256,TNL
chr09,Bn38722,21632139,93049449,71417310,RLK
chr09,Bn38723,28196235,49647622,21451387,RLK
chr09,Bn38724,54343494,63832159,9488665,CN
chr09,Bn38725,47050235,86609261,39559026,RLP
chr09,Bn38726,54059699,72928840,18869141,TN
chr09,Bn38727,81815589,98236091,16420502,RLK
chr09,Bn38728,99507807,99762099,254292,CNL
chr09,Bn38729,19857866,20592882,735016,RLK
chr09,Bn38730,42465595,84604033,42138438,RLP
chr09,Bn38731,99164610,99214389,49779,CNL
chr09,Bn38732,68008088,77231427,9223339,RLK
chr09,Bn38733,34765859,38278887,3513028,NBS
chr09,Bn38734,18991212,77900479,58909267,CNL
chr09,Bn38735,69358999,73175457,3816458,RLP
chr09,Bn38736,15419356,85271477,69852121,NBS
chr09,Bn38737,77540714,87629873,10089159,RLK
chr09,Bn38738,16556916,71130243,54573327,CN
chr09,Bn38739,17494502,86633958,69139456,TN
chr09,Bn38740,9027681,14793414,5765733,CNL
chr09,Bn38741,68237227,77039266,8802039,NBS
chr09,Bn38742,8309746,81884329,73574583,CNL
chr09,Bn38743,6678435,38293484,31615049,CN
chr09,Bn38744,40455765,40869089,413324,CNL
chr09,Bn38745,36427943,84562049,48134106,NBS
chr09,Bn38746,77310052,89055863,11745811,RLP
chr09,Bn38747,84084237,87038545,2954308,RLP
chr09,Bn38748,16190549,77552318,61361769,CNL
chr09,Bn38749,81749833,87987497,6237664,TNL
chr09,Bn38750,4933097,9871247,4938150,TN
chr09,Bn38751,52117984,67467206,15349222,NBS
chr09,Bn38752,1515050,40563081,39048031,CN
chr09,Bn38753,79400772,84185171,4784399,NBS
chr09,Bn38754,30206625,57017669,26811044,RLK
chr09,Bn38755,26145864,83165971,57020107,RLK
chr09,Bn38756,66444922,85403076,18958154,TNL
chr09,Bn38757,16733246,76149917,59416671,CN
chr09,Bn38758,65254938,86154917,20899979,NBS
chr09,Bn38759,80113035,99947416,19834381,TNL
chr09,Bn38760,50803104,99680195,48877091,TNL
chr09,Bn38761,19437908,23683993,4246085,RLK
chr09,Bn38762,1688877,51525959,49837082,RLK
chr09,Bn38763,61085394,69516950,8431556,TN
chr09,Bn38764,72605991,74992859,2386868,CNL
chr09,Bn38765,56766716,99063507,42296791,RLK
chr09,Bn38766,79712248,92846401,13134153,CN
chr09,Bn38767,32767912,80461600,47693688,CNL
chr09,Bn38768,40867886,99490732,58622846,CN
chr09,Bn38769,8176936,76040765,67863829,NBS
chr09,Bn38770,60851833,62425734,1573901,CN
chr09,Bn38771,82178966,82637129,458163,RLK
chr09,Bn38772,37359784,76513097,39153313,RLP
chr09,Bn38773,3302133,65024247,61722114,CNL
chr09,Bn38774,44842383,60770286,15927903,RLK
chr09,Bn38775,63740988,70835073,7094085,CNL
chr09,Bn38776,31909436,87206483,55297047,CNL
chr09,Bn38777,47612842,73561399,25948557,CN
chr09,Bn38778,15935017,91812833,75877816,NBS
chr09,Bn38779,25231176,45889956,20658780,TN
chr09,Bn38780,79527710,92242212,12714502,CNL
chr09,Bn38781,68271492,81323155,13051663,CN
chr09,Bn38782,5319337,34192297,28872960,NBS
chr09,Bn38783,34385668,35904867,1519199,CNL
chr09,Bn38784,80605221,92913854,12308633,TN
chr09,Bn38785,53933864,85449203,31515339,CN
chr09,Bn38786,5562708,21897012,16334304,TNL
chr09,Bn38787,79774021,83709663,3935642,RLK
chr09,Bn38788,79521284,94895168,15373884,TNL
chr09,Bn38789,27585556,52814904,25229348,TNL
chr09,Bn38790,77739677,87895895,10156218,RLK
chr09,Bn38791,91375741,92059497,683756,TN
chr09,Bn38792,30800603,41022493,10221890,NBS
chr09,Bn38793,45585896,85784061,40198165,TN
chr09,Bn38794,5122085,77002468,71880383,RLP
chr09,Bn38795,23534002,83225343,59691341,NBS
chr09,Bn38796,73186057,74607030,1420973,RLP
chr09,Bn38797,66009155,85370485,19361330,CN
chr09,Bn38798,58187765,94734452,36546687,TNL
chr09,Bn38799,87407885,91687790,4279905,TNL
chr09,Bn38800,12866193,73201249,60335056,RLP
chr09,Bn38801,61616402,71062396,9445994,TNL
chr09,Bn38802,69355119,86442427,17087308,TN
chr09,Bn38803,80759756,83209960,2450204,RLP
chr09,Bn38804,53913568,76374594,22461026,RLP
chr09,Bn38805,84483959,88065802,3581843,NBS
chr09,Bn38806,33105971,47909992,14804021,TN
chr09,Bn38807,54668088,72283987,17615899,RLP
chr09,Bn38808,24957176,51000945,26043769,TNL
chr09,Bn38809,76727621,95322045,18594424,TNL
chr09,Bn38810,46135431,70626606,24491175,CNL
chr09,Bn38811,90528563,99526568,8998005,NBS
chr09,Bn38812,13613644,75534574,61920930,NBS
chr09,Bn38813,55398434,95048672,39650238,CN
chr09,Bn38814,52083431,96137024,44053593,CN
chr09,Bn38815,21434352,60921299,39486947,RLP
chr09,Bn38816,73199181,79712550,6513369,NBS
chr09,Bn38817,66661528,67565569,904041,NBS
chr09,Bn38818,88983434,96096886,7113452,TNL
chr09,Bn38819,75043551,78268816,3225265,CN
chr09,Bn38820,88591073,90927683,2336610,CN
chr09,Bn38821,28971056,72788537,43817481,TN
chr09,Bn38822,54507608,94960253,40452645,CNL
chr09,Bn38823,55284195,71117258,15833063,NBS
chr09,Bn38824,20161835,72199194,52037359,NBS
chr09,Bn38825,96806506,99679815,2873309,TN
chr09,Bn38826,6605511,28012428,21406917,TN
chr09,Bn38827,59426483,63021869,3595386,NBS
chr09,Bn38828,99599777,99954209,354432,NBS
chr09,Bn38829,78537886,86791168,8253282,RLP
chr09,Bn38830,3895823,22681614,18785791,RLP
chr09,Bn38831,63335705,90160991,26825286,CN
chr09,Bn38832,75050107,76060939,1010832,CN
chr09,Bn38833,85093829,94619064,9525235,RLK
chr09,Bn38834,94475316,97453873,2978557,RLK
chr09,Bn38835,54098320,94917029,40818709,CN
chr09,Bn38836,88606794,97994965,9388171,NBS
chr09,Bn38837,28606475,32099279,3492804,RLP
chr09,Bn38838,84693992,86130233,1436241,TN
chr09,Bn38839,35344160,86396852,51052692,TNL
chr09,Bn38840,95477815,99740575,4262760,RLK
chr09,Bn38841,6156608,83887006,77730398,RLP
chr09,Bn38842,57313586,81855866,24542280,RLP
chr09,Bn38843,82932589,90190699,7258110,TNL
chr09,Bn38844,57585991,81210196,23624205,NBS
chr09,Bn38845,94235137,98266494,4031357,TNL
chr09,Bn38846,29902309,69147567,39245258,CNL
chr09,Bn38847,56818909,94676559,37857650,RLK
chr09,Bn38848,8807744,94210585,85402841,CNL
chr09,Bn38849,79893864,84656822,4762958,RLP
chr09,Bn38850,80533273,84733092,4199819,RLK
chr09,Bn38851,28617821,45765101,17147280,TN
chr09,Bn38852,6745528,43360859,36615331,CN
chr09,Bn38853,94096288,96603901,2507613,RLP
chr09,Bn38854,89327710,93911223,4583513,TNL
chr09,Bn38855,76044501,83190477,7145976,NBS
chr09,Bn38856,9639896,86562559,76922663,TN
chr09,Bn38857,73115028,79922499,6807471,RLP
chr09,Bn38858,54453468,85108711,30655243,CNL
chr09,Bn38859,12195764,46174676,33978912,RLK
chr09,Bn38860,67070949,72583502,5512553,CNL
chr09,Bn38861,28943951,94475868,65531917,CN
chr09,Bn38862,85366543,88118465,2751922,TNL
chr09,Bn38863,29045252,62840890,33795638,TN
chr09,Bn38864,1639165,81735767,80096602,CN
chr09,Bn38865,68726564,96103131,27376567,RLP
chr09,Bn38866,23672964,65812778,42139814,RLK
chr09,Bn38867,35612957,76955549,41342592,TNL
chr09,Bn38868,92733917,99466662,6732745,TN
chr09,Bn38869,77979369,90878240,12898871,NBS
chr09,Bn38870,61106936,80008064,18901128,TN
chr09,Bn38871,36171586,42681633,6510047,RLK
chr09,Bn38872,82792569,98249638,15457069,RLK
chr09,Bn38873,63157758,98458122,35300364,RLK
chr09,Bn38874,34645466,56317030,21671564,CN
chr09,Bn38875,19694053,68597201,48903148,RLK
chr09,Bn38876,61305941,64998512,3692571,TN
chr09,Bn38877,44515402,59539646,15024244,CN
chr09,Bn38878,76541147,95226818,18685671,CN
chr09,Bn38879,31492550,99850717,68358167,CNL
chr09,Bn38880,42525408,73543493,31018085,TNL
chr09,Bn38881,8592947,31489818,22896871,TN
chr09,Bn38882,71224531,94288556,23064025,NBS
chr09,Bn38883,22122503,79769042,57646539,CNL
chr09,Bn38884,9176536,48521706,39345170,NBS
chr09,Bn38885,89653838,94290923,4637085,CNL
chr09,Bn38886,91624375,94818374,3193999,RLP
chr09,Bn38887,19525780,66796876,47271096,NBS
chr09,Bn38888,68891938,89317416,20425478,RLP
chr09,Bn38889,30200930,87000706,56799776,RLK
chr09,Bn38890,79211001,95826640,16615639,RLP
chr09,Bn38891,10114582,81555082,71440500,TNL
chr09,Bn38892,72444245,85393488,12949243,TNL
chr09,Bn38893,98509716,98912679,402963,RLP
chr09,Bn38894,4899851,90702547,85802696,CN
chr09,Bn38895,65913948,92851286,26937338,RLP
chr09,Bn38896,3476519,77908819,74432300,TNL
chr09,Bn38897,6885799,55248188,48362389,RLK
chr09,Bn38898,88381280,92140384,3759104,RLK
chr09,Bn38899,64753861,92719070,27965209,RLP
chr09,Bn38900,36866889,93478776,56611887,TNL
chr09,Bn38901,57146383,83040989,25894606,CNL
chr09,Bn38902,37399311,93510383,56111072,NBS
chr09,Bn38903,56331879,93926057,37594178,CN
chr09,Bn38904,59870504,81413921,21543417,NBS
chr09,Bn38905,54494501,91988521,37494020,RLP
chr09,Bn38906,16988916,99714764,82725848,TNL
chr09,Bn38907,67683008,90164386,22481378,NBS
chr09,Bn38908,26217741,61538233,35320492,CN
chr09,Bn38909,71342723,90931848,19589125,TN
chr09,Bn38910,78038657,96359786,18321129,CN
chr09,Bn38911,35487351,62092136,26604785,TN
chr09,Bn38912,35418874,92472968,57054094,CN
chr09,Bn38913,25374558,50946550,25571992,TNL
chr09,Bn38914,66969949,74334201,7364252,TNL
chr09,Bn38915,16785156,47192911,30407755,RLP
chr09,Bn38916,93784282,95375194,1590912,CN
chr09,Bn38917,57529470,64622661,7093191,RLK
chr09,Bn38918,79793632,83970165,4176533,NBS
chr09,Bn38919,35006930,61977267,26970337,TNL
chr09,Bn38920,41804620,82922105,41117485,RLK
chr09,Bn38921,66532098,94239774,27707676,CNL
chr09,Bn38922,7205050,34048521,26843471,TNL
chr09,Bn38923,40218650,89318442,49099792,CNL
chr09,Bn38924,55946281,78006468,22060187,CN
chr09,Bn38925,50392491,87195751,36803260,RLP
chr09,Bn38926,75105936,83449726,8343790,TNL
chr09,Bn38927,70478158,86948674,16470516,RLP
chr09,Bn38928,22177284,72364485,50187201,CN
chr09,Bn38929,17062833,75819722,58756889,RLK
chr09,Bn38930,34435869,38124212,3688343,CNL
chr09,Bn38931,5806368,11616182,5809814,TNL
chr09,Bn38932,2327494,16798131,14470637,RLP
chr09,Bn38933,11484074,24579995,13095921,RLP
chr09,Bn38934,64954734,85564226,20609492,RLP
chr09,Bn38935,1617153,81041435,79424282,TN
chr09,Bn38936,8901828,45366953,36465125,TN
chr09,Bn38937,31967813,45275176,13307363,CN
chr09,Bn38938,1339076,31289828,29950752,TNL
chr09,Bn38939,52138860,89513783,37374923,RLK
chr09,Bn38940,12335959,87588358,75252399,TN
chr09,Bn38941,55831428,82145406,26313978,CNL
chr09,Bn38942,84645924,86216617,1570693,CNL
chr09,Bn38943,22846541,78370633,55524092,CNL
chr09,Bn38944,11544992,34035271,22490279,RLK
chr09,Bn38945,86649551,90455912,3806361,NBS
chr09,Bn38946,17671804,92178965,74507161,CNL
chr09,Bn38947,51150199,82948410,31798211,TNL
chr09,Bn38948,46647793,81950561,35302768,RLK
chr09,Bn38949,50630143,95309676,44679533,TN
chr09,Bn38950,44440573,92213257,47772684,TN
chr09,Bn38951,91047651,92971674,1924023,CNL
chr09,Bn38952,16972688,57124437,40151749,CNL
chr09,Bn38953,74708994,94604238,19895244,TN
chr09,Bn38954,66733607,75782906,9049299,TN
chr09,Bn38955,70351607,86501008,16149401,RLK
chr09,Bn38956,32329325,62658540,30329215,CN
chr09,Bn38957,22526939,62042294,39515355,CN
chr09,Bn38958,15116947,71129843,56012896,RLP
chr09,Bn38959,46184875,71052011,24867136,RLP
chr09,Bn38960,44843849,93139582,48295733,RLP
chr09,Bn38961,23375304,35046813,11671509,CN
chr09,Bn38962,57934474,99701988,41767514,NBS
chr09,Bn38963,8865019,82287283,73422264,TNL
chr09,Bn38964,76912211,96809516,19897305,NBS
chr09,Bn38965,44010364,96068270,52057906,TNL
chr09,Bn38966,1719901,41796602,40076701,RLK
chr09,Bn38967,24735864,39683322,14947458,CN
chr09,Bn38968,77465877,85670363,8204486,RLK
chr09,Bn38969,48710116,93202346,44492230,RLP
chr09,Bn38970,1193137,36140472,34947335,CNL
chr09,Bn38971,21182046,42150772,20968726,RLK
chr09,Bn38972,35581295,59200553,23619258,RLK
chr09,Bn38973,5960365,83698367,77738002,TNL
chr09,Bn38974,98865724,99190851,325127,NBS
chr09,Bn38975,66544906,88823245,22278339,TNL
chr09,Bn38976,55871226,83667009,27795783,TN
chr09,Bn38977,66252099,79111395,12859296,TNL
chr09,Bn38978,96160778,96727635,566857,TN
chr09,Bn38979,26313239,34076818,7763579,TNL
chr09,Bn38980,48780420,71390802,22610382,NBS
chr09,Bn38981,5566886,6636868,1069982,CNL
chr09,Bn38982,91704783,96251567,4546784,TN
chr09,Bn38983,8761505,89641463,80879958,CN
chr09,Bn38984,35709479,49384265,13674786,NBS
chr09,Bn38985,26017493,92887274,66869781,CN
chr09,Bn38986,60441896,78144536,17702640,TNL
chr09,Bn38987,2674766,32118835,29444069,CNL
chr09,Bn38988,80246587,84425882,4179295,CN
chr09,Bn38989,86306911,87079426,772515,RLP
chr09,Bn38990,40707174,67611645,26904471,NBS
chr09,Bn38991,14729450,77975420,63245970,TN
chr09,Bn38992,95872058,96409806,537748,TNL
chr09,Bn38993,21774783,87685477,65910694,TNL
chr09,Bn38994,16015164,93324903,77309739,TNL
chr09,Bn38995,10259493,84002342,73742849,NBS
chr09,Bn38996,87011113,98061896,11050783,TN
chr09,Bn38997,12545465,23472679,10927214,RLP
chr09,Bn38998,17694150,56854359,39160209,NBS
chr09,Bn38999,92447834,92575777,127943,TN
chr09,Bn39000,76313050,91875251,15562201,CNL
chr09,Bn39001,80355574,92138806,11783232,CNL
chr09,Bn39002,41251675,99334660,58082985,RLK
chr09,Bn39003,1641729,63494289,61852560,CNL
chr09,Bn39004,92886019,97773514,4887495,RLP
chr09,Bn39005,54453059,80442596,25989537,NBS
chr09,Bn39006,4874522,63617400,58742878,TNL
chr09,Bn39007,42475359,64421348,21945989,NBS
chr09,Bn39008,79701726,80538899,837173,RLK
chr09,Bn39009,38062797,67455612,29392815,RLK
chr09,Bn39010,3751064,30218474,26467410,RLK
chr09,Bn39011,63303261,79560708,16257447,RLK
chr09,Bn39012,5195760,24132027,18936267,CNL
chr09,Bn39013,59197937,64110884,4912947,RLP
chr09,Bn39014,41477150,52993162,11516012,CN
chr09,Bn39015,12985945,46648931,33662986,NBS
chr09,Bn39016,65293647,85222135,19928488,CN
chr09,Bn39017,18726833,29312078,10585245,TN
chr09,Bn39018,23177920,66509851,43331931,RLP
chr09,Bn39019,73704738,99639182,25934444,RLK
chr09,Bn39020,98807910,98844641,36731,CN
chr09,Bn39021,70288062,76537261,6249199,TN
chr09,Bn39022,48145353,89214535,41069182,RLP
chr09,Bn39023,7664896,62320081,54655185,CN
chr09,Bn39024,43995150,90459700,46464550,CN
chr09,Bn39025,92096851,99644315,7547464,RLK
chr09,Bn39026,26512577,49094073,22581496,TN
chr09,Bn39027,60861296,87598291,26736995,RLP
chr09,Bn39028,86924276,92406320,5482044,NBS
chr09,Bn39029,94118496,98003158,3884662,TNL
chr09,Bn39030,53095956,97372852,44276896,CNL
chr09,Bn39031,55544532,94727073,39182541,RLK
chr09,Bn39032,78147624,87016870,8869246,TN
chr09,Bn39033,51824228,96596355,44772127,TN
chr09,Bn39034,70193517,86333802,16140285,RLK
chr09,Bn39035,23806271,63965626,40159355,TNL
chr09,Bn39036,9685421,33265409,23579988,RLP
chr09,Bn39037,26818380,77117128,50298748,TN
chr09,Bn39038,68929908,92510182,23580274,NBS
chr09,Bn39039,43923905,79038330,35114425,TN
chr09,Bn39040,20592000,79079556,58487556,NBS
chr09,Bn39041,54712424,57018802,2306378,TNL
chr09,Bn39042,20085848,56349332,36263484,CNL
chr09,Bn39043,41941271,56644709,14703438,TN
chr09,Bn39044,6509756,96758404,90248648,TN
chr09,Bn39045,56422489,70924825,14502336,TNL
chr09,Bn39046,31085925,78203515,47117590,CN
chr09,Bn39047,95893650,97647198,1753548,TNL
chr09,Bn39048,38556726,48717256,10160530,CNL
chr09,Bn39049,89653371,99359727,9706356,TNL
chr09,Bn39050,28383485,53273784,24890299,CNL
chr09,Bn39051,17933350,59470553,41537203,RLK
chr09,Bn39052,13889747,75104588,61214841,RLP
chr09,Bn39053,78259966,97042019,18782053,RLK
chr09,Bn39054,73014767,99692132,26677365,TN
chr09,Bn39055,73385803,84038421,10652618,CN
chr09,Bn39056,80924674,86680865,5756191,RLK
chr09,Bn39057,89947346,96380241,6432895,RLK
chr09,Bn39058,20701616,22776669,2075053,CN
chr09,Bn39059,32799650,88592279,55792629,RLP
chr09,Bn39060,8170316,8783736,613420,RLK
chr09,Bn39061,90437848,98689774,8251926,CN
chr09,Bn39062,94094434,97134667,3040233,TN
chr09,Bn39063,95246846,99617131,4370285,TN
chr09,Bn39064,63785397,71412491,7627094,NBS
chr09,Bn39065,67080200,78855984,11775784,TNL
chr09,Bn39066,17565774,87194831,69629057,TNL
chr09,Bn39067,33692528,89074531,55382003,NBS
chr09,Bn39068,90158831,99538001,9379170,CN
chr09,Bn39069,30469514,35619254,5149740,TNL
chr09,Bn39070,17093735,22378012,5284277,CN
chr09,Bn39071,98240457,99687823,1447366,CN
chr09,Bn39072,96931501,98383461,1451960,RLK
chr09,Bn39073,7522759,98696602,91173843,TN
chr09,Bn39074,56515831,63065522,6549691,RLK
chr09,Bn39075,81848469,87286790,5438321,RLP
chr09,Bn39076,74041711,80473403,6431692,NBS
chr09,Bn39077,55490306,76886703,21396397,CNL
chr09,Bn39078,86889328,92563413,5674085,CNL
chr09,Bn39079,48583395,85922553,37339158,CN
chr09,Bn39080,88451586,89304770,853184,RLP
chr09,Bn39081,89662880,95557809,5894929,RLP
chr09,Bn39082,69247906,74063646,4815740,CN
chr09,Bn39083,8666264,78491485,69825221,CN
chr09,Bn39084,41556159,64979410,23423251,RLP
chr09,Bn39085,12816323,56845850,44029527,NBS
chr09,Bn39086,78300704,82792782,4492078,NBS
chr09,Bn39087,97322921,99647385,2324464,CN
chr09,Bn39088,12099272,47493758,35394486,RLK
chr09,Bn39089,78264152,92491433,14227281,RLP
chr09,Bn39090,96559280,99056142,2496862,CN
chr09,Bn39091,31332034,40266922,8934888,RLK
chr09,Bn39092,71653610,86932461,15278851,NBS
chr09,Bn39093,21202326,80233487,59031161,CNL
chr09,Bn39094,1586633,30493305,28906672,CN
chr09,Bn39095,6525824,68922120,62396296,CNL
chr09,Bn39096,92449855,93259601,809746,CNL
chr09,Bn39097,54014480,77942194,23927714,CNL
chr09,Bn39098,52739113,93190349,40451236,TNL
chr09,Bn39099,98306073,98468999,162926,TN
chr09,Bn39100,36390126,45265027,8874901,CN
chr09,Bn39101,72422637,83964295,11541658,TN
chr09,Bn39102,14976267,79997722,65021455,RLP
chr09,Bn39103,84650304,96584201,11933897,RLK
chr09,Bn39104,36024659,94897012,58872353,TNL
chr09,Bn39105,73178878,80469307,7290429,CN
chr09,Bn39106,67542249,77513333,9971084,NBS
chr09,Bn39107,63185259,90742866,27557607,RLK
chr09,Bn39108,97819320,98996737,1177417,CNL
chr09,Bn39109,74170591,84992745,10822154,RLK
chr09,Bn39110,4393174,27870505,23477331,NBS
chr09,Bn39111,51228386,79824572,28596186,NBS
chr09,Bn39112,95661625,97434389,1772764,TN
chr09,Bn39113,4411863,91636706,87224843,TN
chr09,Bn39114,3783297,34722497,30939200,TN
chr09,Bn39115,3787717,88402113,84614396,CNL
chr09,Bn39116,98350396,99548854,1198458,TN
chr09,Bn39117,2048920,19522057,17473137,TN
chr09,Bn39118,47596335,87112125,39515790,NBS
chr09,Bn39119,1577794,42149704,40571910,CN
chr09,Bn39120,73829422,93079036,19249614,CN
chr09,Bn39121,97865615,98268624,403009,CN
chr09,Bn39122,3841962,36736146,32894184,TNL
chr09,Bn39123,1229129,88275596,87046467,TNL
chr09,Bn39124,76655902,92771493,16115591,TN
chr09,Bn39125,88772416,99575973,10803557,RLP
chr09,Bn39126,93842633,95411687,1569054,RLK
chr09,Bn39127,85152227,96674437,11522210,RLK
chr09,Bn39128,67405890,76329998,8924108,RLP
chr09,Bn39129,90528309,95470602,4942293,TN
chr09,Bn39130,77180463,84913040,7732577,CN
chr09,Bn39131,3495324,89795845,86300521,TN
chr09,Bn39132,99644325,99815632,171307,CNL
chr09,Bn39133,90785229,95416244,4631015,TNL
chr09,Bn39134,66814405,71147349,4332944,RLP
chr09,Bn39135,66102410,89288525,23186115,TNL
chr09,Bn39136,60046744,97714797,37668053,RLP
chr09,Bn39137,94881400,96609646,1728246,RLP
chr09,Bn39138,19799870,57101390,37301520,CNL
chr09,Bn39139,70854731,74411223,3556492,RLK
chr09,Bn39140,3745650,54494542,50748892,RLK
chr09,Bn39141,26370421,46942901,20572480,RLP
chr09,Bn39142,43737838,46916443,3178605,RLK
chr09,Bn39143,70653713,97425986,26772273,CN
chr09,Bn39144,32437888,48294623,15856735,CN
chr09,Bn39145,53261710,73402762,20141052,NBS
chr09,Bn39146,49899016,52364698,2465682,RLK
chr09,Bn39147,77260211,98234280,20974069,CN
chr09,Bn39148,48917694,95211428,46293734,RLK
chr09,Bn39149,70188838,74932498,4743660,CN
chr09,Bn39150,88478051,92830517,4352466,CN
chr09,Bn39151,46868781,61294661,14425880,TN
chr09,Bn39152,45919122,96218251,50299129,CN
chr09,Bn39153,97992099,99296571,1304472,TNL
chr09,Bn39154,52302350,59706077,7403727,RLP
chr09,Bn39155,27452412,50904954,23452542,RLK
chr09,Bn39156,90061459,92034406,1972947,RLK
chr09,Bn39157,77738233,79641970,1903737,RLK
chr09,Bn39158,24055181,38239547,14184366,TN
chr09,Bn39159,76466530,76592652,126122,CNL
chr09,Bn39160,28539964,61769724,33229760,CN
chr09,Bn39161,42524813,92609560,50084747,RLP
chr09,Bn39162,70440578,80049652,9609074,TN
chr09,Bn39163,12414253,33911110,21496857,TN
chr09,Bn39164,73776283,99991577,26215294,CN
chr09,Bn39165,59318236,60224023,905787,TN
chr09,Bn39166,33997600,73775162,39777562,NBS
chr09,Bn39167,51065468,51100073,34605,CNL
chr09,Bn39168,85020108,90745970,5725862,RLK
chr09,Bn39169,5425205,92523797,87098592,TN
chr09,Bn39170,22200706,98669044,76468338,NBS
chr09,Bn39171,78299304,80809433,2510129,TN
chr09,Bn39172,34401054,57915396,23514342,CN
chr09,Bn39173,98054252,99595582,1541330,CN
chr09,Bn39174,24900720,48534678,23633958,CNL
chr09,Bn39175,7760255,94417507,86657252,TNL
chr09,Bn39176,40852879,65014354,24161475,RLK
chr09,Bn39177,37879770,90960466,53080696,TN
chr09,Bn39178,31947375,47845784,15898409,RLK
chr09,Bn39179,48174151,50654414,2480263,RLK
chr09,Bn39180,69074735,98062942,28988207,TN
chr09,Bn39181,97292943,98645739,1352796,RLK
chr09,Bn39182,7498136,30831254,23333118,CNL
chr09,Bn39183,51065832,72606640,21540808,RLK
chr09,Bn39184,87479119,97958002,10478883,RLK
chr09,Bn39185,78723868,87332111,8608243,CN
chr09,Bn39186,71206223,94999176,23792953,TN
chr09,Bn39187,76635752,82686537,6050785,RLP
chr09,Bn39188,6896246,40191540,33295294,NBS
chr09,Bn39189,87929330,96951765,9022435,TN
chr09,Bn39190,76414264,85381340,8967076,TN
chr09,Bn39191,45301760,47421097,2119337,TN
chr09,Bn39192,27411399,39600958,12189559,TN
chr09,Bn39193,98352715,99835717,1483002,CN
chr09,Bn39194,79913245,96323084,16409839,TNL
chr09,Bn39195,92565610,94151392,1585782,RLP
chr09,Bn39196,37053197,71800804,34747607,CNL
chr09,Bn39197,19084800,89191006,70106206,CNL
chr09,Bn39198,89939317,91200338,1261021,TN
chr09,Bn39199,97687813,97988640,300827,CNL
chr09,Bn39200,81278633,82783966,1505333,NBS
chr09,Bn39201,14598536,66115748,51517212,TNL
chr09,Bn39202,55033269,94743373,39710104,RLP
chr09,Bn39203,56404112,76606891,20202779,NBS
chr09,Bn39204,93085195,96002783,2917588,RLK
chr09,Bn39205,74411297,84721962,10310665,RLK
chr09,Bn39206,47021326,86535960,39514634,TN
chr09,Bn39207,87237513,95466014,8228501,TN
chr09,Bn39208,29304472,68286455,38981983,CNL
chr09,Bn39209,36410551,45135856,8725305,RLK
chr09,Bn39210,89348438,91617706,2269268,CNL
chr09,Bn39211,38798349,71930001,33131652,RLP
chr09,Bn39212,65850112,86049967,20199855,RLK
chr09,Bn39213,50068586,57453324,7384738,CNL
chr09,Bn39214,94518240,98161000,3642760,RLP
chr09,Bn39215,41310534,93549493,52238959,NBS
chr09,Bn39216,57948796,87010943,29062147,CNL
chr09,Bn39217,64257195,72572497,8315302,CN
chr09,Bn39218,98894277,98924881,30604,RLK
chr09,Bn39219,81243100,99941518,18698418,CN
chr09,Bn39220,45371510,49953900,4582390,CN
chr09,Bn39221,58785043,79540030,20754987,CNL
chr09,Bn39222,23008322,87716376,64708054,CNL
chr09,Bn39223,40177718,86563300,46385582,RLK
chr09,Bn39224,45518469,66645557,21127088,RLK
chr09,Bn39225,6991207,9553430,2562223,TNL
chr09,Bn39226,25896706,85012915,59116209,RLP
chr09,Bn39227,59915254,95421548,35506294,RLK
chr09,Bn39228,80111114,94770228,14659114,TN
chr09,Bn39229,46407322,66294626,19887304,RLK
chr09,Bn39230,36397287,91548233,55150946,RLK
chr09,Bn39231,47913909,77611280,29697371,TNL
chr09,Bn39232,59914875,65780853,5865978,CNL
chr09,Bn39233,93851322,97196757,3345435,RLP
chr09,Bn39234,88410656,90360066,1949410,NBS
chr09,Bn39235,73962580,85223906,11261326,TNL
chr09,Bn39236,11220656,26845144,15624488,CN
chr09,Bn39237,83825317,86998920,3173603,CNL
chr09,Bn39238,86759423,91379576,4620153,TN
chr09,Bn39239,57448340,98243054,40794714,RLK
chr09,Bn39240,89331527,94583093,5251566,RLK
chr09,Bn39241,21515047,95180468,73665421,CN
chr09,Bn39242,17547155,77260450,59713295,CNL
chr09,Bn39243,98771691,99072711,301020,CNL
chr09,Bn39244,33555155,70026109,36470954,TNL
chr09,Bn39245,88419065,91922819,3503754,CNL
chr09,Bn39246,58184908,81905777,23720869,TN
chr09,Bn39247,28546127,51162234,22616107,CNL
chr09,Bn39248,98562168,99463081,900913,CN
chr09,Bn39249,27989538,88677772,60688234,RLK
chr09,Bn39250,67277748,71023622,3745874,TN
chr09,Bn39251,59053002,99593466,40540464,NBS
chr09,Bn39252,80569386,96308442,15739056,RLP
chr09,Bn39253,33778571,74137297,40358726,CNL
chr09,Bn39254,33174646,46647680,13473034,CN
chr09,Bn39255,2469696,88952320,86482624,RLP
chr09,Bn39256,41351238,74392255,33041017,TNL
chr09,Bn39257,26026919,49121771,23094852,RLK
chr09,Bn39258,51297694,52887504,1589810,NBS
chr09,Bn39259,32082710,38392080,6309370,RLK
chr09,Bn39260,39741041,83043075,43302034,CNL
chr09,Bn39261,78146511,83060310,4913799,TNL
chr09,Bn39262,69718258,73142533,3424275,RLK
chr09,Bn39263,84029721,89677071,5647350,RLK
chr09,Bn39264,54243893,96758867,42514974,TNL
chr09,Bn39265,46803182,60269857,13466675,CNL
chr09,Bn39266,6940320,45944179,39003859,RLK
chr09,Bn39267,26282807,40833064,14550257,NBS
chr09,Bn39268,44695232,61716538,17021306,TN
chr09,Bn39269,5157601,34677591,29519990,TN
chr09,Bn39270,31468192,56781293,25313101,CNL
chr09,Bn39271,29580329,96782744,67202415,TNL
chr09,Bn39272,10756777,90749437,79992660,CNL
chr09,Bn39273,61207853,95631965,34424112,RLK
chr09,Bn39274,63719025,98712947,34993922,TN
chr09,Bn39275,69260765,92300508,23039743,TNL
chr09,Bn39276,83853242,90749223,6895981,CNL
chr09,Bn39277,2452418,41050572,38598154,RLP
chr09,Bn39278,97893872,98747946,854074,TNL
chr09,Bn39279,98397167,99509863,1112696,TNL
chr09,Bn39280,49924471,96525959,46601488,RLP
chr09,Bn39281,73033819,89203505,16169686,RLP
chr09,Bn39282,14953269,55259288,40306019,CN
chr09,Bn39283,21192416,38445462,17253046,RLK
chr09,Bn39284,44813830,75520481,30706651,TNL
chr09,Bn39285,90064155,94469992,4405837,RLK
chr09,Bn39286,59818616,95905967,36087351,CNL
chr09,Bn39287,68047821,94084528,26036707,NBS
chr09,Bn39288,42046326,80712474,38666148,CN
chr09,Bn39289,51947300,80581454,28634154,TN
chr09,Bn39290,74555049,97310034,22754985,RLP
chr09,Bn39291,13617540,78059462,64441922,TNL
chr09,Bn39292,35555387,96176694,60621307,RLK
chr09,Bn39293,20937137,83924149,62987012,RLP
chr09,Bn39294,14478790,72329042,57850252,RLP
chr09,Bn39295,67050162,96513746,29463584,RLK
chr09,Bn39296,80042983,95841783,15798800,TN
chr09,Bn39297,58298259,58325277,27018,RLP
chr09,Bn39298,15607430,71219746,55612316,CN
chr09,Bn39299,8394322,90328673,81934351,CN
chr09,Bn39300,74807745,90867344,16059599,RLP
chr09,Bn39301,85306624,89093941,3787317,CN
chr09,Bn39302,47828551,87474659,39646108,RLK
chr09,Bn39303,29645704,30449385,803681,CNL
chr09,Bn39304,40657094,67538059,26880965,RLP
chr09,Bn39305,10029892,47824726,37794834,CN
chr09,Bn39306,14487859,22444610,7956751,RLP
chr09,Bn39307,31291914,86610805,55318891,CN
chr09,Bn39308,68501822,87038332,18536510,CNL
chr09,Bn39309,88989467,98712316,9722849,RLK
chr09,Bn39310,90654310,90778211,123901,CN
chr09,Bn39311,56223598,65691158,9467560,RLK
chr09,Bn39312,5796590,8714050,2917460,CNL
chr09,Bn39313,97846523,99754813,1908290,RLK
chr09,Bn39314,55057514,70660353,15602839,RLK
chr09,Bn39315,91533328,98356010,6822682,TNL
chr09,Bn39316,51016490,61018933,10002443,CN
chr09,Bn39317,84940953,89832024,4891071,CNL
chr09,Bn39318,94722933,95370257,647324,NBS
chr09,Bn39319,74703529,82818609,8115080,RLP
chr09,Bn39320,76090563,84816133,8725570,RLK
chr09,Bn39321,63686871,80481503,16794632,TNL
chr09,Bn39322,18440831,74157855,55717024,TNL
chr09,Bn39323,74872282,86131039,11258757,TN
chr09,Bn39324,44064997,93622510,49557513,TN
chr09,Bn39325,11753735,29118781,17365046,TN
chr09,Bn39326,73571580,76938438,3366858,RLP
chr09,Bn39327,81818342,88536922,6718580,RLP
chr09,Bn39328,95362585,99767898,4405313,RLK
chr09,Bn39329,4327327,87752117,83424790,CNL
chr09,Bn39330,23525061,46609161,23084100,CN
chr09,Bn39331,93559277,93604576,45299,CN
chr09,Bn39332,22746408,59667549,36921141,TN
chr09,Bn39333,10781740,46145290,35363550,CNL
chr09,Bn39334,57728338,96289750,38561412,RLK
chr09,Bn39335,3061371,22662332,19600961,NBS
chr09,Bn39336,38562774,55180292,16617518,TN
chr09,Bn39337,62854293,96431377,33577084,CN
chr09,Bn39338,39107032,52610886,13503854,CN
chr09,Bn39339,39130878,65761361,26630483,NBS
chr09,Bn39340,8365765,33140362,24774597,TNL
chr09,Bn39341,40939729,69440414,28500685,TNL
chr09,Bn39342,33425326,63899996,30474670,NBS
chr09,Bn39343,59548386,75531342,15982956,CN
chr09,Bn39344,89032527,99587415,10554888,RLP
chr09,Bn39345,29221704,64271244,35049540,RLP
chr09,Bn39346,73210384,88959306,15748922,TNL
chr09,Bn39347,97836608,99907634,2071026,TN
chr09,Bn39348,22614319,36337277,13722958,NBS
chr09,Bn39349,54849200,78444050,23594850,RLK
chr09,Bn39350,89413467,95185200,5771733,RLP
chr09,Bn39351,10658527,80162778,69504251,RLP
chr09,Bn39352,30027852,69991134,39963282,TNL
chr09,Bn39353,11225074,13297253,2072179,CN
chr09,Bn39354,72018057,74355297,2337240,RLK
chr09,Bn39355,56942296,88080291,31137995,RLP
chr09,Bn39356,15756618,64411895,48655277,TNL
chr09,Bn39357,86188906,95833243,9644337,TN
chr09,Bn39358,91818626,99329605,7510979,NBS
chr09,Bn39359,65393377,79571052,14177675,RLK
chr09,Bn39360,37192891,71466668,34273777,CNL
chr09,Bn39361,89560163,92033677,2473514,TN
chr09,Bn39362,86902572,95234739,8332167,NBS
chr09,Bn39363,56741016,63325446,6584430,TNL
chr09,Bn39364,43572807,47485241,3912434,TN
chr09,Bn39365,73551251,85923783,12372532,NBS
chr09,Bn39366,35890776,67912203,32021427,CNL
chr09,Bn39367,15309276,19033460,3724184,RLK
chr09,Bn39368,36898575,59417698,22519123,RLK
chr09,Bn39369,80889104,91001568,10112464,CN
chr09,Bn39370,41184944,69292875,28107931,RLP
chr09,Bn39371,70590581,77318298,6727717,NBS
chr09,Bn39372,91888151,95468294,3580143,TN
chr09,Bn39373,87955911,90772557,2816646,TN
chr09,Bn39374,34727943,51282536,16554593,CNL
chr09,Bn39375,38936258,82461171,43524913,RLK
chr09,Bn39376,64143222,72212903,8069681,TN
chr09,Bn39377,96874367,99405983,2531616,TNL
chr09,Bn39378,28224631,98792112,70567481,NBS
chr09,Bn39379,27020611,31397481,4376870,CNL
chr09,Bn39380,24712100,72831825,48119725,RLP
chr09,Bn39381,98931538,99809572,878034,RLP
chr09,Bn39382,77348221,91898221,14550000,RLK
chr09,Bn39383,94056000,99883725,5827725,CN
chr09,Bn39384,58781381,98150084,39368703,RLK
chr09,Bn39385,90044881,98402991,8358110,CN
chr09,Bn39386,94588032,97997007,3408975,CNL
chr09,Bn39387,39542398,77850540,38308142,CNL
chr09,Bn39388,56447405,82295420,25848015,RLK
chr09,Bn39389,46582126,65914238,19332112,CN
chr09,Bn39390,22416303,58725705,36309402,NBS
chr09,Bn39391,71768999,76137051,4368052,TNL
chr09,Bn39392,73784288,99906569,26122281,TNL
chr09,Bn39393,85541033,87424636,1883603,TN
chr09,Bn39394,45964505,84257273,38292768,TNL
chr09,Bn39395,1182551,77192943,76010392,CNL
chr09,Bn39396,38229152,87014829,48785677,RLP
chr09,Bn39397,75447947,94402489,18954542,TNL
chr09,Bn39398,55147509,85194473,30046964,CN
chr09,Bn39399,67346356,95829223,28482867,CN
chr09,Bn39400,68356903,72686724,4329821,NBS
chr09,Bn39401,69227086,93864720,24637634,TNL
chr09,Bn39402,2366606,52517827,50151221,RLP
chr09,Bn39403,90581989,91647070,1065081,CNL
chr09,Bn39404,44218190,87167742,42949552,TN
chr09,Bn39405,32431566,61208538,28776972,TN
chr09,Bn39406,40141182,88343666,48202484,TNL
chr09,Bn39407,74214569,95179010,20964441,TN
chr09,Bn39408,39166267,74596752,35430485,TN
chr09,Bn39409,10068841,60947815,50878974,TNL
chr09,Bn39410,56955791,71639027,14683236,TN
chr09,Bn39411,30747023,74233586,43486563,CNL
chr09,Bn39412,96679655,98278624,1598969,RLK
chr09,Bn39413,47143949,54375297,7231348,TN
chr09,Bn39414,61588246,78017271,16429025,TNL
chr09,Bn39415,62366339,98547975,36181636,CNL
chr09,Bn39416,38258198,44383649,6125451,RLK
chr09,Bn39417,77355084,98806310,21451226,NBS
chr09,Bn39418,52990417,54501183,1510766,TN
chr09,Bn39419,56618385,98592686,41974301,RLP
chr09,Bn39420,87769614,94801107,7031493,RLP
chr09,Bn39421,81678628,96190993,14512365,CN
chr09,Bn39422,10795662,86232022,75436360,RLK
chr09,Bn39423,66963583,80974558,14010975,CNL
chr09,Bn39424,6244887,14560656,8315769,RLP
chr09,Bn39425,59763129,85572888,25809759,NBS
chr09,Bn39426,12446473,45954832,33508359,CNL
chr09,Bn39427,48565321,95663580,47098259,TNL
chr09,Bn39428,1388480,79231148,77842668,NBS
chr09,Bn39429,29814202,51036844,21222642,NBS
chr09,Bn39430,33888201,71914101,38025900,RLK
chr09,Bn39431,47743203,60709067,12965864,TNL
chr09,Bn39432,50499435,86542518,36043083,RLP
chr09,Bn39433,13593164,88561770,74968606,RLP
chr09,Bn39434,96609513,99773658,3164145,CN
chr09,Bn39435,23050498,40518713,17468215,CNL
chr09,Bn39436,88155999,95302341,7146342,NBS
chr09,Bn39437,40364215,56857440,16493225,RLK
chr09,Bn39438,50612722,83340748,32728026,RLK
chr09,Bn39439,22692473,80929761,58237288,CN
chr09,Bn39440,41317237,65499779,24182542,RLK
chr09,Bn39441,35590798,80653447,45062649,CNL
chr09,Bn39442,13796372,27367176,13570804,TN
chr09,Bn39443,80286261,88063372,7777111,RLP
chr09,Bn39444,80235299,81590140,1354841,CN
chr09,Bn39445,3280866,60579459,57298593,CNL
chr09,Bn39446,58431726,95108056,36676330,CNL
chr09,Bn39447,11324485,28377843,17053358,RLK
chr09,Bn39448,21983600,63634278,41650678,TNL
chr09,Bn39449,29888524,67636135,37747611,CN
chr09,Bn39450,92638574,93849969,1211395,TNL
chr09,Bn39451,27542730,56643719,29100989,CN
chr09,Bn39452,82280346,90584444,8304098,RLK
chr09,Bn39453,55418048,58480770,3062722,RLP
chr09,Bn39454,63793705,74995998,11202293,NBS
chr09,Bn39455,8115362,86471632,78356270,RLP
chr09,Bn39456,57288275,69742256,12453981,RLK
chr09,Bn39457,22788679,24895873,2107194,TN
chr09,Bn39458,2531890,35324019,32792129,NBS
chr09,Bn39459,63116879,68417565,5300686,CN
chr09,Bn39460,25768630,91946056,66177426,RLP
chr09,Bn39461,50873409,59732144,8858735,NBS
chr09,Bn39462,88704289,94970516,6266227,NBS
chr09,Bn39463,3834400,6699203,2864803,TNL
chr09,Bn39464,55933196,91882895,35949699,NBS
chr09,Bn39465,71228443,76564071,5335628,RLP
chr09,Bn39466,14027847,67498134,53470287,RLK
chr09,Bn39467,77613196,88810870,11197674,TNL
chr09,Bn39468,75911211,98292804,22381593,TNL
chr09,Bn39469,15048665,71903038,56854373,TN
chr09,Bn39470,9341448,58716157,49374709,RLK
chr09,Bn39471,21173362,42509561,21336199,NBS
chr09,Bn39472,81367090,83723179,2356089,CNL
chr09,Bn39473,91468076,93986731,2518655,CN
chr09,Bn39474,58168153,80531604,22363451,CN
chr09,Bn39475,50183118,93330504,43147386,NBS
chr09,Bn39476,66809489,72540460,5730971,NBS
chr09,Bn39477,48175279,53009306,4834027,RLK
chr09,Bn39478,52695919,81009861,28313942,RLK
chr09,Bn39479,27385623,27791462,405839,TN
chr09,Bn39480,13660830,58333486,44672656,NBS
chr09,Bn39481,49074441,75463558,26389117,NBS
chr09,Bn39482,20660720,63920331,43259611,RLK
chr09,Bn39483,9568510,97268524,87700014,CNL
chr09,Bn39484,63708267,92427218,28718951,CN
chr09,Bn39485,73172748,90526030,17353282,TN
chr09,Bn39486,88932316,90879322,1947006,NBS
chr09,Bn39487,93714762,96165184,2450422,RLK
chr09,Bn39488,65796606,87039598,21242992,TNL
chr09,Bn39489,35961842,71637352,35675510,CNL
chr09,Bn39490,19019178,89423168,70403990,RLP
chr09,Bn39491,95055260,95739917,684657,TN
chr09,Bn39492,74635303,78639600,4004297,RLP
chr09,Bn39493,69686075,87084826,17398751,RLP
chr09,Bn39494,91636612,95433233,3796621,NBS
chr09,Bn39495,95804460,99861369,4056909,CNL
chr09,Bn39496,69457878,89426062,19968184,RLP
chr09,Bn39497,40871987,97837994,56966007,RLK
chr09,Bn39498,64823094,82308338,17485244,CNL
chr09,Bn39499,91250069,91383621,133552,NBS
chr09,Bn39500,78684214,83348150,4663936,TNL
chr09,Bn39501,54844964,59210618,4365654,RLK
chr09,Bn39502,28877970,45794443,16916473,TNL
chr09,Bn39503,3153623,5127702,1974079,TN
chr09,Bn39504,67327475,93809743,26482268,CN
chr09,Bn39505,96156318,98875020,2718702,CNL
chr09,Bn39506,14631359,32907432,18276073,TN
chr09,Bn39507,9750183,38201377,28451194,TN
chr09,Bn39508,77509456,95324463,17815007,CN
chr09,Bn39509,97642069,98343890,701821,NBS
chr09,Bn39510,56193344,97133163,40939819,RLK
chr09,Bn39511,32988546,66509640,33521094,NBS
chr09,Bn39512,82232708,82829864,597156,NBS
chr09,Bn39513,35277451,38373437,3095986,CNL
chr09,Bn39514,41106928,64435708,23328780,RLK
chr09,Bn39515,95275552,99725891,4450339,CN
chr09,Bn39516,83386380,98716690,15330310,NBS
chr09,Bn39517,63487483,78354380,14866897,CN
chr09,Bn39518,8233889,47826901,39593012,TN
chr09,Bn39519,2292689,61934923,59642234,RLK
chr09,Bn39520,13355736,44274898,30919162,TNL
chr09,Bn39521,42427066,85819359,43392293,CN
chr09,Bn39522,41351565,91669940,50318375,RLK
chr09,Bn39523,85098585,88947268,3848683,NBS
chr09,Bn39524,23664342,53818820,30154478,RLP
chr09,Bn39525,1268673,14027137,12758464,NBS
chr09,Bn39526,16145606,96626813,80481207,CNL
chr09,Bn39527,63223736,69407282,6183546,NBS
chr09,Bn39528,10524756,83928742,73403986,RLP
chr09,Bn39529,37194806,37335921,141115,TN
chr09,Bn39530,49197405,89811333,40613928,TNL
chr09,Bn39531,57749364,70603148,12853784,CNL
chr09,Bn39532,7181533,45537880,38356347,NBS
chr09,Bn39533,50260652,70854017,20593365,RLP
chr09,Bn39534,10818417,83917324,73098907,TNL
chr09,Bn39535,39267044,54049921,14782877,TN
chr09,Bn39536,5370804,14067448,8696644,NBS
chr09,Bn39537,88220164,99726906,11506742,CN
chr09,Bn39538,92445186,95391344,2946158,RLP
chr09,Bn39539,39576225,45261870,5685645,CN
chr09,Bn39540,85782284,97059237,11276953,CN
chr09,Bn39541,96667076,97780430,1113354,CNL
chr09,Bn39542,8677841,49190557,40512716,CNL
chr09,Bn39543,59015006,78209146,19194140,RLP
chr09,Bn39544,84600706,89869535,5268829,NBS
chr09,Bn39545,53397377,92181645,38784268,RLP
chr09,Bn39546,91160499,93082070,1921571,TN
chr09,Bn39547,94050861,98743434,4692573,CN
chr09,Bn39548,90653799,94374920,3721121,TN
chr09,Bn39549,90511836,98253878,7742042,CNL
chr09,Bn39550,42715935,54258966,11543031,RLK
chr09,Bn39551,18590457,90889172,72298715,CN
chr09,Bn39552,97794067,98357214,563147,NBS
chr09,Bn39553,46623932,60715925,14091993,RLK
chr09,Bn39554,97314898,99004156,1689258,RLK
chr09,Bn39555,86252138,98744650,12492512,TNL
chr09,Bn39556,44112596,53162889,9050293,RLP
chr09,Bn39557,56637964,89787358,33149394,RLP
chr09,Bn39558,91352427,91505359,152932,TNL
chr09,Bn39559,3350968,19730262,16379294,CNL
chr09,Bn39560,87216417,91320851,4104434,TNL
chr09,Bn39561,34055386,37362881,3307495,TNL
chr09,Bn39562,37627991,91060589,53432598,TNL
chr09,Bn39563,38715614,47985674,9270060,TNL
chr09,Bn39564,46517506,70498525,23981019,RLK
chr09,Bn39565,23952366,48092144,24139778,CN
chr09,Bn39566,73467838,82137733,8669895,RLK
chr09,Bn39567,47427283,90994705,43567422,RLK
chr09,Bn39568,30076091,66543130,36467039,RLP
chr09,Bn39569,86751898,87359432,607534,NBS
chr09,Bn39570,72179008,82836943,10657935,CNL
chr09,Bn39571,33016276,87122380,54106104,RLK
chr09,Bn39572,61364856,70291588,8926732,CN
chr09,Bn39573,89682926,97290875,7607949,TNL
chr09,Bn39574,2849586,81436969,78587383,NBS
chr09,Bn39575,25800173,65977574,40177401,TNL
chr09,Bn39576,46521999,53907745,7385746,TN
chr09,Bn39577,16992761,28159779,11167018,TNL
chr09,Bn39578,7379948,30632201,23252253,NBS
chr09,Bn39579,87412934,87824874,411940,RLK
chr09,Bn39580,31277744,84098633,52820889,NBS
chr09,Bn39581,27639626,53101595,25461969,NBS
chr09,Bn39582,85146326,86700859,1554533,RLP
chr09,Bn39583,71229154,81866604,10637450,TNL
chr09,Bn39584,70215896,93819042,23603146,NBS
chr09,Bn39585,13036313,83457686,70421373,TN
chr09,Bn39586,69296076,83609744,14313668,RLK
chr09,Bn39587,2957396,79885175,76927779,TN
chr09,Bn39588,91205555,96386402,5180847,CNL
chr09,Bn39589,52867062,88297172,35430110,CNL
chr09,Bn39590,45668878,77719670,32050792,RLK
chr09,Bn39591,12948648,98774932,85826284,RLP
chr09,Bn39592,42915220,79131704,36216484,NBS
chr09,Bn39593,30631364,37210780,6579416,RLP
chr09,Bn39594,95783515,97427458,1643943,CNL
chr09,Bn39595,45677410,66541381,20863971,NBS
chr09,Bn39596,19674109,87196313,67522204,RLK
chr09,Bn39597,47779644,73062062,25282418,TNL
chr09,Bn39598,90945339,93582526,2637187,NBS
chr09,Bn39599,46243021,75948073,29705052,TNL
chr09,Bn39600,80840013,89974321,9134308,CN
chr09,Bn39601,70397168,80211813,9814645,NBS
chr09,Bn39602,9899984,52725512,42825528,CN
chr09,Bn39603,16517263,93414221,76896958,CN
chr09,Bn39604,53886215,65242650,11356435,NBS
chr09,Bn39605,12366559,82023263,69656704,RLP
chr09,Bn39606,65797089,89506468,23709379,CNL
chr09,Bn39607,10864114,35295744,24431630,TNL
chr09,Bn39608,10806373,42557141,31750768,TN
chr09,Bn39609,31570986,80338604,48767618,RLP
chr09,Bn39610,88097972,91814210,3716238,CN
chr09,Bn39611,82591607,84897813,2306206,TNL
chr09,Bn39612,20121845,65384897,45263052,TNL
chr09,Bn39613,84428461,85395771,967310,RLP
chr09,Bn39614,46375558,55674266,9298708,CNL
chr09,Bn39615,84505013,88442321,3937308,RLK
chr09,Bn39616,56042033,76703043,20661010,TNL
chr09,Bn39617,45051850,74862276,29810426,TN
chr09,Bn39618,70443212,80305590,9862378,CNL
chr09,Bn39619,20456899,55500348,35043449,NBS
chr09,Bn39620,96941813,97668634,726821,TN
chr09,Bn39621,52679995,85566383,32886388,RLK
chr09,Bn39622,53714818,63377909,9663091,CN
chr09,Bn39623,91289297,97698348,6409051,TNL
chr09,Bn39624,85960235,94635392,8675157,RLK
chr09,Bn39625,38124160,73707792,35583632,RLP
chr09,Bn39626,97566480,98116497,550017,RLK
chr09,Bn39627,13348602,67775767,54427165,CNL
chr09,Bn39628,51152249,71144250,19992001,TN
chr09,Bn39629,89240422,96552797,7312375,RLK
chr09,Bn39630,72054926,96534086,24479160,CNL
chr09,Bn39631,83183811,84064260,880449,TN
chr09,Bn39632,49653584,60067997,10414413,NBS
chr09,Bn39633,18480688,35205154,16724466,CNL
chr09,Bn39634,6843646,60209650,53366004,CN
chr09,Bn39635,52401717,94442918,42041201,CN
chr09,Bn39636,48814679,58014921,9200242,RLK
chr09,Bn39637,93640266,94603573,963307,RLP
chr09,Bn39638,95087658,98140581,3052923,RLP
chr09,Bn39639,98059996,99935521,1875525,NBS
chr09,Bn39640,29846457,94113301,64266844,TNL
chr09,Bn39641,47789377,82966646,35177269,TN
chr09,Bn39642,48954874,87700700,38745826,NBS
chr09,Bn39643,50318595,87765752,37447157,RLK
chr09,Bn39644,44906636,64991637,20085001,CN
chr09,Bn39645,46267675,63750012,17482337,RLP
chr09,Bn39646,51396675,96580530,45183855,CN
chr09,Bn39647,62712874,74038780,11325906,RLP
chr09,Bn39648,81740309,89964321,8224012,CNL
chr09,Bn39649,2984170,31592231,28608061,CN
chr09,Bn39650,37168049,79593987,42425938,CNL
chr09,Bn39651,87893249,92088359,4195110,TNL
chr09,Bn39652,2052007,95496135,93444128,RLK
chr09,Bn39653,14537716,71723142,57185426,TNL
chr09,Bn39654,34879756,42266753,7386997,CN
chr09,Bn39655,15608385,36118806,20510421,TNL
chr09,Bn39656,92928833,94168698,1239865,TN
chr09,Bn39657,24210365,85283231,61072866,CN
chr09,Bn39658,58134390,98932131,40797741,TN
chr09,Bn39659,4198352,74169207,69970855,RLP
chr09,Bn39660,17958483,31908058,13949575,CN
chr09,Bn39661,61058286,75996208,14937922,NBS
chr09,Bn39662,86588653,98504732,11916079,RLP
chr09,Bn39663,15116585,31343756,16227171,TN
chr09,Bn39664,85241559,87194191,1952632,RLP
chr09,Bn39665,85305190,99759658,14454468,NBS
chr09,Bn39666,87187592,96910296,9722704,TNL
chr09,Bn39667,41772052,56896013,15123961,NBS
chr09,Bn39668,52584980,69585778,17000798,NBS
chr09,Bn39669,24444415,72190692,47746277,CN
chr09,Bn39670,36480873,44094269,7613396,RLK
chr09,Bn39671,78097981,90403850,12305869,NBS
chr09,Bn39672,44083787,49971101,5887314,RLK
chr09,Bn39673,3716339,9529922,5813583,RLK
chr09,Bn39674,7018858,33349224,26330366,RLK
chr09,Bn39675,29451967,55578579,26126612,RLK
chr09,Bn39676,71269832,80430907,9161075,CN
chr09,Bn39677,57485973,71909869,14423896,TN
chr09,Bn39678,93036781,95310884,2274103,CN
chr09,Bn39679,49132459,71641654,22509195,TNL
chr09,Bn39680,51673081,56374377,4701296,CN
chr09,Bn39681,66974392,85058251,18083859,RLP
chr09,Bn39682,67664954,95553070,27888116,CNL
chr09,Bn39683,53517725,58052969,4535244,RLP
chr09,Bn39684,60752732,82958598,22205866,RLK
chr09,Bn39685,20048979,52556931,32507952,TN
chr09,Bn39686,65628300,93797152,28168852,TNL
chr09,Bn39687,57045809,63190421,6144612,CNL
chr09,Bn39688,31904729,78321211,46416482,NBS
chr09,Bn39689,60033119,71516339,11483220,NBS
chr09,Bn39690,73278861,87791625,14512764,RLP
chr09,Bn39691,51178110,69182523,18004413,CN
chr09,Bn39692,66280733,78422645,12141912,RLK
chr09,Bn39693,2843617,80066119,77222502,NBS
chr09,Bn39694,29806774,32413620,2606846,CN
chr09,Bn39695,62607578,78949014,16341436,TN
chr09,Bn39696,99834262,99852589,18327,TNL
chr09,Bn39697,66347519,83603846,17256327,RLK
chr09,Bn39698,28254540,71500765,43246225,RLP
chr09,Bn39699,25571691,45143482,19571791,RLP
chr09,Bn39700,16145902,55938662,39792760,CN
chr09,Bn39701,55594554,71351798,15757244,TNL
chr09,Bn39702,56717751,82318192,25600441,CNL
chr09,Bn39703,71005695,84500885,13495190,CNL
chr09,Bn39704,70536919,91685170,21148251,CN
chr09,Bn39705,48754452,62982425,14227973,TN
chr09,Bn39706,46397546,56519477,10121931,NBS
chr09,Bn39707,74721315,83082435,8361120,TN
chr09,Bn39708,99261437,99524741,263304,TNL
chr09,Bn39709,75158410,85386931,10228521,TN
chr09,Bn39710,93288581,96564562,3275981,RLK
chr09,Bn39711,6781383,44152106,37370723,RLP
chr09,Bn39712,80200731,94296418,14095687,CNL
chr09,Bn39713,15225908,64545384,49319476,TN
chr09,Bn39714,79703771,93932952,14229181,RLK
chr09,Bn39715,88532100,93303848,4771748,RLK
chr09,Bn39716,22604868,45926314,23321446,TN
chr09,Bn39717,11327544,27139140,15811596,TN
chr09,Bn39718,73625427,78586772,4961345,CN
chr09,Bn39719,85658283,88179015,2520732,NBS
chr09,Bn39720,92562691,94710654,2147963,TN
chr09,Bn39721,42106734,53909962,11803228,TNL
chr09,Bn39722,91246138,96517728,5271590,TN
chr09,Bn39723,60537700,61463795,926095,TNL
chr09,Bn39724,82845379,94126353,11280974,RLK
chr09,Bn39725,65433052,92939066,27506014,NBS
chr09,Bn39726,18182058,97017446,78835388,CNL
chr09,Bn39727,26432776,30013213,3580437,NBS
chr09,Bn39728,49565614,55615445,6049831,RLP
chr09,Bn39729,5427797,25342678,19914881,RLP
chr09,Bn39730,50624242,62247010,11622768,TN
chr09,Bn39731,47826037,76117572,28291535,TNL
chr09,Bn39732,79496680,86560694,7064014,TNL
chr09,Bn39733,16885648,62507340,45621692,RLK
chr09,Bn39734,25462916,59235301,33772385,CNL
chr09,Bn39735,37652655,97463001,59810346,NBS
chr09,Bn39736,98449748,99777342,1327594,TNL
chr09,Bn39737,45945122,82506186,36561064,TN
chr09,Bn39738,26333951,81234472,54900521,RLK
chr09,Bn39739,62455139,93156310,30701171,RLK
chr09,Bn39740,36676933,84368858,47691925,NBS
chr09,Bn39741,82876507,99567364,16690857,TNL
chr09,Bn39742,43216877,67562203,24345326,RLP
chr09,Bn39743,82502425,99716469,17214044,RLP
chr09,Bn39744,27415367,37419604,10004237,TN
chr09,Bn39745,67648867,75829577,8180710,CN
chr09,Bn39746,94009897,94982719,972822,RLP
chr09,Bn39747,17601873,63953862,46351989,TNL
chr09,Bn39748,5943452,54264255,48320803,NBS
chr09,Bn39749,57093304,88019159,30925855,CN
chr09,Bn39750,93271255,97732013,4460758,RLK
chr09,Bn39751,98400846,99647604,1246758,RLP
chr09,Bn39752,42521521,77379910,34858389,CN
chr09,Bn39753,66171107,78977074,12805967,CN
chr09,Bn39754,22457631,87218384,64760753,TNL
chr09,Bn39755,56410144,71459478,15049334,RLK
chr09,Bn39756,21469665,43250309,21780644,CNL
chr09,Bn39757,61121217,82553409,21432192,CNL
chr09,Bn39758,74081906,82827904,8745998,RLK
chr09,Bn39759,96969431,99228684,2259253,RLP
chr09,Bn39760,60961499,99135814,38174315,RLP
chr09,Bn39761,28599845,87350463,58750618,TNL
chr09,Bn39762,12580277,86091572,73511295,CN
chr09,Bn39763,35730568,70659745,34929177,TNL
chr09,Bn39764,75030400,77005503,1975103,NBS
chr09,Bn39765,98779124,98812205,33081,CNL
chr09,Bn39766,3165344,19027952,15862608,NBS
chr09,Bn39767,41634686,62358124,20723438,TNL
chr09,Bn39768,98606533,99159030,552497,NBS
chr09,Bn39769,36421820,81904020,45482200,CN
chr09,Bn39770,52540565,95211896,42671331,CNL
chr09,Bn39771,59137091,86081037,26943946,RLP
chr09,Bn39772,14914835,31254177,16339342,TNL
chr09,Bn39773,44897884,83199550,38301666,RLK
chr09,Bn39774,20236700,76910950,56674250,CN
chr09,Bn39775,92420972,97729300,5308328,CN
chr09,Bn39776,45622319,72853496,27231177,TN
chr09,Bn39777,26231059,58615792,32384733,RLP
chr09,Bn39778,77992387,95022847,17030460,RLK
chr09,Bn39779,70784287,88021117,17236830,CN
chr09,Bn39780,71822511,77771021,5948510,CN
chr09,Bn39781,98539547,99089232,549685,RLK
chr09,Bn39782,95059809,98958118,3898309,NBS
chr09,Bn39783,98697819,99266755,568936,CNL
chr09,Bn39784,38232984,69721084,31488100,TNL
chr09,Bn39785,4567124,18970130,14403006,TN
chr09,Bn39786,82668335,83979644,1311309,RLP
chr09,Bn39787,57454041,84668475,27214434,NBS
chr09,Bn39788,8354233,16639855,8285622,CN
chr09,Bn39789,19233999,97743206,78509207,CNL
chr09,Bn39790,36328532,83401536,47073004,CNL
chr09,Bn39791,63400713,72378726,8978013,NBS
chr09,Bn39792,55095209,72190881,17095672,RLP
chr09,Bn39793,91032079,93762116,2730037,RLP
chr09,Bn39794,83599922,97985259,14385337,TN
chr09,Bn39795,34033119,38725944,4692825,TNL
chr09,Bn39796,71087434,86344241,15256807,NBS
chr09,Bn39797,10953007,46809576,35856569,TN
chr09,Bn39798,18956309,85865941,66909632,CN
chr09,Bn39799,90935027,93461005,2525978,CNL
chr09,Bn39800,17451303,65891386,48440083,NBS
chr09,Bn39801,36432040,52648375,16216335,RLP
chr09,Bn39802,28911407,33576165,4664758,CN
chr09,Bn39803,5438722,74055092,68616370,RLK
chr09,Bn39804,27689548,83992511,56302963,RLK
chr09,Bn39805,17409684,54974475,37564791,CN
chr09,Bn39806,28497207,73000820,44503613,RLP
chr09,Bn39807,70098058,82065058,11967000,TN
chr09,Bn39808,47445347,87273424,39828077,RLK
chr09,Bn39809,35384069,62070856,26686787,RLK
chr09,Bn39810,17007644,86809468,69801824,TNL
chr09,Bn39811,27770515,61583548,33813033,TNL
chr09,Bn39812,82160409,89685908,7525499,CN
chr09,Bn39813,3743115,78212813,74469698,TN
chr09,Bn39814,45248128,80362853,35114725,NBS
chr09,Bn39815,62492806,72278199,9785393,TNL
chr09,Bn39816,10196165,58903369,48707204,TN
chr09,Bn39817,80901402,94586296,13684894,RLK
chr09,Bn39818,8696094,94299570,85603476,NBS
chr09,Bn39819,47585581,76340095,28754514,TNL
chr09,Bn39820,35854918,96214182,60359264,TN
chr09,Bn39821,29306429,73259523,43953094,RLK
chr09,Bn39822,71956957,86403965,14447008,RLP
chr09,Bn39823,17244928,76841952,59597024,RLP
chr09,Bn39824,88415191,89147598,732407,CN
chr09,Bn39825,7541803,54798888,47257085,RLP
chr09,Bn39826,82445511,94405529,11960018,CN
chr09,Bn39827,69556675,71954020,2397345,RLP
chr09,Bn39828,93208853,96979701,3770848,RLP
chr09,Bn39829,15137496,68211665,53074169,NBS
chr09,Bn39830,45816384,84983614,39167230,CN
chr09,Bn39831,15530770,69020083,53489313,CN
chr09,Bn39832,96085527,97491683,1406156,NBS
chr09,Bn39833,46761908,84241363,37479455,TN
chr09,Bn39834,5885221,46460897,40575676,NBS
chr09,Bn39835,50272755,90573703,40300948,RLP
chr09,Bn39836,74018076,82698107,8680031,TNL
chr09,Bn39837,89926130,98534644,8608514,RLK
chr09,Bn39838,16631659,99470849,82839190,CN
chr09,Bn39839,36410641,81228232,44817591,NBS
chr09,Bn39840,93205263,94305495,1100232,RLK
chr09,Bn39841,8123327,22713010,14589683,TNL
chr09,Bn39842,87158972,93902695,6743723,RLP
chr09,Bn39843,31357515,82944427,51586912,CN
chr09,Bn39844,24769728,24964358,194630,NBS
chr09,Bn39845,80377293,81434277,1056984,TN
chr09,Bn39846,73321543,76963076,3641533,RLP
chr09,Bn39847,29627215,62639099,33011884,CN
chr09,Bn39848,34318252,70338566,36020314,TNL
chr09,Bn39849,35000928,85478919,50477991,CNL
chr09,Bn39850,56931209,66509489,9578280,CN
chr09,Bn39851,22850491,38545173,15694682,CNL
chr09,Bn39852,10089244,29700762,19611518,NBS
chr09,Bn39853,28340107,41512584,13172477,CN
chr09,Bn39854,89925939,93391004,3465065,TN
chr09,Bn39855,36564455,55010581,18446126,CNL
chr09,Bn39856,58121804,68067126,9945322,CN
chr09,Bn39857,4992061,25149082,20157021,RLK
chr09,Bn39858,97381071,98988613,1607542,CN
chr09,Bn39859,30103173,82232827,52129654,TNL
chr09,Bn39860,3544210,76790747,73246537,NBS
chr09,Bn39861,86402295,91716020,5313725,TNL
chr09,Bn39862,50613461,50930534,317073,TN
chr09,Bn39863,29962011,46329984,16367973,RLP
chr09,Bn39864,9988276,81375729,71387453,TNL
chr09,Bn39865,62389717,75096296,12706579,TNL
chr09,Bn39866,95275047,97353564,2078517,CNL
chr09,Bn39867,98936778,99516419,579641,TNL
chr09,Bn39868,69679220,72435447,2756227,CN
chr09,Bn39869,32225301,83750061,51524760,TNL
chr09,Bn39870,64495452,67584982,3089530,TNL
chr09,Bn39871,23077032,66051666,42974634,CNL
chr09,Bn39872,58730491,92318595,33588104,CN
chr09,Bn39873,37911583,72733806,34822223,TN
chr09,Bn39874,4163678,87287815,83124137,RLK
chr09,Bn39875,39360570,93710016,54349446,TN
chr09,Bn39876,93029267,94622140,1592873,NBS
chr09,Bn39877,44328001,97207599,52879598,RLP
chr09,Bn39878,81024046,95833038,14808992,CNL
chr09,Bn39879,4255121,68984084,64728963,CNL
chr09,Bn39880,44004465,85994774,41990309,RLK
chr09,Bn39881,24057476,99270885,75213409,CNL
chr09,Bn39882,36760069,58211911,21451842,RLK
chr09,Bn39883,32542233,51252380,18710147,RLP
chr09,Bn39884,89273808,99437758,10163950,TNL
chr09,Bn39885,47977833,85550827,37572994,TNL
chr09,Bn39886,80833495,98135210,17301715,RLP
chr09,Bn39887,86583436,98693585,12110149,NBS
chr09,Bn39888,97563516,98598863,1035347,NBS
chr09,Bn39889,46367867,56279510,9911643,CN
chr09,Bn39890,82262080,85557797,3295717,RLP
chr09,Bn39891,47415001,94193062,46778061,TN
chr09,Bn39892,9276555,87685002,78408447,RLK
chr09,Bn39893,9027863,70306341,61278478,CNL
chr09,Bn39894,95780092,95928360,148268,RLK
chr09,Bn39895,76614251,93861152,17246901,RLP
chr09,Bn39896,70073374,86931390,16858016,CNL
chr09,Bn39897,4157275,51810803,47653528,TN
chr09,Bn39898,72306030,78076590,5770560,NBS
chr09,Bn39899,41298375,83310413,42012038,TN
chr09,Bn39900,87133661,88353422,1219761,RLP
chr09,Bn39901,85869539,88522049,2652510,CNL
chr09,Bn39902,88320787,93361048,5040261,NBS
chr09,Bn39903,74133334,86400824,12267490,RLP
chr09,Bn39904,3648313,52818886,49170573,CN
chr09,Bn39905,73092916,92010865,18917949,CN
chr09,Bn39906,96647435,99621860,2974425,RLK
chr09,Bn39907,36041540,97915275,61873735,CN
chr09,Bn39908,26875843,41948344,15072501,CN
chr09,Bn39909,76980798,81597629,4616831,RLP
chr09,Bn39910,24662982,39504022,14841040,CNL
chr09,Bn39911,55468479,66427080,10958601,RLK
chr09,Bn39912,11808576,79953336,68144760,CNL
chr09,Bn39913,79101795,87915445,8813650,NBS
chr09,Bn39914,47026554,90612799,43586245,CN
chr09,Bn39915,67065856,84232041,17166185,TNL
chr09,Bn39916,37317134,70156439,32839305,NBS
chr09,Bn39917,55287453,55722286,434833,NBS
chr09,Bn39918,31541718,96919084,65377366,TNL
chr09,Bn39919,64363658,67104137,2740479,TNL
chr09,Bn39920,82865369,86790086,3924717,RLP
chr09,Bn39921,15410754,17712096,2301342,RLP
chr09,Bn39922,56243620,61544073,5300453,CN
chr09,Bn39923,32402649,66719280,34316631,RLP
chr09,Bn39924,74172110,89095980,14923870,RLP
chr09,Bn39925,11220513,76145884,64925371,RLP
chr09,Bn39926,3016258,45517038,42500780,TN
chr09,Bn39927,75565167,95774545,20209378,TN
chr09,Bn39928,31101650,76262422,45160772,RLK
chr09,Bn39929,44011626,71770705,27759079,CN
chr09,Bn39930,12093031,96950857,84857826,CNL
chr09,Bn39931,81287953,91102923,9814970,CN
chr09,Bn39932,97611213,97618136,6923,RLK
chr09,Bn39933,76075817,95768910,19693093,TNL
chr09,Bn39934,86152008,98826397,12674389,TN
chr09,Bn39935,84722803,85776407,1053604,TNL
chr09,Bn39936,53876229,68099149,14222920,CNL
chr09,Bn39937,93414188,94125816,711628,RLP
chr09,Bn39938,23794150,62187635,38393485,NBS
chr09,Bn39939,81818264,87232608,5414344,TNL
chr09,Bn39940,98199682,98417205,217523,RLK
chr09,Bn39941,94572433,96434840,1862407,TN
chr09,Bn39942,51706858,86751095,35044237,TNL
chr09,Bn39943,86375383,91688636,5313253,CNL
chr09,Bn39944,7627653,24306575,16678922,RLK
chr09,Bn39945,47670835,70138589,22467754,CN
chr09,Bn39946,68325271,93331761,25006490,TNL
chr09,Bn39947,91606034,92403578,797544,CNL
chr09,Bn39948,20182748,89064448,68881700,RLK
chr09,Bn39949,60572475,97057334,36484859,TNL
chr09,Bn39950,69535490,94886336,25350846,TNL
chr09,Bn39951,91745420,95804082,4058662,CNL
chr09,Bn39952,74611891,89364983,14753092,TN
chr09,Bn39953,1039634,73419503,72379869,NBS
chr09,Bn39954,42824368,78370622,35546254,CNL
chr09,Bn39955,61017317,68247903,7230586,RLP
chr09,Bn39956,17166158,23389025,6222867,CN
chr09,Bn39957,49394656,87329196,37934540,CN
chr09,Bn39958,87805010,91619016,3814006,RLK
chr09,Bn39959,51594561,79966577,28372016,RLK
chr09,Bn39960,88672887,94944852,6271965,TNL
chr09,Bn39961,6683698,72018142,65334444,RLP
chr09,Bn39962,21331236,66747251,45416015,TNL
chr09,Bn39963,45019072,71931731,26912659,CN
chr09,Bn39964,4897160,9862683,4965523,RLP
chr09,Bn39965,31155240,74028278,42873038,TNL
chr09,Bn39966,24664148,46617563,21953415,NBS
chr09,Bn39967,9839286,66714573,56875287,CNL
chr09,Bn39968,3082834,68677118,65594284,CN
chr09,Bn39969,27800576,72886887,45086311,RLK
chr09,Bn39970,13074002,63320364,50246362,CN
chr09,Bn39971,42767858,62973012,20205154,TNL
chr09,Bn39972,93790289,96609522,2819233,RLK
chr09,Bn39973,42079064,78469331,36390267,NBS
chr09,Bn39974,81149836,99462574,18312738,NBS
chr09,Bn39975,10538331,37376976,26838645,CNL
chr09,Bn39976,13256234,65751644,52495410,TN
chr09,Bn39977,92631035,93106415,475380,CNL
chr09,Bn39978,86946776,86985176,38400,NBS
chr09,Bn39979,47278375,87340282,40061907,RLP
chr09,Bn39980,83035102,85546317,2511215,TNL
chr09,Bn39981,40617869,48470557,7852688,TN
chr09,Bn39982,1289755,90319562,89029807,RLP
chr09,Bn39983,64877699,66175283,1297584,TNL
chr09,Bn39984,79891639,92798642,12907003,TN
chr09,Bn39985,71081441,79929306,8847865,RLP
chr09,Bn39986,82495974,84976967,2480993,NBS
chr09,Bn39987,83119270,85490198,2370928,CNL
chr09,Bn39988,74806586,78219256,3412670,RLP
chr09,Bn39989,82904739,94245662,11340923,RLK
chr09,Bn39990,1536633,60328614,58791981,NBS
chr09,Bn39991,82792909,83363518,570609,CN
chr09,Bn39992,40023191,76525347,36502156,CNL
chr09,Bn39993,98602539,99207308,604769,TNL
chr09,Bn39994,93061559,97869745,4808186,TNL
chr09,Bn39995,32887218,90398204,57510986,TNL
chr09,Bn39996,33240105,42203569,8963464,TN
chr09,Bn39997,76715596,86375858,9660262,CNL
chr09,Bn39998,32732475,88094437,55361962,CN
chr09,Bn39999,29789209,58304386,28515177,RLK
chr09,Bn40000,90759838,96819573,6059735,NBS
chr09,Bn40001,53840230,69703578,15863348,CNL
chr09,Bn40002,91746995,93811387,2064392,TNL
chr09,Bn40003,91292601,98201932,6909331,CNL
chr09,Bn40004,11677716,97760397,86082681,CN
chr09,Bn40005,30772554,64961202,34188648,CNL
chr09,Bn40006,8903781,22080202,13176421,RLK
chr09,Bn40007,94782668,96399503,1616835,CNL
chr09,Bn40008,3039365,75629019,72589654,TN
chr09,Bn40009,99108394,99260199,151805,RLP
chr09,Bn40010,22799864,45478442,22678578,RLK
chr09,Bn40011,17000548,21964262,4963714,NBS
chr09,Bn40012,36052429,66201365,30148936,TN
chr09,Bn40013,52156287,58258920,6102633,CN
chr09,Bn40014,81928713,92410213,10481500,NBS
chr09,Bn40015,19598084,65676740,46078656,TN
chr09,Bn40016,94581475,95359334,777859,CNL
chr09,Bn40017,75634552,90513926,14879374,CNL
chr09,Bn40018,63925516,90090709,26165193,TNL
chr09,Bn40019,70622779,84719359,14096580,NBS
chr09,Bn40020,82932345,97372918,14440573,CN
chr09,Bn40021,27455000,33884820,6429820,CN
chr09,Bn40022,50075390,64818542,14743152,CN
chr09,Bn40023,8012149,19427076,11414927,RLP
chr09,Bn40024,68004752,90451097,22446345,RLP
chr09,Bn40025,76767002,85513192,8746190,NBS
chr09,Bn40026,90049960,99748269,9698309,TN
chr09,Bn40027,64459399,74838027,10378628,CNL
chr09,Bn40028,62927603,71509638,8582035,CN
chr09,Bn40029,38168039,86925875,48757836,CN
chr09,Bn40030,52471554,78842227,26370673,CNL
chr09,Bn40031,35351832,96272756,60920924,TN
chr09,Bn40032,55112493,94821865,39709372,CNL
chr09,Bn40033,18044858,65634293,47589435,NBS
chr09,Bn40034,40906511,93825594,52919083,TNL
chr09,Bn40035,21159780,62671570,41511790,RLP
chr09,Bn40036,89310886,99297440,9986554,RLP
chr09,Bn40037,12492838,31872370,19379532,CNL
chr09,Bn40038,56968908,73645513,16676605,NBS
chr09,Bn40039,39195008,74940379,35745371,TNL
chr09,Bn40040,91820963,93976278,2155315,TN
chr09,Bn40041,95939220,99569214,3629994,CN
chr09,Bn40042,62704277,91792193,29087916,NBS
chr09,Bn40043,36705404,44243649,7538245,TN
chr09,Bn40044,39474407,91756168,52281761,TNL
chr09,Bn40045,57873140,62238890,4365750,TN
chr09,Bn40046,58729848,87448800,28718952,TNL
chr09,Bn40047,70431811,83973661,13541850,NBS
chr09,Bn40048,6915924,63966665,57050741,RLK
chr09,Bn40049,14243124,57555755,43312631,TN
chr09,Bn40050,89733423,98353783,8620360,CN
chr09,Bn40051,96027571,98484384,2456813,NBS
chr09,Bn40052,42115817,64660526,22544709,RLP
chr09,Bn40053,46054566,80381597,34327031,CN
chr09,Bn40054,73744212,77858415,4114203,TN
chr09,Bn40055,6087549,42518550,36431001,CNL
chr09,Bn40056,70518379,85064097,14545718,CN
chr09,Bn40057,39018850,74417311,35398461,TNL
chr09,Bn40058,60566430,88618730,28052300,CNL
chr09,Bn40059,40066755,71873297,31806542,NBS
chr09,Bn40060,86299990,89830561,3530571,TN
chr09,Bn40061,92209524,95580620,3371096,TN
chr09,Bn40062,65864782,85213510,19348728,CNL
chr09,Bn40063,61656055,94686145,33030090,RLP
chr09,Bn40064,23008809,29339662,6330853,NBS
chr09,Bn40065,21410518,46313975,24903457,RLP
chr09,Bn40066,82373796,98926245,16552449,TN
chr09,Bn40067,15785257,75785597,60000340,CN
chr09,Bn40068,10961982,91652869,80690887,NBS
chr09,Bn40069,74878845,91060868,16182023,RLK
chr09,Bn40070,3655387,48260457,44605070,CN
chr09,Bn40071,69743862,79495544,9751682,RLK
chr09,Bn40072,53232475,70209714,16977239,NBS
chr09,Bn40073,17109473,27457110,10347637,CN
chr09,Bn40074,68039690,87709933,19670243,TNL
chr09,Bn40075,52271593,70856892,18585299,TN
chr09,Bn40076,85029546,98322476,13292930,RLP
chr09,Bn40077,81007635,93906242,12898607,RLK
chr09,Bn40078,42898019,83386986,40488967,RLP
chr09,Bn40079,32913970,61016018,28102048,NBS
chr09,Bn40080,75917079,89045298,13128219,NBS
chr09,Bn40081,41985580,54265622,12280042,CNL
chr09,Bn40082,7118729,38223192,31104463,NBS
chr09,Bn40083,87500990,91375508,3874518,RLK
chr09,Bn40084,84109899,94657186,10547287,TNL
chr09,Bn40085,90168988,94766836,4597848,RLP
chr09,Bn40086,80091971,88543140,8451169,CN
chr09,Bn40087,10794558,93421245,82626687,CN
chr09,Bn40088,52859450,98759036,45899586,RLP
chr09,Bn40089,8808681,87147190,78338509,TN
chr09,Bn40090,58251638,95577795,37326157,TNL
chr09,Bn40091,46366977,98277382,51910405,CN
chr09,Bn40092,66195234,75875243,9680009,NBS
chr09,Bn40093,35778335,65329216,29550881,CN
chr09,Bn40094,73727999,92235778,18507779,NBS
chr09,Bn40095,57723368,98883780,41160412,CNL
chr09,Bn40096,81417573,81470714,53141,TN
chr09,Bn40097,92154111,96961989,4807878,CN
chr09,Bn40098,89075109,98616783,9541674,RLK
chr09,Bn40099,17756858,68726102,50969244,RLP
chr09,Bn40100,23678532,86212640,62534108,RLK
chr09,Bn40101,60132782,68444840,8312058,TNL
chr09,Bn40102,63667849,72245739,8577890,TN
chr09,Bn40103,41187563,63595961,22408398,RLP
chr09,Bn40104,66686283,75106352,8420069,TN
chr09,Bn40105,78896340,99063104,20166764,TN
chr09,Bn40106,15552282,70857683,55305401,NBS
chr09,Bn40107,5655135,92662556,87007421,TN
chr09,Bn40108,76764107,93393355,16629248,TN
chr09,Bn40109,4639627,31757499,27117872,CN
chr09,Bn40110,97153629,98129001,975372,RLK
chr09,Bn40111,73286389,80471352,7184963,TN
chr09,Bn40112,80796696,86226050,5429354,NBS
chr09,Bn40113,65074216,92832030,27757814,RLP
chr09,Bn40114,19876689,52069019,32192330,CN
chr09,Bn40115,64794950,94544127,29749177,NBS
chr09,Bn40116,95960175,98081146,2120971,CN
chr09,Bn40117,13199729,98739738,85540009,RLK
chr09,Bn40118,41391287,50196470,8805183,RLK
chr09,Bn40119,88629911,98795860,10165949,RLP
chr09,Bn40120,54047601,98876222,44828621,RLK
chr09,Bn40121,86977684,88003533,1025849,TN
chr09,Bn40122,17667519,45929310,28261791,NBS
chr09,Bn40123,86872220,92061185,5188965,CNL
chr09,Bn40124,51157406,59500011,8342605,NBS
chr09,Bn40125,65252856,87798513,22545657,TNL
chr09,Bn40126,87596058,99562076,11966018,TNL
chr09,Bn40127,19430692,43304595,23873903,TN
chr09,Bn40128,90234960,99270793,9035833,TN
chr09,Bn40129,53705686,92102795,38397109,CNL
chr09,Bn40130,73234623,79922449,6687826,TN
chr09,Bn40131,30363586,36596733,6233147,CNL
chr09,Bn40132,56509704,68486010,11976306,CNL
chr09,Bn40133,28714355,58768080,30053725,CNL
chr09,Bn40134,94415348,99725638,5310290,CN
chr09,Bn40135,2214332,87578371,85364039,CN
chr09,Bn40136,92427554,95603342,3175788,TN
chr09,Bn40137,64884465,97746216,32861751,TN
chr09,Bn40138,36178834,46014804,9835970,TN
chr09,Bn40139,29756748,88914175,59157427,CNL
chr09,Bn40140,25962761,79643840,53681079,CNL
chr09,Bn40141,44496966,55909878,11412912,CN
chr09,Bn40142,80221719,82608609,2386890,RLP
chr09,Bn40143,80242013,94257737,14015724,NBS
chr09,Bn40144,46499556,77075148,30575592,NBS
chr09,Bn40145,56155877,86974039,30818162,RLP
chr09,Bn40146,60180219,92708267,32528048,TNL
chr09,Bn40147,96307203,98868220,2561017,CN
chr09,Bn40148,82906980,84601771,1694791,TN
chr09,Bn40149,25798757,95411811,69613054,TN
chr09,Bn40150,60106940,92499326,32392386,TNL
chr09,Bn40151,4405434,53908967,49503533,NBS
chr09,Bn40152,58224025,91676275,33452250,CN
chr09,Bn40153,62869420,75494507,12625087,RLK
chr09,Bn40154,90938493,95358584,4420091,RLK
chr09,Bn40155,41187542,52759052,11571510,CN
chr09,Bn40156,48599685,59729295,11129610,NBS
chr09,Bn40157,13759372,61337679,47578307,TN
chr09,Bn40158,52017898,52061073,43175,RLK
chr09,Bn40159,99315813,99400442,84629,RLK
chr09,Bn40160,71724355,75489768,3765413,RLK
chr09,Bn40161,58019458,58233252,213794,CN
chr09,Bn40162,45784445,80001986,34217541,TNL
chr09,Bn40163,41915879,55615934,13700055,RLP
chr09,Bn40164,48312551,52340775,4028224,CN
chr09,Bn40165,43260356,46419533,3159177,RLK
chr09,Bn40166,9823616,49308390,39484774,TN
chr09,Bn40167,47330073,93208562,45878489,CN
chr09,Bn40168,92846255,95040121,2193866,TNL
chr09,Bn40169,39140400,61405117,22264717,CNL
chr09,Bn40170,39549060,47497457,7948397,TN
chr09,Bn40171,33023100,35327097,2303997,TNL
chr09,Bn40172,89307326,91645605,2338279,NBS
chr09,Bn40173,54034426,76983182,22948756,CNL
chr09,Bn40174,39693145,79778086,40084941,TN
chr09,Bn40175,83921035,94388110,10467075,TN
chr09,Bn40176,9120752,22222750,13101998,TN
chr09,Bn40177,5851278,24237292,18386014,TN
chr09,Bn40178,85166798,96424258,11257460,TNL
chr09,Bn40179,57532280,90868881,33336601,NBS
chr09,Bn40180,71286074,90050532,18764458,RLP
chr09,Bn40181,3483034,76582244,73099210,CN
chr09,Bn40182,39958481,40901366,942885,NBS
chr09,Bn40183,76969274,92503769,15534495,CN
chr09,Bn40184,49932676,93946163,44013487,TNL
chr09,Bn40185,87665730,95644964,7979234,RLP
chr09,Bn40186,17887913,63787056,45899143,NBS
chr09,Bn40187,49229382,58847648,9618266,NBS
chr09,Bn40188,82479540,97103203,14623663,TN
chr09,Bn40189,85356364,98581635,13225271,TN
chr09,Bn40190,30432740,78425774,47993034,RLP
chr09,Bn40191,7571973,99633846,92061873,RLP
chr09,Bn40192,24698487,37103013,12404526,RLP
chr09,Bn40193,7655036,65819570,58164534,CN
chr09,Bn40194,17893263,23522084,5628821,TNL
chr09,Bn40195,26465282,55231903,28766621,NBS
chr09,Bn40196,58295226,70681750,12386524,CNL
chr09,Bn40197,64467230,75569694,11102464,NBS
chr09,Bn40198,81336516,84555769,3219253,CN
chr09,Bn40199,98130267,99947976,1817709,CNL
chr09,Bn40200,43783758,65000804,21217046,CNL
chr09,Bn40201,97490534,99199990,1709456,RLK
chr09,Bn40202,83464386,98677059,15212673,RLP
chr09,Bn40203,67531974,76883770,9351796,RLK
chr09,Bn40204,17140542,60088046,42947504,RLP
chr09,Bn40205,56277870,65448914,9171044,NBS
chr09,Bn40206,29839741,43017793,13178052,CNL
chr09,Bn40207,23562921,32074958,8512037,TNL
chr09,Bn40208,41925081,67765649,25840568,RLK
chr09,Bn40209,77352868,98291798,20938930,TNL
chr09,Bn40210,49268165,74822283,25554118,TNL
chr09,Bn40211,33997186,72995371,38998185,CN
chr09,Bn40212,58188122,66144104,7955982,TNL
chr09,Bn40213,71765948,75026237,3260289,RLK
chr09,Bn40214,2645383,42523138,39877755,RLP
chr09,Bn40215,65274960,93083861,27808901,CNL
chr09,Bn40216,42746315,83569306,40822991,CN
chr09,Bn40217,77883392,79082852,1199460,TN
chr09,Bn40218,85624472,92057061,6432589,CNL
chr09,Bn40219,6505024,17189628,10684604,CNL
chr09,Bn40220,87366514,96727069,9360555,TN
chr09,Bn40221,74334855,98736902,24402047,RLP
chr09,Bn40222,68995595,80478597,11483002,TN
chr09,Bn40223,16738449,43549205,26810756,TN
chr09,Bn40224,60294495,66084027,5789532,TN
chr09,Bn40225,77513032,97281778,19768746,CNL
chr09,Bn40226,80575539,90165151,9589612,CN
chr09,Bn40227,9841987,66919063,57077076,TNL
chr09,Bn40228,58017025,72242332,14225307,TN
chr09,Bn40229,11560298,32275420,20715122,NBS
chr09,Bn40230,61960104,63788711,1828607,TN
chr09,Bn40231,67610867,88819026,21208159,NBS
chr09,Bn40232,81672829,90005639,8332810,TNL
chr09,Bn40233,21289715,95459916,74170201,RLK
chr09,Bn40234,82088360,92225165,10136805,TN
chr09,Bn40235,68223893,71330212,3106319,CNL
chr09,Bn40236,83615844,91169288,7553444,TNL
chr09,Bn40237,90023462,92710456,2686994,TN
chr09,Bn40238,87205081,94983571,7778490,RLK
chr09,Bn40239,60394945,95688224,35293279,CN
chr09,Bn40240,64825201,91586302,26761101,TN
chr09,Bn40241,51933123,72275329,20342206,CN
chr09,Bn40242,59831341,67799099,7967758,RLP
chr09,Bn40243,86047072,86971237,924165,NBS
chr09,Bn40244,98078257,99895146,1816889,RLP
chr09,Bn40245,2793582,12673266,9879684,TNL
chr09,Bn40246,62623864,66161690,3537826,CN
chr09,Bn40247,80741709,99725359,18983650,RLK
chr09,Bn40248,5891017,7767467,1876450,NBS
chr09,Bn40249,85649424,97845983,12196559,NBS
chr09,Bn40250,69962714,91768074,21805360,TN
chr09,Bn40251,4083253,4222850,139597,TN
chr09,Bn40252,17597647,37456234,19858587,RLK
chr09,Bn40253,71679565,99819526,28139961,RLP
chr09,Bn40254,95617771,96746697,1128926,NBS
chr09,Bn40255,69801048,89973845,20172797,CNL
chr09,Bn40256,60239912,67985227,7745315,CNL
chr09,Bn40257,2056651,70595459,68538808,TN
chr09,Bn40258,61514162,94572082,33057920,TNL
chr09,Bn40259,80698887,81414206,715319,NBS
chr09,Bn40260,59083544,70101262,11017718,CN
chr09,Bn40261,62427114,67215374,4788260,TNL
chr09,Bn40262,48919411,91848488,42929077,RLK
chr09,Bn40263,23501378,85286460,61785082,RLK
chr09,Bn40264,91881165,93952175,2071010,CN
chr09,Bn40265,98236610,98720640,484030,TNL
chr09,Bn40266,13742065,66063434,52321369,CN
chr09,Bn40267,38915614,77047486,38131872,CN
chr09,Bn40268,9797383,54914207,45116824,NBS
chr09,Bn40269,39293016,73389919,34096903,NBS
chr09,Bn40270,23734131,30138222,6404091,CNL
chr09,Bn40271,50548528,65180058,14631530,RLK
chr09,Bn40272,5560132,71184755,65624623,TN
chr09,Bn40273,34921591,61225409,26303818,RLP
chr09,Bn40274,46923130,65780088,18856958,RLK
chr09,Bn40275,55964681,66139893,10175212,RLP
chr09,Bn40276,58694814,69654753,10959939,TNL
chr09,Bn40277,74871221,81023318,6152097,CNL
chr09,Bn40278,97840210,99132374,1292164,RLP
chr09,Bn40279,79845641,99004144,19158503,TN
chr09,Bn40280,88209509,97179813,8970304,NBS
chr09,Bn40281,75087679,77075729,1988050,RLP
chr09,Bn40282,72285168,77790306,5505138,CNL
chr09,Bn40283,70318193,81043011,10724818,TN
chr09,Bn40284,42829399,84112501,41283102,TN
chr09,Bn40285,14924610,89327655,74403045,CN
chr09,Bn40286,89138730,90988035,1849305,CN
chr09,Bn40287,15030831,22128866,7098035,RLP
chr09,Bn40288,88482831,96266203,7783372,TNL
chr09,Bn40289,45532865,52260294,6727429,RLK
chr09,Bn40290,85438787,99937260,14498473,NBS
chr09,Bn40291,90534757,97820730,7285973,RLK
chr09,Bn40292,19799889,58963206,39163317,CNL
chr09,Bn40293,67244244,87685597,20441353,RLP
chr09,Bn40294,73827910,98005529,24177619,CN
chr09,Bn40295,64194570,97221134,33026564,NBS
chr09,Bn40296,91171680,96204340,5032660,NBS
chr09,Bn40297,47262794,86053044,38790250,TN
chr09,Bn40298,78509150,84563887,6054737,CN
chr09,Bn40299,48159807,93766928,45607121,RLP
chr09,Bn40300,7438541,94479334,87040793,NBS
chr09,Bn40301,94869862,98478423,3608561,CN
chr09,Bn40302,38134616,71890074,33755458,CNL
chr09,Bn40303,47008157,68764758,21756601,CN
chr09,Bn40304,96415328,97497166,1081838,CN
chr09,Bn40305,37017405,97837563,60820158,RLP
chr09,Bn40306,54379673,84723257,30343584,CNL
chr09,Bn40307,10585249,67911893,57326644,TNL
chr09,Bn40308,9033171,26175645,17142474,TN
chr09,Bn40309,67398221,71281503,3883282,RLK
chr09,Bn40310,83017279,88198338,5181059,CNL
chr09,Bn40311,63755859,76451725,12695866,NBS
chr09,Bn40312,11943677,62887104,50943427,RLP
chr09,Bn40313,77938075,86065369,8127294,TNL
chr09,Bn40314,6129052,55520846,49391794,CN
chr09,Bn40315,98760799,99560667,799868,CN
chr09,Bn40316,40578263,46158424,5580161,RLP
chr09,Bn40317,48787022,56686681,7899659,RLP
chr09,Bn40318,63023275,90599516,27576241,NBS
chr09,Bn40319,60837583,85451505,24613922,CN
chr09,Bn40320,38408415,48589571,10181156,TN
chr09,Bn40321,59550728,90755536,31204808,TNL
chr09,Bn40322,73025721,95029471,22003750,CNL
chr09,Bn40323,90015571,91383198,1367627,TN
chr09,Bn40324,90431995,92124035,1692040,NBS
chr09,Bn40325,6239447,61576485,55337038,CN
chr09,Bn40326,49197507,79743648,30546141,NBS
chr09,Bn40327,28014123,79767224,51753101,CN
chr09,Bn40328,80489128,92287974,11798846,NBS
chr09,Bn40329,18470064,56828384,38358320,CN
chr09,Bn40330,18668081,24008522,5340441,RLP
chr09,Bn40331,36208323,91017838,54809515,CNL
chr09,Bn40332,47421424,82032963,34611539,CNL
chr09,Bn40333,51002075,51073667,71592,TN
chr09,Bn40334,61693814,97209099,35515285,TNL
chr09,Bn40335,29030099,30162010,1131911,TNL
chr09,Bn40336,54643281,55711457,1068176,NBS
chr09,Bn40337,95267776,98604755,3336979,CN
chr09,Bn40338,46465191,72191724,25726533,RLK
chr09,Bn40339,65627459,96466625,30839166,NBS
chr09,Bn40340,24607208,84645924,60038716,NBS
chr09,Bn40341,63465879,75473173,12007294,CN
chr09,Bn40342,49253659,62144359,12890700,NBS
chr09,Bn40343,6965364,89398578,82433214,RLK
chr09,Bn40344,88198010,93136408,4938398,CNL
chr09,Bn40345,46314944,83482945,37168001,RLP
chr09,Bn40346,26699709,51318055,24618346,NBS
chr09,Bn40347,44703673,78484624,33780951,CNL
chr09,Bn40348,75903699,86545727,10642028,TN
chr09,Bn40349,61342826,73958309,12615483,CN
chr09,Bn40350,4113456,56086636,51973180,TN
chr09,Bn40351,77423861,78796919,1373058,CNL
chr09,Bn40352,43105152,97686257,54581105,RLK
chr09,Bn40353,72001707,91418130,19416423,TNL
chr09,Bn40354,36827424,52699213,15871789,NBS
chr09,Bn40355,17548161,63677325,46129164,TN
chr09,Bn40356,92157272,96408902,4251630,TNL
chr09,Bn40357,24723373,67134230,42410857,RLP
chr09,Bn40358,13145697,75659470,62513773,TNL
chr09,Bn40359,44177476,83765272,39587796,TNL
chr09,Bn40360,48707203,55318906,6611703,CNL
chr09,Bn40361,49989748,59510522,9520774,CN
chr09,Bn40362,85430109,87388122,1958013,TN
chr09,Bn40363,1977242,22476374,20499132,NBS
chr09,Bn40364,15476996,93702432,78225436,TNL
chr09,Bn40365,84319805,97210559,12890754,TN
chr09,Bn40366,87343385,91844898,4501513,NBS
chr09,Bn40367,23515689,25536528,2020839,TNL
chr09,Bn40368,97434091,98392403,958312,TN
chr09,Bn40369,17701667,88476877,70775210,RLK
chr09,Bn40370,97343306,98517493,1174187,TNL
chr09,Bn40371,96574152,97152548,578396,CN
chr09,Bn40372,29358335,67589158,38230823,NBS
chr09,Bn40373,43547937,93251580,49703643,RLP
chr09,Bn40374,41828143,70069033,28240890,TNL
chr09,Bn40375,60657318,68430022,7772704,RLP
chr09,Bn40376,89474082,96900989,7426907,TNL
chr09,Bn40377,35026579,88543658,53517079,CNL
chr09,Bn40378,41737951,43836486,2098535,RLK
chr09,Bn40379,22734017,82096424,59362407,TN
chr09,Bn40380,38218097,57879195,19661098,RLK
chr09,Bn40381,64090804,94157653,30066849,CN
chr09,Bn40382,99898055,99912148,14093,CNL
chr09,Bn40383,35509757,68762126,33252369,TNL
chr09,Bn40384,4530988,25994871,21463883,RLK
chr09,Bn40385,80723835,99160804,18436969,RLK
chr09,Bn40386,72695561,85939966,13244405,CN
chr09,Bn40387,5084750,62128802,57044052,NBS
chr09,Bn40388,8331358,43000196,34668838,RLP
chr09,Bn40389,28089562,35165454,7075892,RLP
chr09,Bn40390,7678405,23301014,15622609,RLK
chr09,Bn40391,83797544,84926872,1129328,CN
chr09,Bn40392,65723484,82398635,16675151,CNL
chr09,Bn40393,80495520,81872985,1377465,TNL
chr09,Bn40394,59519134,99321854,39802720,TNL
chr09,Bn40395,8966153,96413087,87446934,CN
chr09,Bn40396,69061220,91358184,22296964,CNL
chr09,Bn40397,43873427,52883803,9010376,TN
chr09,Bn40398,71262145,79331232,8069087,RLP
chr09,Bn40399,14263391,99711098,85447707,RLK
chr09,Bn40400,28973709,45825223,16851514,NBS
chr09,Bn40401,88967343,99632067,10664724,TN
chr09,Bn40402,95755259,99703964,3948705,NBS
chr09,Bn40403,84670789,87409151,2738362,RLK
chr09,Bn40404,17226454,83633193,66406739,TNL
chr09,Bn40405,77996393,78983438,987045,RLP
chr09,Bn40406,52507018,74729663,22222645,TNL
chr09,Bn40407,60654166,78503682,17849516,CN
chr09,Bn40408,81148753,84797632,3648879,TNL
chr09,Bn40409,72637039,73631854,994815,TNL
chr09,Bn40410,8178517,94694499,86515982,CN
chr09,Bn40411,81062342,93202678,12140336,TN
chr09,Bn40412,42484562,49749579,7265017,TN
chr09,Bn40413,73221140,77846839,4625699,RLK
chr09,Bn40414,47601657,97191193,49589536,CNL
chr09,Bn40415,25375128,48149577,22774449,CNL
chr09,Bn40416,9842483,77398235,67555752,CNL
chr09,Bn40417,82849714,98204041,15354327,CN
chr09,Bn40418,17449318,38028158,20578840,CN
chr09,Bn40419,48078427,86331382,38252955,CNL
chr09,Bn40420,85851584,96765228,10913644,CNL
chr09,Bn40421,84821830,89593773,4771943,RLK
chr09,Bn40422,25997686,33235648,7237962,TNL
chr09,Bn40423,58191800,99932146,41740346,RLK
chr09,Bn40424,37105721,39879187,2773466,CNL
chr09,Bn40425,20443439,39901440,19458001,CN
chr09,Bn40426,3936334,40247498,36311164,TNL
chr09,Bn40427,59381973,76665391,17283418,TN
chr09,Bn40428,3734419,16164666,12430247,CN
chr09,Bn40429,75456156,79153667,3697511,RLP
chr09,Bn40430,10467451,93949395,83481944,NBS
chr09,Bn40431,42671149,94429936,51758787,NBS
chr09,Bn40432,15007424,71268506,56261082,RLP
chr09,Bn40433,38268335,93850996,55582661,CN
chr09,Bn40434,22107351,71345703,49238352,TN
chr09,Bn40435,53126330,58476973,5350643,TN
chr09,Bn40436,41580214,76507100,34926886,RLP
chr09,Bn40437,10174710,50737950,40563240,TN
chr09,Bn40438,39380219,94635457,55255238,CNL
chr09,Bn40439,78063657,78382924,319267,TN
chr09,Bn40440,64829304,93337815,28508511,NBS
chr09,Bn40441,31522391,41513576,9991185,RLK
chr09,Bn40442,41739777,55517259,13777482,CN
chr09,Bn40443,73752545,85642546,11890001,CNL
chr09,Bn40444,23602145,94593146,70991001,TN
chr09,Bn40445,47064073,89334199,42270126,TNL
chr09,Bn40446,90136079,99707288,9571209,RLK
chr09,Bn40447,58735283,83342159,24606876,CNL
chr09,Bn40448,97176248,99053811,1877563,CNL
chr09,Bn40449,80953397,92441624,11488227,TNL
chr09,Bn40450,23770753,74767250,50996497,RLP
chr09,Bn40451,73006453,86537684,13531231,RLK
chr09,Bn40452,76588480,97088335,20499855,RLK
chr09,Bn40453,60059849,69039330,8979481,RLP
chr09,Bn40454,48627594,89821176,41193582,TNL
chr09,Bn40455,74312968,79145820,4832852,TN
chr09,Bn40456,24797894,42901392,18103498,NBS
chr09,Bn40457,27576094,66604312,39028218,CNL
chr09,Bn40458,23811998,83270408,59458410,TN
chr09,Bn40459,6576540,15865640,9289100,RLK
chr09,Bn40460,49113281,64034259,14920978,CNL
chr09,Bn40461,56936242,84736948,27800706,TN
chr09,Bn40462,18839114,36304349,17465235,TN
chr09,Bn40463,95895416,98026909,2131493,RLP
chr09,Bn40464,62229415,81221576,18992161,CN
chr09,Bn40465,83364618,94838628,11474010,CNL
chr09,Bn40466,97240220,98510548,1270328,CN
chr09,Bn40467,70921029,89496291,18575262,TN
chr09,Bn40468,48629100,89950180,41321080,TNL
chr09,Bn40469,77733183,91141740,13408557,TNL
chr09,Bn40470,35394589,60806796,25412207,RLK
chr09,Bn40471,45476257,65183461,19707204,RLK
chr09,Bn40472,68813135,89478022,20664887,CN
chr09,Bn40473,58157342,59908352,1751010,CN
chr09,Bn40474,45602564,73157269,27554705,RLP
chr09,Bn40475,34526972,71223178,36696206,CNL
chr09,Bn40476,84152468,87005215,2852747,TNL
chr09,Bn40477,48993988,57811943,8817955,CNL
chr09,Bn40478,14919029,74873448,59954419,CNL
chr09,Bn40479,63915829,83763142,19847313,NBS
chr09,Bn40480,47033740,81033444,33999704,TN
chr09,Bn40481,45822020,88542720,42720700,TN
chr09,Bn40482,47854806,87793352,39938546,RLK
chr09,Bn40483,27918407,50848357,22929950,CN
chr09,Bn40484,21273969,38405532,17131563,RLK
chr09,Bn40485,82984802,86579886,3595084,RLK
chr09,Bn40486,2406081,96269688,93863607,TNL
chr09,Bn40487,46240316,73901817,27661501,CN
chr09,Bn40488,4844198,53110915,48266717,RLK
chr09,Bn40489,35073176,94690294,59617118,CN
chr09,Bn40490,5906563,8120325,2213762,RLP
chr09,Bn40491,47928876,81920959,33992083,RLP
chr09,Bn40492,99455008,99986514,531506,CN
chr09,Bn40493,91192901,98931710,7738809,RLP
chr09,Bn40494,57223214,63784599,6561385,CN
chr09,Bn40495,63610088,83438225,19828137,NBS
chr09,Bn40496,84193471,96733696,12540225,RLK
chr09,Bn40497,55845645,70032667,14187022,RLP
chr09,Bn40498,80334019,91922266,11588247,TNL
chr09,Bn40499,43241992,75410237,32168245,TNL
chr09,Bn40500,77718335,88677967,10959632,RLK
chr09,Bn40501,68027273,95953727,27926454,NBS
chr09,Bn40502,65780116,92218043,26437927,NBS
chr09,Bn40503,96398934,97118602,719668,NBS
chr09,Bn40504,51721837,76235734,24513897,TN
chr09,Bn40505,31933891,75878762,43944871,TNL
chr09,Bn40506,49471544,95137854,45666310,TN
chr09,Bn40507,99571907,99729403,157496,NBS
chr09,Bn40508,50020426,93784326,43763900,RLK
chr09,Bn40509,86428570,89790391,3361821,CN
chr09,Bn40510,23201076,98520687,75319611,TN
chr09,Bn40511,19313286,41051999,21738713,TN
chr09,Bn40512,37306851,65441069,28134218,CNL
chr09,Bn40513,7229209,93443719,86214510,NBS
chr09,Bn40514,78028863,99682976,21654113,TNL
chr09,Bn40515,32397508,64160402,31762894,CNL
chr09,Bn40516,71164246,99358834,28194588,TN
chr09,Bn40517,25823432,73704154,47880722,RLP
chr09,Bn40518,58733078,90708034,31974956,NBS
chr09,Bn40519,2235108,58953318,56718210,CNL
chr09,Bn40520,91412295,91437071,24776,RLP
chr09,Bn40521,7308298,89937251,82628953,TN
chr09,Bn40522,79374089,79790275,416186,RLK
chr09,Bn40523,2572096,17405539,14833443,NBS
chr09,Bn40524,92787957,96582888,3794931,TNL
chr09,Bn40525,63657752,77222963,13565211,TN
chr09,Bn40526,89752394,96134591,6382197,CN
chr09,Bn40527,35418706,43537670,8118964,TN
chr09,Bn40528,88211298,96994830,8783532,RLP
chr09,Bn40529,23518427,71491989,47973562,NBS
chr09,Bn40530,25692791,71916189,46223398,CNL
chr09,Bn40531,44139912,86481229,42341317,TNL
chr09,Bn40532,61430696,95198233,33767537,TN
chr09,Bn40533,6041566,57647976,51606410,NBS
chr09,Bn40534,68758841,85155519,16396678,NBS
chr09,Bn40535,81446755,83234966,1788211,RLK
chr09,Bn40536,52106700,81703555,29596855,RLP
chr09,Bn40537,44729749,80346144,35616395,CN
chr09,Bn40538,18304847,55450263,37145416,CNL
chr09,Bn40539,26396208,45611293,19215085,CNL
chr09,Bn40540,85706163,90692774,4986611,RLK
chr09,Bn40541,43575886,98077450,54501564,RLK
chr09,Bn40542,77904370,78908339,1003969,TN
chr09,Bn40543,82213774,88960230,6746456,CNL
chr09,Bn40544,14456271,44360305,29904034,TNL
chr09,Bn40545,43915864,89032731,45116867,CN
chr09,Bn40546,57974722,74494360,16519638,NBS
chr09,Bn40547,77971326,79414505,1443179,NBS
chr09,Bn40548,23694560,86839101,63144541,TN
chr09,Bn40549,29265663,34361009,5095346,TN
chr09,Bn40550,34653764,94443268,59789504,RLK
chr09,Bn40551,30640366,76973391,46333025,RLK
chr09,Bn40552,44434822,70446697,26011875,RLP
chr09,Bn40553,7142645,58616232,51473587,CNL
chr09,Bn40554,59320672,90386409,31065737,CN
chr09,Bn40555,24699405,54854160,30154755,NBS
chr09,Bn40556,13308049,80474848,67166799,TN
chr09,Bn40557,13396219,25766994,12370775,NBS
chr09,Bn40558,94157855,96134287,1976432,NBS
chr09,Bn40559,62436596,93407848,30971252,TNL
chr09,Bn40560,96029829,99118433,3088604,TNL
chr09,Bn40561,14821722,92107471,77285749,CN
chr09,Bn40562,99757303,99818527,61224,CNL
chr09,Bn40563,52984044,78190898,25206854,TN
chr09,Bn40564,63598961,90869302,27270341,RLK
chr09,Bn40565,83478520,97447904,13969384,NBS
chr09,Bn40566,7379498,64051178,56671680,CN
chr09,Bn40567,27100142,47641313,20541171,RLP
chr09,Bn40568,58196912,76081433,17884521,RLK
chr09,Bn40569,67963463,69327812,1364349,TNL
chr09,Bn40570,68650393,78464937,9814544,RLP
chr09,Bn40571,61417020,64356175,2939155,RLK
chr09,Bn40572,40822930,48532053,7709123,CNL
chr09,Bn40573,82732436,89468190,6735754,RLP
chr09,Bn40574,82572769,85675215,3102446,TNL
chr09,Bn40575,93165380,94963075,1797695,RLP
chr09,Bn40576,1095641,71794894,70699253,TN
chr09,Bn40577,74170761,92437684,18266923,RLP
chr09,Bn40578,83258293,95578155,12319862,RLP
chr09,Bn40579,5921937,12436617,6514680,RLP
chr09,Bn40580,37764902,46343631,8578729,TN
chr09,Bn40581,78483439,86526441,8043002,CN
chr09,Bn40582,30977419,91562907,60585488,CN
chr09,Bn40583,44697762,52483856,7786094,TNL
chr09,Bn40584,54441207,74540027,20098820,NBS
chr09,Bn40585,8135711,14965059,6829348,RLK
chr09,Bn40586,90510991,99540017,9029026,TN
chr09,Bn40587,92922853,93193057,270204,TNL
chr09,Bn40588,52060520,52204566,144046,RLK
chr09,Bn40589,12400110,27995602,15595492,TN
chr09,Bn40590,21084990,92959826,71874836,CNL
chr09,Bn40591,17272052,97619239,80347187,NBS
chr09,Bn40592,37424946,60441979,23017033,CN
chr09,Bn40593,33840743,77244497,43403754,NBS
chr09,Bn40594,45095598,48965571,3869973,CNL
chr09,Bn40595,35042901,80814543,45771642,RLK
chr09,Bn40596,61536705,74749852,13213147,TNL
chr09,Bn40597,92670671,95149085,2478414,CN
chr09,Bn40598,94626998,97659218,3032220,NBS
chr09,Bn40599,61460859,68314132,6853273,RLP
chr09,Bn40600,88707406,92168198,3460792,NBS
chr09,Bn40601,32877140,94477986,61600846,RLK
chr09,Bn40602,46235205,59239623,13004418,NBS
chr09,Bn40603,90517634,93044883,2527249,RLK
chr09,Bn40604,98338811,99361389,1022578,TN
chr09,Bn40605,50846461,51985278,1138817,RLK
chr09,Bn40606,99343971,99655713,311742,TNL
chr09,Bn40607,14975022,65961351,50986329,TNL
chr09,Bn40608,29940070,40127814,10187744,NBS
chr09,Bn40609,65725876,82562630,16836754,TN
chr09,Bn40610,6335069,8472449,2137380,NBS
chr09,Bn40611,31261350,80253628,48992278,TNL
chr09,Bn40612,43217660,69788130,26570470,NBS
chr09,Bn40613,41151981,81555666,40403685,RLP
chr09,Bn40614,58946005,72246635,13300630,TN
chr09,Bn40615,65656127,80557447,14901320,CNL
chr09,Bn40616,25491882,56613388,31121506,CNL
chr09,Bn40617,16598989,44546907,27947918,RLP
chr09,Bn40618,18471447,72280847,53809400,NBS
chr09,Bn40619,42965455,75896250,32930795,TN
chr09,Bn40620,42701424,89731982,47030558,RLP
chr09,Bn40621,13687648,80485982,66798334,RLK
chr09,Bn40622,57587848,77322529,19734681,TNL
chr09,Bn40623,75913596,90880308,14966712,CNL
chr09,Bn40624,1856877,13969916,12113039,RLK
chr09,Bn40625,58339928,88952865,30612937,CNL
chr09,Bn40626,38984898,47533265,8548367,RLP
chr09,Bn40627,49979131,63423703,13444572,CNL
chr09,Bn40628,24742235,74029844,49287609,TN
chr09,Bn40629,40667069,92794341,52127272,TN
chr09,Bn40630,80566301,90440028,9873727,CN
chr09,Bn40631,56833911,73167996,16334085,CNL
chr09,Bn40632,87752965,95608038,7855073,TNL
chr09,Bn40633,4745509,31570407,26824898,TNL
chr09,Bn40634,33795904,71155880,37359976,TN
chr09,Bn40635,18644065,24797470,6153405,CNL
chr09,Bn40636,29782985,96873580,67090595,RLP
chr09,Bn40637,49371548,92373051,43001503,RLP
chr09,Bn40638,76812573,77165619,353046,NBS
chr09,Bn40639,45224441,65299516,20075075,TNL
chr09,Bn40640,52227924,98531286,46303362,CN
chr09,Bn40641,81909272,89598847,7689575,CN
chr09,Bn40642,65776036,97837304,32061268,CN
chr09,Bn40643,54016348,89795422,35779074,RLK
chr09,Bn40644,73027746,95801845,22774099,NBS
chr09,Bn40645,70544477,72427844,1883367,RLK
chr09,Bn40646,28214001,43799676,15585675,CN
chr09,Bn40647,23196208,23531179,334971,RLP
chr09,Bn40648,34587993,96027870,61439877,NBS
chr09,Bn40649,54377266,88353600,33976334,RLP
chr09,Bn40650,4334172,8807954,4473782,CN
chr09,Bn40651,28102393,86445914,58343521,TN
chr09,Bn40652,54764123,70117075,15352952,CNL
chr09,Bn40653,85321812,93667640,8345828,TNL
chr09,Bn40654,27539999,32506194,4966195,TNL
chr09,Bn40655,10993676,22530704,11537028,CN
chr09,Bn40656,43975154,91592248,47617094,RLP
chr09,Bn40657,71309792,78925222,7615430,NBS
chr09,Bn40658,84618511,91250895,6632384,TN
chr09,Bn40659,47622120,88883545,41261425,CNL
chr09,Bn40660,10496552,98206063,87709511,RLP
chr09,Bn40661,44590233,47495993,2905760,RLK
chr09,Bn40662,7872878,80851748,72978870,RLP
chr09,Bn40663,84609998,85897411,1287413,TN
chr09,Bn40664,89465101,89581041,115940,TN
chr09,Bn40665,93697772,96849738,3151966,RLP
chr09,Bn40666,2360385,64775908,62415523,TNL
chr09,Bn40667,36177354,53052295,16874941,CNL
chr09,Bn40668,1348441,44748705,43400264,CNL
chr09,Bn40669,46928552,69068485,22139933,RLP
chr09,Bn40670,9726626,84000653,74274027,RLK
chr09,Bn40671,28741375,91705536,62964161,TNL
chr09,Bn40672,9910165,38523492,28613327,RLP
chr09,Bn40673,4573995,27804092,23230097,TN
chr09,Bn40674,39733605,45210183,5476578,RLP
chr09,Bn40675,1704767,93879445,92174678,CNL
chr09,Bn40676,38733938,72197440,33463502,RLP
chr09,Bn40677,5637555,48186873,42549318,RLK
chr09,Bn40678,60144277,68883316,8739039,CNL
chr09,Bn40679,97816931,97921446,104515,CNL
chr09,Bn40680,20796624,45142145,24345521,TNL
chr09,Bn40681,33951762,96671662,62719900,TNL
chr09,Bn40682,9291303,80543573,71252270,CN
chr09,Bn40683,84581443,92719399,8137956,NBS
chr09,Bn40684,46998791,65157264,18158473,CN
chr09,Bn40685,16811938,34208281,17396343,CNL
chr09,Bn40686,12182462,38485997,26303535,NBS
chr09,Bn40687,41891830,80369680,38477850,RLK
chr09,Bn40688,28800546,80307979,51507433,TNL
chr09,Bn40689,31116802,58678736,27561934,NBS
chr09,Bn40690,43999206,44584026,584820,CNL
chr09,Bn40691,87893933,94775966,6882033,TN
chr09,Bn40692,58475478,98387654,39912176,RLK
chr09,Bn40693,53185601,68915043,15729442,RLK
chr09,Bn40694,22867200,71677506,48810306,RLP
chr09,Bn40695,95575687,98934985,3359298,CNL
chr09,Bn40696,59255359,90489594,31234235,RLK
chr09,Bn40697,24280777,44405696,20124919,CNL
chr09,Bn40698,77613090,92483477,14870387,TN
chr09,Bn40699,77632291,87002072,9369781,NBS
chr09,Bn40700,21558225,63208889,41650664,CNL
chr09,Bn40701,88952986,95707927,6754941,CN
chr09,Bn40702,94622374,96571732,1949358,CNL
chr09,Bn40703,88303196,99614062,11310866,RLK
chr09,Bn40704,17203781,27180008,9976227,NBS
chr09,Bn40705,40575832,63180448,22604616,RLP
chr09,Bn40706,44373107,44379837,6730,TN
chr09,Bn40707,51279377,93742573,42463196,NBS
chr09,Bn40708,44639215,83035211,38395996,TNL
chr09,Bn40709,54446262,79628232,25181970,CN
chr09,Bn40710,34109543,43608114,9498571,TN
chr09,Bn40711,85239768,90147042,4907274,TN
chr09,Bn40712,66804847,80721109,13916262,TNL
chr09,Bn40713,32386391,89762119,57375728,TN
chr09,Bn40714,43051108,72384468,29333360,TN
chr09,Bn40715,55844481,78033856,22189375,TNL
chr09,Bn40716,14522477,25534653,11012176,TN
chr09,Bn40717,44627992,62333723,17705731,TNL
chr09,Bn40718,28071465,96852433,68780968,NBS
chr09,Bn40719,83428114,93359239,9931125,NBS
chr09,Bn40720,97419352,99950821,2531469,CN
chr09,Bn40721,83023588,99084448,16060860,NBS
chr09,Bn40722,93043568,98535567,5491999,TNL
chr09,Bn40723,24031687,78266480,54234793,TN
chr09,Bn40724,61451173,91543935,30092762,CN
chr09,Bn40725,77047433,95197513,18150080,RLK
chr09,Bn40726,43170839,75248639,32077800,TNL
chr09,Bn40727,7857846,80808008,72950162,TNL
chr09,Bn40728,79478140,98245630,18767490,TNL
chr09,Bn40729,93978743,94231862,253119,CNL
chr09,Bn40730,63779050,80036835,16257785,RLK
chr09,Bn40731,70011058,72255308,2244250,CN
chr09,Bn40732,84701639,89973439,5271800,CNL
chr09,Bn40733,62524509,70422907,7898398,TNL
chr09,Bn40734,10362295,46553221,36190926,RLP
chr09,Bn40735,43780078,45596414,1816336,TNL
chr09,Bn40736,2735428,76052400,73316972,TNL
chr09,Bn40737,80210455,88159840,7949385,CNL
chr09,Bn40738,81717637,85817233,4099596,CN
chr09,Bn40739,72586414,91200765,18614351,RLP
chr09,Bn40740,16329677,46131496,29801819,CN
chr09,Bn40741,33440845,90997018,57556173,TNL
chr09,Bn40742,85233931,86220299,986368,CNL
chr09,Bn40743,92318781,97420491,5101710,RLP
chr09,Bn40744,69404531,94796017,25391486,TNL
chr09,Bn40745,20551695,84688085,64136390,TN
chr09,Bn40746,35663853,57542685,21878832,RLK
chr09,Bn40747,10786547,21063101,10276554,TNL
chr09,Bn40748,93880947,96105668,2224721,RLK
chr09,Bn40749,58969550,70045045,11075495,RLP
chr09,Bn40750,31166992,92267315,61100323,RLP
chr09,Bn40751,81838032,87069763,5231731,CNL
chr09,Bn40752,29537522,96427005,66889483,TN
chr09,Bn40753,98679158,99089820,410662,NBS
chr09,Bn40754,45939701,57899842,11960141,RLP
chr09,Bn40755,59109877,83494068,24384191,NBS
chr09,Bn40756,96550930,97268693,717763,CNL
chr09,Bn40757,24638211,31064108,6425897,NBS
chr09,Bn40758,16976407,42315514,25339107,NBS
chr09,Bn40759,47675623,52147776,4472153,TN
chr09,Bn40760,4059260,45768920,41709660,TNL
chr09,Bn40761,29863867,44246696,14382829,TNL
chr09,Bn40762,93266700,96232819,2966119,CNL
chr09,Bn40763,71876439,75576464,3700025,NBS
chr09,Bn40764,41438152,68530841,27092689,RLK
chr09,Bn40765,36936132,49164879,12228747,TNL
chr09,Bn40766,59051452,96539467,37488015,TNL
chr09,Bn40767,26981599,93029883,66048284,CNL
chr09,Bn40768,88149840,89074609,924769,CNL
chr09,Bn40769,58977430,97790381,38812951,TNL
chr09,Bn40770,50189362,89703221,39513859,CN
chr09,Bn40771,70822165,71324363,502198,CN
chr09,Bn40772,80666162,93218788,12552626,CN
chr09,Bn40773,81682495,94952473,13269978,RLP
chr09,Bn40774,68244112,89214928,20970816,RLK
chr09,Bn40775,48039484,67876584,19837100,TN
chr09,Bn40776,98305811,98877401,571590,CNL
chr09,Bn40777,23604066,83958540,60354474,RLP
chr09,Bn40778,34522505,44898244,10375739,TN
chr09,Bn40779,46352484,89346205,42993721,RLK
chr09,Bn40780,10079386,27672848,17593462,NBS
chr09,Bn40781,25584941,91919051,66334110,RLK
chr09,Bn40782,70711965,94872655,24160690,NBS
chr09,Bn40783,44265830,86692880,42427050,RLK
chr09,Bn40784,93604715,98597082,4992367,TNL
chr09,Bn40785,81371025,82964878,1593853,CNL
chr09,Bn40786,78092026,90177964,12085938,RLK
chr09,Bn40787,52294073,75563270,23269197,TNL
chr09,Bn40788,67070761,98522939,31452178,RLP
chr09,Bn40789,85327748,95145363,9817615,RLK
chr09,Bn40790,35754536,56689023,20934487,CNL
chr09,Bn40791,59656644,94289129,34632485,TN
chr09,Bn40792,6842628,73157924,66315296,TN
chr09,Bn40793,94127745,96755533,2627788,CNL
chr09,Bn40794,83756039,92435160,8679121,TN
chr09,Bn40795,41592961,58986452,17393491,RLP
chr09,Bn40796,91582829,91601116,18287,RLK
chr09,Bn40797,62257914,71092007,8834093,RLP
chr09,Bn40798,8169963,32419975,24250012,CNL
chr09,Bn40799,90778994,95664632,4885638,CN
chr09,Bn40800,77105862,91819954,14714092,TN
chr09,Bn40801,98269423,98500213,230790,RLK
chr09,Bn40802,23624019,53858286,30234267,RLP
chr09,Bn40803,1451230,97353054,95901824,CN
chr09,Bn40804,33450467,35468771,2018304,CN
chr09,Bn40805,49963804,90826786,40862982,TN
chr09,Bn40806,93318491,99638068,6319577,CNL
chr09,Bn40807,47491649,98985765,51494116,RLK
chr09,Bn40808,21054307,78233895,57179588,NBS
chr09,Bn40809,39078569,42717291,3638722,NBS
chr09,Bn40810,86108632,93038364,6929732,CN
chr09,Bn40811,32346826,57001041,24654215,CN
chr09,Bn40812,61927033,63095602,1168569,RLP
chr09,Bn40813,27166808,45106961,17940153,CNL
chr09,Bn40814,7148622,61181518,54032896,CN
chr09,Bn40815,94901514,98511760,3610246,RLP
chr09,Bn40816,18626439,47161882,28535443,CN
chr09,Bn40817,13037698,35042524,22004826,NBS
chr09,Bn40818,19470495,88505751,69035256,TNL
chr09,Bn40819,36452457,50493564,14041107,TN
chr09,Bn40820,77329738,94790780,17461042,NBS
chr09,Bn40821,9286489,14453469,5166980,NBS
chr09,Bn40822,66796119,69842470,3046351,CNL
chr09,Bn40823,56133697,80375476,24241779,TN
chr09,Bn40824,53305835,94541520,41235685,TN
chr09,Bn40825,22121007,27304804,5183797,CNL
chr09,Bn40826,24759603,53756123,28996520,RLP
chr09,Bn40827,4603555,47559476,42955921,RLP
chr09,Bn40828,84157082,86957699,2800617,TN
chr09,Bn40829,51579675,71961758,20382083,TN
chr09,Bn40830,33969923,96337112,62367189,CNL
chr09,Bn40831,69306289,88351586,19045297,CNL
chr09,Bn40832,86801385,92168763,5367378,CN
chr09,Bn40833,45855362,96554531,50699169,TN
chr09,Bn40834,32165074,78039517,45874443,CN
chr09,Bn40835,55880272,73971680,18091408,TN
chr09,Bn40836,68961804,82227108,13265304,RLP
chr09,Bn40837,94153302,99810796,5657494,TN
chr09,Bn40838,28982908,49073413,20090505,TNL
chr09,Bn40839,69313654,89274912,19961258,CN
chr09,Bn40840,8174663,40019970,31845307,TN
chr09,Bn40841,93494631,94217623,722992,CN
chr09,Bn40842,87544723,96147109,8602386,RLP
chr09,Bn40843,21719934,98574570,76854636,RLP
chr09,Bn40844,27266741,91646121,64379380,NBS
chr09,Bn40845,93847242,98989194,5141952,RLK
chr09,Bn40846,59150395,88097869,28947474,TNL
chr09,Bn40847,32954802,51018309,18063507,NBS
chr09,Bn40848,91478697,94984469,3505772,NBS
chr09,Bn40849,49597723,55099082,5501359,TNL
chr09,Bn40850,46659129,53060830,6401701,TNL
chr09,Bn40851,81770718,88394335,6623617,TNL
chr09,Bn40852,17791843,98340730,80548887,RLK
chr09,Bn40853,78710062,88197707,9487645,CNL
chr09,Bn40854,98810907,99052534,241627,RLK
chr09,Bn40855,11084098,70028203,58944105,NBS
chr09,Bn40856,86475994,96570860,10094866,NBS
chr09,Bn40857,15327126,32239577,16912451,RLP
chr09,Bn40858,70669608,85817171,15147563,CN
chr09,Bn40859,93414927,98362738,4947811,TNL
chr09,Bn40860,73699823,91047139,17347316,TN
chr09,Bn40861,21518471,76714524,55196053,TN
chr09,Bn40862,9080286,30492780,21412494,TN
chr09,Bn40863,57794220,91225197,33430977,CN
chr09,Bn40864,88422433,89318294,895861,RLP
chr09,Bn40865,80816938,84541444,3724506,NBS
chr09,Bn40866,2942570,20546095,17603525,TNL
chr09,Bn40867,13942719,63901979,49959260,CNL
chr09,Bn40868,87142799,96004161,8861362,NBS
chr09,Bn40869,18960374,81406508,62446134,CN
chr09,Bn40870,44751931,90935236,46183305,TN
chr09,Bn40871,45236682,56376867,11140185,CN
chr09,Bn40872,15460101,64134635,48674534,TNL
chr09,Bn40873,21280295,22869573,1589278,NBS
chr09,Bn40874,14086645,23252023,9165378,TN
chr09,Bn40875,55478258,77796324,22318066,RLP
chr09,Bn40876,13202535,61821764,48619229,RLK
chr09,Bn40877,59955121,68185520,8230399,RLK
chr09,Bn40878,43247789,90870341,47622552,CNL
chr09,Bn40879,47777715,74816809,27039094,CNL
chr09,Bn40880,64935102,68815732,3880630,RLK
chr09,Bn40881,19331500,23054520,3723020,CN
chr09,Bn40882,6417097,25073611,18656514,CNL
chr09,Bn40883,32513396,82946219,50432823,NBS
chr09,Bn40884,21378214,78703788,57325574,NBS
chr09,Bn40885,14071538,48935878,34864340,RLK
chr09,Bn40886,21548501,90229513,68681012,CN
chr09,Bn40887,31466428,65800025,34333597,RLK
chr09,Bn40888,53738096,84151072,30412976,TN
chr09,Bn40889,65253920,81090513,15836593,CNL
chr09,Bn40890,23408788,38408863,15000075,RLK
chr09,Bn40891,12602153,35486594,22884441,RLP
chr09,Bn40892,61165804,82763972,21598168,NBS
chr09,Bn40893,4560669,97741173,93180504,TN
chr09,Bn40894,18342511,41701345,23358834,CN
chr09,Bn40895,23367180,37364468,13997288,CNL
chr09,Bn40896,54178001,95007594,40829593,TN
chr09,Bn40897,23495138,39631832,16136694,CN
chr09,Bn40898,23498377,42755445,19257068,RLK
chr09,Bn40899,33164712,77194253,44029541,NBS
chr09,Bn40900,52617746,88784206,36166460,CNL
chr09,Bn40901,64599719,96528888,31929169,RLP
chr09,Bn40902,2120424,15344226,13223802,TN
chr09,Bn40903,36410452,82354751,45944299,TNL
chr09,Bn40904,37828652,46222558,8393906,CN
chr09,Bn40905,45271804,75473053,30201249,TNL
chr09,Bn40906,78168275,97327546,19159271,TNL
chr09,Bn40907,28133458,83977040,55843582,TNL
chr09,Bn40908,50535089,52836473,2301384,TNL
chr09,Bn40909,80019639,83771044,3751405,TN
chr09,Bn40910,86875181,96157819,9282638,RLK
chr09,Bn40911,15197481,83270456,68072975,RLP
chr09,Bn40912,11550075,69791002,58240927,NBS
chr09,Bn40913,47009418,85059780,38050362,CN
chr09,Bn40914,10000890,19580827,9579937,TN
chr09,Bn40915,23325406,32383501,9058095,CNL
chr09,Bn40916,32871027,83185820,50314793,RLK
chr09,Bn40917,67142153,76514612,9372459,NBS
chr09,Bn40918,1286059,59430610,58144551,NBS
chr09,Bn40919,6574082,80229549,73655467,CN
chr09,Bn40920,57803884,84131644,26327760,CNL
chr09,Bn40921,77670751,84527355,6856604,TNL
chr09,Bn40922,2140974,67540181,65399207,CNL
chr09,Bn40923,48773380,80064262,31290882,RLP
chr09,Bn40924,13160156,24066969,10906813,NBS
chr09,Bn40925,67753004,69236239,1483235,RLK
chr09,Bn40926,60696657,78031664,17335007,RLK
chr09,Bn40927,52128895,84437397,32308502,NBS
chr09,Bn40928,59224583,71970404,12745821,TN
chr09,Bn40929,80766250,82523233,1756983,TN
chr09,Bn40930,91344451,97505833,6161382,TNL
chr09,Bn40931,36486597,53574230,17087633,TN
chr09,Bn40932,45934849,89654884,43720035,RLP
chr09,Bn40933,7101726,65207483,58105757,TNL
chr09,Bn40934,70913430,72392313,1478883,CNL
chr09,Bn40935,12617208,99475143,86857935,RLP
chr09,Bn40936,74466059,98615483,24149424,CNL
chr09,Bn40937,54718666,89691050,34972384,CN
chr09,Bn40938,30476781,42971228,12494447,TN
chr09,Bn40939,59220920,67525191,8304271,TN
chr09,Bn40940,85483894,86665608,1181714,RLP
chr09,Bn40941,7675529,8576228,900699,RLK
chr09,Bn40942,25971353,95876991,69905638,NBS
chr09,Bn40943,15885298,20179776,4294478,CN
chr09,Bn40944,15092575,20858635,5766060,CN
chr09,Bn40945,23675169,90138984,66463815,RLP
chr09,Bn40946,83373683,97103418,13729735,TNL
chr09,Bn40947,15542859,99208135,83665276,TNL
chr09,Bn40948,10846155,31573856,20727701,CN
chr09,Bn40949,59657218,88060098,28402880,NBS
chr09,Bn40950,96192004,98914080,2722076,NBS
chr09,Bn40951,11587194,22990943,11403749,CN
chr09,Bn40952,84582664,99786466,15203802,RLK
chr09,Bn40953,93281664,97646268,4364604,RLP
chr09,Bn40954,77120969,96174273,19053304,CN
chr09,Bn40955,75445604,82104911,6659307,NBS
chr09,Bn40956,95662178,99150429,3488251,CN
chr09,Bn40957,29784310,61244281,31459971,RLK
chr09,Bn40958,18865562,60417656,41552094,TN
chr09,Bn40959,65655239,86652174,20996935,CN
chr09,Bn40960,45377014,76315995,30938981,TNL
chr09,Bn40961,29514562,54126694,24612132,TNL
chr09,Bn40962,87164673,91454703,4290030,CNL
chr09,Bn40963,15397506,63581988,48184482,CN
chr09,Bn40964,3803726,29716885,25913159,RLP
chr09,Bn40965,94722495,98569062,3846567,TN
chr09,Bn40966,48989249,75413675,26424426,TN
chr09,Bn40967,80888728,89737067,8848339,RLP
chr09,Bn40968,97967961,99326013,1358052,TNL
chr09,Bn40969,82251102,95466742,13215640,TN
chr09,Bn40970,53975098,56985438,3010340,CN
chr09,Bn40971,89175448,92061882,2886434,TNL
chr09,Bn40972,29630568,49915742,20285174,RLK
chr09,Bn40973,88462690,90954098,2491408,NBS
chr09,Bn40974,23422409,95627999,72205590,TNL
chr09,Bn40975,44405052,50957803,6552751,CN
chr09,Bn40976,65453611,83776338,18322727,TN
chr09,Bn40977,73728013,81587768,7859755,RLP
chr09,Bn40978,55967717,79742452,23774735,TNL
chr09,Bn40979,39312980,89681592,50368612,RLP
chr09,Bn40980,60679873,78555860,17875987,NBS
chr09,Bn40981,30017327,59185421,29168094,TNL
chr09,Bn40982,27237966,91802391,64564425,RLK
chr09,Bn40983,15795383,43262819,27467436,CN
chr09,Bn40984,20498199,86677017,66178818,CN
chr09,Bn40985,47626341,54581454,6955113,NBS
chr09,Bn40986,92007166,99630714,7623548,NBS
chr09,Bn40987,65642568,81420570,15778002,CN
chr09,Bn40988,27844623,31053357,3208734,TN
chr09,Bn40989,98308922,98909145,600223,CN
chr09,Bn40990,17055720,18582082,1526362,TNL
chr09,Bn40991,3903497,17390081,13486584,NBS
chr09,Bn40992,27522859,42988543,15465684,TNL
chr09,Bn40993,42688859,84662389,41973530,RLP
chr09,Bn40994,94814890,99364882,4549992,NBS
chr09,Bn40995,16162984,92028960,75865976,CN
chr09,Bn40996,18491470,33788143,15296673,CN
chr09,Bn40997,28231765,78004893,49773128,CNL
chr09,Bn40998,13426538,75375914,61949376,RLK
chr09,Bn40999,27194540,84518078,57323538,CN
chr09,Bn41000,1320931,98045808,96724877,CN
chr09,Bn41001,36494825,92951861,56457036,CNL
chr09,Bn41002,79904900,81590449,1685549,CNL
chr09,Bn41003,82044755,87960059,5915304,NBS
chr09,Bn41004,35948063,85443277,49495214,TN
chr09,Bn41005,88706945,90344295,1637350,TNL
chr09,Bn41006,99495802,99659524,163722,TN
chr09,Bn41007,34731334,97649096,62917762,TN
chr09,Bn41008,31299642,93127661,61828019,CN
chr09,Bn41009,34503935,85367856,50863921,CN
chr09,Bn41010,57787866,57831958,44092,RLP
chr09,Bn41011,60332529,67852422,7519893,RLP
chr09,Bn41012,89102394,89505490,403096,TNL
chr09,Bn41013,69328977,98032913,28703936,TNL
chr09,Bn41014,59857596,65306473,5448877,RLP
chr09,Bn41015,85764356,99999937,14235581,RLK
chr09,Bn41016,40397982,58116791,17718809,CNL
chr09,Bn41017,78873582,80351975,1478393,CNL
chr09,Bn41018,71511388,79607446,8096058,RLK
chr09,Bn41019,69979828,81346852,11367024,TNL
chr09,Bn41020,82751311,90061162,7309851,TN
chr09,Bn41021,50320614,51982904,1662290,TNL
chr09,Bn41022,65478204,99986140,34507936,TN
chr09,Bn41023,96289608,98484057,2194449,RLP
chr09,Bn41024,16522913,72073596,55550683,CN
chr09,Bn41025,72340945,90574689,18233744,CN
chr09,Bn41026,90151229,94095437,3944208,NBS
chr09,Bn41027,42295692,50173396,7877704,NBS
chr09,Bn41028,40656245,82759402,42103157,RLP
chr09,Bn41029,70193707,72855855,2662148,TNL
chr09,Bn41030,25965241,87189042,61223801,RLP
chr09,Bn41031,23196738,68446934,45250196,CNL
chr09,Bn41032,41137328,42653973,1516645,TNL
chr09,Bn41033,52869018,55992016,3122998,CNL
chr09,Bn41034,70386273,92639950,22253677,TNL
chr09,Bn41035,80965217,95903994,14938777,RLP
chr09,Bn41036,37534998,97518134,59983136,TNL
chr09,Bn41037,83380386,97742440,14362054,CNL
chr09,Bn41038,40379576,78279427,37899851,TNL
chr09,Bn41039,10091896,98361848,88269952,CN
chr09,Bn41040,46689023,76775976,30086953,CNL
chr09,Bn41041,11871017,95284931,83413914,TN
chr09,Bn41042,33927664,55531370,21603706,TN
chr09,Bn41043,93637027,99193667,5556640,TNL
chr09,Bn41044,5226981,67574338,62347357,TN
chr09,Bn41045,29151167,37330361,8179194,TN
chr09,Bn41046,16893415,56457177,39563762,TNL
chr09,Bn41047,13619884,15309832,1689948,TN
chr09,Bn41048,24481284,67037323,42556039,TN
chr09,Bn41049,43990714,46472241,2481527,RLP
chr09,Bn41050,60213037,81184761,20971724,TNL
chr09,Bn41051,64402327,71059967,6657640,RLP
chr09,Bn41052,81315335,99152308,17836973,CNL
chr09,Bn41053,69057862,95566802,26508940,NBS
chr09,Bn41054,84587893,96777845,12189952,NBS
chr09,Bn41055,73895920,75761011,1865091,RLK
chr09,Bn41056,65540021,76248931,10708910,CN
chr09,Bn41057,58817774,87611807,28794033,CN
chr09,Bn41058,85513245,98657060,13143815,CNL
chr09,Bn41059,31018335,79515931,48497596,TNL
chr09,Bn41060,39925311,40174575,249264,TNL
chr09,Bn41061,55060907,99575296,44514389,CN
chr09,Bn41062,44431904,93333599,48901695,TN
chr09,Bn41063,60461513,78207470,17745957,RLP
chr09,Bn41064,67858490,98376238,30517748,TNL
chr09,Bn41065,71869657,73768438,1898781,TNL
chr09,Bn41066,63563623,98500779,34937156,NBS
chr09,Bn41067,62143992,73774816,11630824,NBS
chr09,Bn41068,89446716,93751065,4304349,CNL
chr09,Bn41069,72894908,79448868,6553960,CNL
chr09,Bn41070,24074847,40741201,16666354,NBS
chr09,Bn41071,87959417,94666095,6706678,RLK
chr09,Bn41072,8355251,8404350,49099,RLP
chr09,Bn41073,36339354,63697053,27357699,RLK
chr09,Bn41074,35515319,97752118,62236799,NBS
chr09,Bn41075,87657593,89562427,1904834,TN
chr09,Bn41076,85539565,91127679,5588114,CN
chr09,Bn41077,35711708,76398869,40687161,RLP
chr09,Bn41078,8167868,69911376,61743508,CN
chr09,Bn41079,24250606,42291654,18041048,TN
chr09,Bn41080,38219529,86237149,48017620,CN
chr09,Bn41081,72475962,85719165,13243203,RLK
chr09,Bn41082,70034963,81842693,11807730,RLP
chr09,Bn41083,68511123,91079413,22568290,NBS
chr09,Bn41084,16004103,80985020,64980917,CNL
chr09,Bn41085,20964824,43522155,22557331,TNL
chr09,Bn41086,49136474,88634585,39498111,RLK
chr09,Bn41087,15743625,17000387,1256762,TN
chr09,Bn41088,94586564,99278530,4691966,RLK
chr09,Bn41089,3193777,91944442,88750665,CNL
chr09,Bn41090,6262871,60793355,54530484,RLP
chr09,Bn41091,55113475,61191855,6078380,RLP
chr09,Bn41092,38213236,89427237,51214001,NBS
chr09,Bn41093,64317747,99630364,35312617,NBS
chr09,Bn41094,89410199,90362691,952492,RLK
chr09,Bn41095,82267338,99863590,17596252,RLP
chr09,Bn41096,82544636,89054432,6509796,RLK
chr09,Bn41097,63110725,95428030,32317305,CNL
chr09,Bn41098,93064717,96215986,3151269,RLP
chr09,Bn41099,38110832,86081010,47970178,CNL
chr09,Bn41100,60455825,83430360,22974535,NBS
chr09,Bn41101,23322039,88946584,65624545,RLK
chr09,Bn41102,47166440,56039955,8873515,CNL
chr09,Bn41103,60296303,74260936,13964633,TNL
chr09,Bn41104,57269693,84393302,27123609,RLP
chr09,Bn41105,95888880,98438729,2549849,RLP
chr09,Bn41106,60108543,67573181,7464638,NBS
chr09,Bn41107,14284534,74301226,60016692,RLP
chr09,Bn41108,61689409,76014076,14324667,CN
chr09,Bn41109,73184973,73649547,464574,NBS
chr09,Bn41110,87514693,99126928,11612235,TN
chr09,Bn41111,35107578,44010911,8903333,NBS
chr09,Bn41112,24669059,53250677,28581618,CNL
chr09,Bn41113,99333609,99753337,419728,TN
chr09,Bn41114,9603197,83453382,73850185,RLP
chr09,Bn41115,8461181,33411792,24950611,CNL
chr09,Bn41116,60971444,63290903,2319459,TN
chr09,Bn41117,73795550,76209557,2414007,TNL
chr09,Bn41118,57865366,80286114,22420748,RLK
chr09,Bn41119,48239134,60944115,12704981,CNL
chr09,Bn41120,40466661,89230464,48763803,NBS
chr09,Bn41121,93173744,94626728,1452984,CNL
chr09,Bn41122,27387878,96071968,68684090,NBS
chr09,Bn41123,42211849,80021385,37809536,RLP
chr09,Bn41124,58284782,61086358,2801576,NBS
chr09,Bn41125,44065787,64794782,20728995,TN
chr09,Bn41126,69378300,75348680,5970380,TNL
chr09,Bn41127,47446938,85143695,37696757,CN
chr09,Bn41128,3875319,95233964,91358645,RLK
chr09,Bn41129,82129467,93342483,11213016,CNL
chr09,Bn41130,48605403,72082613,23477210,RLK
chr09,Bn41131,85925698,97859295,11933597,TNL
chr09,Bn41132,31514867,82301497,50786630,RLP
chr09,Bn41133,75585444,97825217,22239773,CNL
chr09,Bn41134,59056506,83293297,24236791,NBS
chr09,Bn41135,36708745,82898762,46190017,RLP
chr09,Bn41136,13878122,40350664,26472542,NBS
chr09,Bn41137,57581106,83433762,25852656,CNL
chr09,Bn41138,8946576,54827309,45880733,TN
chr09,Bn41139,74305348,91807316,17501968,CNL
chr09,Bn41140,38617313,94865598,56248285,TN
chr09,Bn41141,79853484,96735095,16881611,CNL
chr09,Bn41142,93612368,95401083,1788715,RLP
chr09,Bn41143,69190707,72288537,3097830,NBS
chr09,Bn41144,30108831,88751500,58642669,CNL
chr09,Bn41145,29769164,86367928,56598764,TNL
chr09,Bn41146,97834665,98979241,1144576,CNL
chr09,Bn41147,89327925,93758191,4430266,CNL
chr09,Bn41148,96037408,97809737,1772329,CN
chr09,Bn41149,9136293,91394846,82258553,TN
chr09,Bn41150,47028116,54174130,7146014,TN
chr09,Bn41151,53386532,94672729,41286197,TN
chr09,Bn41152,64030992,83120407,19089415,CN
chr09,Bn41153,33409850,57795683,24385833,NBS
chr09,Bn41154,44411877,81187989,36776112,NBS
chr09,Bn41155,37426343,63031820,25605477,TN
chr09,Bn41156,42207371,81396723,39189352,TNL
chr09,Bn41157,57007605,92363935,35356330,TNL
chr09,Bn41158,39241655,70033399,30791744,CNL
chr09,Bn41159,56258201,78206050,21947849,NBS
chr09,Bn41160,39002617,46077866,7075249,TNL
chr09,Bn41161,96152137,99585019,3432882,TN
chr09,Bn41162,38967825,92682772,53714947,TN
chr09,Bn41163,45183905,49420179,4236274,RLK
chr09,Bn41164,54092309,79228543,25136234,RLK
chr09,Bn41165,94181426,95878398,1696972,CNL
chr09,Bn41166,3260775,49376445,46115670,RLP
chr09,Bn41167,18999996,95568837,76568841,TNL
chr09,Bn41168,18222902,25668268,7445366,RLP
chr09,Bn41169,20457444,72253093,51795649,RLP
chr09,Bn41170,76040545,95134230,19093685,CN
chr09,Bn41171,26325615,36959426,10633811,TNL
chr09,Bn41172,57365983,89562561,32196578,RLK
chr09,Bn41173,20797286,64734710,43937424,CNL
chr09,Bn41174,25220126,44163379,18943253,TN
chr09,Bn41175,87043455,92908816,5865361,NBS
chr09,Bn41176,53256155,73105465,19849310,RLP
chr09,Bn41177,71128165,80569236,9441071,CN
chr09,Bn41178,62444604,71460429,9015825,CN
chr09,Bn41179,86348779,88560017,2211238,CN
chr09,Bn41180,37584859,76289125,38704266,TNL
chr09,Bn41181,61333302,62489088,1155786,CNL
chr09,Bn41182,63051412,99239509,36188097,TNL
chr09,Bn41183,39612804,93979868,54367064,NBS
chr09,Bn41184,51273593,56645434,5371841,TN
chr09,Bn41185,6721819,23891521,17169702,TNL
chr09,Bn41186,29525868,33154960,3629092,RLK
chr09,Bn41187,59899088,84610522,24711434,TN
chr09,Bn41188,91664844,95103222,3438378,TNL
chr09,Bn41189,76228700,97161379,20932679,CN
chr09,Bn41190,11471922,65985878,54513956,RLP
chr09,Bn41191,7745693,96659888,88914195,TNL
chr09,Bn41192,29954866,50961477,21006611,RLP
chr09,Bn41193,38861518,85161390,46299872,RLK
chr09,Bn41194,32447394,68898097,36450703,NBS
chr09,Bn41195,6968411,20015678,13047267,TNL
chr09,Bn41196,24385679,82854555,58468876,NBS
chr09,Bn41197,93025251,98842296,5817045,TNL
chr09,Bn41198,39720179,65341501,25621322,RLK
chr09,Bn41199,67779187,86863944,19084757,CNL
chr09,Bn41200,89629588,98072057,8442469,TNL
chr09,Bn41201,99020312,99403697,383385,CNL
chr09,Bn41202,29990755,62686029,32695274,CN
chr09,Bn41203,33201359,62240047,29038688,RLK
chr09,Bn41204,19367907,45420241,26052334,RLP
chr09,Bn41205,9713747,30946887,21233140,CN
chr09,Bn41206,14039463,21016502,6977039,RLP
chr09,Bn41207,1990645,19696401,17705756,TNL
chr09,Bn41208,8402533,95853188,87450655,NBS
chr09,Bn41209,67834618,70134862,2300244,CNL
chr09,Bn41210,83200333,92306611,9106278,CNL
chr09,Bn41211,25166348,50629999,25463651,TN
chr09,Bn41212,44277854,48651810,4373956,NBS
chr09,Bn41213,39356398,83001684,43645286,CN
chr09,Bn41214,2151084,84490404,82339320,RLP
chr09,Bn41215,32505245,79033546,46528301,CN
chr09,Bn41216,19245703,20924218,1678515,RLK
chr09,Bn41217,27629655,87473683,59844028,TNL
chr09,Bn41218,17563560,99967880,82404320,NBS
chr09,Bn41219,77029724,92942960,15913236,RLK
chr09,Bn41220,84923526,90218899,5295373,RLP
chr09,Bn41221,9317149,92016696,82699547,NBS
chr09,Bn41222,48423405,68833187,20409782,RLP
chr09,Bn41223,5550624,20900250,15349626,TNL
chr09,Bn41224,25934889,71043778,45108889,TNL
chr09,Bn41225,4747151,32797559,28050408,CN
chr09,Bn41226,79975266,97494731,17519465,NBS
chr09,Bn41227,40609178,85191503,44582325,RLK
chr09,Bn41228,64892144,98342711,33450567,RLP
chr09,Bn41229,30249142,67073944,36824802,TNL
chr09,Bn41230,76922410,77545414,623004,TNL
chr09,Bn41231,32982548,78554518,45571970,TN
chr09,Bn41232,97010447,97788515,778068,CNL
chr09,Bn41233,84431112,86923870,2492758,CN
chr09,Bn41234,14449482,92863614,78414132,NBS
chr09,Bn41235,99376795,99818362,441567,TNL
chr09,Bn41236,47529159,74031766,26502607,NBS
chr09,Bn41237,91893068,96272778,4379710,CNL
chr09,Bn41238,92406324,94240206,1833882,RLP
chr09,Bn41239,58806925,98352400,39545475,RLP
chr09,Bn41240,67056255,78884542,11828287,CNL
chr09,Bn41241,61473304,70459870,8986566,RLK
chr09,Bn41242,68929589,80869832,11940243,CN
chr09,Bn41243,7057166,31089560,24032394,CN
chr09,Bn41244,78599717,97502032,18902315,NBS
chr09,Bn41245,93521615,96931974,3410359,RLP
chr09,Bn41246,47681277,99872878,52191601,TN
chr09,Bn41247,42646484,67302327,24655843,TNL
chr09,Bn41248,12978903,95309614,82330711,RLP
chr09,Bn41249,1156628,73550195,72393567,CNL
chr09,Bn41250,65544928,90425915,24880987,RLK
chr10,Bn41251,2343170,48762309,46419139,CN
chr10,Bn41252,93538555,98009737,4471182,TNL
chr10,Bn41253,98196849,99388691,1191842,TN
chr10,Bn41254,82415442,99014517,16599075,CN
chr10,Bn41255,50481790,76517278,26035488,TN
chr10,Bn41256,13428344,91858476,78430132,NBS
chr10,Bn41257,25223895,54376879,29152984,TN
chr10,Bn41258,94622058,98049018,3426960,RLK
chr10,Bn41259,32274106,50433406,18159300,TNL
chr10,Bn41260,80636230,91475900,10839670,CN
chr10,Bn41261,51736289,87328895,35592606,TN
chr10,Bn41262,52528815,73477340,20948525,NBS
chr10,Bn41263,60564150,91662634,31098484,RLK
chr10,Bn41264,83674336,87933777,4259441,TN
chr10,Bn41265,47286991,92713191,45426200,CNL
chr10,Bn41266,88534931,96198772,7663841,CN
chr10,Bn41267,17832245,39597536,21765291,RLP
chr10,Bn41268,45496297,63980088,18483791,RLP
chr10,Bn41269,32545603,98690200,66144597,TNL
chr10,Bn41270,95103784,97691155,2587371,TN
chr10,Bn41271,26182830,54572807,28389977,NBS
chr10,Bn41272,56930566,72556922,15626356,NBS
chr10,Bn41273,39798200,48874233,9076033,TN
chr10,Bn41274,42997432,98845860,55848428,TN
chr10,Bn41275,28570157,61745629,33175472,RLP
chr10,Bn41276,95238813,95468256,229443,RLP
chr10,Bn41277,53873104,88758782,34885678,RLK
chr10,Bn41278,30501282,48011128,17509846,TNL
chr10,Bn41279,3819175,67287940,63468765,RLP
chr10,Bn41280,17918992,62004708,44085716,NBS
chr10,Bn41281,39090998,67253081,28162083,CNL
chr10,Bn41282,33645198,40623271,6978073,TNL
chr10,Bn41283,34762494,98527605,63765111,CN
chr10,Bn41284,77371576,91230661,13859085,CN
chr10,Bn41285,38673090,38748547,75457,TNL
chr10,Bn41286,83197891,97639336,14441445,TNL
chr10,Bn41287,62716979,78439281,15722302,RLK
chr10,Bn41288,42878112,56121770,13243658,RLK
chr10,Bn41289,15053533,85664179,70610646,TNL
chr10,Bn41290,75557729,98939325,23381596,RLK
chr10,Bn41291,9853320,57054029,47200709,TNL
chr10,Bn41292,28196040,64250912,36054872,CN
chr10,Bn41293,39373776,82961404,43587628,CNL
chr10,Bn41294,52446539,55613334,3166795,CNL
chr10,Bn41295,18899897,89750653,70850756,RLK
chr10,Bn41296,1601342,29782314,28180972,CN
chr10,Bn41297,60235265,63759563,3524298,NBS
chr10,Bn41298,22171957,73825556,51653599,RLK
chr10,Bn41299,74011448,74996836,985388,TNL
chr10,Bn41300,82497390,90517871,8020481,CNL
chr10,Bn41301,16004642,79490860,63486218,TNL
chr10,Bn41302,47564907,84613879,37048972,RLK
chr10,Bn41303,11659278,57462345,45803067,RLP
chr10,Bn41304,57334856,82096037,24761181,CN
chr10,Bn41305,60946726,86899327,25952601,RLP
chr10,Bn41306,54620992,80572504,25951512,NBS
chr10,Bn41307,50920071,86714653,35794582,NBS
chr10,Bn41308,71896872,79454458,7557586,RLK
chr10,Bn41309,69020329,71468739,2448410,RLP
chr10,Bn41310,63874917,77489059,13614142,CNL
chr10,Bn41311,74453266,91861367,17408101,RLP
chr10,Bn41312,18083487,49259020,31175533,RLP
chr10,Bn41313,2881773,16568344,13686571,CN
chr10,Bn41314,98406162,98812070,405908,CN
chr10,Bn41315,21309971,46570641,25260670,NBS
chr10,Bn41316,18597004,93654762,75057758,RLP
chr10,Bn41317,81263412,93947838,12684426,NBS
chr10,Bn41318,45299563,54001483,8701920,TNL
chr10,Bn41319,61959771,98563161,36603390,RLK
chr10,Bn41320,20716044,95519036,74802992,RLP
chr10,Bn41321,50277478,73340426,23062948,CNL
chr10,Bn41322,16612489,97955107,81342618,CN
chr10,Bn41323,15022953,20884624,5861671,NBS
chr10,Bn41324,72340357,98597524,26257167,CN
chr10,Bn41325,51286445,73970462,22684017,CNL
chr10,Bn41326,52288185,99517820,47229635,RLP
chr10,Bn41327,16356990,66782986,50425996,NBS
chr10,Bn41328,30680610,85072746,54392136,NBS
chr10,Bn41329,17608670,26398548,8789878,CN
chr10,Bn41330,47530935,69875059,22344124,TN
chr10,Bn41331,43400935,52719378,9318443,CNL
chr10,Bn41332,14261593,81097479,66835886,CN
chr10,Bn41333,38042392,80404069,42361677,CN
chr10,Bn41334,61588412,79934224,18345812,TN
chr10,Bn41335,4347014,26922999,22575985,CNL
chr10,Bn41336,78129398,89824168,11694770,TN
chr10,Bn41337,99606409,99988675,382266,CNL
chr10,Bn41338,78388707,81197025,2808318,TNL
chr10,Bn41339,97634450,98762978,1128528,RLP
chr10,Bn41340,34755576,66137811,31382235,CN
chr10,Bn41341,57038691,72936645,15897954,TN
chr10,Bn41342,90275031,91019338,744307,TN
chr10,Bn41343,64639472,89462329,24822857,TNL
chr10,Bn41344,14424216,70191448,55767232,CN
chr10,Bn41345,86757785,87397591,639806,TN
chr10,Bn41346,75875435,86728814,10853379,CN
chr10,Bn41347,97906571,98544733,638162,CN
chr10,Bn41348,29344820,33759354,4414534,CN
chr10,Bn41349,65469241,91442487,25973246,NBS
chr10,Bn41350,31365753,49746737,18380984,NBS
chr10,Bn41351,87810325,98704876,10894551,RLP
chr10,Bn41352,58219904,75896300,17676396,RLP
chr10,Bn41353,20392245,93885129,73492884,NBS
chr10,Bn41354,91632608,91890140,257532,CNL
chr10,Bn41355,97519458,99942009,2422551,NBS
chr10,Bn41356,39765649,44022077,4256428,CN
chr10,Bn41357,29415992,40190481,10774489,RLK
chr10,Bn41358,17413055,77954555,60541500,CNL
chr10,Bn41359,71323535,80530787,9207252,TNL
chr10,Bn41360,95905791,98761245,2855454,RLK
chr10,Bn41361,71953206,83089702,11136496,NBS
chr10,Bn41362,5337170,27012206,21675036,NBS
chr10,Bn41363,34910015,47251167,12341152,TNL
chr10,Bn41364,67452118,97368080,29915962,TNL
chr10,Bn41365,96911530,97389406,477876,RLK
chr10,Bn41366,79203769,82255600,3051831,TNL
chr10,Bn41367,86877438,94084056,7206618,RLP
chr10,Bn41368,8862242,25860548,16998306,CNL
chr10,Bn41369,36004048,61952722,25948674,RLP
chr10,Bn41370,20144929,81134996,60990067,TNL
chr10,Bn41371,23879590,73600939,49721349,TNL
chr10,Bn41372,70789501,92416306,21626805,CN
chr10,Bn41373,1949059,66931528,64982469,TN
chr10,Bn41374,38493105,40778925,2285820,RLK
chr10,Bn41375,44146820,95171410,51024590,NBS
chr10,Bn41376,4560615,74021124,69460509,RLK
chr10,Bn41377,92636409,99276796,6640387,TNL
chr10,Bn41378,67887446,99374592,31487146,CNL
chr10,Bn41379,40728735,58003645,17274910,CN
chr10,Bn41380,28707278,84512366,55805088,RLP
chr10,Bn41381,93465565,97702198,4236633,RLK
chr10,Bn41382,78857885,82183627,3325742,RLP
chr10,Bn41383,33980798,75859313,41878515,CNL
chr10,Bn41384,70578773,91603095,21024322,TN
chr10,Bn41385,98428838,98754452,325614,RLP
chr10,Bn41386,81069325,81407778,338453,TNL
chr10,Bn41387,42149052,87582117,45433065,NBS
chr10,Bn41388,14787204,72249793,57462589,RLK
chr10,Bn41389,99253252,99636265,383013,TNL
chr10,Bn41390,55566559,63345180,7778621,CN
chr10,Bn41391,79318433,85805371,6486938,CN
chr10,Bn41392,76081528,81793086,5711558,TNL
chr10,Bn41393,20153106,20170344,17238,NBS
chr10,Bn41394,13002409,61057575,48055166,NBS
chr10,Bn41395,4893519,59398967,54505448,CN
chr10,Bn41396,19160853,27832402,8671549,NBS
chr10,Bn41397,37824684,52692791,14868107,CN
chr10,Bn41398,54162988,82718384,28555396,RLK
chr10,Bn41399,81399785,93229990,11830205,RLP
chr10,Bn41400,14640312,72323712,57683400,NBS
chr10,Bn41401,95171117,99835208,4664091,CN
chr10,Bn41402,66803985,76628101,9824116,RLP
chr10,Bn41403,29825841,86923565,57097724,TNL
chr10,Bn41404,96163974,99286799,3122825,NBS
chr10,Bn41405,1710493,7102655,5392162,TN
chr10,Bn41406,82216973,97534334,15317361,TNL
chr10,Bn41407,19345009,49230043,29885034,CN
chr10,Bn41408,56260827,71809255,15548428,NBS
chr10,Bn41409,77564748,97951059,20386311,CN
chr10,Bn41410,92349400,99171476,6822076,CN
chr10,Bn41411,43466780,67232073,23765293,NBS
chr10,Bn41412,2143531,95806510,93662979,CN
chr10,Bn41413,22663607,72249819,49586212,CN
chr10,Bn41414,44477675,72252550,27774875,RLP
chr10,Bn41415,17553544,24035129,6481585,TN
chr10,Bn41416,36045505,48519697,12474192,RLP
chr10,Bn41417,42598867,87279641,44680774,CNL
chr10,Bn41418,74307659,81544370,7236711,TNL
chr10,Bn41419,32430750,44179833,11749083,RLP
chr10,Bn41420,81701864,95652603,13950739,CN
chr10,Bn41421,82731519,90659671,7928152,RLK
chr10,Bn41422,4525708,8334239,3808531,CN
chr10,Bn41423,32100841,68644886,36544045,TN
chr10,Bn41424,99453663,99457121,3458,CN
chr10,Bn41425,31099486,75636897,44537411,TN
chr10,Bn41426,83381997,88218965,4836968,TN
chr10,Bn41427,69432115,85362674,15930559,RLK
chr10,Bn41428,47571820,66293773,18721953,CN
chr10,Bn41429,94027566,96853369,2825803,RLP
chr10,Bn41430,90643345,97629257,6985912,TN
chr10,Bn41431,56141192,81384758,25243566,NBS
chr10,Bn41432,32438772,60738462,28299690,RLP
chr10,Bn41433,14114970,63397343,49282373,CN
chr10,Bn41434,23031270,70144984,47113714,CNL
chr10,Bn41435,20060976,90353080,70292104,RLK
chr10,Bn41436,29850912,37288472,7437560,NBS
chr10,Bn41437,71247315,99959559,28712244,TN
chr10,Bn41438,62145527,65157695,3012168,RLK
chr10,Bn41439,33941901,84112395,50170494,CNL
chr10,Bn41440,26150172,60764506,34614334,CN
chr10,Bn41441,89220802,99948137,10727335,CN
chr10,Bn41442,51625366,80704519,29079153,NBS
chr10,Bn41443,16347183,46773549,30426366,RLP
chr10,Bn41444,68308225,76630524,8322299,RLK
chr10,Bn41445,22036202,45332916,23296714,CN
chr10,Bn41446,51517625,82671689,31154064,RLK
chr10,Bn41447,38517519,87208030,48690511,TN
chr10,Bn41448,6296495,7911751,1615256,NBS
chr10,Bn41449,1897499,58666651,56769152,RLK
chr10,Bn41450,40659101,86241151,45582050,TN
chr10,Bn41451,93204608,99207615,6003007,TN
chr10,Bn41452,97735766,99247287,1511521,NBS
chr10,Bn41453,17617063,27476271,9859208,CN
chr10,Bn41454,52198066,63773486,11575420,CN
chr10,Bn41455,89431691,94349172,4917481,CN
chr10,Bn41456,14305357,26770126,12464769,RLK
chr10,Bn41457,18925116,32211782,13286666,CN
chr10,Bn41458,60815810,65331464,4515654,RLK
chr10,Bn41459,71178577,88656539,17477962,RLK
chr10,Bn41460,34566813,40303490,5736677,NBS
chr10,Bn41461,33031802,54195533,21163731,CN
chr10,Bn41462,49570041,66452166,16882125,NBS
chr10,Bn41463,62344343,91782271,29437928,RLK
chr10,Bn41464,73757421,95027113,21269692,NBS
chr10,Bn41465,70097462,85157714,15060252,RLK
chr10,Bn41466,73470233,85367339,11897106,RLK
chr10,Bn41467,15523098,21615752,6092654,CNL
chr10,Bn41468,44534725,63375655,18840930,RLP
chr10,Bn41469,76436131,84488556,8052425,TN
chr10,Bn41470,52876347,56968163,4091816,TNL
chr10,Bn41471,66302152,93477234,27175082,TNL
chr10,Bn41472,69935702,89549825,19614123,NBS
chr10,Bn41473,58541643,89766087,31224444,TNL
chr10,Bn41474,7802491,67874895,60072404,RLP
chr10,Bn41475,71892773,93173679,21280906,TNL
chr10,Bn41476,81119811,97384354,16264543,NBS
chr10,Bn41477,69017997,78052552,9034555,TN
chr10,Bn41478,54931909,73203876,18271967,RLP
chr10,Bn41479,28876899,96202489,67325590,RLK
chr10,Bn41480,78460783,84872735,6411952,NBS
chr10,Bn41481,65804325,78259846,12455521,TN
chr10,Bn41482,77499900,91030042,13530142,CN
chr10,Bn41483,79987929,87166875,7178946,TNL
chr10,Bn41484,35854112,51059469,15205357,NBS
chr10,Bn41485,73578693,76364020,2785327,RLK
chr10,Bn41486,32064038,91181991,59117953,RLP
chr10,Bn41487,85044532,93955162,8910630,TNL
chr10,Bn41488,82762044,89863234,7101190,RLK
chr10,Bn41489,35488350,39783977,4295627,TN
chr10,Bn41490,10581077,26969386,16388309,TN
chr10,Bn41491,10707432,82270737,71563305,TN
chr10,Bn41492,79043695,99042681,19998986,CN
chr10,Bn41493,20316596,30384714,10068118,TNL
chr10,Bn41494,7682826,39619331,31936505,TNL
chr10,Bn41495,8302221,15115365,6813144,TNL
chr10,Bn41496,51254724,89753726,38499002,TNL
chr10,Bn41497,73055232,99289623,26234391,TNL
chr10,Bn41498,3796524,97480484,93683960,TNL
chr10,Bn41499,70668174,85530417,14862243,RLK
chr10,Bn41500,64992500,79487889,14495389,CNL
chr10,Bn41501,1312676,91004106,89691430,TN
chr10,Bn41502,39549450,71397940,31848490,NBS
chr10,Bn41503,50138051,85021434,34883383,NBS
chr10,Bn41504,38869991,91885039,53015048,RLK
chr10,Bn41505,14303343,97903065,83599722,RLP
chr10,Bn41506,58834428,73438473,14604045,CNL
chr10,Bn41507,96525681,97386324,860643,TNL
chr10,Bn41508,94486373,99744776,5258403,TN
chr10,Bn41509,7113993,16387187,9273194,TN
chr10,Bn41510,60084196,74475286,14391090,TN
chr10,Bn41511,81942329,90018829,8076500,NBS
chr10,Bn41512,4992038,97226761,92234723,CNL
chr10,Bn41513,81697970,89564308,7866338,CN
chr10,Bn41514,58490615,99496206,41005591,CN
chr10,Bn41515,64918952,66444368,1525416,RLK
chr10,Bn41516,93986446,96400029,2413583,CN
chr10,Bn41517,35816126,81887788,46071662,NBS
chr10,Bn41518,10615901,18647382,8031481,NBS
chr10,Bn41519,19262283,99041496,79779213,CN
chr10,Bn41520,20602847,74927220,54324373,NBS
chr10,Bn41521,45599493,88457101,42857608,TNL
chr10,Bn41522,60930058,71178454,10248396,NBS
chr10,Bn41523,77330893,90536495,13205602,NBS
chr10,Bn41524,24880701,54514793,29634092,TN
chr10,Bn41525,99263764,99771674,507910,RLK
chr10,Bn41526,90477581,97280155,6802574,NBS
chr10,Bn41527,46269817,57414637,11144820,TN
chr10,Bn41528,80271085,96530281,16259196,RLP
chr10,Bn41529,36697444,57871203,21173759,NBS
chr10,Bn41530,87085035,96506775,9421740,NBS
chr10,Bn41531,64849791,73858945,9009154,TNL
chr10,Bn41532,98551761,98564351,12590,CN
chr10,Bn41533,73887215,97874655,23987440,TN
chr10,Bn41534,71715008,73362364,1647356,RLK
chr10,Bn41535,20684434,95913899,75229465,NBS
chr10,Bn41536,51774755,88720062,36945307,TNL
chr10,Bn41537,71559202,83030464,11471262,TN
chr10,Bn41538,39131905,88948943,49817038,TN
chr10,Bn41539,1504510,50898547,49394037,CN
chr10,Bn41540,92331263,93539669,1208406,RLK
chr10,Bn41541,26903585,31427096,4523511,RLK
chr10,Bn41542,40490637,52920920,12430283,TN
chr10,Bn41543,24679571,91350266,66670695,CNL
chr10,Bn41544,62730612,93816032,31085420,CN
chr10,Bn41545,50825733,58787768,7962035,RLK
chr10,Bn41546,42005928,42907089,901161,NBS
chr10,Bn41547,79449829,92818246,13368417,CNL
chr10,Bn41548,46719860,84594143,37874283,TNL
chr10,Bn41549,63898222,84446715,20548493,RLP
chr10,Bn41550,10012163,29361706,19349543,CN
chr10,Bn41551,72515660,80795161,8279501,RLK
chr10,Bn41552,8133301,39793121,31659820,CNL
chr10,Bn41553,50286425,73396199,23109774,RLK
chr10,Bn41554,28483752,28821699,337947,TNL
chr10,Bn41555,51553420,55624614,4071194,CN
chr10,Bn41556,6634712,41799902,35165190,CNL
chr10,Bn41557,34819120,73903089,39083969,RLP
chr10,Bn41558,55656687,74861126,19204439,CNL
chr10,Bn41559,39084270,44916873,5832603,NBS
chr10,Bn41560,72866113,96499599,23633486,TNL
chr10,Bn41561,58078142,81725394,23647252,TN
chr10,Bn41562,86713645,88252272,1538627,TNL
chr10,Bn41563,47711171,50889011,3177840,TN
chr10,Bn41564,79110951,89055702,9944751,RLP
chr10,Bn41565,51060855,75300526,24239671,RLP
chr10,Bn41566,48138314,76335820,28197506,NBS
chr10,Bn41567,66696501,98832767,32136266,TN
chr10,Bn41568,40920015,41496579,576564,NBS
chr10,Bn41569,52951849,89391921,36440072,NBS
chr10,Bn41570,23690304,83268197,59577893,NBS
chr10,Bn41571,30169091,32423371,2254280,NBS
chr10,Bn41572,70957861,91341809,20383948,RLK
chr10,Bn41573,89451355,98087331,8635976,RLK
chr10,Bn41574,40240291,61214368,20974077,TN
chr10,Bn41575,1249205,11680435,10431230,CNL
chr10,Bn41576,53265777,75266994,22001217,RLP
chr10,Bn41577,7464152,52445720,44981568,RLP
chr10,Bn41578,4166089,30117372,25951283,CNL
chr10,Bn41579,55673797,61797207,6123410,CNL
chr10,Bn41580,72707344,78552827,5845483,TNL
chr10,Bn41581,64157374,71863012,7705638,TNL
chr10,Bn41582,84275827,86418475,2142648,RLK
chr10,Bn41583,1381892,18035610,16653718,RLP
chr10,Bn41584,79004510,94796458,15791948,CN
chr10,Bn41585,78426152,89459107,11032955,CNL
chr10,Bn41586,47382293,82396658,35014365,TN
chr10,Bn41587,39164404,51334744,12170340,TN
chr10,Bn41588,52743803,70352191,17608388,RLK
chr10,Bn41589,66805825,79744136,12938311,NBS
chr10,Bn41590,66803700,95669284,28865584,RLK
chr10,Bn41591,63625309,65765634,2140325,NBS
chr10,Bn41592,60441983,75427965,14985982,TN
chr10,Bn41593,46757481,79393955,32636474,RLP
chr10,Bn41594,99373445,99760351,386906,CNL
chr10,Bn41595,99099183,99703277,604094,NBS
chr10,Bn41596,51683995,52560068,876073,RLP
chr10,Bn41597,58876072,61694050,2817978,RLP
chr10,Bn41598,47680606,84062766,36382160,RLK
chr10,Bn41599,42960143,62328838,19368695,NBS
chr10,Bn41600,91498358,95033497,3535139,NBS
chr10,Bn41601,43664382,57653306,13988924,RLP
chr10,Bn41602,26261115,93197707,66936592,TNL
chr10,Bn41603,51711263,70482997,18771734,RLP
chr10,Bn41604,69551728,99674681,30122953,RLP
chr10,Bn41605,44508093,50369333,5861240,TNL
chr10,Bn41606,21703691,65674620,43970929,RLP
chr10,Bn41607,68536198,71365437,2829239,RLK
chr10,Bn41608,12643544,88343331,75699787,NBS
chr10,Bn41609,12509901,29056833,16546932,CNL
chr10,Bn41610,78340241,97781399,19441158,CN
chr10,Bn41611,70360374,93214300,22853926,TNL
chr10,Bn41612,82420273,84061439,1641166,TN
chr10,Bn41613,27572764,86456869,58884105,TN
chr10,Bn41614,30193915,93011124,62817209,RLK
chr10,Bn41615,99231874,99735539,503665,TN
chr10,Bn41616,98034074,99488850,1454776,RLK
chr10,Bn41617,48174058,94639168,46465110,CNL
chr10,Bn41618,43134999,50766567,7631568,RLP
chr10,Bn41619,16753908,38086227,21332319,RLP
chr10,Bn41620,76064572,91668950,15604378,CNL
chr10,Bn41621,56200346,80865403,24665057,CNL
chr10,Bn41622,21542254,64919483,43377229,RLK
chr10,Bn41623,31559915,74465462,42905547,CN
chr10,Bn41624,84003372,98885206,14881834,RLK
chr10,Bn41625,97412599,98931589,1518990,TN
chr10,Bn41626,10826459,17108363,6281904,NBS
chr10,Bn41627,40588478,72685310,32096832,TN
chr10,Bn41628,11592909,24143036,12550127,RLP
chr10,Bn41629,69375779,95548156,26172377,RLK
chr10,Bn41630,14832587,32971128,18138541,CN
chr10,Bn41631,10843594,25101692,14258098,NBS
chr10,Bn41632,77772670,83472994,5700324,TNL
chr10,Bn41633,41464277,87714551,46250274,TNL
chr10,Bn41634,47391814,79397147,32005333,RLK
chr10,Bn41635,56225112,86039812,29814700,CN
chr10,Bn41636,55327849,75261302,19933453,RLK
chr10,Bn41637,20952050,22798137,1846087,RLP
chr10,Bn41638,99092957,99676954,583997,RLP
chr10,Bn41639,88156721,91649917,3493196,TN
chr10,Bn41640,15134458,85444091,70309633,TN
chr10,Bn41641,87636958,95556320,7919362,RLK
chr10,Bn41642,46446744,85443911,38997167,RLK
chr10,Bn41643,83677998,93327624,9649626,TNL
chr10,Bn41644,23578072,37942002,14363930,RLK
chr10,Bn41645,29625551,86975989,57350438,CNL
chr10,Bn41646,89437095,99810307,10373212,NBS
chr10,Bn41647,5595417,19749171,14153754,RLK
chr10,Bn41648,22302092,41818213,19516121,CNL
chr10,Bn41649,81423593,93685570,12261977,TNL
chr10,Bn41650,73167296,89666398,16499102,NBS
chr10,Bn41651,57770676,63632836,5862160,TNL
chr10,Bn41652,54462815,56172598,1709783,TNL
chr10,Bn41653,18700026,92116715,73416689,CNL
chr10,Bn41654,36890568,78333853,41443285,CN
chr10,Bn41655,99675378,99929808,254430,CNL
chr10,Bn41656,54952369,98757392,43805023,CNL
chr10,Bn41657,18003246,45236820,27233574,CNL
chr10,Bn41658,79137841,79798164,660323,CNL
chr10,Bn41659,36786904,56863494,20076590,CNL
chr10,Bn41660,84242377,96683708,12441331,RLK
chr10,Bn41661,17579390,68779778,51200388,TNL
chr10,Bn41662,46640250,79351411,32711161,CN
chr10,Bn41663,97268115,97457995,189880,TN
chr10,Bn41664,78143579,81843283,3699704,TN
chr10,Bn41665,63660695,92157570,28496875,RLP
chr10,Bn41666,95842792,97552186,1709394,TNL
chr10,Bn41667,25892402,75771672,49879270,NBS
chr10,Bn41668,6354349,54476155,48121806,RLP
chr10,Bn41669,61123847,92148705,31024858,TNL
chr10,Bn41670,55121576,90035021,34913445,CN
chr10,Bn41671,22776758,48555973,25779215,CN
chr10,Bn41672,71345093,78121000,6775907,TNL
chr10,Bn41673,91096927,94592720,3495793,TN
chr10,Bn41674,35467365,84922157,49454792,TN
chr10,Bn41675,28531849,52107321,23575472,NBS
chr10,Bn41676,81167576,83900531,2732955,CNL
chr10,Bn41677,55873458,65552152,9678694,CN
chr10,Bn41678,76567973,77230030,662057,CN
chr10,Bn41679,54836912,59821956,4985044,TN
chr10,Bn41680,42774114,52977052,10202938,TN
chr10,Bn41681,86122268,93268829,7146561,RLP
chr10,Bn41682,14074121,27385432,13311311,RLP
chr10,Bn41683,73274758,88438129,15163371,CN
chr10,Bn41684,62693655,90022434,27328779,TN
chr10,Bn41685,59286346,78294113,19007767,CN
chr10,Bn41686,98214813,98678461,463648,CN
chr10,Bn41687,97045005,99433127,2388122,TNL
chr10,Bn41688,22836796,68667207,45830411,TN
chr10,Bn41689,23105372,91526800,68421428,CNL
chr10,Bn41690,9787189,26934726,17147537,RLK
chr10,Bn41691,38507202,43499692,4992490,CN
chr10,Bn41692,67335263,91562049,24226786,TN
chr10,Bn41693,3028254,74598047,71569793,RLK
chr10,Bn41694,74017448,84454863,10437415,TN
chr10,Bn41695,78073743,98379670,20305927,CNL
chr10,Bn41696,57292232,83087665,25795433,NBS
chr10,Bn41697,85730811,87938383,2207572,RLP
chr10,Bn41698,96970757,97224158,253401,NBS
chr10,Bn41699,71907353,98199614,26292261,RLP
chr10,Bn41700,72572183,86383830,13811647,RLK
chr10,Bn41701,30220255,93500429,63280174,CNL
chr10,Bn41702,65163010,91421296,26258286,TN
chr10,Bn41703,95114873,99122211,4007338,TNL
chr10,Bn41704,96177934,99978595,3800661,NBS
chr10,Bn41705,18916672,55567366,36650694,RLK
chr10,Bn41706,47886516,92074761,44188245,RLP
chr10,Bn41707,57586856,69953821,12366965,NBS
chr10,Bn41708,15470362,98469644,82999282,TNL
chr10,Bn41709,25790455,76163946,50373491,RLP
chr10,Bn41710,21725746,23712455,1986709,RLK
chr10,Bn41711,23425774,88531601,65105827,CN
chr10,Bn41712,87674244,98117086,10442842,RLK
chr10,Bn41713,15565520,56217482,40651962,TNL
chr10,Bn41714,22038888,91442442,69403554,CNL
chr10,Bn41715,34588880,53664072,19075192,TNL
chr10,Bn41716,86420031,86513885,93854,CNL
chr10,Bn41717,37598182,70000702,32402520,CN
chr10,Bn41718,70594844,74403510,3808666,NBS
chr10,Bn41719,59260313,98013629,38753316,NBS
chr10,Bn41720,95353734,99837907,4484173,RLP
chr10,Bn41721,30778071,58646477,27868406,CN
chr10,Bn41722,80162438,83150999,2988561,CNL
chr10,Bn41723,76968833,89040808,12071975,CNL
chr10,Bn41724,12221876,71775599,59553723,CNL
chr10,Bn41725,52727392,90437003,37709611,RLK
chr10,Bn41726,61935082,87621660,25686578,CN
chr10,Bn41727,79557695,97931861,18374166,TN
chr10,Bn41728,15347918,82692818,67344900,NBS
chr10,Bn41729,38858967,51501623,12642656,CNL
chr10,Bn41730,75192598,79420868,4228270,TN
chr10,Bn41731,39213446,85290149,46076703,CN
chr10,Bn41732,73706067,79570587,5864520,RLK
chr10,Bn41733,52022628,56804180,4781552,TN
chr10,Bn41734,84447618,97859409,13411791,RLK
chr10,Bn41735,56473987,88058822,31584835,CNL
chr10,Bn41736,69480091,94855188,25375097,TN
chr10,Bn41737,49628421,98310045,48681624,RLP
chr10,Bn41738,13366708,57076122,43709414,CNL
chr10,Bn41739,48989833,88121290,39131457,CN
chr10,Bn41740,60945068,79574806,18629738,RLP
chr10,Bn41741,22128452,74727209,52598757,CNL
chr10,Bn41742,47538799,82484818,34946019,RLK
chr10,Bn41743,2441393,88670887,86229494,RLP
chr10,Bn41744,95316381,99739501,4423120,CN
chr10,Bn41745,71471317,73098613,1627296,CN
chr10,Bn41746,95685820,97751898,2066078,CN
chr10,Bn41747,15830719,65962684,50131965,RLK
chr10,Bn41748,52443953,82659876,30215923,TN
chr10,Bn41749,12872301,78645174,65772873,RLP
chr10,Bn41750,42290564,90267818,47977254,NBS
chr10,Bn41751,53199490,93232012,40032522,NBS
chr10,Bn41752,50199654,68956040,18756386,CN
chr10,Bn41753,97001186,98867405,1866219,TNL
chr10,Bn41754,7178702,52047044,44868342,NBS
chr10,Bn41755,49263484,95026057,45762573,TN
chr10,Bn41756,99641026,99940212,299186,CNL
chr10,Bn41757,3637259,12004659,8367400,RLP
chr10,Bn41758,34835558,75876671,41041113,TNL
chr10,Bn41759,35290935,58168722,22877787,RLP
chr10,Bn41760,74452424,80240649,5788225,NBS
chr10,Bn41761,66441697,91379014,24937317,NBS
chr10,Bn41762,27482535,95888553,68406018,RLP
chr10,Bn41763,7597483,81299954,73702471,TN
chr10,Bn41764,8830906,21041667,12210761,RLP
chr10,Bn41765,7483215,62093915,54610700,CN
chr10,Bn41766,51704772,96585940,44881168,CN
chr10,Bn41767,28904095,65982884,37078789,NBS
chr10,Bn41768,90791210,96051915,5260705,CNL
chr10,Bn41769,96888075,97220717,332642,CNL
chr10,Bn41770,67767724,72765458,4997734,NBS
chr10,Bn41771,52480048,64512238,12032190,RLP
chr10,Bn41772,51503060,55254513,3751453,RLK
chr10,Bn41773,33214750,98982844,65768094,CN
chr10,Bn41774,10714533,40106168,29391635,RLK
chr10,Bn41775,86991530,87408232,416702,CNL
chr10,Bn41776,29424727,91114514,61689787,RLP
chr10,Bn41777,25753646,95959088,70205442,RLP
chr10,Bn41778,59479496,73441313,13961817,TNL
chr10,Bn41779,7197271,12068998,4871727,CN
chr10,Bn41780,43066616,62261283,19194667,TN
chr10,Bn41781,85099307,92248895,7149588,TN
chr10,Bn41782,69995056,76879356,6884300,CNL
chr10,Bn41783,57125989,67823794,10697805,RLK
chr10,Bn41784,8008763,31926819,23918056,RLK
chr10,Bn41785,6520619,62082516,55561897,RLK
chr10,Bn41786,13533229,77060529,63527300,RLP
chr10,Bn41787,94854064,99810569,4956505,TNL
chr10,Bn41788,9231644,23741878,14510234,CN
chr10,Bn41789,20728596,90127794,69399198,RLP
chr10,Bn41790,34971208,44225179,9253971,TN
chr10,Bn41791,41097658,53237476,12139818,RLP
chr10,Bn41792,92241720,98745270,6503550,CN
chr10,Bn41793,68775245,95883575,27108330,NBS
chr10,Bn41794,78262164,97999861,19737697,CNL
chr10,Bn41795,59360302,66709346,7349044,RLK
chr10,Bn41796,55450124,70193883,14743759,CN
chr10,Bn41797,50323411,92644818,42321407,RLK
chr10,Bn41798,7205136,34439415,27234279,RLP
chr10,Bn41799,56541572,99845009,43303437,TN
chr10,Bn41800,64720039,89064708,24344669,RLK
chr10,Bn41801,63946688,78598692,14652004,NBS
chr10,Bn41802,10699764,94874402,84174638,CN
chr10,Bn41803,64732697,80530890,15798193,CNL
chr10,Bn41804,51714810,65436949,13722139,CNL
chr10,Bn41805,6869053,29716537,22847484,RLK
chr10,Bn41806,46310027,92423117,46113090,CN
chr10,Bn41807,41776255,95054085,53277830,CN
chr10,Bn41808,19133749,94978239,75844490,TNL
chr10,Bn41809,65958136,98342608,32384472,TNL
chr10,Bn41810,10879086,87253529,76374443,RLK
chr10,Bn41811,59431526,88033122,28601596,TNL
chr10,Bn41812,38997911,71886945,32889034,RLK
chr10,Bn41813,58977321,99828471,40851150,NBS
chr10,Bn41814,20163490,69603688,49440198,NBS
chr10,Bn41815,48791236,90450066,41658830,CN
chr10,Bn41816,59073504,97482591,38409087,TN
chr10,Bn41817,74728421,88866247,14137826,NBS
chr10,Bn41818,38101464,58301647,20200183,TN
chr10,Bn41819,92848798,95167240,2318442,TN
chr10,Bn41820,72635548,94008901,21373353,TNL
chr10,Bn41821,54309624,96552016,42242392,TN
chr10,Bn41822,35406697,74194752,38788055,CN
chr10,Bn41823,59288074,65733768,6445694,RLK
chr10,Bn41824,81140245,81355651,215406,RLP
chr10,Bn41825,49101022,74233147,25132125,CN
chr10,Bn41826,52908942,88261352,35352410,TN
chr10,Bn41827,22806888,96347556,73540668,TNL
chr10,Bn41828,59905012,94643933,34738921,RLP
chr10,Bn41829,44220603,94441825,50221222,NBS
chr10,Bn41830,18911890,50116788,31204898,RLK
chr10,Bn41831,24594863,39617125,15022262,TN
chr10,Bn41832,25140051,34267119,9127068,RLP
chr10,Bn41833,60189212,96074158,35884946,TN
chr10,Bn41834,67500273,79926646,12426373,RLK
chr10,Bn41835,97236550,98395175,1158625,NBS
chr10,Bn41836,77318613,79776824,2458211,TNL
chr10,Bn41837,59647962,77437982,17790020,RLK
chr10,Bn41838,6827007,44639047,37812040,CN
chr10,Bn41839,70143299,70292010,148711,RLK
chr10,Bn41840,41634438,59008958,17374520,TN
chr10,Bn41841,31806206,55378446,23572240,CNL
chr10,Bn41842,32193797,87573872,55380075,RLK
chr10,Bn41843,71824418,84129642,12305224,RLK
chr10,Bn41844,28938584,97008910,68070326,RLK
chr10,Bn41845,33682030,55312137,21630107,CNL
chr10,Bn41846,96869074,98874462,2005388,RLP
chr10,Bn41847,84741246,91236087,6494841,TNL
chr10,Bn41848,45300723,69653602,24352879,CNL
chr10,Bn41849,96103713,97126967,1023254,CN
chr10,Bn41850,21074696,22363230,1288534,CN
chr10,Bn41851,19875031,52122850,32247819,CNL
chr10,Bn41852,47636814,66151839,18515025,CNL
chr10,Bn41853,11325928,94027098,82701170,RLK
chr10,Bn41854,91546419,99440804,7894385,TNL
chr10,Bn41855,34379589,51224600,16845011,CNL
chr10,Bn41856,1351702,34057230,32705528,CN
chr10,Bn41857,24121084,53679688,29558604,RLK
chr10,Bn41858,24841739,63917963,39076224,RLK
chr10,Bn41859,90934672,94411633,3476961,NBS
chr10,Bn41860,96176115,98642838,2466723,CN
chr10,Bn41861,42926856,61561859,18635003,RLK
chr10,Bn41862,38271692,84776180,46504488,TN
chr10,Bn41863,32507799,41583603,9075804,CNL
chr10,Bn41864,59686702,63241661,3554959,RLK
chr10,Bn41865,93821993,96212554,2390561,TN
chr10,Bn41866,14751502,41586085,26834583,RLK
chr10,Bn41867,73784124,75709212,1925088,CNL
chr10,Bn41868,43041984,55761616,12719632,CN
chr10,Bn41869,31438370,90610114,59171744,CNL
chr10,Bn41870,7844427,41460384,33615957,TN
chr10,Bn41871,9757753,23442352,13684599,CN
chr10,Bn41872,87993952,96673968,8680016,TNL
chr10,Bn41873,97618868,98118474,499606,NBS
chr10,Bn41874,83770381,86565729,2795348,TN
chr10,Bn41875,17316652,22159751,4843099,TNL
chr10,Bn41876,18551346,20129231,1577885,CNL
chr10,Bn41877,29445593,52617162,23171569,NBS
chr10,Bn41878,23540661,27522361,3981700,TN
chr10,Bn41879,36415684,61392702,24977018,TNL
chr10,Bn41880,99867580,99994658,127078,NBS
chr10,Bn41881,6397550,59544990,53147440,CNL
chr10,Bn41882,71235647,84349871,13114224,RLP
chr10,Bn41883,42860952,48914176,6053224,TN
chr10,Bn41884,81437421,88365558,6928137,RLK
chr10,Bn41885,34912607,61352926,26440319,RLP
chr10,Bn41886,75365442,90566785,15201343,NBS
chr10,Bn41887,58285049,61598950,3313901,NBS
chr10,Bn41888,54873204,91515269,36642065,CNL
chr10,Bn41889,29244001,37522291,8278290,NBS
chr10,Bn41890,32258175,41474707,9216532,RLK
chr10,Bn41891,37268240,60957930,23689690,RLK
chr10,Bn41892,97086864,98809621,1722757,NBS
chr10,Bn41893,22716090,71444976,48728886,NBS
chr10,Bn41894,62062893,92884910,30822017,RLK
chr10,Bn41895,32872275,98473628,65601353,NBS
chr10,Bn41896,7859963,11665780,3805817,RLP
chr10,Bn41897,54147632,68576261,14428629,NBS
chr10,Bn41898,53347508,60281229,6933721,CN
chr10,Bn41899,47004389,99847568,52843179,RLK
chr10,Bn41900,7536685,62021576,54484891,NBS
chr10,Bn41901,51874348,76725462,24851114,RLK
chr10,Bn41902,49629857,97283123,47653266,NBS
chr10,Bn41903,28149964,38757693,10607729,RLK
chr10,Bn41904,82301614,90936520,8634906,CN
chr10,Bn41905,40466250,72596207,32129957,CNL
chr10,Bn41906,18773304,20229140,1455836,TN
chr10,Bn41907,45674285,63616438,17942153,CNL
chr10,Bn41908,70057947,90349711,20291764,CN
chr10,Bn41909,15793881,47334028,31540147,NBS
chr10,Bn41910,56035835,82500568,26464733,CN
chr10,Bn41911,8966463,69562111,60595648,RLP
chr10,Bn41912,62694002,76012978,13318976,CNL
chr10,Bn41913,17735188,50630262,32895074,NBS
chr10,Bn41914,26046572,79227854,53181282,CNL
chr10,Bn41915,88787420,95705060,6917640,CNL
chr10,Bn41916,64965719,82291678,17325959,CNL
chr10,Bn41917,85636943,98872196,13235253,CN
chr10,Bn41918,73896596,79969622,6073026,CN
chr10,Bn41919,82269584,84134861,1865277,RLK
chr10,Bn41920,67793351,68493326,699975,TN
chr10,Bn41921,96600654,98311016,1710362,NBS
chr10,Bn41922,13665714,96325019,82659305,CN
chr10,Bn41923,18087128,68280842,50193714,CN
chr10,Bn41924,51094307,68989194,17894887,CN
chr10,Bn41925,37545541,50781345,13235804,CN
chr10,Bn41926,74040764,90693995,16653231,TNL
chr10,Bn41927,5054094,88290696,83236602,CN
chr10,Bn41928,23312930,86729415,63416485,RLP
chr10,Bn41929,34291333,72694163,38402830,NBS
chr10,Bn41930,45106309,84059952,38953643,TN
chr10,Bn41931,89833774,90815966,982192,TNL
chr10,Bn41932,77347742,96258706,18910964,RLP
chr10,Bn41933,71458298,84844712,13386414,RLP
chr10,Bn41934,93418571,99774598,6356027,RLP
chr10,Bn41935,98391087,99058986,667899,RLK
chr10,Bn41936,23542377,32540706,8998329,TNL
chr10,Bn41937,11104239,23701437,12597198,TNL
chr10,Bn41938,53169075,53762496,593421,RLK
chr10,Bn41939,62833746,81635480,18801734,NBS
chr10,Bn41940,13181398,18701615,5520217,RLK
chr10,Bn41941,65062729,75955459,10892730,TN
chr10,Bn41942,27930280,68711430,40781150,TNL
chr10,Bn41943,66355139,86546856,20191717,TNL
chr10,Bn41944,83649209,85983016,2333807,CNL
chr10,Bn41945,41704109,83191175,41487066,RLK
chr10,Bn41946,51918318,60064591,8146273,TN
chr10,Bn41947,76295310,86530508,10235198,TN
chr10,Bn41948,87961675,98003742,10042067,TN
chr10,Bn41949,35765767,98511685,62745918,CNL
chr10,Bn41950,62980775,85944455,22963680,CN
chr10,Bn41951,4525824,7800606,3274782,CN
chr10,Bn41952,20886275,62537206,41650931,RLK
chr10,Bn41953,34777871,59894392,25116521,CNL
chr10,Bn41954,14131954,57759817,43627863,TNL
chr10,Bn41955,89120029,95058990,5938961,TN
chr10,Bn41956,78448131,96841244,18393113,RLP
chr10,Bn41957,90289287,94328480,4039193,TNL
chr10,Bn41958,25924584,50354287,24429703,TN
chr10,Bn41959,11465559,18092786,6627227,RLK
chr10,Bn41960,80336902,96510312,16173410,RLK
chr10,Bn41961,64008679,69651327,5642648,NBS
chr10,Bn41962,86880386,88695858,1815472,NBS
chr10,Bn41963,81028966,81438147,409181,NBS
chr10,Bn41964,71381656,82048660,10667004,CNL
chr10,Bn41965,53100415,63019986,9919571,RLK
chr10,Bn41966,43880699,63424076,19543377,RLK
chr10,Bn41967,3431092,97618867,94187775,CNL
chr10,Bn41968,96906925,96955964,49039,TN
chr10,Bn41969,34465332,91675964,57210632,RLK
chr10,Bn41970,33932460,75035793,41103333,RLP
chr10,Bn41971,51418124,75186845,23768721,RLK
chr10,Bn41972,61464680,97522747,36058067,CNL
chr10,Bn41973,30244711,61266427,31021716,CNL
chr10,Bn41974,8024633,46317267,38292634,RLK
chr10,Bn41975,86454374,97249469,10795095,TN
chr10,Bn41976,26836532,78948224,52111692,TNL
chr10,Bn41977,38048146,61681834,23633688,TN
chr10,Bn41978,35709349,46406626,10697277,RLP
chr10,Bn41979,68653311,84701849,16048538,RLK
chr10,Bn41980,11509830,49316544,37806714,CN
chr10,Bn41981,77577593,81351878,3774285,TNL
chr10,Bn41982,14244986,38732408,24487422,RLK
chr10,Bn41983,87765272,95497275,7732003,CNL
chr10,Bn41984,59417530,75609699,16192169,TNL
chr10,Bn41985,92356651,94853859,2497208,TNL
chr10,Bn41986,57177649,76719735,19542086,TNL
chr10,Bn41987,65956134,80924703,14968569,RLK
chr10,Bn41988,4540782,77540277,72999495,NBS
chr10,Bn41989,50998970,99488562,48489592,TN
chr10,Bn41990,26710712,60466389,33755677,NBS
chr10,Bn41991,34149320,65484710,31335390,TNL
chr10,Bn41992,21809829,78937645,57127816,RLP
chr10,Bn41993,97844471,98130173,285702,RLP
chr10,Bn41994,16647999,75075560,58427561,TN
chr10,Bn41995,95771706,98473368,2701662,TN
chr10,Bn41996,91736592,95840494,4103902,RLK
chr10,Bn41997,12931339,19998807,7067468,NBS
chr10,Bn41998,48472917,51217295,2744378,TNL
chr10,Bn41999,28750929,61157701,32406772,CN
chr10,Bn42000,81678477,88824672,7146195,RLK
chr10,Bn42001,67996942,97752863,29755921,NBS
chr10,Bn42002,15372515,97600620,82228105,CN
chr10,Bn42003,64036774,90121034,26084260,TNL
chr10,Bn42004,34928302,90065597,55137295,TNL
chr10,Bn42005,54855476,87021312,32165836,RLP
chr10,Bn42006,41495243,68017013,26521770,TN
chr10,Bn42007,30730829,53196453,22465624,TNL
chr10,Bn42008,3812878,62751002,58938124,CNL
chr10,Bn42009,50877349,96788257,45910908,CN
chr10,Bn42010,23252326,30764823,7512497,RLP
chr10,Bn42011,79762468,91636251,11873783,CN
chr10,Bn42012,32032669,94421004,62388335,TN
chr10,Bn42013,30666831,57058732,26391901,RLK
chr10,Bn42014,16162322,90538214,74375892,RLK
chr10,Bn42015,3287891,84757603,81469712,CN
chr10,Bn42016,69757537,77464184,7706647,NBS
chr10,Bn42017,91360680,94108879,2748199,RLK
chr10,Bn42018,77952947,88476536,10523589,NBS
chr10,Bn42019,47202795,52946080,5743285,TN
chr10,Bn42020,78236639,99012748,20776109,RLK
chr10,Bn42021,93519208,98443610,4924402,RLP
chr10,Bn42022,1337002,65996043,64659041,TN
chr10,Bn42023,45442220,47606828,2164608,NBS
chr10,Bn42024,48198531,72362568,24164037,TNL
chr10,Bn42025,6621839,93307728,86685889,RLK
chr10,Bn42026,76194223,97048222,20853999,RLK
chr10,Bn42027,71498563,71639870,141307,RLP
chr10,Bn42028,86419773,94462808,8043035,TN
chr10,Bn42029,40044144,40227679,183535,TNL
chr10,Bn42030,5095522,97376065,92280543,CN
chr10,Bn42031,88915621,94495023,5579402,CNL
chr10,Bn42032,34034612,86412435,52377823,CN
chr10,Bn42033,75835591,96580839,20745248,CN
chr10,Bn42034,49992272,72316274,22324002,TN
chr10,Bn42035,6232429,42135752,35903323,TN
chr10,Bn42036,20759499,84839177,64079678,TN
chr10,Bn42037,96900645,99926730,3026085,CNL
chr10,Bn42038,95224718,98879779,3655061,CNL
chr10,Bn42039,85238584,93358860,8120276,CNL
chr10,Bn42040,92737124,96753837,4016713,RLK
chr10,Bn42041,96050484,99009180,2958696,NBS
chr10,Bn42042,70233476,70956609,723133,CNL
chr10,Bn42043,79438465,92805295,13366830,NBS
chr10,Bn42044,25969972,43808937,17838965,TNL
chr10,Bn42045,52332539,60622413,8289874,NBS
chr10,Bn42046,87466519,99764940,12298421,CNL
chr10,Bn42047,66974972,84497342,17522370,CNL
chr10,Bn42048,23839134,40782005,16942871,RLK
chr10,Bn42049,54594094,68715698,14121604,RLK
chr10,Bn42050,57286866,96385685,39098819,CN
chr10,Bn42051,91078397,95026096,3947699,NBS
chr10,Bn42052,74913126,95653326,20740200,TN
chr10,Bn42053,21903478,35784672,13881194,TNL
chr10,Bn42054,96269336,99046007,2776671,TNL
chr10,Bn42055,61882437,73265047,11382610,RLP
chr10,Bn42056,11351093,44187684,32836591,RLP
chr10,Bn42057,43033385,45741459,2708074,RLK
chr10,Bn42058,42148747,82561122,40412375,TNL
chr10,Bn42059,85050574,86767500,1716926,TNL
chr10,Bn42060,56002949,74041095,18038146,CN
chr10,Bn42061,91143662,93443206,2299544,NBS
chr10,Bn42062,87747310,96857842,9110532,RLP
chr10,Bn42063,26894201,84935157,58040956,TNL
chr10,Bn42064,91505868,98978613,7472745,RLP
chr10,Bn42065,20295810,75145934,54850124,TN
chr10,Bn42066,98877413,98942557,65144,RLK
chr10,Bn42067,53686130,88042323,34356193,NBS
chr10,Bn42068,92253170,94077975,1824805,CN
chr10,Bn42069,67952844,76387319,8434475,CN
chr10,Bn42070,17352166,89708497,72356331,TN
chr10,Bn42071,93250028,97329943,4079915,TNL
chr10,Bn42072,62247801,83249549,21001748,NBS
chr10,Bn42073,72191663,79269203,7077540,CN
chr10,Bn42074,4000539,4561969,561430,TNL
chr10,Bn42075,12765862,17729383,4963521,RLP
chr10,Bn42076,6281943,41816634,35534691,NBS
chr10,Bn42077,83226067,83768244,542177,CNL
chr10,Bn42078,23376796,64697844,41321048,NBS
chr10,Bn42079,15163152,71580362,56417210,TN
chr10,Bn42080,66590347,68624028,2033681,TN
chr10,Bn42081,60149523,84512996,24363473,CN
chr10,Bn42082,66041852,91544689,25502837,RLK
chr10,Bn42083,72230351,91890892,19660541,CN
chr10,Bn42084,45107148,53241890,8134742,CNL
chr10,Bn42085,44206899,60233358,16026459,CNL
chr10,Bn42086,15311080,55669267,40358187,RLP
chr10,Bn42087,97691327,97719545,28218,TNL
chr10,Bn42088,76462442,90685437,14222995,RLK
chr10,Bn42089,46204479,48038789,1834310,CNL
chr10,Bn42090,83119582,95477951,12358369,NBS
chr10,Bn42091,55137811,95580210,40442399,TNL
chr10,Bn42092,90357768,95211695,4853927,CNL
chr10,Bn42093,29107334,61875718,32768384,RLP
chr10,Bn42094,71630197,74202154,2571957,RLP
chr10,Bn42095,57530327,63572731,6042404,CNL
chr10,Bn42096,92865098,93991861,1126763,RLP
chr10,Bn42097,81177276,99567621,18390345,RLP
chr10,Bn42098,38888600,76312327,37423727,CN
chr10,Bn42099,22774807,68517276,45742469,CNL
chr10,Bn42100,45521022,96941078,51420056,TN
chr10,Bn42101,27719542,67566167,39846625,CN
chr10,Bn42102,20932328,69520616,48588288,RLK
chr10,Bn42103,80317295,94247366,13930071,TN
chr10,Bn42104,82308858,82556303,247445,TN
chr10,Bn42105,76060919,90957973,14897054,NBS
chr10,Bn42106,25396685,82385916,56989231,TNL
chr10,Bn42107,84319215,87491638,3172423,CNL
chr10,Bn42108,43984071,88036686,44052615,TNL
chr10,Bn42109,2477554,70188623,67711069,RLK
chr10,Bn42110,72295667,83213981,10918314,TN
chr10,Bn42111,47375647,97823956,50448309,RLK
chr10,Bn42112,39026905,95365421,56338516,NBS
chr10,Bn42113,74936404,90623846,15687442,RLP
chr10,Bn42114,33912991,73007968,39094977,TNL
chr10,Bn42115,22046692,72231513,50184821,NBS
chr10,Bn42116,63793665,68235039,4441374,RLK
chr10,Bn42117,75017038,82837342,7820304,RLP
chr10,Bn42118,69132313,74493625,5361312,RLK
chr10,Bn42119,65359095,83355757,17996662,CNL
chr10,Bn42120,49702540,83630269,33927729,TN
chr10,Bn42121,9164662,20745664,11581002,TNL
chr10,Bn42122,84939613,89187611,4247998,CNL
chr10,Bn42123,50896422,74574950,23678528,NBS
chr10,Bn42124,69763849,71744259,1980410,NBS
chr10,Bn42125,78389460,85541191,7151731,NBS
chr10,Bn42126,65526720,78451927,12925207,CN
chr10,Bn42127,5781052,26460638,20679586,RLP
chr10,Bn42128,99962103,99980571,18468,CN
chr10,Bn42129,44831933,73751784,28919851,CNL
chr10,Bn42130,81538823,91807396,10268573,CN
chr10,Bn42131,21151908,26111709,4959801,TNL
chr10,Bn42132,13859627,99871797,86012170,CN
chr10,Bn42133,79290186,80997627,1707441,CN
chr10,Bn42134,16649882,48124420,31474538,RLP
chr10,Bn42135,92582192,97230127,4647935,RLK
chr10,Bn42136,89708023,89739776,31753,TN
chr10,Bn42137,94158598,97196427,3037829,CNL
chr10,Bn42138,37870934,84729553,46858619,RLP
chr10,Bn42139,40605851,81964561,41358710,RLP
chr10,Bn42140,51499256,54209911,2710655,CNL
chr10,Bn42141,44350373,88631636,44281263,RLK
chr10,Bn42142,25428555,61661413,36232858,TNL
chr10,Bn42143,97946438,99211890,1265452,CN
chr10,Bn42144,20321725,81120898,60799173,TN
chr10,Bn42145,49012012,68275548,19263536,RLK
chr10,Bn42146,68098465,98836621,30738156,NBS
chr10,Bn42147,9611764,97949394,88337630,CNL
chr10,Bn42148,81523343,86698961,5175618,TNL
chr10,Bn42149,3793474,29665094,25871620,RLP
chr10,Bn42150,28684083,48021828,19337745,TNL
chr10,Bn42151,1129322,70220685,69091363,CNL
chr10,Bn42152,91224777,93876211,2651434,CNL
chr10,Bn42153,51402398,93695631,42293233,RLK
chr10,Bn42154,73338363,79244992,5906629,NBS
chr10,Bn42155,70314354,88302364,17988010,NBS
chr10,Bn42156,77575829,80966340,3390511,RLK
chr10,Bn42157,60480246,75555242,15074996,TN
chr10,Bn42158,47377817,86108260,38730443,NBS
chr10,Bn42159,73142210,91515415,18373205,TNL
chr10,Bn42160,83622511,98063727,14441216,RLP
chr10,Bn42161,45875968,66751843,20875875,TN
chr10,Bn42162,2708141,94338392,91630251,TNL
chr10,Bn42163,91809491,93252913,1443422,CN
chr10,Bn42164,84071848,92716556,8644708,RLP
chr10,Bn42165,53582305,80743990,27161685,CNL
chr10,Bn42166,67956623,87131261,19174638,RLK
chr10,Bn42167,20870738,39012366,18141628,TN
chr10,Bn42168,19388593,41004453,21615860,TNL
chr10,Bn42169,21289188,90703757,69414569,CN
chr10,Bn42170,41454575,65491295,24036720,NBS
chr10,Bn42171,43681176,46667646,2986470,CNL
chr10,Bn42172,50586149,91619416,41033267,CNL
chr10,Bn42173,5630414,95059165,89428751,CNL
chr10,Bn42174,90430745,98746541,8315796,CN
chr10,Bn42175,35079409,64200650,29121241,TN
chr10,Bn42176,41294178,79918078,38623900,RLK
chr10,Bn42177,25923613,82420477,56496864,NBS
chr10,Bn42178,91967990,92827933,859943,CNL
chr10,Bn42179,90923617,93233909,2310292,NBS
chr10,Bn42180,31432377,66176755,34744378,RLP
chr10,Bn42181,38956086,78839487,39883401,TN
chr10,Bn42182,19387339,39054517,19667178,RLK
chr10,Bn42183,99339491,99623671,284180,TNL
chr10,Bn42184,89710159,96064604,6354445,TNL
chr10,Bn42185,46914491,82779521,35865030,RLK
chr10,Bn42186,91439939,96400092,4960153,RLK
chr10,Bn42187,67432300,84567627,17135327,TN
chr10,Bn42188,34597613,40836087,6238474,CNL
chr10,Bn42189,2956106,78988046,76031940,NBS
chr10,Bn42190,56115095,94548649,38433554,CNL
chr10,Bn42191,41421384,77068034,35646650,CN
chr10,Bn42192,5534275,66365534,60831259,RLP
chr10,Bn42193,95805485,96341420,535935,CN
chr10,Bn42194,45847491,66845373,20997882,TNL
chr10,Bn42195,14702612,37823271,23120659,RLP
chr10,Bn42196,11382055,65477063,54095008,TN
chr10,Bn42197,82640635,90710693,8070058,RLK
chr10,Bn42198,96751878,98485129,1733251,CN
chr10,Bn42199,66050088,77437069,11386981,TNL
chr10,Bn42200,61013732,91131046,30117314,TNL
chr10,Bn42201,24604092,67591999,42987907,TNL
chr10,Bn42202,68698419,89391807,20693388,RLK
chr10,Bn42203,52937048,71914504,18977456,CN
chr10,Bn42204,54463690,74036205,19572515,RLK
chr10,Bn42205,11329464,36309806,24980342,CNL
chr10,Bn42206,20143246,33176080,13032834,RLK
chr10,Bn42207,51941345,73639663,21698318,TN
chr10,Bn42208,40611154,81228450,40617296,RLK
chr10,Bn42209,73339815,79686493,6346678,NBS
chr10,Bn42210,84467435,97877583,13410148,CNL
chr10,Bn42211,70398864,79359610,8960746,RLP
chr10,Bn42212,81996746,96094191,14097445,TN
chr10,Bn42213,96903862,99268562,2364700,TN
chr10,Bn42214,38059692,62609906,24550214,TN
chr10,Bn42215,40198706,99788565,59589859,CN
chr10,Bn42216,1565042,8644514,7079472,RLK
chr10,Bn42217,21891985,95513170,73621185,NBS
chr10,Bn42218,4743297,28965033,24221736,CN
chr10,Bn42219,77617554,83262645,5645091,NBS
chr10,Bn42220,18759841,37004785,18244944,TN
chr10,Bn42221,99391812,99632473,240661,CN
chr10,Bn42222,75427370,83657544,8230174,TNL
chr10,Bn42223,70570616,90417204,19846588,TN
chr10,Bn42224,72656866,86719429,14062563,NBS
chr10,Bn42225,28797222,99109789,70312567,RLP
chr10,Bn42226,32596443,62434955,29838512,CN
chr10,Bn42227,95179991,97785408,2605417,TNL
chr10,Bn42228,13180739,68881967,55701228,NBS
chr10,Bn42229,96221837,96231606,9769,RLK
chr10,Bn42230,70195323,71936739,1741416,TNL
chr10,Bn42231,63665685,71581457,7915772,TNL
chr10,Bn42232,1941424,20865721,18924297,NBS
chr10,Bn42233,9492547,47608490,38115943,CN
chr10,Bn42234,63043522,70848687,7805165,NBS
chr10,Bn42235,81723803,83814489,2090686,RLK
chr10,Bn42236,96013765,97138006,1124241,TN
chr10,Bn42237,8949507,22180093,13230586,CN
chr10,Bn42238,32753614,55974360,23220746,CNL
chr10,Bn42239,67344090,85371998,18027908,RLK
chr10,Bn42240,46745611,89505596,42759985,TNL
chr10,Bn42241,50308057,91524686,41216629,RLK
chr10,Bn42242,75049750,89994645,14944895,TNL
chr10,Bn42243,87124434,92486823,5362389,TN
chr10,Bn42244,86464232,98317679,11853447,CNL
chr10,Bn42245,53469789,80673570,27203781,RLP
chr10,Bn42246,7032706,26789385,19756679,TNL
chr10,Bn42247,56546654,67034388,10487734,NBS
chr10,Bn42248,91064019,92458389,1394370,NBS
chr10,Bn42249,87981389,98194744,10213355,RLK
chr10,Bn42250,87012176,95108814,8096638,TN
chr10,Bn42251,93238247,97892948,4654701,NBS
chr10,Bn42252,61853750,80932635,19078885,CNL
chr10,Bn42253,41287351,86907533,45620182,CNL
chr10,Bn42254,86430584,95105232,8674648,TNL
chr10,Bn42255,59115006,78666133,19551127,TNL
chr10,Bn42256,35089593,90469030,55379437,TNL
chr10,Bn42257,91997190,92579412,582222,RLP
chr10,Bn42258,10763072,84099526,73336454,TNL
chr10,Bn42259,3835300,33796016,29960716,NBS
chr10,Bn42260,74948283,83231078,8282795,RLP
chr10,Bn42261,39238434,50504822,11266388,CNL
chr10,Bn42262,73252279,96706665,23454386,CN
chr10,Bn42263,75182241,88974225,13791984,RLP
chr10,Bn42264,36613277,50716827,14103550,RLK
chr10,Bn42265,69482635,85912119,16429484,RLK
chr10,Bn42266,52715611,81574674,28859063,TN
chr10,Bn42267,26361473,37626414,11264941,NBS
chr10,Bn42268,33634722,85056969,51422247,CNL
chr10,Bn42269,72916967,80594112,7677145,TN
chr10,Bn42270,11204004,26870314,15666310,NBS
chr10,Bn42271,60304263,81354392,21050129,TNL
chr10,Bn42272,95655534,98458708,2803174,RLP
chr10,Bn42273,67573669,77328464,9754795,RLK
chr10,Bn42274,45659850,65669927,20010077,RLK
chr10,Bn42275,21335228,23423915,2088687,NBS
chr10,Bn42276,16825391,28802532,11977141,RLK
chr10,Bn42277,30647474,47440590,16793116,RLK
chr10,Bn42278,6733208,52344008,45610800,CNL
chr10,Bn42279,91538879,96498340,4959461,TN
chr10,Bn42280,52798698,73705386,20906688,CNL
chr10,Bn42281,41340614,82900351,41559737,TN
chr10,Bn42282,76909222,83826601,6917379,RLP
chr10,Bn42283,1322647,10154773,8832126,TNL
chr10,Bn42284,59230026,66437309,7207283,CNL
chr10,Bn42285,53516124,92934465,39418341,NBS
chr10,Bn42286,41609593,98463559,56853966,NBS
chr10,Bn42287,17247595,61583200,44335605,CNL
chr10,Bn42288,90182430,90432980,250550,TNL
chr10,Bn42289,67032488,74394791,7362303,NBS
chr10,Bn42290,82387190,97102812,14715622,NBS
chr10,Bn42291,55241208,98011042,42769834,TN
chr10,Bn42292,1873604,91947169,90073565,CN
chr10,Bn42293,81555091,82326188,771097,RLP
chr10,Bn42294,57102625,71337909,14235284,CN
chr10,Bn42295,66385761,97251502,30865741,RLK
chr10,Bn42296,93802953,99587616,5784663,RLP
chr10,Bn42297,81756366,98900750,17144384,NBS
chr10,Bn42298,1276933,68497537,67220604,RLP
chr10,Bn42299,69734698,79278404,9543706,RLK
chr10,Bn42300,72115671,97574838,25459167,RLK
chr10,Bn42301,78131479,87932912,9801433,TN
chr10,Bn42302,54450885,85560985,31110100,RLP
chr10,Bn42303,23688031,64340876,40652845,TNL
chr10,Bn42304,37996323,76846791,38850468,RLK
chr10,Bn42305,82557411,85072345,2514934,RLP
chr10,Bn42306,68501653,78303834,9802181,TN
chr10,Bn42307,60225012,90774830,30549818,CN
chr10,Bn42308,7396064,30272533,22876469,CN
chr10,Bn42309,35610313,40992525,5382212,TN
chr10,Bn42310,27994392,35756175,7761783,CN
chr10,Bn42311,41142425,95706557,54564132,RLP
chr10,Bn42312,91594087,92416459,822372,CN
chr10,Bn42313,15992316,17725783,1733467,TN
chr10,Bn42314,4628752,42944637,38315885,TN
chr10,Bn42315,91573521,96509179,4935658,NBS
chr10,Bn42316,73432716,95460059,22027343,CNL
chr10,Bn42317,66294023,83050514,16756491,CNL
chr10,Bn42318,38306009,87801694,49495685,RLP
chr10,Bn42319,81545268,88592576,7047308,TN
chr10,Bn42320,58085412,67255309,9169897,NBS
chr10,Bn42321,95642883,96763224,1120341,CNL
chr10,Bn42322,95562634,97971213,2408579,RLK
chr10,Bn42323,61533473,66490311,4956838,RLK
chr10,Bn42324,55202286,64703135,9500849,RLK
chr10,Bn42325,88907596,98944850,10037254,TNL
chr10,Bn42326,46665654,66592205,19926551,RLP
chr10,Bn42327,81773859,99788798,18014939,RLP
chr10,Bn42328,85671246,93574862,7903616,TN
chr10,Bn42329,57850509,93542223,35691714,TNL
chr10,Bn42330,36077444,54095119,18017675,CN
chr10,Bn42331,81709382,94625292,12915910,RLP
chr10,Bn42332,92380106,99689039,7308933,RLP
chr10,Bn42333,21430385,64924761,43494376,NBS
chr10,Bn42334,39290331,94956081,55665750,RLK
chr10,Bn42335,96186384,97536596,1350212,CN
chr10,Bn42336,7122651,21305547,14182896,RLP
chr10,Bn42337,98854439,99048020,193581,CNL
chr10,Bn42338,32476103,42694613,10218510,RLP
chr10,Bn42339,77138846,85598951,8460105,RLP
chr10,Bn42340,82418435,85308732,2890297,TN
chr10,Bn42341,58556288,83432474,24876186,CNL
chr10,Bn42342,75995620,97709539,21713919,RLK
chr10,Bn42343,23922707,49489578,25566871,CNL
chr10,Bn42344,99636344,99982565,346221,CNL
chr10,Bn42345,98486262,99590072,1103810,RLK
chr10,Bn42346,62618378,93191359,30572981,CNL
chr10,Bn42347,28069347,29649222,1579875,RLK
chr10,Bn42348,3485724,92591439,89105715,CNL
chr10,Bn42349,1533257,50447181,48913924,TN
chr10,Bn42350,24207533,46471039,22263506,NBS
chr10,Bn42351,6600294,36258001,29657707,TNL
chr10,Bn42352,10266611,51208335,40941724,CNL
chr10,Bn42353,92744547,93641047,896500,TN
chr10,Bn42354,52204741,80277891,28073150,RLK
chr10,Bn42355,72818756,76269877,3451121,NBS
chr10,Bn42356,8146163,70394769,62248606,NBS
chr10,Bn42357,21798590,26412642,4614052,RLP
chr10,Bn42358,47778873,56739404,8960531,RLP
chr10,Bn42359,99534671,99554394,19723,RLP
chr10,Bn42360,60862497,82540960,21678463,TNL
chr10,Bn42361,51682176,57046844,5364668,TN
chr10,Bn42362,60547929,72371935,11824006,CN
chr10,Bn42363,86010941,87907672,1896731,NBS
chr10,Bn42364,15001785,24204343,9202558,TN
chr10,Bn42365,57879994,87338948,29458954,RLP
chr10,Bn42366,34099061,75466333,41367272,TNL
chr10,Bn42367,6063586,6082582,18996,CNL
chr10,Bn42368,76414429,77488750,1074321,CNL
chr10,Bn42369,78289398,89907247,11617849,RLK
chr10,Bn42370,3862980,52880940,49017960,RLP
chr10,Bn42371,83548066,91312324,7764258,RLK
chr10,Bn42372,97180601,99442682,2262081,TNL
chr10,Bn42373,68419661,90893112,22473451,CN
chr10,Bn42374,25589432,73545127,47955695,NBS
chr10,Bn42375,73257091,80577365,7320274,TN
chr10,Bn42376,5557928,89725624,84167696,RLP
chr10,Bn42377,61810475,62670998,860523,TN
chr10,Bn42378,64118290,81165835,17047545,CNL
chr10,Bn42379,91500064,97243862,5743798,RLP
chr10,Bn42380,78977887,85861543,6883656,TN
chr10,Bn42381,46211852,95660369,49448517,RLK
chr10,Bn42382,67533235,89111311,21578076,CN
chr10,Bn42383,52463981,98433819,45969838,RLP
chr10,Bn42384,1326096,58258004,56931908,NBS
chr10,Bn42385,57678056,83974764,26296708,RLK
chr10,Bn42386,63236504,63456365,219861,TN
chr10,Bn42387,89911986,99919786,10007800,RLP
chr10,Bn42388,69848061,79734413,9886352,CN
chr10,Bn42389,84323420,94016928,9693508,TNL
chr10,Bn42390,42019847,48210383,6190536,RLK
chr10,Bn42391,76848322,82620552,5772230,TN
chr10,Bn42392,68415194,94163650,25748456,TN
chr10,Bn42393,5857192,44018327,38161135,CNL
chr10,Bn42394,98133478,99370714,1237236,NBS
chr10,Bn42395,12131267,87995574,75864307,CN
chr10,Bn42396,60846266,83674941,22828675,CN
chr10,Bn42397,66802722,71024438,4221716,NBS
chr10,Bn42398,30589513,90047238,59457725,NBS
chr10,Bn42399,49619608,67393947,17774339,TNL
chr10,Bn42400,53162615,80445441,27282826,RLP
chr10,Bn42401,10236367,16637280,6400913,TN
chr10,Bn42402,14302388,30583232,16280844,CN
chr10,Bn42403,68619805,76592322,7972517,CNL
chr10,Bn42404,41502496,56319819,14817323,RLP
chr10,Bn42405,2264237,23809378,21545141,TN
chr10,Bn42406,81916504,99143187,17226683,CNL
chr10,Bn42407,50632538,98867571,48235033,TN
chr10,Bn42408,29016428,98691177,69674749,RLK
chr10,Bn42409,82190167,89920786,7730619,RLK
chr10,Bn42410,2899927,43407767,40507840,TN
chr10,Bn42411,5742719,64663874,58921155,CN
chr10,Bn42412,28290995,74622682,46331687,NBS
chr10,Bn42413,87733718,90564026,2830308,CNL
chr10,Bn42414,53350460,74943671,21593211,TN
chr10,Bn42415,21170256,89248657,68078401,CN
chr10,Bn42416,28139657,89426042,61286385,CNL
chr10,Bn42417,68427209,88235445,19808236,TN
chr10,Bn42418,56475207,69087582,12612375,CNL
chr10,Bn42419,25670042,43392374,17722332,RLK
chr10,Bn42420,52295192,69645954,17350762,CNL
chr10,Bn42421,63634553,93627990,29993437,TN
chr10,Bn42422,62458489,80072767,17614278,TN
chr10,Bn42423,85650371,99357142,13706771,TN
chr10,Bn42424,99945200,99953619,8419,RLP
chr10,Bn42425,54483476,80798809,26315333,TNL
chr10,Bn42426,26707435,38054554,11347119,TN
chr10,Bn42427,62864424,64824189,1959765,TN
chr10,Bn42428,36484165,37648821,1164656,NBS
chr10,Bn42429,21941498,46315085,24373587,NBS
chr10,Bn42430,74166966,79937756,5770790,CN
chr10,Bn42431,18583566,86660392,68076826,TNL
chr10,Bn42432,29865830,45900410,16034580,NBS
chr10,Bn42433,18135736,66638086,48502350,RLP
chr10,Bn42434,82222073,88645262,6423189,NBS
chr10,Bn42435,37525332,73294121,35768789,NBS
chr10,Bn42436,81269685,89669898,8400213,RLP
chr10,Bn42437,45091029,61834060,16743031,NBS
chr10,Bn42438,16674159,88696946,72022787,RLP
chr10,Bn42439,14122697,24213911,10091214,NBS
chr10,Bn42440,82481214,98520165,16038951,TNL
chr10,Bn42441,31156739,47834323,16677584,RLK
chr10,Bn42442,94239189,99858283,5619094,RLK
chr10,Bn42443,11783842,78974550,67190708,TNL
chr10,Bn42444,58546997,70323573,11776576,RLP
chr10,Bn42445,42636855,86213236,43576381,CN
chr10,Bn42446,65416053,95852170,30436117,CN
chr10,Bn42447,65720814,83678915,17958101,RLP
chr10,Bn42448,40158028,73628697,33470669,CN
chr10,Bn42449,48157179,50962569,2805390,RLP
chr10,Bn42450,75678083,77431074,1752991,TN
chr10,Bn42451,45518430,73654536,28136106,NBS
chr10,Bn42452,54559563,91636380,37076817,NBS
chr10,Bn42453,21478230,39425966,17947736,RLK
chr10,Bn42454,63768155,80530697,16762542,RLK
chr10,Bn42455,26580376,90641930,64061554,TN
chr10,Bn42456,34031686,83300827,49269141,TNL
chr10,Bn42457,24611820,75551970,50940150,RLK
chr10,Bn42458,54389167,57176546,2787379,RLP
chr10,Bn42459,44840225,76323764,31483539,NBS
chr10,Bn42460,59116908,89305983,30189075,NBS
chr10,Bn42461,5601623,89500730,83899107,CN
chr10,Bn42462,12012585,75344235,63331650,RLP
chr10,Bn42463,71669231,87197058,15527827,TN
chr10,Bn42464,16994000,91631075,74637075,NBS
chr10,Bn42465,8253300,21934506,13681206,CNL
chr10,Bn42466,33892833,99345780,65452947,CNL
chr10,Bn42467,92414025,93262438,848413,CN
chr10,Bn42468,98476994,99578934,1101940,RLK
chr10,Bn42469,64015844,97068467,33052623,NBS
chr10,Bn42470,93040092,95005928,1965836,CN
chr10,Bn42471,35978416,54088157,18109741,TNL
chr10,Bn42472,70982731,81226651,10243920,TNL
chr10,Bn42473,48747683,99387712,50640029,TNL
chr10,Bn42474,70451383,82612416,12161033,CN
chr10,Bn42475,41942053,78505501,36563448,RLK
chr10,Bn42476,28782606,91220614,62438008,CN
chr10,Bn42477,15936093,55681867,39745774,RLK
chr10,Bn42478,9143607,74912027,65768420,CN
chr10,Bn42479,4298029,65092164,60794135,CN
chr10,Bn42480,2763426,28023925,25260499,NBS
chr10,Bn42481,71509832,72729200,1219368,CNL
chr10,Bn42482,86209516,93189236,6979720,TN
chr10,Bn42483,98743538,99571287,827749,TN
chr10,Bn42484,79785442,81075136,1289694,RLK
chr10,Bn42485,87866614,91570350,3703736,TN
chr10,Bn42486,78873031,92583474,13710443,TN
chr10,Bn42487,61844284,88735610,26891326,CN
chr10,Bn42488,17096923,81168643,64071720,CN
chr10,Bn42489,54649373,61578314,6928941,CN
chr10,Bn42490,16254041,91101142,74847101,CNL
chr10,Bn42491,92731215,94790124,2058909,CNL
chr10,Bn42492,83273212,98639210,15365998,TNL
chr10,Bn42493,49409643,69500939,20091296,CN
chr10,Bn42494,99354189,99881179,526990,CNL
chr10,Bn42495,67201517,96460235,29258718,RLK
chr10,Bn42496,95619407,97223428,1604021,CNL
chr10,Bn42497,78722997,89644229,10921232,TNL
chr10,Bn42498,44329277,57003602,12674325,TN
chr10,Bn42499,96800787,98477784,1676997,TN
chr10,Bn42500,23824486,98212181,74387695,NBS
chr10,Bn42501,53260207,65498477,12238270,CN
chr10,Bn42502,41821017,45078453,3257436,NBS
chr10,Bn42503,54344770,76967517,22622747,TNL
chr10,Bn42504,3078169,23109848,20031679,RLP
chr10,Bn42505,98243993,99797652,1553659,TNL
chr10,Bn42506,98255145,99660342,1405197,TN
chr10,Bn42507,26303226,54461802,28158576,RLP
chr10,Bn42508,23749612,75130493,51380881,RLK
chr10,Bn42509,27583597,79349221,51765624,RLK
chr10,Bn42510,32630214,78131405,45501191,TNL
chr10,Bn42511,85435009,94182921,8747912,RLP
chr10,Bn42512,84948123,91321129,6373006,TN
chr10,Bn42513,12435498,34460672,22025174,RLK
chr10,Bn42514,49109027,54398930,5289903,RLP
chr10,Bn42515,2566202,88380977,85814775,RLP
chr10,Bn42516,99272850,99827955,555105,RLK
chr10,Bn42517,34447384,45242996,10795612,TN
chr10,Bn42518,99164010,99628293,464283,CN
chr10,Bn42519,59753488,86059380,26305892,RLK
chr10,Bn42520,67222372,71320719,4098347,TNL
chr10,Bn42521,59895640,78926199,19030559,TNL
chr10,Bn42522,43421339,69674897,26253558,CNL
chr10,Bn42523,60351987,91408601,31056614,CNL
chr10,Bn42524,23581693,91594905,68013212,TN
chr10,Bn42525,71220874,98218479,26997605,TNL
chr10,Bn42526,68905799,99141093,30235294,CN
chr10,Bn42527,79578149,94273475,14695326,TN
chr10,Bn42528,40645409,89678395,49032986,NBS
chr10,Bn42529,89172069,94938904,5766835,RLK
chr10,Bn42530,61932535,68978552,7046017,TN
chr10,Bn42531,34417615,41975979,7558364,RLK
chr10,Bn42532,60658354,91168490,30510136,CN
chr10,Bn42533,23837325,57368872,33531547,CN
chr10,Bn42534,46379917,57805052,11425135,RLP
chr10,Bn42535,51824862,81638188,29813326,CN
chr10,Bn42536,38043987,71075753,33031766,CN
chr10,Bn42537,34190495,44630513,10440018,RLP
chr10,Bn42538,88965814,96253648,7287834,TNL
chr10,Bn42539,37952947,39298070,1345123,TNL
chr10,Bn42540,41441071,97597188,56156117,CN
chr10,Bn42541,22652935,70490794,47837859,NBS
chr10,Bn42542,40505851,74725803,34219952,RLP
chr10,Bn42543,8715763,81864824,73149061,TNL
chr10,Bn42544,46339309,81524110,35184801,RLK
chr10,Bn42545,88152995,91068549,2915554,TN
chr10,Bn42546,28258242,29506542,1248300,CN
chr10,Bn42547,9726564,69090318,59363754,RLK
chr10,Bn42548,92511313,98836058,6324745,TNL
chr10,Bn42549,26530106,99329856,72799750,TNL
chr10,Bn42550,47899223,87901700,40002477,TNL
chr10,Bn42551,61998862,70449813,8450951,NBS
chr10,Bn42552,46031845,62342584,16310739,RLP
chr10,Bn42553,52027750,71133185,19105435,TNL
chr10,Bn42554,68546486,81228414,12681928,NBS
chr10,Bn42555,7409969,74249349,66839380,CNL
chr10,Bn42556,14144562,90726828,76582266,CNL
chr10,Bn42557,19249038,29280203,10031165,RLP
chr10,Bn42558,37139562,53370692,16231130,CN
chr10,Bn42559,20290871,26837322,6546451,CN
chr10,Bn42560,3754195,22932379,19178184,TNL
chr10,Bn42561,43608143,60468407,16860264,CN
chr10,Bn42562,37860549,84714228,46853679,RLP
chr10,Bn42563,69673281,73927943,4254662,RLK
chr10,Bn42564,11044529,80558266,69513737,CNL
chr10,Bn42565,21231219,50807356,29576137,CN
chr10,Bn42566,96641672,99266139,2624467,TNL
chr10,Bn42567,69546693,96264885,26718192,CN
chr10,Bn42568,5091746,25856244,20764498,RLK
chr10,Bn42569,36861844,61928083,25066239,NBS
chr10,Bn42570,3714950,11683151,7968201,CN
chr10,Bn42571,68727201,97117463,28390262,NBS
chr10,Bn42572,43944390,68527865,24583475,RLK
chr10,Bn42573,63870512,82034518,18164006,NBS
chr10,Bn42574,48641882,70801566,22159684,TNL
chr10,Bn42575,26313064,63581826,37268762,TNL
chr10,Bn42576,98953207,99801375,848168,NBS
chr10,Bn42577,81143880,86509649,5365769,TN
chr10,Bn42578,41067340,76052824,34985484,NBS
chr10,Bn42579,26502212,38168679,11666467,CNL
chr10,Bn42580,24480576,54253595,29773019,TN
chr10,Bn42581,53164596,79637198,26472602,TNL
chr10,Bn42582,20550531,72295710,51745179,CN
chr10,Bn42583,89549333,93231086,3681753,RLP
chr10,Bn42584,8400503,55281340,46880837,RLK
chr10,Bn42585,37229725,83918861,46689136,RLP
chr10,Bn42586,39812356,61584934,21772578,NBS
chr10,Bn42587,79924937,82179118,2254181,TNL
chr10,Bn42588,91698550,94509403,2810853,NBS
chr10,Bn42589,21990709,42715305,20724596,CN
chr10,Bn42590,84554140,91256583,6702443,TNL
chr10,Bn42591,79039822,95980974,16941152,RLK
chr10,Bn42592,74428105,78252298,3824193,RLK
chr10,Bn42593,10482077,71685495,61203418,NBS
chr10,Bn42594,11261157,65136888,53875731,TN
chr10,Bn42595,84175366,92479806,8304440,RLK
chr10,Bn42596,87206063,90828195,3622132,TNL
chr10,Bn42597,49609276,89723558,40114282,CN
chr10,Bn42598,63537358,73278278,9740920,RLK
chr10,Bn42599,29638839,54698189,25059350,CN
chr10,Bn42600,35333349,53506840,18173491,RLK
chr10,Bn42601,27524762,56272099,28747337,RLP
chr10,Bn42602,62284681,76151580,13866899,CNL
chr10,Bn42603,22887321,35354201,12466880,TNL
chr10,Bn42604,22956021,97080149,74124128,TNL
chr10,Bn42605,27732785,57020508,29287723,TN
chr10,Bn42606,14209738,44438532,30228794,TNL
chr10,Bn42607,58659508,78424218,19764710,TNL
chr10,Bn42608,80603978,83394919,2790941,CNL
chr10,Bn42609,34025720,40394761,6369041,TNL
chr10,Bn42610,78973833,98935892,19962059,NBS
chr10,Bn42611,29407502,69251745,39844243,RLK
chr10,Bn42612,52337317,78939683,26602366,CNL
chr10,Bn42613,46086350,68455606,22369256,CN
chr10,Bn42614,83859013,98878313,15019300,RLK
chr10,Bn42615,8546258,12301017,3754759,CN
chr10,Bn42616,53412203,60241894,6829691,TN
chr10,Bn42617,61737758,88437258,26699500,TNL
chr10,Bn42618,82454011,92402324,9948313,NBS
chr10,Bn42619,25018711,80361614,55342903,CN
chr10,Bn42620,33487173,38942453,5455280,TNL
chr10,Bn42621,41388615,71540725,30152110,TN
chr10,Bn42622,77300178,88277418,10977240,TN
chr10,Bn42623,71609872,80959115,9349243,TNL
chr10,Bn42624,5398328,29486069,24087741,TN
chr10,Bn42625,68820275,83455265,14634990,RLP
chr10,Bn42626,12346879,97634045,85287166,NBS
chr10,Bn42627,45159005,88112826,42953821,CNL
chr10,Bn42628,29168528,41257137,12088609,RLP
chr10,Bn42629,51440640,54931239,3490599,RLP
chr10,Bn42630,92610339,93154516,544177,CNL
chr10,Bn42631,7803157,80596256,72793099,TNL
chr10,Bn42632,58861253,61511975,2650722,NBS
chr10,Bn42633,86170221,91062442,4892221,RLK
chr10,Bn42634,20976685,55764303,34787618,RLK
chr10,Bn42635,19964217,41950236,21986019,RLK
chr10,Bn42636,59054564,83439911,24385347,NBS
chr10,Bn42637,17901741,59786041,41884300,NBS
chr10,Bn42638,22317873,85329053,63011180,TNL
chr10,Bn42639,94778268,96667162,1888894,RLK
chr10,Bn42640,77644603,90955521,13310918,TNL
chr10,Bn42641,21549657,56583170,35033513,TN
chr10,Bn42642,58845016,92812812,33967796,RLP
chr10,Bn42643,28774388,82141118,53366730,TN
chr10,Bn42644,38678519,75999169,37320650,NBS
chr10,Bn42645,88161034,94055663,5894629,TNL
chr10,Bn42646,91696316,92745816,1049500,RLK
chr10,Bn42647,53432183,81535634,28103451,TNL
chr10,Bn42648,7648141,8899066,1250925,CNL
chr10,Bn42649,39298015,56373780,17075765,TNL
chr10,Bn42650,88277810,97405299,9127489,RLP
chr10,Bn42651,50840143,82631320,31791177,TNL
chr10,Bn42652,40829175,97872924,57043749,RLK
chr10,Bn42653,79135684,83826994,4691310,TNL
chr10,Bn42654,62016416,83916572,21900156,TN
chr10,Bn42655,72151354,91507219,19355865,RLP
chr10,Bn42656,84005759,90952774,6947015,TNL
chr10,Bn42657,15113184,64079275,48966091,NBS
chr10,Bn42658,82553531,96094277,13540746,RLK
chr10,Bn42659,48169472,58720183,10550711,CNL
chr10,Bn42660,66554667,93523675,26969008,RLK
chr10,Bn42661,50119056,72276862,22157806,CNL
chr10,Bn42662,64805890,72283609,7477719,TN
chr10,Bn42663,45956825,70072009,24115184,TNL
chr10,Bn42664,26445661,63232490,36786829,TN
chr10,Bn42665,50937008,99009394,48072386,TN
chr10,Bn42666,19612328,83334520,63722192,TN
chr10,Bn42667,52585183,67178488,14593305,CNL
chr10,Bn42668,45893280,50570136,4676856,RLP
chr10,Bn42669,12521315,27860953,15339638,CNL
chr10,Bn42670,24889241,91687627,66798386,TN
chr10,Bn42671,29673701,85779334,56105633,CN
chr10,Bn42672,81619486,85004488,3385002,CNL
chr10,Bn42673,60675020,99258937,38583917,NBS
chr10,Bn42674,32967749,96601827,63634078,NBS
chr10,Bn42675,87216886,90658745,3441859,NBS
chr10,Bn42676,26748591,99165315,72416724,CN
chr10,Bn42677,7602806,20373065,12770259,RLK
chr10,Bn42678,45590343,57764160,12173817,RLK
chr10,Bn42679,63501255,78799035,15297780,CNL
chr10,Bn42680,41395987,84917364,43521377,CN
chr10,Bn42681,20072965,35725056,15652091,RLP
chr10,Bn42682,32646813,61630067,28983254,RLP
chr10,Bn42683,61689698,95537319,33847621,NBS
chr10,Bn42684,61002840,68427464,7424624,CN
chr10,Bn42685,56303749,96877846,40574097,CNL
chr10,Bn42686,81566695,92064350,10497655,RLP
chr10,Bn42687,38596988,59743069,21146081,NBS
chr10,Bn42688,59000124,78233184,19233060,RLK
chr10,Bn42689,20842850,36016752,15173902,TNL
chr10,Bn42690,72852534,85436452,12583918,CN
chr10,Bn42691,48846742,74989400,26142658,RLK
chr10,Bn42692,65836753,70214189,4377436,CNL
chr10,Bn42693,6009570,73425464,67415894,TN
chr10,Bn42694,86604539,88755685,2151146,CNL
chr10,Bn42695,80287997,88160724,7872727,TNL
chr10,Bn42696,55151932,55851166,699234,TNL
chr10,Bn42697,48127212,84896226,36769014,TNL
chr10,Bn42698,30269694,55421273,25151579,TNL
chr10,Bn42699,76095936,92707789,16611853,TN
chr10,Bn42700,77024331,91158472,14134141,CN
chr10,Bn42701,34225014,75576461,41351447,RLP
chr10,Bn42702,96919987,99322576,2402589,CN
chr10,Bn42703,60910572,86760688,25850116,TNL
chr10,Bn42704,5091378,63041181,57949803,RLP
chr10,Bn42705,82798697,92311290,9512593,RLK
chr10,Bn42706,56960092,80923624,23963532,CN
chr10,Bn42707,49150435,50331325,1180890,CNL
chr10,Bn42708,79536828,83985116,4448288,RLK
chr10,Bn42709,37191331,65373723,28182392,RLK
chr10,Bn42710,12394660,36826002,24431342,TN
chr10,Bn42711,28692218,72093993,43401775,RLP
chr10,Bn42712,80087520,85834741,5747221,TN
chr10,Bn42713,33252164,78067526,44815362,TN
chr10,Bn42714,1726964,83246130,81519166,RLK
chr10,Bn42715,36191775,65704272,29512497,TN
chr10,Bn42716,38015306,47094773,9079467,TN
chr10,Bn42717,67318517,70242430,2923913,RLP
chr10,Bn42718,61800697,80143069,18342372,TN
chr10,Bn42719,81145637,92302165,11156528,TNL
chr10,Bn42720,6666200,74894866,68228666,TN
chr10,Bn42721,25259461,66569183,41309722,CNL
chr10,Bn42722,74538812,76659841,2121029,TN
chr10,Bn42723,78869638,99896950,21027312,CN
chr10,Bn42724,25412480,72299257,46886777,CN
chr10,Bn42725,53412174,72461556,19049382,TN
chr10,Bn42726,41777403,71864858,30087455,CN
chr10,Bn42727,16411342,24658508,8247166,NBS
chr10,Bn42728,53367626,78084726,24717100,CNL
chr10,Bn42729,71883725,96040414,24156689,RLP
chr10,Bn42730,1189127,16450564,15261437,RLP
chr10,Bn42731,21964870,88785279,66820409,NBS
chr10,Bn42732,44867474,69995219,25127745,CN
chr10,Bn42733,31664197,78946195,47281998,RLK
chr10,Bn42734,95175673,98579869,3404196,TNL
chr10,Bn42735,83575222,95126585,11551363,RLP
chr10,Bn42736,64579668,92325850,27746182,CNL
chr10,Bn42737,79218549,89866582,10648033,CNL
chr10,Bn42738,70275681,77539111,7263430,TN
chr10,Bn42739,2207216,29487661,27280445,RLK
chr10,Bn42740,25463347,54301746,28838399,RLP
chr10,Bn42741,14564567,94841139,80276572,CNL
chr10,Bn42742,88247810,91513827,3266017,RLP
chr10,Bn42743,4034887,97230414,93195527,RLK
chr10,Bn42744,80747250,88540501,7793251,NBS
chr10,Bn42745,13524099,77161803,63637704,RLP
chr10,Bn42746,53872014,96702680,42830666,CN
chr10,Bn42747,1976236,18792259,16816023,RLK
chr10,Bn42748,21975876,93696092,71720216,CN
chr10,Bn42749,43585854,44509341,923487,RLK
chr10,Bn42750,22230832,33695758,11464926,RLP
chr10,Bn42751,4699853,33138038,28438185,RLK
chr10,Bn42752,34809962,38554901,3744939,RLP
chr10,Bn42753,45705455,55129813,9424358,CNL
chr10,Bn42754,46869575,72571450,25701875,RLK
chr10,Bn42755,52967750,61377434,8409684,RLK
chr10,Bn42756,98511799,99876345,1364546,TNL
chr10,Bn42757,98977233,99501523,524290,TNL
chr10,Bn42758,21431715,29090783,7659068,RLP
chr10,Bn42759,59276717,85967768,26691051,RLP
chr10,Bn42760,9470685,33048936,23578251,CNL
chr10,Bn42761,74750174,79403109,4652935,TN
chr10,Bn42762,71087802,79279229,8191427,CN
chr10,Bn42763,8078724,12880557,4801833,TNL
chr10,Bn42764,63475690,64042491,566801,TN
chr10,Bn42765,56530528,71358476,14827948,TNL
chr10,Bn42766,51100144,91342588,40242444,CN
chr10,Bn42767,52224085,60187033,7962948,CN
chr10,Bn42768,39010925,99083234,60072309,NBS
chr10,Bn42769,99608101,99633569,25468,CNL
chr10,Bn42770,92611103,97188699,4577596,CNL
chr10,Bn42771,37529549,39101991,1572442,NBS
chr10,Bn42772,75040863,81094697,6053834,RLP
chr10,Bn42773,2999615,32442047,29442432,RLP
chr10,Bn42774,37531010,45914599,8383589,TN
chr10,Bn42775,86784525,92488675,5704150,CN
chr10,Bn42776,42872707,75803952,32931245,CNL
chr10,Bn42777,32078560,79915902,47837342,TNL
chr10,Bn42778,19951172,73504813,53553641,RLP
chr10,Bn42779,23928671,69849070,45920399,NBS
chr10,Bn42780,14680842,76431332,61750490,RLK
chr10,Bn42781,19029713,56922812,37893099,CN
chr10,Bn42782,43756954,85990415,42233461,NBS
chr10,Bn42783,80591959,86615089,6023130,NBS
chr10,Bn42784,90898910,93937074,3038164,RLP
chr10,Bn42785,90320261,94734669,4414408,CN
chr10,Bn42786,96473030,98502037,2029007,RLK
chr10,Bn42787,55914490,80002683,24088193,CN
chr10,Bn42788,27068835,69997617,42928782,CNL
chr10,Bn42789,53456566,92040799,38584233,NBS
chr10,Bn42790,68855356,87760300,18904944,NBS
chr10,Bn42791,94564150,97815062,3250912,TNL
chr10,Bn42792,9957121,62536331,52579210,NBS
chr10,Bn42793,77827080,96698630,18871550,CNL
chr10,Bn42794,4784542,96280645,91496103,TNL
chr10,Bn42795,43108245,70025153,26916908,RLK
chr10,Bn42796,43878272,81974735,38096463,RLP
chr10,Bn42797,62679100,66329422,3650322,CNL
chr10,Bn42798,15211482,89006137,73794655,RLP
chr10,Bn42799,97617957,97658359,40402,RLK
chr10,Bn42800,86847914,94842035,7994121,NBS
chr10,Bn42801,17726176,86232091,68505915,CN
chr10,Bn42802,84067707,90926770,6859063,CNL
chr10,Bn42803,33064849,51914946,18850097,RLP
chr10,Bn42804,15324960,79078091,63753131,CN
chr10,Bn42805,72785592,80839324,8053732,CNL
chr10,Bn42806,81972481,94013097,12040616,CN
chr10,Bn42807,72979898,83092317,10112419,RLK
chr10,Bn42808,82271458,97109820,14838362,RLP
chr10,Bn42809,30235945,96925725,66689780,CN
chr10,Bn42810,39118505,77621884,38503379,CN
chr10,Bn42811,39830462,70119000,30288538,RLK
chr10,Bn42812,86660409,96962277,10301868,CNL
chr10,Bn42813,99551823,99873176,321353,NBS
chr10,Bn42814,46365026,55664242,9299216,NBS
chr10,Bn42815,95408320,99676612,4268292,CN
chr10,Bn42816,27467517,93317824,65850307,RLK
chr10,Bn42817,81220325,86697846,5477521,RLK
chr10,Bn42818,23525158,71757246,48232088,CN
chr10,Bn42819,4979817,65453468,60473651,TN
chr10,Bn42820,34346528,87073712,52727184,TN
chr10,Bn42821,92132775,94153914,2021139,TN
chr10,Bn42822,9046195,83846814,74800619,RLP
chr10,Bn42823,73170766,97235765,24064999,CN
chr10,Bn42824,55424271,97602257,42177986,TN
chr10,Bn42825,57673035,98138094,40465059,TNL
chr10,Bn42826,24844721,32693808,7849087,NBS
chr10,Bn42827,75717009,84688601,8971592,RLP
chr10,Bn42828,28275707,47442221,19166514,TNL
chr10,Bn42829,70986537,97518982,26532445,RLK
chr10,Bn42830,22715192,84242464,61527272,CNL
chr10,Bn42831,66533906,95444628,28910722,TN
chr10,Bn42832,75394796,81763305,6368509,RLK
chr10,Bn42833,68099039,70715462,2616423,CNL
chr10,Bn42834,61276878,94300839,33023961,TN
chr10,Bn42835,67848648,73087274,5238626,RLK
chr10,Bn42836,65655118,96064143,30409025,TN
chr10,Bn42837,34247232,97054311,62807079,TNL
chr10,Bn42838,66929277,75778970,8849693,RLK
chr10,Bn42839,80072360,96029220,15956860,TNL
chr10,Bn42840,7163562,33345499,26181937,TN
chr10,Bn42841,27117678,40439406,13321728,CN
chr10,Bn42842,50269989,86345984,36075995,RLP
chr10,Bn42843,90312148,96785871,6473723,NBS
chr10,Bn42844,77160007,89143529,11983522,CN
chr10,Bn42845,57949097,97764838,39815741,NBS
chr10,Bn42846,20027955,77936332,57908377,RLP
chr10,Bn42847,88739268,92946673,4207405,CNL
chr10,Bn42848,52631980,99810432,47178452,CNL
chr10,Bn42849,49361547,75404605,26043058,RLK
chr10,Bn42850,43873517,68033583,24160066,RLP
chr10,Bn42851,17185003,42429602,25244599,NBS
chr10,Bn42852,91051054,95213484,4162430,CN
chr10,Bn42853,90626705,97320663,6693958,TNL
chr10,Bn42854,56293252,73264225,16970973,RLP
chr10,Bn42855,26723943,40063793,13339850,TNL
chr10,Bn42856,47857880,85664549,37806669,RLK
chr10,Bn42857,77416531,90858987,13442456,CNL
chr10,Bn42858,2303623,34172293,31868670,CNL
chr10,Bn42859,93680641,95516603,1835962,RLP
chr10,Bn42860,75155662,86079085,10923423,NBS
chr10,Bn42861,71228634,94192420,22963786,TNL
chr10,Bn42862,93981665,99051267,5069602,TN
chr10,Bn42863,92427850,96617273,4189423,CN
chr10,Bn42864,46969199,91631761,44662562,RLK
chr10,Bn42865,19175722,36113169,16937447,NBS
chr10,Bn42866,62836053,89083686,26247633,RLK
chr10,Bn42867,19045820,96608408,77562588,TN
chr10,Bn42868,28675555,86856475,58180920,RLP
chr10,Bn42869,9622109,94023081,84400972,RLK
chr10,Bn42870,52140440,53175994,1035554,TNL
chr10,Bn42871,77863363,86318141,8454778,TN
chr10,Bn42872,22059348,99694454,77635106,TN
chr10,Bn42873,71523816,91900121,20376305,RLP
chr10,Bn42874,89173335,95079111,5905776,RLP
chr10,Bn42875,1822769,97367160,95544391,NBS
chr10,Bn42876,50948861,68795300,17846439,TNL
chr10,Bn42877,7659762,88292682,80632920,NBS
chr10,Bn42878,66149704,95257331,29107627,TNL
chr10,Bn42879,42059757,97554583,55494826,RLK
chr10,Bn42880,36336658,50167229,13830571,RLK
chr10,Bn42881,27752594,99772814,72020220,RLK
chr10,Bn42882,65057377,71401800,6344423,RLP
chr10,Bn42883,8912148,70172189,61260041,TN
chr10,Bn42884,53207658,81441348,28233690,RLK
chr10,Bn42885,16252128,36688716,20436588,RLP
chr10,Bn42886,11928157,47147943,35219786,RLK
chr10,Bn42887,4458088,55114773,50656685,RLK
chr10,Bn42888,14872556,81876545,67003989,CN
chr10,Bn42889,68079615,98431674,30352059,CN
chr10,Bn42890,71589736,85022759,13433023,CNL
chr10,Bn42891,56707090,61993698,5286608,TN
chr10,Bn42892,29636616,32431821,2795205,RLP
chr10,Bn42893,90283514,94676118,4392604,TN
chr10,Bn42894,20945708,22595149,1649441,CNL
chr10,Bn42895,81996190,99777151,17780961,TN
chr10,Bn42896,12354024,77474141,65120117,TNL
chr10,Bn42897,99066238,99428404,362166,TN
chr10,Bn42898,20365633,26092003,5726370,CNL
chr10,Bn42899,58743649,88852578,30108929,RLK
chr10,Bn42900,9592839,58051576,48458737,RLK
chr10,Bn42901,13568296,40009017,26440721,CN
chr10,Bn42902,53890974,95124876,41233902,TN
chr10,Bn42903,48431341,48546665,115324,TN
chr10,Bn42904,53547818,75818689,22270871,TN
chr10,Bn42905,77168964,90852911,13683947,NBS
chr10,Bn42906,59080801,96076031,36995230,TN
chr10,Bn42907,9619595,42002984,32383389,CN
chr10,Bn42908,55805853,64222938,8417085,NBS
chr10,Bn42909,3320893,82959245,79638352,RLK
chr10,Bn42910,83712969,88204331,4491362,TNL
chr10,Bn42911,47991738,65367026,17375288,TN
chr10,Bn42912,31499926,62166176,30666250,CN
chr10,Bn42913,18777477,38311951,19534474,CN
chr10,Bn42914,86083344,95902978,9819634,RLK
chr10,Bn42915,82776589,87516722,4740133,TNL
chr10,Bn42916,93384368,98979443,5595075,TNL
chr10,Bn42917,30901289,93363726,62462437,RLP
chr10,Bn42918,51258161,61697255,10439094,CNL
chr10,Bn42919,37101733,50796731,13694998,TNL
chr10,Bn42920,88040402,93287351,5246949,CN
chr10,Bn42921,33363846,94394057,61030211,TN
chr10,Bn42922,46111637,80623241,34511604,CN
chr10,Bn42923,6919164,19058549,12139385,CNL
chr10,Bn42924,81466342,95883572,14417230,NBS
chr10,Bn42925,98140534,99817532,1676998,CNL
chr10,Bn42926,96402991,98444270,2041279,NBS
chr10,Bn42927,56703560,85779686,29076126,NBS
chr10,Bn42928,62858882,64092516,1233634,RLK
chr10,Bn42929,33332976,54745547,21412571,TN
chr10,Bn42930,44498765,48561004,4062239,CNL
chr10,Bn42931,38165545,90186883,52021338,RLK
chr10,Bn42932,60599150,94440015,33840865,CNL
chr10,Bn42933,50811681,75530231,24718550,RLK
chr10,Bn42934,18606839,80725847,62119008,CN
chr10,Bn42935,77648316,92550687,14902371,NBS
chr10,Bn42936,59104055,91762767,32658712,CNL
chr10,Bn42937,25634789,86350022,60715233,TNL
chr10,Bn42938,63781312,81551541,17770229,TN
chr10,Bn42939,52675138,54227396,1552258,CNL
chr10,Bn42940,11190615,58704770,47514155,TN
chr10,Bn42941,79407024,82361583,2954559,RLP
chr10,Bn42942,12536051,99271834,86735783,NBS
chr10,Bn42943,48103003,59752375,11649372,NBS
chr10,Bn42944,26206116,99195136,72989020,NBS
chr10,Bn42945,55660652,70021863,14361211,RLP
chr10,Bn42946,41266987,86360650,45093663,RLK
chr10,Bn42947,66970307,74432515,7462208,RLK
chr10,Bn42948,51606184,74977060,23370876,NBS
chr10,Bn42949,75806799,98332556,22525757,CNL
chr10,Bn42950,36262508,59855481,23592973,RLK
chr10,Bn42951,94254992,98851319,4596327,CN
chr10,Bn42952,64761954,74715812,9953858,TNL
chr10,Bn42953,81619137,87757254,6138117,CNL
chr10,Bn42954,21836219,41509403,19673184,CNL
chr10,Bn42955,61766449,68074928,6308479,RLP
chr10,Bn42956,11445186,86584176,75138990,TN
chr10,Bn42957,70163694,98148060,27984366,CN
chr10,Bn42958,45482676,59287960,13805284,NBS
chr10,Bn42959,58735326,89911355,31176029,CNL
chr10,Bn42960,30776500,72653131,41876631,RLK
chr10,Bn42961,75326871,87409929,12083058,TNL
chr10,Bn42962,81061973,85680162,4618189,TNL
chr10,Bn42963,33192494,56084043,22891549,NBS
chr10,Bn42964,90659269,99296738,8637469,TNL
chr10,Bn42965,17078134,53910685,36832551,CN
chr10,Bn42966,98412187,99530037,1117850,CNL
chr10,Bn42967,83971125,99431642,15460517,NBS
chr10,Bn42968,99307780,99940257,632477,TN
chr10,Bn42969,74114488,83962645,9848157,TN
chr10,Bn42970,92224138,94014131,1789993,NBS
chr10,Bn42971,99880154,99909078,28924,RLP
chr10,Bn42972,41778745,73442081,31663336,NBS
chr10,Bn42973,92649763,96196401,3546638,CN
chr10,Bn42974,96901693,97322233,420540,RLK
chr10,Bn42975,82555573,84115492,1559919,NBS
chr10,Bn42976,87042921,87767073,724152,CN
chr10,Bn42977,53403319,66140895,12737576,CNL
chr10,Bn42978,95904806,98996226,3091420,RLK
chr10,Bn42979,71620200,93214136,21593936,NBS
chr10,Bn42980,13989614,65748823,51759209,NBS
chr10,Bn42981,54041047,85523559,31482512,CNL
chr10,Bn42982,44465028,79939012,35473984,TNL
chr10,Bn42983,9491682,43931570,34439888,RLK
chr10,Bn42984,25416420,34085245,8668825,RLP
chr10,Bn42985,62850493,92610828,29760335,RLK
chr10,Bn42986,62993997,93344632,30350635,CNL
chr10,Bn42987,96215913,97927650,1711737,RLK
chr10,Bn42988,73095225,89917068,16821843,TN
chr10,Bn42989,35796120,72953168,37157048,RLP
chr10,Bn42990,24634619,35000319,10365700,RLK
chr10,Bn42991,78874832,92370939,13496107,RLK
chr10,Bn42992,63141944,72677487,9535543,RLP
chr10,Bn42993,87404241,96375151,8970910,RLK
chr10,Bn42994,49813354,85248517,35435163,TNL
chr10,Bn42995,49732460,83658543,33926083,CN
chr10,Bn42996,4062138,68589222,64527084,RLP
chr10,Bn42997,17585912,78172814,60586902,RLK
chr10,Bn42998,45015099,94685806,49670707,RLP
chr10,Bn42999,89706252,90829485,1123233,RLP
chr10,Bn43000,36557088,82947823,46390735,TNL
chr10,Bn43001,25714877,67922428,42207551,RLP
chr10,Bn43002,88513344,93321921,4808577,CN
chr10,Bn43003,14774692,59190018,44415326,TNL
chr10,Bn43004,3673379,79222805,75549426,RLP
chr10,Bn43005,56332439,92371632,36039193,CNL
chr10,Bn43006,65865853,87613439,21747586,RLK
chr10,Bn43007,54705587,71807134,17101547,TNL
chr10,Bn43008,82046324,94397053,12350729,CN
chr10,Bn43009,31299536,65465243,34165707,RLK
chr10,Bn43010,45258523,91252162,45993639,CN
chr10,Bn43011,8201784,8451634,249850,RLP
chr10,Bn43012,75443135,98270187,22827052,TN
chr10,Bn43013,48787466,74313721,25526255,TN
chr10,Bn43014,31739587,49408839,17669252,TN
chr10,Bn43015,40161887,80104597,39942710,RLK
chr10,Bn43016,7817330,69672803,61855473,TN
chr10,Bn43017,58201216,91799159,33597943,TNL
chr10,Bn43018,15613215,18754959,3141744,CNL
chr10,Bn43019,30778084,69919834,39141750,TNL
chr10,Bn43020,51475134,56916205,5441071,CN
chr10,Bn43021,3350239,54478809,51128570,CNL
chr10,Bn43022,7824071,75348429,67524358,CNL
chr10,Bn43023,46510070,92692057,46181987,TN
chr10,Bn43024,39322344,75936997,36614653,TN
chr10,Bn43025,18838186,25386046,6547860,TNL
chr10,Bn43026,31138684,58880379,27741695,NBS
chr10,Bn43027,1484964,48164993,46680029,TN
chr10,Bn43028,54951386,71271572,16320186,TN
chr10,Bn43029,67112059,93010783,25898724,TN
chr10,Bn43030,73778297,95653648,21875351,NBS
chr10,Bn43031,91077186,99204817,8127631,RLP
chr10,Bn43032,74973819,89166101,14192282,CN
chr10,Bn43033,21702604,92871882,71169278,CNL
chr10,Bn43034,49769431,90650435,40881004,RLP
chr10,Bn43035,11083277,72268925,61185648,CN
chr10,Bn43036,13152161,32317448,19165287,CNL
chr10,Bn43037,14161125,32840814,18679689,CNL
chr10,Bn43038,69791927,74128470,4336543,TNL
chr10,Bn43039,91199141,94264829,3065688,CNL
chr10,Bn43040,23498294,94059372,70561078,RLP
chr10,Bn43041,19381665,97060068,77678403,CN
chr10,Bn43042,12093188,72455783,60362595,CNL
chr10,Bn43043,60480387,86289325,25808938,RLK
chr10,Bn43044,14858831,53154834,38296003,NBS
chr10,Bn43045,96343963,97823835,1479872,RLP
chr10,Bn43046,95855493,99989644,4134151,CNL
chr10,Bn43047,85488209,89798621,4310412,CNL
chr10,Bn43048,72134712,73207162,1072450,RLP
chr10,Bn43049,79443791,98672561,19228770,CN
chr10,Bn43050,70260150,87631516,17371366,RLP
chr10,Bn43051,98449748,99268824,819076,TNL
chr10,Bn43052,65502127,77528298,12026171,CNL
chr10,Bn43053,82466511,99114644,16648133,TN
chr10,Bn43054,38155534,83739585,45584051,CNL
chr10,Bn43055,20640923,94417232,73776309,RLK
chr10,Bn43056,68986675,98416157,29429482,CNL
chr10,Bn43057,97280684,97887822,607138,TN
chr10,Bn43058,13327118,99378652,86051534,TN
chr10,Bn43059,76452490,78238464,1785974,NBS
chr10,Bn43060,56321364,75666070,19344706,NBS
chr10,Bn43061,50637476,59043699,8406223,TNL
chr10,Bn43062,49312373,64223716,14911343,TN
chr10,Bn43063,12496856,66383840,53886984,CNL
chr10,Bn43064,56796606,63994605,7197999,RLP
chr10,Bn43065,61906681,99512674,37605993,CN
chr10,Bn43066,18234397,99119289,80884892,TN
chr10,Bn43067,45354048,91033171,45679123,TN
chr10,Bn43068,3585017,86265810,82680793,RLP
chr10,Bn43069,6039322,44141807,38102485,CN
chr10,Bn43070,88511460,91000861,2489401,RLK
chr10,Bn43071,42919650,81270060,38350410,RLP
chr10,Bn43072,51468585,74527789,23059204,RLP
chr10,Bn43073,3252149,4160951,908802,TN
chr10,Bn43074,25850969,50809044,24958075,CN
chr10,Bn43075,51844362,85821075,33976713,RLP
chr10,Bn43076,44643396,98250837,53607441,TN
chr10,Bn43077,68701074,79990780,11289706,TNL
chr10,Bn43078,62900557,86470836,23570279,RLK
chr10,Bn43079,49761861,86417177,36655316,NBS
chr10,Bn43080,17626211,79400077,61773866,TN
chr10,Bn43081,13279039,49679359,36400320,TN
chr10,Bn43082,39052782,60989225,21936443,CN
chr10,Bn43083,62058978,78261903,16202925,TN
chr10,Bn43084,26715678,33051343,6335665,TN
chr10,Bn43085,48106786,77700962,29594176,CNL
chr10,Bn43086,42994638,51304455,8309817,NBS
chr10,Bn43087,55875164,97181860,41306696,RLP
chr10,Bn43088,73988274,99981389,25993115,TNL
chr10,Bn43089,44342939,85273907,40930968,CN
chr10,Bn43090,74301409,96222439,21921030,TNL
chr10,Bn43091,68219362,88965317,20745955,NBS
chr10,Bn43092,74434554,84788528,10353974,RLK
chr10,Bn43093,20302393,45165972,24863579,CNL
chr10,Bn43094,7555094,85016382,77461288,TN
chr10,Bn43095,71564461,73325021,1760560,CN
chr10,Bn43096,64296491,67819705,3523214,RLK
chr10,Bn43097,99596370,99901974,305604,CN
chr10,Bn43098,57108267,84994260,27885993,TN
chr10,Bn43099,35519423,73197108,37677685,RLP
chr10,Bn43100,10453641,12416665,1963024,CN
chr10,Bn43101,82520056,82798915,278859,CNL
chr10,Bn43102,79380961,93356359,13975398,CN
chr10,Bn43103,15226531,40815867,25589336,TNL
chr10,Bn43104,86694874,87959668,1264794,RLK
chr10,Bn43105,63514400,68281990,4767590,CNL
chr10,Bn43106,53458607,92584900,39126293,RLP
chr10,Bn43107,51416337,54738167,3321830,TN
chr10,Bn43108,21348085,53793468,32445383,NBS
chr10,Bn43109,17956618,70328031,52371413,CNL
chr10,Bn43110,89857546,99164278,9306732,CNL
chr10,Bn43111,55205017,94562057,39357040,CN
chr10,Bn43112,77670587,83941266,6270679,TNL
chr10,Bn43113,91836722,93678019,1841297,NBS
chr10,Bn43114,41445112,66530897,25085785,CNL
chr10,Bn43115,54834928,72139235,17304307,CNL
chr10,Bn43116,84333932,92635883,8301951,NBS
chr10,Bn43117,54509313,75405716,20896403,RLK
chr10,Bn43118,78887997,87273460,8385463,CN
chr10,Bn43119,83582721,98861697,15278976,RLK
chr10,Bn43120,62883845,87992033,25108188,NBS
chr10,Bn43121,74589808,81356276,6766468,TN
chr10,Bn43122,48771841,95544196,46772355,CN
chr10,Bn43123,15529034,33396767,17867733,TNL
chr10,Bn43124,65471655,78364176,12892521,RLP
chr10,Bn43125,51937289,83028717,31091428,RLP
chr10,Bn43126,87143492,99387418,12243926,RLP
chr10,Bn43127,59802860,99590649,39787789,CN
chr10,Bn43128,64829637,77212423,12382786,NBS
chr10,Bn43129,25170237,30681948,5511711,TN
chr10,Bn43130,15681098,78350288,62669190,CN
chr10,Bn43131,71113597,85854236,14740639,RLK
chr10,Bn43132,12162030,43658918,31496888,NBS
chr10,Bn43133,60487506,98844713,38357207,NBS
chr10,Bn43134,90537381,92547628,2010247,CNL
chr10,Bn43135,22767502,48471324,25703822,TNL
chr10,Bn43136,26968759,47921379,20952620,TN
chr10,Bn43137,22994657,49143352,26148695,TNL
chr10,Bn43138,59788579,78892399,19103820,RLK
chr10,Bn43139,4144842,4345050,200208,CN
chr10,Bn43140,4517652,98521733,94004081,TN
chr10,Bn43141,87992231,97459775,9467544,CNL
chr10,Bn43142,4498123,39584888,35086765,TNL
chr10,Bn43143,15951665,57849668,41898003,TNL
chr10,Bn43144,34993605,53054420,18060815,TN
chr10,Bn43145,21699194,39907207,18208013,TNL
chr10,Bn43146,33588651,43482531,9893880,TN
chr10,Bn43147,64195302,87314098,23118796,RLP
chr10,Bn43148,21873890,87630429,65756539,TN
chr10,Bn43149,30433699,88629819,58196120,NBS
chr10,Bn43150,10420294,94552511,84132217,NBS
chr10,Bn43151,43000503,67201258,24200755,TN
chr10,Bn43152,41773710,96379899,54606189,TN
chr10,Bn43153,16343242,35116074,18772832,TNL
chr10,Bn43154,3351452,55288080,51936628,RLP
chr10,Bn43155,59701667,65396737,5695070,CN
chr10,Bn43156,56366354,94528332,38161978,TN
chr10,Bn43157,43160099,56601627,13441528,RLP
chr10,Bn43158,44588001,51979317,7391316,RLK
chr10,Bn43159,45637537,70419841,24782304,NBS
chr10,Bn43160,78430459,78957792,527333,CNL
chr10,Bn43161,3042821,83847730,80804909,RLK
chr10,Bn43162,12426494,35239472,22812978,RLK
chr10,Bn43163,68144977,97998448,29853471,NBS
chr10,Bn43164,8886929,21888643,13001714,NBS
chr10,Bn43165,89061698,93646702,4585004,RLK
chr10,Bn43166,53586774,72410690,18823916,CNL
chr10,Bn43167,46166604,93408381,47241777,NBS
chr10,Bn43168,68090417,78104039,10013622,CNL
chr10,Bn43169,57006433,59831817,2825384,TNL
chr10,Bn43170,68835706,99631901,30796195,TNL
chr10,Bn43171,63003999,95015209,32011210,NBS
chr10,Bn43172,95131825,97915637,2783812,RLK
chr10,Bn43173,18262884,59049547,40786663,NBS
chr10,Bn43174,92330922,93585797,1254875,CN
chr10,Bn43175,14984490,19044566,4060076,RLK
chr10,Bn43176,87949540,99543727,11594187,RLP
chr10,Bn43177,39441842,53091027,13649185,RLK
chr10,Bn43178,65240225,72822073,7581848,TN
chr10,Bn43179,40543216,42541224,1998008,TN
chr10,Bn43180,10716454,16066021,5349567,CNL
chr10,Bn43181,88260430,92415034,4154604,TNL
chr10,Bn43182,69641510,92399020,22757510,TNL
chr10,Bn43183,60585755,72733888,12148133,RLP
chr10,Bn43184,66076875,92339787,26262912,TNL
chr10,Bn43185,71171030,87631691,16460661,RLK
chr10,Bn43186,80221138,94548762,14327624,NBS
chr10,Bn43187,24307845,46611268,22303423,RLP
chr10,Bn43188,95214221,98916982,3702761,RLK
chr10,Bn43189,46855513,79720415,32864902,CNL
chr10,Bn43190,76247801,80671615,4423814,TN
chr10,Bn43191,16210655,44955911,28745256,TNL
chr10,Bn43192,84166731,87345016,3178285,TN
chr10,Bn43193,66814240,67012968,198728,CN
chr10,Bn43194,73849216,74696329,847113,TNL
chr10,Bn43195,5398314,28499091,23100777,CNL
chr10,Bn43196,81094350,92773386,11679036,RLP
chr10,Bn43197,39840466,88952430,49111964,TNL
chr10,Bn43198,83037960,87208900,4170940,RLK
chr10,Bn43199,82939814,86671245,3731431,CN
chr10,Bn43200,74975747,76648452,1672705,NBS
chr10,Bn43201,56998299,70869241,13870942,CN
chr10,Bn43202,24282216,42291286,18009070,RLP
chr10,Bn43203,71716791,85191002,13474211,CNL
chr10,Bn43204,32829429,68584312,35754883,CNL
chr10,Bn43205,63516574,86106837,22590263,NBS
chr10,Bn43206,47202027,51500294,4298267,CNL
chr10,Bn43207,67128695,96547106,29418411,CN
chr10,Bn43208,67632905,93749543,26116638,CN
chr10,Bn43209,59179154,81350086,22170932,RLK
chr10,Bn43210,90826678,96703550,5876872,RLP
chr10,Bn43211,35383842,80581956,45198114,CN
chr10,Bn43212,28725781,37547602,8821821,RLK
chr10,Bn43213,12348195,29794980,17446785,NBS
chr10,Bn43214,27484002,35660042,8176040,CNL
chr10,Bn43215,83112196,89575518,6463322,CN
chr10,Bn43216,33224772,59341580,26116808,CN
chr10,Bn43217,61764681,78313213,16548532,CN
chr10,Bn43218,78257644,90140007,11882363,NBS
chr10,Bn43219,36066704,60968105,24901401,RLP
chr10,Bn43220,69312900,77562286,8249386,TNL
chr10,Bn43221,2787911,79230066,76442155,TNL
chr10,Bn43222,62108898,85465036,23356138,RLP
chr10,Bn43223,81887600,83939317,2051717,TNL
chr10,Bn43224,14235582,70126342,55890760,TN
chr10,Bn43225,23609502,29050629,5441127,CN
chr10,Bn43226,56357410,80456929,24099519,RLP
chr10,Bn43227,39129214,72259236,33130022,TN
chr10,Bn43228,82221669,84697868,2476199,TNL
chr10,Bn43229,64406394,84120161,19713767,TNL
chr10,Bn43230,80902141,93649214,12747073,TN
chr10,Bn43231,75207979,90857954,15649975,CN
chr10,Bn43232,53193171,57563087,4369916,RLK
chr10,Bn43233,66613352,73554870,6941518,RLK
chr10,Bn43234,53356234,78603330,25247096,CNL
chr10,Bn43235,30553808,83535604,52981796,RLK
chr10,Bn43236,9625046,56625498,47000452,TN
chr10,Bn43237,57642166,63091222,5449056,RLP
chr10,Bn43238,18956227,82273686,63317459,TN
chr10,Bn43239,48539126,82154998,33615872,RLP
chr10,Bn43240,14636135,54562892,39926757,RLP
chr10,Bn43241,48948865,81878595,32929730,TNL
chr10,Bn43242,66101989,82520911,16418922,NBS
chr10,Bn43243,50378686,83156070,32777384,NBS
chr10,Bn43244,63914702,76097029,12182327,RLP
chr10,Bn43245,89509795,89931548,421753,CN
chr10,Bn43246,25484496,91103486,65618990,CN
chr10,Bn43247,55036778,90070359,35033581,RLP
chr10,Bn43248,11590140,76145117,64554977,RLP
chr10,Bn43249,9887637,71799229,61911592,RLK
chr10,Bn43250,26936077,64974775,38038698,RLP
chr10,Bn43251,47074934,86530563,39455629,RLK
chr10,Bn43252,5560645,6714436,1153791,CN
chr10,Bn43253,42023339,60317864,18294525,RLK
chr10,Bn43254,77518877,85095636,7576759,CN
chr10,Bn43255,4001435,64428531,60427096,CN
chr10,Bn43256,9558831,94529786,84970955,TN
chr10,Bn43257,58728854,70278810,11549956,TNL
chr10,Bn43258,34599438,87868367,53268929,RLK
chr10,Bn43259,26831476,52658044,25826568,NBS
chr10,Bn43260,85650375,96566656,10916281,RLP
chr10,Bn43261,42106349,62661162,20554813,CN
chr10,Bn43262,90343874,94835594,4491720,TNL
chr10,Bn43263,7385308,74099883,66714575,TNL
chr10,Bn43264,94532264,96381687,1849423,NBS
chr10,Bn43265,27898773,80599997,52701224,TN
chr10,Bn43266,88563911,99709168,11145257,NBS
chr10,Bn43267,73152582,80503245,7350663,RLP
chr10,Bn43268,63921787,78515734,14593947,NBS
chr10,Bn43269,34437636,91936001,57498365,TN
chr10,Bn43270,74797211,99299799,24502588,RLP
chr10,Bn43271,43362795,81677639,38314844,RLP
chr10,Bn43272,16458176,63642372,47184196,RLK
chr10,Bn43273,24779282,35870397,11091115,CNL
chr10,Bn43274,46216138,77295951,31079813,RLK
chr10,Bn43275,98496237,98625661,129424,TN
chr10,Bn43276,46951549,50165401,3213852,NBS
chr10,Bn43277,37821992,86254428,48432436,TNL
chr10,Bn43278,62259061,79890406,17631345,TNL
chr10,Bn43279,94337334,97829028,3491694,TNL
chr10,Bn43280,3691574,18876875,15185301,CNL
chr10,Bn43281,57292483,90978952,33686469,RLK
chr10,Bn43282,23029941,29574468,6544527,CNL
chr10,Bn43283,60712524,78942780,18230256,RLK
chr10,Bn43284,60565830,70939152,10373322,NBS
chr10,Bn43285,41146935,70252017,29105082,RLP
chr10,Bn43286,3473769,79603546,76129777,TN
chr10,Bn43287,98377524,99213386,835862,TNL
chr10,Bn43288,14638342,44109148,29470806,TN
chr10,Bn43289,75610681,88663535,13052854,NBS
chr10,Bn43290,13844383,99368921,85524538,RLK
chr10,Bn43291,43944546,60933068,16988522,CN
chr10,Bn43292,61869681,84134416,22264735,NBS
chr10,Bn43293,71441252,99028466,27587214,RLK
chr10,Bn43294,54471162,56104312,1633150,NBS
chr10,Bn43295,96439776,98827917,2388141,CNL
chr10,Bn43296,2792845,77662153,74869308,RLK
chr10,Bn43297,54874281,72140536,17266255,CNL
chr10,Bn43298,68984913,73737281,4752368,NBS
chr10,Bn43299,7348443,77823441,70474998,TNL
chr10,Bn43300,15443544,44262003,28818459,NBS
chr10,Bn43301,7644763,60026847,52382084,TNL
chr10,Bn43302,22004376,44694139,22689763,TN
chr10,Bn43303,70684384,96658262,25973878,NBS
chr10,Bn43304,66148775,86394570,20245795,TN
chr10,Bn43305,81831807,83082052,1250245,TN
chr10,Bn43306,19952477,65991405,46038928,TNL
chr10,Bn43307,44962519,69003846,24041327,CN
chr10,Bn43308,71046585,95427729,24381144,CN
chr10,Bn43309,10554908,56670102,46115194,CNL
chr10,Bn43310,12059333,16777511,4718178,RLP
chr10,Bn43311,85351005,98107537,12756532,NBS
chr10,Bn43312,39608802,89296102,49687300,NBS
chr10,Bn43313,2437586,97793640,95356054,CNL
chr10,Bn43314,99120633,99756065,635432,NBS
chr10,Bn43315,13055271,63395245,50339974,NBS
chr10,Bn43316,57609107,96311026,38701919,CN
chr10,Bn43317,24429606,53806804,29377198,NBS
chr10,Bn43318,71833686,77301321,5467635,TN
chr10,Bn43319,58721972,85932328,27210356,TN
chr10,Bn43320,45325884,72454848,27128964,CNL
chr10,Bn43321,93782619,97218018,3435399,TN
chr10,Bn43322,74276305,90646782,16370477,CNL
chr10,Bn43323,83527350,94065147,10537797,RLP
chr10,Bn43324,71939350,78446108,6506758,TN
chr10,Bn43325,17471884,78698458,61226574,CN
chr10,Bn43326,56439217,74588850,18149633,TNL
chr10,Bn43327,12157536,81585377,69427841,NBS
chr10,Bn43328,72669090,96206002,23536912,CNL
chr10,Bn43329,10686666,49144065,38457399,TNL
chr10,Bn43330,1257930,24743366,23485436,TN
chr10,Bn43331,5255296,32173233,26917937,NBS
chr10,Bn43332,69763147,79235678,9472531,CN
chr10,Bn43333,91929343,94049452,2120109,RLP
chr10,Bn43334,12694408,40528370,27833962,RLK
chr10,Bn43335,29379463,53742772,24363309,CN
chr10,Bn43336,78744448,89892113,11147665,RLK
chr10,Bn43337,70905892,74912583,4006691,NBS
chr10,Bn43338,17631404,81441202,63809798,CNL
chr10,Bn43339,46124711,88223776,42099065,TNL
chr10,Bn43340,32360643,70674806,38314163,RLK
chr10,Bn43341,65761397,91884476,26123079,RLK
chr10,Bn43342,22655022,85572343,62917321,TN
chr10,Bn43343,9893717,80659325,70765608,CN
chr10,Bn43344,29370735,30137430,766695,RLP
chr10,Bn43345,69483690,72097480,2613790,TN
chr10,Bn43346,34262278,78953258,44690980,TN
chr10,Bn43347,52431737,57150316,4718579,RLK
chr10,Bn43348,27610722,44975468,17364746,NBS
chr10,Bn43349,58786389,61193881,2407492,CNL
chr10,Bn43350,72952443,91104884,18152441,CN
chr10,Bn43351,79441521,83064150,3622629,NBS
chr10,Bn43352,23724628,69874896,46150268,CN
chr10,Bn43353,84683688,87545077,2861389,TNL
chr10,Bn43354,95611831,99159138,3547307,RLP
chr10,Bn43355,15548785,84776581,69227796,CNL
chr10,Bn43356,32206042,61103687,28897645,RLK
chr10,Bn43357,71756487,95874607,24118120,CN
chr10,Bn43358,15496813,87750396,72253583,TN
chr10,Bn43359,52484502,64778694,12294192,TN
chr10,Bn43360,46068444,60080993,14012549,NBS
chr10,Bn43361,99452285,99645717,193432,TNL
chr10,Bn43362,87310190,94549340,7239150,TNL
chr10,Bn43363,89993141,90198600,205459,CNL
chr10,Bn43364,68412938,91650955,23238017,TNL
chr10,Bn43365,33460879,72715186,39254307,TN
chr10,Bn43366,20303295,97013568,76710273,TNL
chr10,Bn43367,77329816,98903272,21573456,CN
chr10,Bn43368,82197785,87467013,5269228,RLP
chr10,Bn43369,82145021,92099248,9954227,CN
chr10,Bn43370,73144309,84939067,11794758,RLK
chr10,Bn43371,27164633,43109771,15945138,RLK
chr10,Bn43372,44323161,83017746,38694585,TN
chr10,Bn43373,32864328,76394542,43530214,RLP
chr10,Bn43374,48154765,97818698,49663933,TN
chr10,Bn43375,71502100,84626656,13124556,TNL
chr10,Bn43376,1976223,20429623,18453400,CNL
chr10,Bn43377,12814869,29296656,16481787,RLK
chr10,Bn43378,66044910,71901138,5856228,TN
chr10,Bn43379,62802031,84980163,22178132,RLK
chr10,Bn43380,1561448,77959880,76398432,TN
chr10,Bn43381,34618070,45630444,11012374,NBS
chr10,Bn43382,13032736,97137227,84104491,RLK
chr10,Bn43383,65111672,69855901,4744229,RLP
chr10,Bn43384,78007807,79739704,1731897,CN
chr10,Bn43385,53121587,68287659,15166072,RLP
chr10,Bn43386,93327280,93343543,16263,TN
chr10,Bn43387,15534896,35708743,20173847,CNL
chr10,Bn43388,46308640,49200795,2892155,RLK
chr10,Bn43389,54650644,93275461,38624817,RLK
chr10,Bn43390,76550759,81105865,4555106,TNL
chr10,Bn43391,92413202,99754632,7341430,RLK
chr10,Bn43392,93122200,98743018,5620818,RLK
chr10,Bn43393,31654665,46007687,14353022,CN
chr10,Bn43394,92382916,92454301,71385,RLK
chr10,Bn43395,66159205,85233364,19074159,RLK
chr10,Bn43396,97479575,98654058,1174483,TN
chr10,Bn43397,99038285,99438549,400264,RLK
chr10,Bn43398,12457929,57055767,44597838,NBS
chr10,Bn43399,33769315,41242471,7473156,NBS
chr10,Bn43400,46428196,48408884,1980688,TN
chr10,Bn43401,47263081,58550003,11286922,TN
chr10,Bn43402,64826689,95906056,31079367,NBS
chr10,Bn43403,33859236,86187461,52328225,CN
chr10,Bn43404,32303094,95347423,63044329,CNL
chr10,Bn43405,89505182,89809927,304745,RLK
chr10,Bn43406,84393716,86279918,1886202,CNL
chr10,Bn43407,70618260,73817474,3199214,NBS
chr10,Bn43408,77859979,91966148,14106169,RLK
chr10,Bn43409,59643290,67297063,7653773,TN
chr10,Bn43410,11736531,90103316,78366785,NBS
chr10,Bn43411,27485251,34261943,6776692,TNL
chr10,Bn43412,72288894,85711818,13422924,CN
chr10,Bn43413,33218126,33921256,703130,NBS
chr10,Bn43414,45862056,70389126,24527070,TNL
chr10,Bn43415,28895083,74703260,45808177,RLK
chr10,Bn43416,70841387,80039460,9198073,TNL
chr10,Bn43417,13479364,25485443,12006079,RLK
chr10,Bn43418,90819429,93985879,3166450,TNL
chr10,Bn43419,2921835,36045782,33123947,TN
chr10,Bn43420,9909870,97663933,87754063,RLP
chr10,Bn43421,20494743,54478613,33983870,TN
chr10,Bn43422,49608204,96983049,47374845,TNL
chr10,Bn43423,53315000,60949252,7634252,RLK
chr10,Bn43424,66977347,99815834,32838487,CNL
chr10,Bn43425,84695277,87677700,2982423,CN
chr10,Bn43426,66838717,87188849,20350132,TN
chr10,Bn43427,71405085,91516332,20111247,RLP
chr10,Bn43428,50069385,79793375,29723990,TN
chr10,Bn43429,45071959,78908221,33836262,RLK
chr10,Bn43430,55860249,97457253,41597004,TNL
chr10,Bn43431,64497686,90239313,25741627,NBS
chr10,Bn43432,80716576,98969410,18252834,CN
chr10,Bn43433,41228607,90323608,49095001,NBS
chr10,Bn43434,56829345,61502383,4673038,CNL
chr10,Bn43435,26725809,27473840,748031,TNL
chr10,Bn43436,34366672,37484985,3118313,RLP
chr10,Bn43437,76133066,79447573,3314507,RLK
chr10,Bn43438,42680968,59981056,17300088,CN
chr10,Bn43439,19242980,89838793,70595813,TN
chr10,Bn43440,43071916,72692757,29620841,CNL
chr10,Bn43441,15531295,39449709,23918414,TNL
chr10,Bn43442,82411135,86921362,4510227,CNL
chr10,Bn43443,76359658,89464518,13104860,RLK
chr10,Bn43444,50812027,58582419,7770392,CN
chr10,Bn43445,85415193,86819358,1404165,RLP
chr10,Bn43446,52698569,85036816,32338247,CN
chr10,Bn43447,5376017,87582518,82206501,TN
chr10,Bn43448,39843430,75408929,35565499,NBS
chr10,Bn43449,1877964,50594524,48716560,TN
chr10,Bn43450,43799918,97778416,53978498,TNL
chr10,Bn43451,40964248,75445822,34481574,TNL
chr10,Bn43452,51069385,92542058,41472673,RLP
chr10,Bn43453,47070905,85990982,38920077,TN
chr10,Bn43454,11289686,55555079,44265393,TNL
chr10,Bn43455,43035775,82126348,39090573,NBS
chr10,Bn43456,15909312,75826821,59917509,RLP
chr10,Bn43457,5327132,45994185,40667053,TNL
chr10,Bn43458,2984796,74554058,71569262,NBS
chr10,Bn43459,26910748,66978690,40067942,NBS
chr10,Bn43460,63868181,77225371,13357190,TN
chr10,Bn43461,77527410,82343404,4815994,CN
chr10,Bn43462,15352181,74019709,58667528,TN
chr10,Bn43463,55944285,72981224,17036939,CN
chr10,Bn43464,51675691,52239059,563368,TNL
chr10,Bn43465,12958020,73357089,60399069,CN
chr10,Bn43466,37865364,47594004,9728640,CNL
chr10,Bn43467,56310325,68842687,12532362,CNL
chr10,Bn43468,79261287,79275483,14196,TNL
chr10,Bn43469,9455153,44108556,34653403,NBS
chr10,Bn43470,20838147,92112318,71274171,RLP
chr10,Bn43471,30030311,98111722,68081411,NBS
chr10,Bn43472,84164836,94819468,10654632,CN
chr10,Bn43473,2451565,41826909,39375344,NBS
chr10,Bn43474,99902593,99936537,33944,CNL
chr10,Bn43475,76559349,84716654,8157305,CN
chr10,Bn43476,78795310,82437889,3642579,RLP
chr10,Bn43477,91263244,94109757,2846513,TNL
chr10,Bn43478,20473049,44818426,24345377,RLK
chr10,Bn43479,86196468,94477327,8280859,CN
chr10,Bn43480,66067835,75206419,9138584,RLK
chr10,Bn43481,64261623,75329184,11067561,TNL
chr10,Bn43482,54304748,91379825,37075077,CNL
chr10,Bn43483,82680728,96617288,13936560,CN
chr10,Bn43484,98641341,99667000,1025659,CN
chr10,Bn43485,3252345,84680183,81427838,CN
chr10,Bn43486,70536044,83546224,13010180,TNL
chr10,Bn43487,76096540,97808167,21711627,TN
chr10,Bn43488,96382784,99903217,3520433,TN
chr10,Bn43489,63633907,95476213,31842306,CNL
chr10,Bn43490,51213060,75065028,23851968,RLP
chr10,Bn43491,1060776,91644150,90583374,RLP
chr10,Bn43492,52835942,61629832,8793890,RLP
chr10,Bn43493,93967560,95900231,1932671,CN
chr10,Bn43494,71929107,79548039,7618932,RLK
chr10,Bn43495,43535365,96395807,52860442,RLK
chr10,Bn43496,39520211,72009263,32489052,CN
chr10,Bn43497,77530175,90133470,12603295,NBS
chr10,Bn43498,29621452,47846001,18224549,RLK
chr10,Bn43499,42592070,85662743,43070673,TN
chr10,Bn43500,1030397,75715262,74684865,CNL
chr10,Bn43501,6889383,10407559,3518176,NBS
chr10,Bn43502,5308513,79690600,74382087,TNL
chr10,Bn43503,48659809,61438691,12778882,TN
chr10,Bn43504,74812953,88016579,13203626,CN
chr10,Bn43505,72971082,81134568,8163486,TNL
chr10,Bn43506,39335555,48810745,9475190,TN
chr10,Bn43507,29574093,94683926,65109833,RLP
chr10,Bn43508,56255777,72219138,15963361,TNL
chr10,Bn43509,14057772,32106526,18048754,TN
chr10,Bn43510,8216023,33196511,24980488,CN
chr10,Bn43511,74372567,86266829,11894262,NBS
chr10,Bn43512,46889868,88326103,41436235,TN
chr10,Bn43513,5013265,87833317,82820052,RLP
chr10,Bn43514,29832595,36566193,6733598,RLK
chr10,Bn43515,79679812,94609037,14929225,TNL
chr10,Bn43516,95041946,95791567,749621,TN
chr10,Bn43517,39523004,43147658,3624654,CNL
chr10,Bn43518,56986886,72282254,15295368,TNL
chr10,Bn43519,45632660,85688393,40055733,NBS
chr10,Bn43520,73531941,78110593,4578652,NBS
chr10,Bn43521,31504991,87645307,56140316,CNL
chr10,Bn43522,42067960,60235306,18167346,RLK
chr10,Bn43523,81285165,98530752,17245587,TN
chr10,Bn43524,69690422,71518074,1827652,RLK
chr10,Bn43525,95231867,99173677,3941810,RLP
chr10,Bn43526,40994597,87865212,46870615,CNL
chr10,Bn43527,54766978,92931559,38164581,RLP
chr10,Bn43528,54190786,81038082,26847296,CN
chr10,Bn43529,66247931,94229634,27981703,TN
chr10,Bn43530,50808700,69639285,18830585,TNL
chr10,Bn43531,9614950,74435637,64820687,CNL
chr10,Bn43532,38275734,39253871,978137,CNL
chr10,Bn43533,19232761,57399759,38166998,NBS
chr10,Bn43534,3835380,69559924,65724544,CNL
chr10,Bn43535,14881042,99128857,84247815,CN
chr10,Bn43536,90390071,98707099,8317028,CNL
chr10,Bn43537,29625965,60015432,30389467,RLK
chr10,Bn43538,44875868,65502632,20626764,TN
chr10,Bn43539,47877619,67590583,19712964,NBS
chr10,Bn43540,25140551,77794961,52654410,RLP
chr10,Bn43541,60316383,62974538,2658155,CN
chr10,Bn43542,90959915,94938700,3978785,TNL
chr10,Bn43543,16151914,53149571,36997657,CNL
chr10,Bn43544,68605336,71919683,3314347,TN
chr10,Bn43545,40796756,65544304,24747548,CN
chr10,Bn43546,55406549,78329098,22922549,RLP
chr10,Bn43547,86204718,91222393,5017675,RLP
chr10,Bn43548,97604510,99564610,1960100,CN
chr10,Bn43549,19404794,94278564,74873770,TNL
chr10,Bn43550,76824415,80644076,3819661,CN
chr10,Bn43551,85397268,99465651,14068383,NBS
chr10,Bn43552,38493734,64566187,26072453,RLK
chr10,Bn43553,13369925,43015730,29645805,TN
chr10,Bn43554,5441479,33242455,27800976,RLK
chr10,Bn43555,63558337,88695575,25137238,RLP
chr10,Bn43556,41523546,76456880,34933334,CNL
chr10,Bn43557,63901684,89749222,25847538,TNL
chr10,Bn43558,28173641,53470310,25296669,NBS
chr10,Bn43559,19499123,28245400,8746277,TNL
chr10,Bn43560,27797544,53826107,26028563,TNL
chr10,Bn43561,98294118,99428312,1134194,TN
chr10,Bn43562,36787965,38781618,1993653,TNL
chr10,Bn43563,41640280,92891501,51251221,TN
chr10,Bn43564,72106615,78481519,6374904,NBS
chr10,Bn43565,19385817,48502616,29116799,CNL
chr10,Bn43566,8884070,64158646,55274576,CN
chr10,Bn43567,81423487,87188508,5765021,CN
chr10,Bn43568,85459175,87200156,1740981,NBS
chr10,Bn43569,9286621,15725825,6439204,TNL
chr10,Bn43570,92598851,92756259,157408,RLP
chr10,Bn43571,95737097,98606666,2869569,RLP
chr10,Bn43572,31698695,99871651,68172956,TNL
chr10,Bn43573,60426364,98451515,38025151,TN
chr10,Bn43574,35849066,94553139,58704073,TNL
chr10,Bn43575,9394028,67518488,58124460,NBS
chr10,Bn43576,14986958,65649291,50662333,TNL
chr10,Bn43577,86346598,88322763,1976165,TNL
chr10,Bn43578,23016565,51856544,28839979,TNL
chr10,Bn43579,77128340,82696648,5568308,CN
chr10,Bn43580,55200033,83911002,28710969,TNL
chr10,Bn43581,67536714,95631104,28094390,RLP
chr10,Bn43582,19696441,60199773,40503332,RLK
chr10,Bn43583,71411962,82570738,11158776,CN
chr10,Bn43584,88903630,92069065,3165435,TNL
chr10,Bn43585,88776241,96047790,7271549,RLP
chr10,Bn43586,26404259,84642003,58237744,RLP
chr10,Bn43587,22566332,61302911,38736579,RLK
chr10,Bn43588,76864337,96419834,19555497,TNL
chr10,Bn43589,27109556,89247700,62138144,CN
chr10,Bn43590,97595392,99806346,2210954,NBS
chr10,Bn43591,73770728,76218146,2447418,TN
chr10,Bn43592,1339559,58462398,57122839,TNL
chr10,Bn43593,26400886,88659765,62258879,TN
chr10,Bn43594,21849716,33902050,12052334,CN
chr10,Bn43595,7630141,78519735,70889594,RLP
chr10,Bn43596,28984638,65155666,36171028,RLK
chr10,Bn43597,72734555,96420580,23686025,RLK
chr10,Bn43598,13664836,24650813,10985977,TNL
chr10,Bn43599,98437728,98620198,182470,CN
chr10,Bn43600,28343323,38157667,9814344,RLK
chr10,Bn43601,4839282,11013576,6174294,CNL
chr10,Bn43602,41304777,43610107,2305330,RLK
chr10,Bn43603,9851416,67902693,58051277,NBS
chr10,Bn43604,51191467,64336979,13145512,TN
chr10,Bn43605,6716363,22926802,16210439,TNL
chr10,Bn43606,86272578,97976301,11703723,CN
chr10,Bn43607,88953542,99205141,10251599,TNL
chr10,Bn43608,27674403,87581695,59907292,NBS
chr10,Bn43609,61981670,62619786,638116,NBS
chr10,Bn43610,97939392,99482165,1542773,TNL
chr10,Bn43611,69467352,88119944,18652592,TN
chr10,Bn43612,1303611,12375538,11071927,NBS
chr10,Bn43613,47363100,48299269,936169,NBS
chr10,Bn43614,89289942,98307644,9017702,TN
chr10,Bn43615,26919675,35097658,8177983,NBS
chr10,Bn43616,57954466,96879068,38924602,NBS
chr10,Bn43617,70746086,72130883,1384797,NBS
chr10,Bn43618,47542072,72575110,25033038,TNL
chr10,Bn43619,23254190,49466705,26212515,NBS
chr10,Bn43620,18881159,96644561,77763402,TN
chr10,Bn43621,73939868,98676223,24736355,CN
chr10,Bn43622,97710406,99844805,2134399,CNL
chr10,Bn43623,17039210,35446151,18406941,RLK
chr10,Bn43624,12614318,87324807,74710489,TNL
chr10,Bn43625,69879913,86073729,16193816,TNL
chr10,Bn43626,95116841,97888708,2771867,RLP
chr10,Bn43627,41540298,54751972,13211674,TNL
chr10,Bn43628,14482235,35926592,21444357,RLK
chr10,Bn43629,53581946,90864676,37282730,TNL
chr10,Bn43630,78124618,79416648,1292030,RLP
chr10,Bn43631,9046814,26928088,17881274,CN
chr10,Bn43632,97002204,99867255,2865051,NBS
chr10,Bn43633,67973687,94311147,26337460,RLK
chr10,Bn43634,70266044,73468306,3202262,CN
chr10,Bn43635,6323548,83533434,77209886,RLP
chr10,Bn43636,83398428,91132597,7734169,RLK
chr10,Bn43637,96737213,97968088,1230875,RLK
chr10,Bn43638,71501191,89056748,17555557,NBS
chr10,Bn43639,40088723,80774896,40686173,NBS
chr10,Bn43640,9681944,81021537,71339593,NBS
chr10,Bn43641,13138832,13257731,118899,TNL
chr10,Bn43642,76975731,98690731,21715000,RLK
chr10,Bn43643,24860737,34820905,9960168,CN
chr10,Bn43644,31799927,48490424,16690497,RLK
chr10,Bn43645,47177578,74947286,27769708,RLK
chr10,Bn43646,47131591,58585099,11453508,CNL
chr10,Bn43647,2783479,8700195,5916716,NBS
chr10,Bn43648,34819133,90889706,56070573,CNL
chr10,Bn43649,35150385,47042760,11892375,CN
chr10,Bn43650,11769432,35682812,23913380,TN
chr10,Bn43651,77351861,85546883,8195022,RLP
chr10,Bn43652,27194491,94531748,67337257,CN
chr10,Bn43653,54435573,67078534,12642961,TN
chr10,Bn43654,36782472,95104914,58322442,CN
chr10,Bn43655,98163707,99934878,1771171,CNL
chr10,Bn43656,13144033,97424148,84280115,CN
chr10,Bn43657,9742611,60133101,50390490,CN
chr10,Bn43658,52630306,88429555,35799249,RLP
chr10,Bn43659,29172852,97322018,68149166,NBS
chr10,Bn43660,3506514,92342194,88835680,NBS
chr10,Bn43661,92399946,96803800,4403854,RLP
chr10,Bn43662,95969893,96898469,928576,CN
chr10,Bn43663,83050111,93966734,10916623,TN
chr10,Bn43664,54438165,54763234,325069,TN
chr10,Bn43665,70193741,83091096,12897355,NBS
chr10,Bn43666,92345301,98980230,6634929,TN
chr10,Bn43667,8467256,47897085,39429829,RLK
chr10,Bn43668,8777334,34544850,25767516,NBS
chr10,Bn43669,83583425,91876471,8293046,TNL
chr10,Bn43670,56689544,58900564,2211020,NBS
chr10,Bn43671,79031347,83451675,4420328,TN
chr10,Bn43672,18937122,55707707,36770585,CNL
chr10,Bn43673,15291128,66546693,51255565,TN
chr10,Bn43674,8902036,94663827,85761791,TN
chr10,Bn43675,97424038,99480623,2056585,RLK
chr10,Bn43676,28996195,94840952,65844757,NBS
chr10,Bn43677,83262687,99247701,15985014,TNL
chr10,Bn43678,76822174,88756497,11934323,RLK
chr10,Bn43679,58897954,89344844,30446890,TNL
chr10,Bn43680,36570446,63323235,26752789,RLK
chr10,Bn43681,61141191,80109411,18968220,RLP
chr10,Bn43682,93215878,94636517,1420639,RLK
chr10,Bn43683,18378977,93208911,74829934,NBS
chr10,Bn43684,93126797,93474856,348059,CNL
chr10,Bn43685,77395024,95130201,17735177,RLP
chr10,Bn43686,46694085,75593535,28899450,TNL
chr10,Bn43687,73876297,78920498,5044201,RLK
chr10,Bn43688,10026789,38661170,28634381,NBS
chr10,Bn43689,48086471,48431808,345337,RLK
chr10,Bn43690,78223368,81385219,3161851,CNL
chr10,Bn43691,93602685,93973398,370713,CN
chr10,Bn43692,36903969,87352102,50448133,CN
chr10,Bn43693,65266441,74852383,9585942,CNL
chr10,Bn43694,93588850,94792418,1203568,NBS
chr10,Bn43695,2714831,38142548,35427717,RLK
chr10,Bn43696,23816243,92541999,68725756,CN
chr10,Bn43697,25465062,39791942,14326880,NBS
chr10,Bn43698,30770437,68172513,37402076,CN
chr10,Bn43699,84298335,85976369,1678034,CN
chr10,Bn43700,43316452,72600954,29284502,RLP
chr10,Bn43701,65260407,78365219,13104812,TNL
chr10,Bn43702,78473032,88916850,10443818,TN
chr10,Bn43703,6363355,17375213,11011858,CNL
chr10,Bn43704,25247408,42405939,17158531,TNL
chr10,Bn43705,79868479,92714735,12846256,NBS
chr10,Bn43706,52609857,55533839,2923982,CNL
chr10,Bn43707,50416439,91629210,41212771,TNL
chr10,Bn43708,59831353,81336060,21504707,TN
chr10,Bn43709,57186836,72640175,15453339,CNL
chr10,Bn43710,58659754,60649315,1989561,TN
chr10,Bn43711,29902814,50849456,20946642,RLK
chr10,Bn43712,91153580,95690562,4536982,CNL
chr10,Bn43713,63267246,83299730,20032484,RLK
chr10,Bn43714,72549051,74165431,1616380,CNL
chr10,Bn43715,30473393,94114690,63641297,RLK
chr10,Bn43716,43152723,95811428,52658705,NBS
chr10,Bn43717,64953680,66626179,1672499,CNL
chr10,Bn43718,64611201,75007805,10396604,RLP
chr10,Bn43719,92991169,99949974,6958805,TNL
chr10,Bn43720,73274575,87475779,14201204,NBS
chr10,Bn43721,6788597,32609943,25821346,TNL
chr10,Bn43722,10196858,55364832,45167974,RLK
chr10,Bn43723,20802426,34647560,13845134,NBS
chr10,Bn43724,5520813,90852729,85331916,RLK
chr10,Bn43725,63210431,63938512,728081,RLP
chr10,Bn43726,82612585,92225095,9612510,TNL
chr10,Bn43727,82135365,90008398,7873033,CNL
chr10,Bn43728,97524661,98986521,1461860,TNL
chr10,Bn43729,28875966,88004182,59128216,RLK
chr10,Bn43730,76242575,82035283,5792708,CN
chr10,Bn43731,60366742,71081403,10714661,RLP
chr10,Bn43732,96461772,99936277,3474505,NBS
chr10,Bn43733,39979373,59082700,19103327,NBS
chr10,Bn43734,60314621,61801900,1487279,RLP
chr10,Bn43735,89879740,90120761,241021,TNL
chr10,Bn43736,55432188,69944054,14511866,CN
chr10,Bn43737,24160951,74083787,49922836,NBS
chr10,Bn43738,31954928,75480987,43526059,CNL
chr10,Bn43739,17526724,31912196,14385472,TNL
chr10,Bn43740,41381983,73580990,32199007,NBS
chr10,Bn43741,27462458,53132629,25670171,RLK
chr10,Bn43742,1006161,21366706,20360545,RLP
chr10,Bn43743,73638652,97839279,24200627,TN
chr10,Bn43744,67743354,88075573,20332219,CNL
chr10,Bn43745,5186874,71737156,66550282,RLK
chr10,Bn43746,13546643,21559464,8012821,TN
chr10,Bn43747,83136403,98382838,15246435,CNL
chr10,Bn43748,84029534,94642382,10612848,TNL
chr10,Bn43749,9360922,18064404,8703482,RLK
chr10,Bn43750,84974502,95942792,10968290,RLK
chr10,Bn43751,76103392,89558249,13454857,RLK
chr10,Bn43752,5187158,83544342,78357184,NBS
chr10,Bn43753,24944015,35461422,10517407,RLK
chr10,Bn43754,57519335,57736237,216902,RLK
chr10,Bn43755,92749719,94903582,2153863,CNL
chr10,Bn43756,47008682,79216551,32207869,CNL
chr10,Bn43757,31760382,70517390,38757008,RLP
chr10,Bn43758,25060450,52318476,27258026,TNL
chr10,Bn43759,47313093,78836618,31523525,CNL
chr10,Bn43760,49015164,79680482,30665318,CN
chr10,Bn43761,45754201,52514226,6760025,RLP
chr10,Bn43762,56141757,69022435,12880678,TNL
chr10,Bn43763,37860730,99699121,61838391,TN
chr10,Bn43764,17599546,66173819,48574273,CN
chr10,Bn43765,87334433,94150126,6815693,TN
chr10,Bn43766,6358005,76039419,69681414,CNL
chr10,Bn43767,4803585,92398522,87594937,TN
chr10,Bn43768,64153232,72699777,8546545,CNL
chr10,Bn43769,64917301,88133482,23216181,RLP
chr10,Bn43770,6476384,55143192,48666808,RLK
chr10,Bn43771,70542978,93393446,22850468,RLK
chr10,Bn43772,84539715,98894970,14355255,NBS
chr10,Bn43773,9609543,54969484,45359941,CNL
chr10,Bn43774,77939556,90701340,12761784,CNL
chr10,Bn43775,57969225,89028075,31058850,TNL
chr10,Bn43776,72583903,90867912,18284009,TNL
chr10,Bn43777,35317181,68322286,33005105,CNL
chr10,Bn43778,97292494,98625678,1333184,CN
chr10,Bn43779,21082402,46736788,25654386,NBS
chr10,Bn43780,76619560,76781712,162152,RLK
chr10,Bn43781,98426604,99602071,1175467,TNL
chr10,Bn43782,85103507,98146493,13042986,CNL
chr10,Bn43783,67799284,93633286,25834002,RLK
chr10,Bn43784,35046155,59013906,23967751,TN
chr10,Bn43785,63414594,64934867,1520273,NBS
chr10,Bn43786,40775065,93122139,52347074,TNL
chr10,Bn43787,12168210,42400110,30231900,RLK
chr10,Bn43788,88513041,88782032,268991,RLK
chr10,Bn43789,58844970,75202566,16357596,NBS
chr10,Bn43790,53927236,66147406,12220170,TNL
chr10,Bn43791,95441531,98432297,2990766,CN
chr10,Bn43792,63759470,68070638,4311168,TN
chr10,Bn43793,34817978,55626329,20808351,TN
chr10,Bn43794,65767157,76994401,11227244,TNL
chr10,Bn43795,36879111,73552482,36673371,RLP
chr10,Bn43796,9476643,35882366,26405723,RLK
chr10,Bn43797,38600305,54249261,15648956,RLP
chr10,Bn43798,56668004,80858515,24190511,TNL
chr10,Bn43799,24543511,50873922,26330411,TN
chr10,Bn43800,69998496,88535805,18537309,NBS
chr10,Bn43801,19050295,19363100,312805,CNL
chr10,Bn43802,96449520,97912622,1463102,CNL
chr10,Bn43803,79001127,86605665,7604538,CNL
chr10,Bn43804,16096149,70447013,54350864,CNL
chr10,Bn43805,53425379,65008324,11582945,RLP
chr10,Bn43806,70356289,98372933,28016644,NBS
chr10,Bn43807,89022752,99031602,10008850,CNL
chr10,Bn43808,99995217,99998288,3071,TN
chr10,Bn43809,34575262,83949957,49374695,CNL
chr10,Bn43810,21916028,94444623,72528595,CNL
chr10,Bn43811,87794331,90846222,3051891,TNL
chr10,Bn43812,92336688,93851126,1514438,TNL
chr10,Bn43813,16795405,62562964,45767559,CNL
chr10,Bn43814,62294570,97217833,34923263,NBS
chr10,Bn43815,48506266,71272789,22766523,RLK
chr10,Bn43816,31695736,38357584,6661848,RLP
chr10,Bn43817,30559998,56473125,25913127,NBS
chr10,Bn43818,3838482,37448416,33609934,TN
chr10,Bn43819,46688827,55054946,8366119,RLP
chr10,Bn43820,53432310,73452688,20020378,RLP
chr10,Bn43821,5272443,28140053,22867610,NBS
chr10,Bn43822,10410927,32575048,22164121,RLP
chr10,Bn43823,22021305,74267724,52246419,TNL
chr10,Bn43824,90349775,96633708,6283933,TNL
chr10,Bn43825,6631898,77325647,70693749,NBS
chr10,Bn43826,67564296,77982401,10418105,RLK
chr10,Bn43827,3186878,64949252,61762374,TN
chr10,Bn43828,95396997,99800832,4403835,NBS
chr10,Bn43829,97602908,99352949,1750041,TNL
chr10,Bn43830,9695473,79347451,69651978,RLK
chr10,Bn43831,41780717,69188224,27407507,TN
chr10,Bn43832,80555910,83711049,3155139,RLK
chr10,Bn43833,40382443,59640511,19258068,TNL
chr10,Bn43834,38049403,52196316,14146913,RLP
chr10,Bn43835,41841425,48321474,6480049,RLK
chr10,Bn43836,42880270,47975432,5095162,RLP
chr10,Bn43837,3722966,97179613,93456647,RLK
chr10,Bn43838,72781959,93673452,20891493,CNL
chr10,Bn43839,80969223,82625407,1656184,RLP
chr10,Bn43840,4555282,40380987,35825705,NBS
chr10,Bn43841,72994905,87202993,14208088,CN
chr10,Bn43842,4706560,9611978,4905418,CNL
chr10,Bn43843,65040279,90858164,25817885,CN
chr10,Bn43844,23993283,67002794,43009511,RLK
chr10,Bn43845,93378279,95022862,1644583,NBS
chr10,Bn43846,25540793,72997143,47456350,TNL
chr10,Bn43847,97817402,98891534,1074132,RLK
chr10,Bn43848,9767318,55312686,45545368,RLK
chr10,Bn43849,51807816,99072447,47264631,TN
chr10,Bn43850,91858457,92057992,199535,RLP
chr10,Bn43851,31273342,98133295,66859953,CNL
chr10,Bn43852,69117572,94221563,25103991,CNL
chr10,Bn43853,59329166,91298725,31969559,TN
chr10,Bn43854,93144793,96462677,3317884,TNL
chr10,Bn43855,25247000,61492979,36245979,RLK
chr10,Bn43856,10832394,97078788,86246394,TN
chr10,Bn43857,61193561,79889591,18696030,RLP
chr10,Bn43858,79015280,91197989,12182709,NBS
chr10,Bn43859,78306617,78642548,335931,TN
chr10,Bn43860,87870179,99129182,11259003,CNL
chr10,Bn43861,16054202,65410609,49356407,TN
chr10,Bn43862,52104401,72811632,20707231,TNL
chr10,Bn43863,12298339,25791476,13493137,CN
chr10,Bn43864,20383369,37839306,17455937,TNL
chr10,Bn43865,27391306,55080719,27689413,TNL
chr10,Bn43866,88990340,96734367,7744027,CNL
chr10,Bn43867,92696076,98425055,5728979,TNL
chr10,Bn43868,88284500,97808392,9523892,CN
chr10,Bn43869,96490982,99046768,2555786,NBS
chr10,Bn43870,89213723,93981655,4767932,NBS
chr10,Bn43871,51678327,94226233,42547906,RLP
chr10,Bn43872,93262928,99171407,5908479,TN
chr10,Bn43873,21729587,98794810,77065223,CNL
chr10,Bn43874,34562843,34603595,40752,NBS
chr10,Bn43875,20279573,31880116,11600543,NBS
chr10,Bn43876,75531498,81997891,6466393,TNL
chr10,Bn43877,80632972,91225653,10592681,CN
chr10,Bn43878,76416647,97021963,20605316,RLP
chr10,Bn43879,52993276,73945778,20952502,RLP
chr10,Bn43880,21216949,76274185,55057236,RLP
chr10,Bn43881,36716487,52929433,16212946,TN
chr10,Bn43882,26902771,80290943,53388172,CN
chr10,Bn43883,91765154,98258807,6493653,NBS
chr10,Bn43884,54104337,88163844,34059507,CN
chr10,Bn43885,4236467,64999391,60762924,CNL
chr10,Bn43886,45220822,76917667,31696845,RLK
chr10,Bn43887,94362606,97483936,3121330,CNL
chr10,Bn43888,57288659,80465277,23176618,CN
chr10,Bn43889,57551480,63137924,5586444,CNL
chr10,Bn43890,55751258,99177214,43425956,CN
chr10,Bn43891,95334405,97836762,2502357,RLP
chr10,Bn43892,15535324,28820110,13284786,CNL
chr10,Bn43893,80103626,97058125,16954499,TN
chr10,Bn43894,42827007,73228041,30401034,RLP
chr10,Bn43895,85402302,91816654,6414352,RLK
chr10,Bn43896,44249507,45837877,1588370,RLP
chr10,Bn43897,17179010,68507214,51328204,NBS
chr10,Bn43898,78877769,90614532,11736763,CNL
chr10,Bn43899,1145529,18426794,17281265,TNL
chr10,Bn43900,94820098,97423037,2602939,RLK
chr10,Bn43901,76997566,87888048,10890482,RLK
chr10,Bn43902,16605593,78325460,61719867,CNL
chr10,Bn43903,8856013,87537284,78681271,TNL
chr10,Bn43904,83445682,85900424,2454742,RLK
chr10,Bn43905,15659956,28109129,12449173,CNL
chr10,Bn43906,81252372,84340403,3088031,CNL
chr10,Bn43907,62511390,84576919,22065529,CN
chr10,Bn43908,78470412,97696408,19225996,CN
chr10,Bn43909,72818002,94010467,21192465,RLK
chr10,Bn43910,95116104,98986369,3870265,RLK
chr10,Bn43911,96237019,98517503,2280484,RLP
chr10,Bn43912,49556370,96510517,46954147,CNL
chr10,Bn43913,45465871,73188157,27722286,RLK
chr10,Bn43914,28551314,69826172,41274858,TNL
chr10,Bn43915,99479232,99634693,155461,RLP
chr10,Bn43916,31386759,53926735,22539976,RLP
chr10,Bn43917,14609613,33319426,18709813,TN
chr10,Bn43918,50609797,67560072,16950275,CNL
chr10,Bn43919,57126882,92949867,35822985,TNL
chr10,Bn43920,84639688,85147016,507328,CN
chr10,Bn43921,72374978,89590144,17215166,TN
chr10,Bn43922,63085136,83404259,20319123,RLK
chr10,Bn43923,83875105,97254457,13379352,RLP
chr10,Bn43924,54320643,61897543,7576900,RLP
chr10,Bn43925,22473269,36785432,14312163,CN
chr10,Bn43926,60676230,74072548,13396318,CN
chr10,Bn43927,71178846,83890066,12711220,CN
chr10,Bn43928,73265076,91905684,18640608,RLP
chr10,Bn43929,84366837,90929179,6562342,CNL
chr10,Bn43930,38062448,47958033,9895585,CN
chr10,Bn43931,43465220,98454732,54989512,RLK
chr10,Bn43932,62140955,95863368,33722413,CNL
chr10,Bn43933,54524509,71721688,17197179,RLK
chr10,Bn43934,83460234,89714959,6254725,RLP
chr10,Bn43935,78962745,80953145,1990400,CN
chr10,Bn43936,64529194,99779650,35250456,NBS
chr10,Bn43937,36707657,92253714,55546057,RLP
chr10,Bn43938,65970405,71374488,5404083,TN
chr10,Bn43939,3809205,49318219,45509014,RLK
chr10,Bn43940,97179963,99730957,2550994,CN
chr10,Bn43941,88185969,91767213,3581244,RLP
chr10,Bn43942,30015981,61079254,31063273,RLP
chr10,Bn43943,57395083,65755591,8360508,CN
chr10,Bn43944,57479208,91440085,33960877,NBS
chr10,Bn43945,89568531,89683162,114631,TN
chr10,Bn43946,14020561,78622235,64601674,CN
chr10,Bn43947,79125813,93739339,14613526,RLK
chr10,Bn43948,65579827,69432195,3852368,TN
chr10,Bn43949,26316365,98357448,72041083,TN
chr10,Bn43950,6241876,83860967,77619091,RLK
chr10,Bn43951,5278087,19549742,14271655,TNL
chr10,Bn43952,30633184,78977167,48343983,RLP
chr10,Bn43953,80190970,90289443,10098473,RLK
chr10,Bn43954,68421713,77658318,9236605,RLP
chr10,Bn43955,87542749,93999607,6456858,CN
chr10,Bn43956,45724506,95089175,49364669,TN
chr10,Bn43957,1800495,46353667,44553172,RLK
chr10,Bn43958,72986528,79026153,6039625,TN
chr10,Bn43959,23883843,90953123,67069280,CN
chr10,Bn43960,2141893,19928273,17786380,CN
chr10,Bn43961,83448941,96922839,13473898,RLK
chr10,Bn43962,81695367,87524062,5828695,NBS
chr10,Bn43963,66334704,81238955,14904251,CN
chr10,Bn43964,67666507,72769471,5102964,RLK
chr10,Bn43965,93545276,95281178,1735902,CN
chr10,Bn43966,14926336,73215815,58289479,CNL
chr10,Bn43967,82741643,92295652,9554009,TNL
chr10,Bn43968,15995135,74136540,58141405,RLK
chr10,Bn43969,56249570,91388853,35139283,TNL
chr10,Bn43970,70958503,79537249,8578746,CN
chr10,Bn43971,39112604,43860730,4748126,RLK
chr10,Bn43972,7720471,62976527,55256056,RLK
chr10,Bn43973,74263647,83172769,8909122,CN
chr10,Bn43974,56090936,63161175,7070239,CN
chr10,Bn43975,91538295,94446597,2908302,CNL
chr10,Bn43976,84439763,95952840,11513077,CNL
chr10,Bn43977,2396043,84481254,82085211,RLP
chr10,Bn43978,20613564,83359507,62745943,TNL
chr10,Bn43979,68790788,70787271,1996483,RLP
chr10,Bn43980,46005541,79934613,33929072,TNL
chr10,Bn43981,57633301,89787810,32154509,TN
chr10,Bn43982,3328170,78339916,75011746,RLK
chr10,Bn43983,77501622,79867605,2365983,TN
chr10,Bn43984,42966057,94765002,51798945,RLK
chr10,Bn43985,33368524,35975623,2607099,CNL
chr10,Bn43986,13205607,32797885,19592278,TN
chr10,Bn43987,32917826,55183377,22265551,CNL
chr10,Bn43988,92185408,93376868,1191460,RLP
chr10,Bn43989,45773263,53227840,7454577,RLK
chr10,Bn43990,78981360,83683201,4701841,CN
chr10,Bn43991,62103444,97632875,35529431,NBS
chr10,Bn43992,74712086,90474559,15762473,CN
chr10,Bn43993,25330342,57116055,31785713,RLP
chr10,Bn43994,62541595,80966518,18424923,TNL
chr10,Bn43995,31170435,48456115,17285680,CN
chr10,Bn43996,53808831,61156997,7348166,NBS
chr10,Bn43997,42892754,60754025,17861271,CNL
chr10,Bn43998,35590195,67938939,32348744,RLP
chr10,Bn43999,55809272,80150236,24340964,CN
chr10,Bn44000,51712432,57404330,5691898,RLK
chr10,Bn44001,93737039,99259158,5522119,CNL
chr11,Bn44002,68285433,93427394,25141961,NBS
chr11,Bn44003,99980220,99986002,5782,CNL
chr11,Bn44004,3412440,62643674,59231234,RLK
chr11,Bn44005,53637368,96952487,43315119,NBS
chr11,Bn44006,78712666,84692829,5980163,RLK
chr11,Bn44007,31952195,50122267,18170072,TN
chr11,Bn44008,41359409,41359993,584,RLK
chr11,Bn44009,62144491,79920227,17775736,NBS
chr11,Bn44010,72533347,95116839,22583492,CN
chr11,Bn44011,74047078,74862507,815429,CN
chr11,Bn44012,3634342,91773049,88138707,RLP
chr11,Bn44013,67046515,90088868,23042353,RLP
chr11,Bn44014,33557108,34031120,474012,CNL
chr11,Bn44015,62828111,71549291,8721180,CN
chr11,Bn44016,29894360,89138632,59244272,TN
chr11,Bn44017,83279369,99820258,16540889,RLK
chr11,Bn44018,10062761,26743586,16680825,TN
chr11,Bn44019,13258346,17743052,4484706,RLK
chr11,Bn44020,32514261,84772827,52258566,RLK
chr11,Bn44021,67930446,87468712,19538266,TNL
chr11,Bn44022,77910375,84829506,6919131,TN
chr11,Bn44023,81090889,88003115,6912226,CN
chr11,Bn44024,37628825,66397906,28769081,CN
chr11,Bn44025,4374132,70024306,65650174,TNL
chr11,Bn44026,39886651,95009088,55122437,CNL
chr11,Bn44027,43659425,85472729,41813304,TN
chr11,Bn44028,36599049,79561867,42962818,CNL
chr11,Bn44029,27710853,45327700,17616847,RLP
chr11,Bn44030,34582289,77841814,43259525,CN
chr11,Bn44031,70996907,88825280,17828373,CN
chr11,Bn44032,30710965,72416224,41705259,NBS
chr11,Bn44033,18394193,46950959,28556766,RLK
chr11,Bn44034,93761184,97634746,3873562,CNL
chr11,Bn44035,93916631,97180248,3263617,RLP
chr11,Bn44036,94497544,97520054,3022510,RLP
chr11,Bn44037,99892785,99907627,14842,RLK
chr11,Bn44038,69747907,88352922,18605015,TNL
chr11,Bn44039,21214872,98634771,77419899,NBS
chr11,Bn44040,2370900,63040979,60670079,RLP
chr11,Bn44041,73593994,81579017,7985023,CNL
chr11,Bn44042,2606673,76594260,73987587,TNL
chr11,Bn44043,6625598,91100973,84475375,TNL
chr11,Bn44044,44854250,87152797,42298547,TN
chr11,Bn44045,2527362,85199606,82672244,RLK
chr11,Bn44046,26080984,39285870,13204886,RLP
chr11,Bn44047,91622658,98135413,6512755,CN
chr11,Bn44048,28489321,70033643,41544322,CNL
chr11,Bn44049,69827966,74342588,4514622,RLK
chr11,Bn44050,76920581,81723909,4803328,CNL
chr11,Bn44051,84120003,85938999,1818996,TN
chr11,Bn44052,45674049,47728798,2054749,RLK
chr11,Bn44053,59906763,80985375,21078612,NBS
chr11,Bn44054,92886505,94499482,1612977,RLK
chr11,Bn44055,90892451,93030660,2138209,NBS
chr11,Bn44056,80090564,91445422,11354858,RLK
chr11,Bn44057,90593720,96844013,6250293,CN
chr11,Bn44058,75102136,89942684,14840548,NBS
chr11,Bn44059,75526528,80975093,5448565,TN
chr11,Bn44060,93127899,95758969,2631070,TNL
chr11,Bn44061,34088835,47510343,13421508,TNL
chr11,Bn44062,32651836,57672307,25020471,RLK
chr11,Bn44063,74333000,84127041,9794041,RLP
chr11,Bn44064,23837755,50463864,26626109,CN
chr11,Bn44065,99654895,99758854,103959,RLK
chr11,Bn44066,85941924,99541842,13599918,CN
chr11,Bn44067,89286654,94265905,4979251,CNL
chr11,Bn44068,61331104,79006618,17675514,TN
chr11,Bn44069,93134563,99577837,6443274,RLK
chr11,Bn44070,88794180,99278318,10484138,RLK
chr11,Bn44071,11097952,21580257,10482305,TNL
chr11,Bn44072,70975351,88581895,17606544,NBS
chr11,Bn44073,84126095,91774194,7648099,NBS
chr11,Bn44074,40628578,76703058,36074480,RLK
chr11,Bn44075,24432928,35030147,10597219,TN
chr11,Bn44076,41658367,92473759,50815392,RLK
chr11,Bn44077,97699979,98703877,1003898,NBS
chr11,Bn44078,46942185,80048049,33105864,CNL
chr11,Bn44079,59084602,68107261,9022659,CNL
chr11,Bn44080,8928616,60896761,51968145,TN
chr11,Bn44081,68035271,95056525,27021254,RLP
chr11,Bn44082,18930407,93725038,74794631,CN
chr11,Bn44083,97593684,99453513,1859829,RLK
chr11,Bn44084,56430481,95943469,39512988,TN
chr11,Bn44085,27175906,57735436,30559530,CN
chr11,Bn44086,97432510,98039779,607269,RLP
chr11,Bn44087,6505871,92735790,86229919,TN
chr11,Bn44088,16197455,61195244,44997789,TNL
chr11,Bn44089,65583434,70907621,5324187,CNL
chr11,Bn44090,75237070,75451764,214694,RLP
chr11,Bn44091,39638745,67436855,27798110,CN
chr11,Bn44092,52781622,60322724,7541102,CN
chr11,Bn44093,90850916,98865742,8014826,TN
chr11,Bn44094,45663344,90335639,44672295,TNL
chr11,Bn44095,75229675,76214857,985182,RLK
chr11,Bn44096,70992720,90847025,19854305,CNL
chr11,Bn44097,29049867,49541618,20491751,CNL
chr11,Bn44098,58523693,66706479,8182786,RLK
chr11,Bn44099,69280559,73012809,3732250,NBS
chr11,Bn44100,44162600,72736228,28573628,TNL
chr11,Bn44101,8091278,59054609,50963331,TN
chr11,Bn44102,69754126,70428647,674521,NBS
chr11,Bn44103,7308670,85932024,78623354,CN
chr11,Bn44104,71766380,80726612,8960232,NBS
chr11,Bn44105,10517080,16217690,5700610,CNL
chr11,Bn44106,64734077,96958371,32224294,RLK
chr11,Bn44107,99133289,99947723,814434,TN
chr11,Bn44108,94263529,97185104,2921575,CN
chr11,Bn44109,57650393,91399562,33749169,CNL
chr11,Bn44110,10666309,83979375,73313066,TNL
chr11,Bn44111,69404348,88039962,18635614,CNL
chr11,Bn44112,71003830,94374738,23370908,RLP
chr11,Bn44113,61084441,99105952,38021511,TNL
chr11,Bn44114,91131453,98728181,7596728,RLP
chr11,Bn44115,84629065,86666487,2037422,NBS
chr11,Bn44116,55652330,65164272,9511942,RLP
chr11,Bn44117,67680902,96934001,29253099,NBS
chr11,Bn44118,23876123,88515698,64639575,RLK
chr11,Bn44119,70702534,99395825,28693291,TN
chr11,Bn44120,12277947,29777655,17499708,CN
chr11,Bn44121,17927249,57178517,39251268,CN
chr11,Bn44122,22701788,40776652,18074864,TN
chr11,Bn44123,27531660,42247505,14715845,CNL
chr11,Bn44124,99603199,99990863,387664,TN
chr11,Bn44125,28739541,81604231,52864690,RLK
chr11,Bn44126,21596815,38365864,16769049,CNL
chr11,Bn44127,66924365,69840422,2916057,NBS
chr11,Bn44128,61468688,94349989,32881301,RLP
chr11,Bn44129,13298240,26298435,13000195,RLK
chr11,Bn44130,54474799,89092628,34617829,TNL
chr11,Bn44131,53734978,90560686,36825708,RLP
chr11,Bn44132,36582155,71030341,34448186,CNL
chr11,Bn44133,28364466,90669427,62304961,RLK
chr11,Bn44134,82516488,85496195,2979707,NBS
chr11,Bn44135,5572821,36589955,31017134,CNL
chr11,Bn44136,35512070,37507068,1994998,TNL
chr11,Bn44137,88997704,95567742,6570038,TNL
chr11,Bn44138,93823650,94057710,234060,RLK
chr11,Bn44139,66376187,90918996,24542809,TNL
chr11,Bn44140,44382035,60480907,16098872,TNL
chr11,Bn44141,7973680,45086898,37113218,NBS
chr11,Bn44142,66580385,80222051,13641666,TN
chr11,Bn44143,9040373,88252018,79211645,NBS
chr11,Bn44144,26468476,38503133,12034657,RLK
chr11,Bn44145,36349497,96926385,60576888,RLK
chr11,Bn44146,73801346,84547263,10745917,RLP
chr11,Bn44147,95793755,97582462,1788707,CNL
chr11,Bn44148,57836941,78839885,21002944,CNL
chr11,Bn44149,80011543,94078204,14066661,RLP
chr11,Bn44150,82147505,83352452,1204947,NBS
chr11,Bn44151,56951492,89546856,32595364,TNL
chr11,Bn44152,22646685,77769059,55122374,RLK
chr11,Bn44153,26796913,64081242,37284329,TNL
chr11,Bn44154,85280157,98628727,13348570,NBS
chr11,Bn44155,15641342,63205066,47563724,RLP
chr11,Bn44156,4613182,41610193,36997011,CNL
chr11,Bn44157,17603867,97736882,80133015,CN
chr11,Bn44158,64361678,76978833,12617155,RLP
chr11,Bn44159,5263432,98243835,92980403,TN
chr11,Bn44160,64367013,72595149,8228136,TNL
chr11,Bn44161,95380037,97082077,1702040,RLP
chr11,Bn44162,48220922,69658038,21437116,TNL
chr11,Bn44163,47482236,49356344,1874108,RLP
chr11,Bn44164,58902299,69329586,10427287,CNL
chr11,Bn44165,19011338,29888141,10876803,TN
chr11,Bn44166,45350352,63627079,18276727,NBS
chr11,Bn44167,26876630,40856566,13979936,TN
chr11,Bn44168,38406212,83630916,45224704,NBS
chr11,Bn44169,7397020,14000998,6603978,TN
chr11,Bn44170,68283607,68913846,630239,TNL
chr11,Bn44171,59483612,90165400,30681788,RLK
chr11,Bn44172,81522845,83263675,1740830,RLK
chr11,Bn44173,35472308,38343476,2871168,NBS
chr11,Bn44174,88892694,98588570,9695876,NBS
chr11,Bn44175,69154359,79527643,10373284,NBS
chr11,Bn44176,68242386,95731868,27489482,RLP
chr11,Bn44177,9010681,99785615,90774934,CN
chr11,Bn44178,36603952,89242158,52638206,CN
chr11,Bn44179,68812429,72710128,3897699,TN
chr11,Bn44180,39595883,96438281,56842398,TN
chr11,Bn44181,5561451,82890345,77328894,RLP
chr11,Bn44182,50101757,72271313,22169556,RLK
chr11,Bn44183,20613764,96973598,76359834,TN
chr11,Bn44184,4146079,46891095,42745016,TNL
chr11,Bn44185,26381527,51821611,25440084,RLP
chr11,Bn44186,54626190,93470012,38843822,CNL
chr11,Bn44187,46784318,95670477,48886159,NBS
chr11,Bn44188,4650911,35900715,31249804,CNL
chr11,Bn44189,71231661,82293385,11061724,NBS
chr11,Bn44190,91939395,99209017,7269622,RLP
chr11,Bn44191,63231194,92756764,29525570,RLP
chr11,Bn44192,41486873,99615049,58128176,NBS
chr11,Bn44193,92782790,97636957,4854167,RLK
chr11,Bn44194,85717054,92648430,6931376,TNL
chr11,Bn44195,20445901,39763737,19317836,TN
chr11,Bn44196,12632483,43190522,30558039,NBS
chr11,Bn44197,4659265,81019535,76360270,CNL
chr11,Bn44198,38969698,70061972,31092274,CNL
chr11,Bn44199,2600128,36365142,33765014,RLP
chr11,Bn44200,43270679,64678415,21407736,TNL
chr11,Bn44201,43788088,49452914,5664826,CNL
chr11,Bn44202,91471135,92875848,1404713,RLK
chr11,Bn44203,48911889,98224615,49312726,CN
chr11,Bn44204,17442990,83826132,66383142,TN
chr11,Bn44205,65055329,83578350,18523021,CN
chr11,Bn44206,26007616,81810932,55803316,CN
chr11,Bn44207,71560327,96056139,24495812,NBS
chr11,Bn44208,21076915,99133897,78056982,CN
chr11,Bn44209,8925673,62533658,53607985,TN
chr11,Bn44210,54073836,57300562,3226726,TNL
chr11,Bn44211,31841437,42117842,10276405,CNL
chr11,Bn44212,35073746,66269428,31195682,TN
chr11,Bn44213,42855482,68516751,25661269,TN
chr11,Bn44214,90614475,92771543,2157068,TN
chr11,Bn44215,53439349,60969537,7530188,NBS
chr11,Bn44216,82705182,96283423,13578241,TNL
chr11,Bn44217,18868858,90238056,71369198,CNL
chr11,Bn44218,42174063,86604142,44430079,RLK
chr11,Bn44219,23218302,97084892,73866590,RLP
chr11,Bn44220,98942476,99858171,915695,CN
chr11,Bn44221,36007493,55934175,19926682,TNL
chr11,Bn44222,4568144,68031364,63463220,TN
chr11,Bn44223,86390283,88992109,2601826,TN
chr11,Bn44224,11537144,40625234,29088090,RLK
chr11,Bn44225,6452807,7090018,637211,CN
chr11,Bn44226,96689712,97598108,908396,RLP
chr11,Bn44227,14227099,98211079,83983980,RLP
chr11,Bn44228,46601918,61062092,14460174,RLP
chr11,Bn44229,22233304,27183084,4949780,TN
chr11,Bn44230,39348585,40307014,958429,RLP
chr11,Bn44231,75133629,99449474,24315845,RLK
chr11,Bn44232,5777532,16509999,10732467,TN
chr11,Bn44233,47787596,91368234,43580638,TNL
chr11,Bn44234,34427030,53944188,19517158,CN
chr11,Bn44235,23336646,52433229,29096583,RLP
chr11,Bn44236,69371761,85391910,16020149,RLK
chr11,Bn44237,64667282,76802003,12134721,NBS
chr11,Bn44238,47745744,62455766,14710022,RLP
chr11,Bn44239,85690694,94008969,8318275,RLK
chr11,Bn44240,40012515,66582332,26569817,CNL
chr11,Bn44241,4463786,44206547,39742761,TN
chr11,Bn44242,73966017,89595069,15629052,RLP
chr11,Bn44243,48806980,84097264,35290284,TNL
chr11,Bn44244,32420351,73195900,40775549,CNL
chr11,Bn44245,8318765,31444984,23126219,TN
chr11,Bn44246,96062105,96171620,109515,NBS
chr11,Bn44247,13818689,64499272,50680583,CN
chr11,Bn44248,10424586,87264112,76839526,NBS
chr11,Bn44249,30955803,60791873,29836070,TN
chr11,Bn44250,74171936,90046389,15874453,NBS
chr11,Bn44251,99072750,99177276,104526,TN
chr11,Bn44252,17949881,86619928,68670047,TN
chr11,Bn44253,32842076,89106984,56264908,CNL
chr11,Bn44254,2057940,15355477,13297537,NBS
chr11,Bn44255,36413175,83110824,46697649,TN
chr11,Bn44256,25410203,46668138,21257935,RLK
chr11,Bn44257,34233275,72329323,38096048,NBS
chr11,Bn44258,51181217,90347424,39166207,CN
chr11,Bn44259,18717189,79578273,60861084,CNL
chr11,Bn44260,1583482,73066813,71483331,CN
chr11,Bn44261,8591124,52045731,43454607,RLP
chr11,Bn44262,68951914,93067161,24115247,TNL
chr11,Bn44263,89692335,90154078,461743,TNL
chr11,Bn44264,32874526,67735007,34860481,NBS
chr11,Bn44265,83297202,85988605,2691403,CN
chr11,Bn44266,80229362,87684167,7454805,RLK
chr11,Bn44267,91952608,96249733,4297125,RLK
chr11,Bn44268,88921380,91384712,2463332,TN
chr11,Bn44269,56751718,77365950,20614232,RLP
chr11,Bn44270,29329307,54344915,25015608,TN
chr11,Bn44271,72607077,82177641,9570564,CN
chr11,Bn44272,4668968,79424468,74755500,CN
chr11,Bn44273,80400596,91585278,11184682,CN
chr11,Bn44274,85996237,94552188,8555951,TNL
chr11,Bn44275,46305270,99125074,52819804,RLP
chr11,Bn44276,58281825,68722160,10440335,NBS
chr11,Bn44277,72584465,93421433,20836968,CN
chr11,Bn44278,92625228,96250690,3625462,RLK
chr11,Bn44279,61290191,98062985,36772794,TN
chr11,Bn44280,78232025,99342231,21110206,TN
chr11,Bn44281,74749749,95783948,21034199,NBS
chr11,Bn44282,20354750,47374155,27019405,CNL
chr11,Bn44283,84848848,94672685,9823837,CNL
chr11,Bn44284,47151156,91979731,44828575,RLK
chr11,Bn44285,94981192,97253182,2271990,RLK
chr11,Bn44286,66952336,86966198,20013862,CNL
chr11,Bn44287,32291009,43920026,11629017,TN
chr11,Bn44288,44099927,62713870,18613943,TNL
chr11,Bn44289,51966637,56101724,4135087,CNL
chr11,Bn44290,99024277,99884939,860662,CNL
chr11,Bn44291,81079972,92501004,11421032,RLP
chr11,Bn44292,28481285,95272346,66791061,RLP
chr11,Bn44293,15139282,61513387,46374105,NBS
chr11,Bn44294,29957508,94925064,64967556,TNL
chr11,Bn44295,4722356,61148297,56425941,CNL
chr11,Bn44296,61807893,81471819,19663926,CNL
chr11,Bn44297,72281344,73102864,821520,RLP
chr11,Bn44298,9660484,85327848,75667364,NBS
chr11,Bn44299,62402254,84687196,22284942,NBS
chr11,Bn44300,53882355,55715079,1832724,NBS
chr11,Bn44301,50781370,95401052,44619682,NBS
chr11,Bn44302,45530620,75680759,30150139,CNL
chr11,Bn44303,6829289,70967353,64138064,TNL
chr11,Bn44304,55647434,71165550,15518116,TNL
chr11,Bn44305,1873687,13667365,11793678,TN
chr11,Bn44306,96860974,98242269,1381295,RLK
chr11,Bn44307,92894764,97064174,4169410,RLP
chr11,Bn44308,7614059,32058332,24444273,RLK
chr11,Bn44309,75934998,88728029,12793031,CNL
chr11,Bn44310,60223774,62380145,2156371,CNL
chr11,Bn44311,71354748,95986846,24632098,CN
chr11,Bn44312,59464119,92845903,33381784,RLK
chr11,Bn44313,94264196,97881208,3617012,RLK
chr11,Bn44314,37991900,85918035,47926135,CN
chr11,Bn44315,91885293,99087774,7202481,TN
chr11,Bn44316,87505683,87777078,271395,CN
chr11,Bn44317,56953281,90467894,33514613,NBS
chr11,Bn44318,84832794,89132094,4299300,CNL
chr11,Bn44319,42010232,77346019,35335787,NBS
chr11,Bn44320,12642984,17442755,4799771,TN
chr11,Bn44321,99293194,99442585,149391,RLK
chr11,Bn44322,84328242,96140052,11811810,RLK
chr11,Bn44323,65046669,72475965,7429296,TN
chr11,Bn44324,8296963,17851766,9554803,NBS
chr11,Bn44325,71720408,73440981,1720573,NBS
chr11,Bn44326,91545612,98140893,6595281,TN
chr11,Bn44327,83697880,93206692,9508812,NBS
chr11,Bn44328,54225478,69451551,15226073,CN
chr11,Bn44329,59895663,81892127,21996464,NBS
chr11,Bn44330,12479414,75392022,62912608,CN
chr11,Bn44331,89652627,91685487,2032860,CNL
chr11,Bn44332,1427094,15750200,14323106,NBS
chr11,Bn44333,49756203,55876334,6120131,TNL
chr11,Bn44334,14269553,93109364,78839811,NBS
chr11,Bn44335,88122927,97936901,9813974,RLK
chr11,Bn44336,78565758,91853510,13287752,CN
chr11,Bn44337,28241570,46166799,17925229,RLK
chr11,Bn44338,80178022,85063009,4884987,RLK
chr11,Bn44339,5773253,44794344,39021091,RLP
chr11,Bn44340,22583506,57465266,34881760,TNL
chr11,Bn44341,28844328,69789629,40945301,TN
chr11,Bn44342,16592656,37658773,21066117,NBS
chr11,Bn44343,83700260,94638438,10938178,TNL
chr11,Bn44344,4427407,86200044,81772637,TN
chr11,Bn44345,64503162,82398516,17895354,NBS
chr11,Bn44346,99183960,99950136,766176,TN
chr11,Bn44347,22530816,49186548,26655732,NBS
chr11,Bn44348,94467172,94811224,344052,NBS
chr11,Bn44349,80340544,98056451,17715907,CN
chr11,Bn44350,20510531,67642568,47132037,CNL
chr11,Bn44351,33809651,39980593,6170942,NBS
chr11,Bn44352,69804389,97871617,28067228,CNL
chr11,Bn44353,19432171,38435454,19003283,TN
chr11,Bn44354,51375474,88246241,36870767,RLP
chr11,Bn44355,43528161,63293214,19765053,TN
chr11,Bn44356,18880593,36834225,17953632,RLK
chr11,Bn44357,75599207,94604396,19005189,RLK
chr11,Bn44358,74950836,86376178,11425342,CNL
chr11,Bn44359,21678458,71936518,50258060,RLP
chr11,Bn44360,4058252,81478550,77420298,TNL
chr11,Bn44361,87966682,98363406,10396724,TN
chr11,Bn44362,67510849,87283128,19772279,CN
chr11,Bn44363,25609543,96609340,70999797,TNL
chr11,Bn44364,38441203,86070542,47629339,TN
chr11,Bn44365,32504052,48264027,15759975,TN
chr11,Bn44366,16500337,36348032,19847695,NBS
chr11,Bn44367,32599356,80565344,47965988,TNL
chr11,Bn44368,49688995,90595559,40906564,CNL
chr11,Bn44369,13500241,48848328,35348087,CN
chr11,Bn44370,90703269,95837453,5134184,CNL
chr11,Bn44371,82684775,83964368,1279593,CN
chr11,Bn44372,77616566,79223010,1606444,TNL
chr11,Bn44373,20068948,54835189,34766241,RLK
chr11,Bn44374,48380988,53559679,5178691,CN
chr11,Bn44375,39892450,72990660,33098210,CNL
chr11,Bn44376,43167704,43637856,470152,NBS
chr11,Bn44377,89537318,96288047,6750729,NBS
chr11,Bn44378,65346736,67217980,1871244,RLK
chr11,Bn44379,36184092,79055907,42871815,RLK
chr11,Bn44380,11950922,88932957,76982035,TN
chr11,Bn44381,4612507,94890875,90278368,TN
chr11,Bn44382,77840856,94211328,16370472,RLP
chr11,Bn44383,22726455,29607179,6880724,NBS
chr11,Bn44384,78593288,87374249,8780961,RLP
chr11,Bn44385,58262923,60286112,2023189,NBS
chr11,Bn44386,12975876,54605842,41629966,RLP
chr11,Bn44387,64933855,83088098,18154243,RLP
chr11,Bn44388,97994816,99926378,1931562,NBS
chr11,Bn44389,59210351,85209716,25999365,CNL
chr11,Bn44390,87023811,90581009,3557198,TN
chr11,Bn44391,55297881,78971708,23673827,CN
chr11,Bn44392,25628972,51967519,26338547,TN
chr11,Bn44393,74936367,83120740,8184373,NBS
chr11,Bn44394,22027785,38538309,16510524,RLK
chr11,Bn44395,16065187,81846879,65781692,NBS
chr11,Bn44396,36523125,83455975,46932850,TNL
chr11,Bn44397,1084383,6854110,5769727,CNL
chr11,Bn44398,79420103,92057905,12637802,NBS
chr11,Bn44399,22284452,81891987,59607535,NBS
chr11,Bn44400,18926116,92562430,73636314,TN
chr11,Bn44401,45186362,51853014,6666652,RLK
chr11,Bn44402,15842944,91516589,75673645,NBS
chr11,Bn44403,46374692,66511053,20136361,RLK
chr11,Bn44404,82215162,87372672,5157510,TNL
chr11,Bn44405,99372208,99907813,535605,CN
chr11,Bn44406,27539932,84341078,56801146,CNL
chr11,Bn44407,52803391,58628697,5825306,TN
chr11,Bn44408,23814404,46114702,22300298,RLK
chr11,Bn44409,33744160,89733250,55989090,RLK
chr11,Bn44410,67965720,88494201,20528481,CNL
chr11,Bn44411,61324804,83947599,22622795,RLK
chr11,Bn44412,95162310,97218279,2055969,CNL
chr11,Bn44413,60140166,87031970,26891804,CNL
chr11,Bn44414,43522945,83998489,40475544,CNL
chr11,Bn44415,16454034,31623126,15169092,CN
chr11,Bn44416,70069353,93147542,23078189,CN
chr11,Bn44417,62795706,68543693,5747987,RLP
chr11,Bn44418,60626061,67079530,6453469,CN
chr11,Bn44419,83374720,83875585,500865,NBS
chr11,Bn44420,64748822,85477664,20728842,CNL
chr11,Bn44421,56826763,57306408,479645,CN
chr11,Bn44422,95221316,97488502,2267186,CN
chr11,Bn44423,60990921,90169487,29178566,NBS
chr11,Bn44424,88106751,98634449,10527698,CN
chr11,Bn44425,76499738,87263784,10764046,TNL
chr11,Bn44426,40897530,62608539,21711009,RLP
chr11,Bn44427,93272022,94742803,1470781,TN
chr11,Bn44428,59258123,73475025,14216902,TNL
chr11,Bn44429,39251984,69385800,30133816,RLP
chr11,Bn44430,12808001,63907143,51099142,CN
chr11,Bn44431,63559929,81506472,17946543,TNL
chr11,Bn44432,16319283,39007769,22688486,NBS
chr11,Bn44433,74515987,76655500,2139513,CN
chr11,Bn44434,6677964,56221480,49543516,RLK
chr11,Bn44435,34350115,53899969,19549854,TNL
chr11,Bn44436,37963462,38210162,246700,TN
chr11,Bn44437,34226266,41343921,7117655,TN
chr11,Bn44438,55979715,59206748,3227033,NBS
chr11,Bn44439,61988107,98276015,36287908,TN
chr11,Bn44440,74838059,88606328,13768269,TN
chr11,Bn44441,47311070,54326317,7015247,CN
chr11,Bn44442,92284421,96654160,4369739,RLK
chr11,Bn44443,99900985,99914183,13198,RLK
chr11,Bn44444,63402866,89489938,26087072,RLK
chr11,Bn44445,25315721,39452511,14136790,RLP
chr11,Bn44446,22385346,83051241,60665895,RLK
chr11,Bn44447,89863021,90035152,172131,RLP
chr11,Bn44448,76142670,89112166,12969496,RLK
chr11,Bn44449,73577875,99740975,26163100,RLP
chr11,Bn44450,72554695,87285921,14731226,TNL
chr11,Bn44451,54225873,81774092,27548219,CNL
chr11,Bn44452,37607104,47187581,9580477,CNL
chr11,Bn44453,84191454,88466133,4274679,RLP
chr11,Bn44454,56675008,73402217,16727209,RLP
chr11,Bn44455,28395018,94333280,65938262,RLP
chr11,Bn44456,60884826,79632299,18747473,TN
chr11,Bn44457,5669810,24411027,18741217,RLP
chr11,Bn44458,28749462,92241953,63492491,RLK
chr11,Bn44459,15208665,92569597,77360932,CNL
chr11,Bn44460,19699052,98814721,79115669,TNL
chr11,Bn44461,77089107,95446990,18357883,CN
chr11,Bn44462,28596571,86792546,58195975,NBS
chr11,Bn44463,50787244,82274821,31487577,TN
chr11,Bn44464,17900594,29005876,11105282,RLK
chr11,Bn44465,44677341,89183869,44506528,CN
chr11,Bn44466,48591251,57359765,8768514,CNL
chr11,Bn44467,84568301,98262736,13694435,TN
chr11,Bn44468,70239793,73864571,3624778,RLK
chr11,Bn44469,22305629,66658389,44352760,CN
chr11,Bn44470,63248406,77610798,14362392,CNL
chr11,Bn44471,37794687,62396567,24601880,NBS
chr11,Bn44472,69112451,90340815,21228364,TN
chr11,Bn44473,79772696,84986897,5214201,RLK
chr11,Bn44474,92438425,97416279,4977854,TN
chr11,Bn44475,19224347,28596690,9372343,TNL
chr11,Bn44476,56417227,59246803,2829576,RLP
chr11,Bn44477,61311623,87711141,26399518,CNL
chr11,Bn44478,91609322,98510512,6901190,TNL
chr11,Bn44479,41664380,96729328,55064948,NBS
chr11,Bn44480,94002210,97647134,3644924,CNL
chr11,Bn44481,50144071,87193968,37049897,TN
chr11,Bn44482,9309026,97619412,88310386,TN
chr11,Bn44483,43548472,93247061,49698589,TN
chr11,Bn44484,30971521,89903046,58931525,TNL
chr11,Bn44485,4644429,15156437,10512008,CNL
chr11,Bn44486,98605151,99463789,858638,RLK
chr11,Bn44487,84873332,86942125,2068793,CNL
chr11,Bn44488,51582752,94773246,43190494,NBS
chr11,Bn44489,11285961,82755141,71469180,TN
chr11,Bn44490,7080419,52472509,45392090,TNL
chr11,Bn44491,27012139,69578769,42566630,CNL
chr11,Bn44492,92914194,93848828,934634,NBS
chr11,Bn44493,94273294,95536778,1263484,RLP
chr11,Bn44494,18022614,55462792,37440178,TNL
chr11,Bn44495,19884145,97476096,77591951,TNL
chr11,Bn44496,42514020,81161586,38647566,RLK
chr11,Bn44497,69848005,90048655,20200650,TN
chr11,Bn44498,53385684,65166170,11780486,CNL
chr11,Bn44499,96619737,99995803,3376066,TN
chr11,Bn44500,52250096,86220679,33970583,TN
chr11,Bn44501,96447796,98296995,1849199,CNL
chr11,Bn44502,13137204,46876550,33739346,CNL
chr11,Bn44503,76213230,94337526,18124296,RLK
chr11,Bn44504,31098223,76304023,45205800,TN
chr11,Bn44505,66264011,82747986,16483975,CNL
chr11,Bn44506,93893862,98169242,4275380,RLK
chr11,Bn44507,37041308,38774631,1733323,TNL
chr11,Bn44508,87697878,88221098,523220,CNL
chr11,Bn44509,52494272,94784389,42290117,CNL
chr11,Bn44510,32220414,38235339,6014925,TNL
chr11,Bn44511,73207845,73913136,705291,CNL
chr11,Bn44512,38862352,80280827,41418475,CN
chr11,Bn44513,44251957,51232987,6981030,CN
chr11,Bn44514,48189720,71261508,23071788,RLP
chr11,Bn44515,95682315,98229512,2547197,CNL
chr11,Bn44516,32547411,96488227,63940816,RLP
chr11,Bn44517,80465260,89153935,8688675,CNL
chr11,Bn44518,20832256,66219789,45387533,CNL
chr11,Bn44519,50713498,69594101,18880603,TNL
chr11,Bn44520,18371543,93983456,75611913,TN
chr11,Bn44521,69569287,73800664,4231377,NBS
chr11,Bn44522,78590106,83578019,4987913,RLK
chr11,Bn44523,87202586,90192078,2989492,TNL
chr11,Bn44524,98216877,99703476,1486599,RLK
chr11,Bn44525,89104647,98727761,9623114,TNL
chr11,Bn44526,92506234,95090380,2584146,TN
chr11,Bn44527,55305849,89993654,34687805,TN
chr11,Bn44528,93648344,95925460,2277116,NBS
chr11,Bn44529,16930886,55509864,38578978,TNL
chr11,Bn44530,96052013,97984641,1932628,RLK
chr11,Bn44531,68453000,81460973,13007973,NBS
chr11,Bn44532,7409096,15524952,8115856,NBS
chr11,Bn44533,2690992,80914823,78223831,TN
chr11,Bn44534,22554169,87897397,65343228,NBS
chr11,Bn44535,46017018,99115085,53098067,CNL
chr11,Bn44536,27585326,83960785,56375459,CNL
chr11,Bn44537,99300406,99608677,308271,CN
chr11,Bn44538,57441420,93434806,35993386,RLP
chr11,Bn44539,14910153,62888703,47978550,RLP
chr11,Bn44540,68873210,91146118,22272908,CNL
chr11,Bn44541,27155306,96860692,69705386,TNL
chr11,Bn44542,20296314,75368642,55072328,CNL
chr11,Bn44543,94754292,98887047,4132755,NBS
chr11,Bn44544,93913110,97551955,3638845,TNL
chr11,Bn44545,56212067,93957049,37744982,NBS
chr11,Bn44546,50782303,70807908,20025605,NBS
chr11,Bn44547,3680810,60985232,57304422,RLK
chr11,Bn44548,44563281,46740836,2177555,NBS
chr11,Bn44549,81980385,90552365,8571980,CNL
chr11,Bn44550,91189578,98569937,7380359,TN
chr11,Bn44551,58416437,79402589,20986152,CNL
chr11,Bn44552,32231025,96010396,63779371,NBS
chr11,Bn44553,63067133,67632310,4565177,RLK
chr11,Bn44554,42480397,46915363,4434966,NBS
chr11,Bn44555,88463319,98986608,10523289,CNL
chr11,Bn44556,33384478,48822429,15437951,TNL
chr11,Bn44557,65344083,68413275,3069192,CNL
chr11,Bn44558,73247153,98342306,25095153,TNL
chr11,Bn44559,39457903,83570336,44112433,RLP
chr11,Bn44560,46160331,85781856,39621525,RLP
chr11,Bn44561,88645230,95271145,6625915,NBS
chr11,Bn44562,85342434,99252472,13910038,TN
chr11,Bn44563,55639792,75340447,19700655,NBS
chr11,Bn44564,5299446,45741653,40442207,TN
chr11,Bn44565,73111095,74757999,1646904,RLK
chr11,Bn44566,55664999,76500554,20835555,CNL
chr11,Bn44567,91224228,93594420,2370192,NBS
chr11,Bn44568,86134167,90761463,4627296,TN
chr11,Bn44569,29837621,69803622,39966001,TN
chr11,Bn44570,77245382,88736550,11491168,RLK
chr11,Bn44571,6352524,27718371,21365847,TNL
chr11,Bn44572,69036814,72210430,3173616,NBS
chr11,Bn44573,65571218,92416107,26844889,CN
chr11,Bn44574,93646998,97298142,3651144,CNL
chr11,Bn44575,79074191,90295494,11221303,RLK
chr11,Bn44576,70372379,75855437,5483058,CN
chr11,Bn44577,13370845,17639099,4268254,NBS
chr11,Bn44578,92064797,97036676,4971879,RLK
chr11,Bn44579,14527437,71262278,56734841,TN
chr11,Bn44580,33046645,33614129,567484,NBS
chr11,Bn44581,56283378,83279900,26996522,RLK
chr11,Bn44582,24940818,46385965,21445147,CN
chr11,Bn44583,81423762,93846262,12422500,RLP
chr11,Bn44584,11437823,35899591,24461768,RLK
chr11,Bn44585,98874901,99283991,409090,NBS
chr11,Bn44586,54502880,81335544,26832664,NBS
chr11,Bn44587,22930221,71639909,48709688,TN
chr11,Bn44588,93767238,96838288,3071050,NBS
chr11,Bn44589,77797294,95968471,18171177,RLK
chr11,Bn44590,56587946,66320397,9732451,CN
chr11,Bn44591,91905712,95442166,3536454,TNL
chr11,Bn44592,9390718,17145489,7754771,RLK
chr11,Bn44593,97233044,99324725,2091681,TN
chr11,Bn44594,34583129,93060162,58477033,CNL
chr11,Bn44595,99851903,99873366,21463,RLP
chr11,Bn44596,99970962,99978865,7903,NBS
chr11,Bn44597,55191170,68536775,13345605,RLP
chr11,Bn44598,68915424,81537470,12622046,TN
chr11,Bn44599,40689445,42586209,1896764,RLK
chr11,Bn44600,76107767,96584091,20476324,RLP
chr11,Bn44601,26477020,92340331,65863311,CNL
chr11,Bn44602,31437920,53774801,22336881,CNL
chr11,Bn44603,7508285,8919627,1411342,RLP
chr11,Bn44604,15694465,16950385,1255920,CN
chr11,Bn44605,97097126,98390442,1293316,CNL
chr11,Bn44606,22062666,83548107,61485441,CN
chr11,Bn44607,40461507,57101930,16640423,NBS
chr11,Bn44608,61998267,91799990,29801723,CNL
chr11,Bn44609,21047771,78094845,57047074,TNL
chr11,Bn44610,29062625,97363754,68301129,CN
chr11,Bn44611,75133008,82838486,7705478,RLK
chr11,Bn44612,47927930,84620398,36692468,CN
chr11,Bn44613,15991461,46807538,30816077,NBS
chr11,Bn44614,36247485,93841308,57593823,RLK
chr11,Bn44615,69260909,69678344,417435,RLK
chr11,Bn44616,85036204,90686889,5650685,TNL
chr11,Bn44617,14112478,33170789,19058311,RLP
chr11,Bn44618,65012214,93633720,28621506,NBS
chr11,Bn44619,94346586,95789165,1442579,RLP
chr11,Bn44620,65549439,80447979,14898540,RLP
chr11,Bn44621,11692668,25328021,13635353,TN
chr11,Bn44622,11123054,59508061,48385007,CNL
chr11,Bn44623,3763599,84569043,80805444,RLP
chr11,Bn44624,21223624,91969965,70746341,TN
chr11,Bn44625,92271410,95859105,3587695,TNL
chr11,Bn44626,93833722,96161311,2327589,NBS
chr11,Bn44627,56173593,64250898,8077305,RLK
chr11,Bn44628,92014775,93453196,1438421,TN
chr11,Bn44629,84515318,88963335,4448017,CNL
chr11,Bn44630,96849881,97866429,1016548,NBS
chr12,Bn44631,93954244,96636739,2682495,CNL
chr12,Bn44632,7525281,56216481,48691200,CN
chr12,Bn44633,95354798,96557186,1202388,CNL
chr12,Bn44634,23259258,35312989,12053731,CNL
chr12,Bn44635,60804109,84383032,23578923,RLP
chr12,Bn44636,95072667,97686834,2614167,RLK
chr12,Bn44637,14259617,48706086,34446469,CN
chr12,Bn44638,44157474,90424249,46266775,RLK
chr12,Bn44639,66541582,93533668,26992086,CNL
chr12,Bn44640,26850237,86854620,60004383,TNL
chr12,Bn44641,5054794,66724501,61669707,CNL
chr12,Bn44642,88306628,94852704,6546076,CN
chr12,Bn44643,90746387,93488086,2741699,TN
chr12,Bn44644,12389556,96430988,84041432,TNL
chr12,Bn44645,38770252,67999869,29229617,RLK
chr12,Bn44646,21854382,99088865,77234483,CNL
chr12,Bn44647,64092415,79478341,15385926,NBS
chr12,Bn44648,59313740,67412048,8098308,CNL
chr12,Bn44649,34935302,85137897,50202595,RLK
chr12,Bn44650,54384247,79806595,25422348,CNL
chr12,Bn44651,89849509,96962755,7113246,NBS
chr12,Bn44652,46137770,81756699,35618929,CN
chr12,Bn44653,67014427,69754206,2739779,NBS
chr12,Bn44654,94988647,99096534,4107887,NBS
chr12,Bn44655,81235772,86699494,5463722,TNL
chr12,Bn44656,31132624,53805704,22673080,TN
chr12,Bn44657,46514256,56483862,9969606,RLK
chr12,Bn44658,26781554,46600517,19818963,TN
chr12,Bn44659,66887791,84968549,18080758,RLP
chr12,Bn44660,58708355,91839602,33131247,CNL
chr12,Bn44661,25772094,54297085,28524991,TN
chr12,Bn44662,75102154,90050825,14948671,TN
chr12,Bn44663,39728429,60329649,20601220,RLK
chr12,Bn44664,96837011,97522592,685581,TNL
chr12,Bn44665,54570373,76938016,22367643,NBS
chr12,Bn44666,89170658,93482536,4311878,TN
chr12,Bn44667,44055460,53281848,9226388,CNL
chr12,Bn44668,95751398,98683488,2932090,CNL
chr12,Bn44669,82404364,89281071,6876707,CN
chr12,Bn44670,45304045,49569025,4264980,TNL
chr12,Bn44671,89884610,92742626,2858016,TNL
chr12,Bn44672,51950730,77022967,25072237,TN
chr12,Bn44673,46204257,89830068,43625811,TN
chr12,Bn44674,77621780,84545887,6924107,RLP
chr12,Bn44675,59646664,69629414,9982750,TNL
chr12,Bn44676,58649584,79186104,20536520,RLP
chr12,Bn44677,45701105,49492487,3791382,RLP
chr12,Bn44678,49497633,71972331,22474698,TN
chr12,Bn44679,65902794,86193673,20290879,TNL
chr12,Bn44680,90630379,94085704,3455325,CN
chr12,Bn44681,57069908,99660448,42590540,TNL
chr12,Bn44682,40264714,58020554,17755840,CNL
chr12,Bn44683,11816135,21326066,9509931,RLK
chr12,Bn44684,16800922,83979194,67178272,RLK
chr12,Bn44685,30514605,51598387,21083782,CN
chr12,Bn44686,21225247,25064018,3838771,TNL
chr12,Bn44687,16261893,68295516,52033623,RLP
chr12,Bn44688,85857827,99609676,13751849,CN
chr12,Bn44689,75243640,86636363,11392723,CN
chr12,Bn44690,74333939,74888690,554751,RLK
chr12,Bn44691,82842989,85853367,3010378,TN
chr12,Bn44692,71926107,94009261,22083154,CNL
chr12,Bn44693,77857034,79388267,1531233,CN
chr12,Bn44694,36259617,76407800,40148183,CN
chr12,Bn44695,28147378,79889982,51742604,CN
chr12,Bn44696,92733355,94498760,1765405,RLP
chr12,Bn44697,36103356,39402735,3299379,NBS
chr12,Bn44698,57668461,94870589,37202128,RLP
chr12,Bn44699,38509488,45415221,6905733,TN
chr12,Bn44700,8619351,52909944,44290593,RLP
chr12,Bn44701,55640958,85597764,29956806,RLK
chr12,Bn44702,77614241,82165861,4551620,NBS
chr12,Bn44703,89354600,92768740,3414140,CN
chr12,Bn44704,23914092,70717128,46803036,TN
chr12,Bn44705,31006864,38615817,7608953,CN
chr12,Bn44706,82610405,87433359,4822954,CN
chr12,Bn44707,31583365,81047822,49464457,TNL
chr12,Bn44708,77794373,80651737,2857364,CN
chr12,Bn44709,59754743,59957779,203036,TNL
chr12,Bn44710,87581300,89317193,1735893,TNL
chr12,Bn44711,25434787,97067995,71633208,RLK
chr12,Bn44712,55562186,75269446,19707260,TN
chr12,Bn44713,1740076,17301738,15561662,CNL
chr12,Bn44714,28862397,41409184,12546787,RLP
chr12,Bn44715,63210023,99555716,36345693,CNL
chr12,Bn44716,64433374,73767797,9334423,NBS
chr12,Bn44717,25592784,87121057,61528273,NBS
chr12,Bn44718,19489472,63147982,43658510,CNL
chr12,Bn44719,85078667,91935564,6856897,NBS
chr12,Bn44720,69778354,75216416,5438062,NBS
chr12,Bn44721,58249450,89779065,31529615,CN
chr12,Bn44722,27088088,77412505,50324417,CNL
chr12,Bn44723,3653127,94792274,91139147,CNL
chr12,Bn44724,26393442,35206094,8812652,RLP
chr12,Bn44725,30562712,90778620,60215908,CN
chr12,Bn44726,59001940,98187204,39185264,RLP
chr12,Bn44727,44479513,74244274,29764761,RLP
chr12,Bn44728,69876277,76793538,6917261,TNL
chr12,Bn44729,14442373,42845805,28403432,TNL
chr12,Bn44730,8382690,38711351,30328661,RLK
chr12,Bn44731,13772711,55094480,41321769,TNL
chr12,Bn44732,55345307,59170252,3824945,CN
chr12,Bn44733,40520607,49036801,8516194,NBS
chr12,Bn44734,86414643,89724038,3309395,RLK
chr12,Bn44735,23863852,89307715,65443863,CNL
chr12,Bn44736,77756442,80577719,2821277,CNL
chr12,Bn44737,48389538,69883490,21493952,RLP
chr12,Bn44738,52666227,61245011,8578784,RLK
chr12,Bn44739,83337530,84038125,700595,TN
chr12,Bn44740,50313821,71954089,21640268,TN
chr12,Bn44741,27982674,59026581,31043907,TN
chr12,Bn44742,98715287,99632199,916912,RLK
chr12,Bn44743,57805206,67673214,9868008,TNL
chr12,Bn44744,9701410,87351497,77650087,CNL
chr12,Bn44745,49515780,67642748,18126968,RLP
chr12,Bn44746,11994943,37603649,25608706,CNL
chr12,Bn44747,25994364,97380947,71386583,NBS
chr12,Bn44748,70561250,76313201,5751951,CN
chr12,Bn44749,40903734,49738466,8834732,NBS
chr12,Bn44750,17064695,70794340,53729645,CNL
chr12,Bn44751,19107011,85754295,66647284,CNL
chr12,Bn44752,31049977,54741820,23691843,RLK
chr12,Bn44753,58015423,84071754,26056331,RLP
chr12,Bn44754,43580220,58855819,15275599,RLP
chr12,Bn44755,40585454,53626064,13040610,TNL
chr12,Bn44756,81409372,83819098,2409726,RLK
chr12,Bn44757,92661888,98304531,5642643,CNL
chr12,Bn44758,18871499,61168683,42297184,CNL
chr12,Bn44759,88917278,89013822,96544,NBS
chr12,Bn44760,43184865,62737113,19552248,RLP
chr12,Bn44761,39746576,42960216,3213640,RLK
chr12,Bn44762,51697926,96268577,44570651,TN
chr12,Bn44763,14715592,67743995,53028403,TNL
chr12,Bn44764,79279236,99322689,20043453,CNL
chr12,Bn44765,59362220,69399277,10037057,TN
chr12,Bn44766,4664299,32943116,28278817,RLP
chr12,Bn44767,30255417,85232442,54977025,RLK
chr12,Bn44768,60021943,65505060,5483117,CNL
chr12,Bn44769,97072015,99278191,2206176,CN
chr12,Bn44770,75572992,98946581,23373589,TNL
chr12,Bn44771,87540229,91354889,3814660,NBS
chr12,Bn44772,42764912,76660179,33895267,RLP
chr12,Bn44773,55174165,66398483,11224318,TN
chr12,Bn44774,87174940,95582861,8407921,NBS
chr12,Bn44775,81131752,88429706,7297954,CNL
chr12,Bn44776,74090381,75126751,1036370,CNL
chr12,Bn44777,56374666,82258078,25883412,TNL
chr12,Bn44778,22768309,47869925,25101616,TN
chr12,Bn44779,18172519,78610427,60437908,CNL
chr12,Bn44780,11162655,97187876,86025221,CN
chr12,Bn44781,47442686,49631175,2188489,CNL
chr12,Bn44782,14562530,43581724,29019194,RLK
chr12,Bn44783,70254289,82701582,12447293,RLP
chr12,Bn44784,70804856,94073863,23269007,CNL
chr12,Bn44785,82721617,91915132,9193515,TNL
chr12,Bn44786,8175033,91980585,83805552,RLP
chr12,Bn44787,87340216,99671032,12330816,RLP
chr12,Bn44788,45664908,68852233,23187325,CNL
chr12,Bn44789,29945211,69585676,39640465,RLK
chr12,Bn44790,97729531,98372988,643457,TN
chr12,Bn44791,42491585,74043649,31552064,NBS
chr12,Bn44792,41706417,78442999,36736582,RLP
chr12,Bn44793,66436947,81544207,15107260,NBS
chr12,Bn44794,22937511,40994580,18057069,CN
chr12,Bn44795,9142799,65715027,56572228,NBS
chr12,Bn44796,74192738,93485914,19293176,CN
chr12,Bn44797,8450648,62704185,54253537,NBS
chr12,Bn44798,19779791,36126426,16346635,CNL
chr12,Bn44799,32705144,82821563,50116419,RLK
chr12,Bn44800,32191030,59117867,26926837,TNL
chr12,Bn44801,76770014,86377334,9607320,TNL
chr12,Bn44802,37186674,81171211,43984537,NBS
chr12,Bn44803,32304285,99834002,67529717,TN
chr12,Bn44804,84423462,89067016,4643554,NBS
chr12,Bn44805,44482268,72220427,27738159,CN
chr12,Bn44806,44575770,80660027,36084257,TNL
chr12,Bn44807,43532299,90263708,46731409,RLK
chr12,Bn44808,19139866,21342478,2202612,TNL
chr12,Bn44809,34859629,54945760,20086131,RLP
chr12,Bn44810,22196364,70638786,48442422,NBS
chr12,Bn44811,73937598,97063966,23126368,TN
chr12,Bn44812,84399896,94940616,10540720,RLP
chr12,Bn44813,94096455,94319024,222569,NBS
chr12,Bn44814,66056199,85395467,19339268,RLK
chr12,Bn44815,44876255,64062335,19186080,TN
chr12,Bn44816,27694993,33669214,5974221,NBS
chr12,Bn44817,72781705,97705361,24923656,RLP
chr12,Bn44818,86376328,91017046,4640718,CN
chr12,Bn44819,78018962,82545196,4526234,NBS
chr12,Bn44820,15147550,91141643,75994093,RLP
chr12,Bn44821,99032342,99857488,825146,TNL
chr12,Bn44822,67801306,99957129,32155823,TNL
chr12,Bn44823,28888092,94577324,65689232,CNL
chr12,Bn44824,14571529,21917637,7346108,RLP
chr12,Bn44825,70914364,85042659,14128295,CNL
chr12,Bn44826,6493465,7680258,1186793,RLP
chr12,Bn44827,46009652,98299425,52289773,NBS
chr12,Bn44828,18443415,23167696,4724281,CNL
chr12,Bn44829,15108485,60113621,45005136,CNL
chr12,Bn44830,79247685,92224091,12976406,RLP
chr12,Bn44831,54931446,86844162,31912716,CNL
chr12,Bn44832,76824808,94139857,17315049,NBS
chr12,Bn44833,29414161,58350292,28936131,TNL
chr12,Bn44834,27043970,72821115,45777145,TN
chr12,Bn44835,72272504,74627352,2354848,CN
chr12,Bn44836,76802019,92277893,15475874,NBS
chr12,Bn44837,34483050,50648073,16165023,TN
chr12,Bn44838,46856799,82810768,35953969,RLK
chr12,Bn44839,22640968,49785648,27144680,RLP
chr12,Bn44840,63416584,81349729,17933145,CNL
chr12,Bn44841,7998199,84135863,76137664,CNL
chr12,Bn44842,94541774,97615818,3074044,CNL
chr12,Bn44843,73453085,97681460,24228375,NBS
chr12,Bn44844,39627253,47357906,7730653,RLK
chr12,Bn44845,36565937,83703086,47137149,RLP
chr12,Bn44846,36946542,84258774,47312232,NBS
chr12,Bn44847,30308621,85940252,55631631,TN
chr12,Bn44848,19201951,60611767,41409816,CNL
chr12,Bn44849,51375293,72947075,21571782,RLK
chr12,Bn44850,68314278,92225151,23910873,RLP
chr12,Bn44851,82349336,85361504,3012168,TN
chr12,Bn44852,28232424,84256877,56024453,RLK
chr12,Bn44853,74929649,94373066,19443417,CNL
chr12,Bn44854,35289430,84319581,49030151,CN
chr12,Bn44855,8168581,26478161,18309580,RLK
chr12,Bn44856,49149975,89187445,40037470,RLP
chr12,Bn44857,4221745,78237982,74016237,CNL
chr12,Bn44858,84303192,96516682,12213490,CN
chr12,Bn44859,54113840,65017936,10904096,CNL
chr12,Bn44860,86561140,86856882,295742,NBS
chr12,Bn44861,5498799,29501681,24002882,TNL
chr12,Bn44862,14796358,39504113,24707755,RLK
chr12,Bn44863,79736859,92443708,12706849,CN
chr12,Bn44864,29844755,40557305,10712550,NBS
chr12,Bn44865,90632276,99403644,8771368,TN
chr12,Bn44866,5514189,52794863,47280674,RLK
chr12,Bn44867,99609339,99976071,366732,CNL
chr12,Bn44868,78066168,93982222,15916054,NBS
chr12,Bn44869,1226203,70239776,69013573,CN
chr12,Bn44870,39215621,60171061,20955440,RLP
chr12,Bn44871,2151906,3421876,1269970,TN
chr12,Bn44872,47409060,56110652,8701592,NBS
chr12,Bn44873,2615461,17476889,14861428,CN
chr12,Bn44874,76098842,91205820,15106978,CNL
chr12,Bn44875,49294558,87111065,37816507,NBS
chr12,Bn44876,74671078,92789939,18118861,CNL
chr12,Bn44877,25408706,45901044,20492338,RLP
chr12,Bn44878,40929796,84374860,43445064,TNL
chr12,Bn44879,91700002,98410058,6710056,CNL
chr12,Bn44880,48555715,51211670,2655955,CNL
chr12,Bn44881,88663235,93491166,4827931,RLK
chr12,Bn44882,34885277,92542468,57657191,NBS
chr12,Bn44883,38331166,85437311,47106145,RLK
chr12,Bn44884,43613317,92835576,49222259,TN
chr12,Bn44885,51381431,90082414,38700983,RLP
chr12,Bn44886,64667663,94652900,29985237,TNL
chr12,Bn44887,68852127,84251569,15399442,TN
chr12,Bn44888,19835540,97446602,77611062,RLK
chr12,Bn44889,19171849,83614703,64442854,CNL
chr12,Bn44890,23119372,46577020,23457648,TNL
chr12,Bn44891,56770481,79863728,23093247,TN
chr12,Bn44892,34551840,44591610,10039770,TN
chr12,Bn44893,26246257,65474904,39228647,CN
chr12,Bn44894,21358232,26061350,4703118,CNL
chr12,Bn44895,81181669,86172444,4990775,NBS
chr12,Bn44896,18769196,21819540,3050344,CN
chr12,Bn44897,95236472,96339678,1103206,CN
chr12,Bn44898,22519813,41154566,18634753,TN
chr12,Bn44899,38272561,87361681,49089120,TN
chr12,Bn44900,78529377,85630649,7101272,CN
chr12,Bn44901,65952265,84651229,18698964,RLK
chr12,Bn44902,10264831,36342966,26078135,TN
chr12,Bn44903,13810653,82825312,69014659,CNL
chr12,Bn44904,85593265,91107555,5514290,NBS
chr12,Bn44905,58308140,73894998,15586858,TNL
chr12,Bn44906,76210517,84659554,8449037,CNL
chr12,Bn44907,9243708,25465561,16221853,NBS
chr12,Bn44908,5846473,46312079,40465606,TN
chr12,Bn44909,20394719,44836697,24441978,CNL
chr12,Bn44910,76918743,96301593,19382850,CNL
chr12,Bn44911,33090195,69570041,36479846,CN
chr12,Bn44912,95107094,96846790,1739696,CNL
chr12,Bn44913,58514907,60082812,1567905,TN
chr12,Bn44914,86997437,88958751,1961314,RLK
chr12,Bn44915,85005901,89130043,4124142,TNL
chr12,Bn44916,28493735,36200460,7706725,TNL
chr12,Bn44917,89871614,91879083,2007469,CN
chr12,Bn44918,6592002,40699486,34107484,CNL
chr12,Bn44919,86187497,91840944,5653447,CN
chr12,Bn44920,4185563,44179971,39994408,RLP
chr12,Bn44921,86107755,90516407,4408652,TN
chr12,Bn44922,16789459,63896353,47106894,RLK
chr12,Bn44923,40749127,99076433,58327306,TNL
chr12,Bn44924,66817621,80233143,13415522,CNL
chr12,Bn44925,17570360,84543934,66973574,NBS
chr12,Bn44926,7622537,9227347,1604810,RLP
chr12,Bn44927,2703501,10444065,7740564,RLK
chr12,Bn44928,33741884,70967970,37226086,RLK
chr12,Bn44929,76593014,88681982,12088968,TN
chr12,Bn44930,29883316,83758009,53874693,NBS
chr12,Bn44931,97896697,99373769,1477072,NBS
chr12,Bn44932,4251747,22804154,18552407,TN
chr12,Bn44933,80153740,92843391,12689651,RLP
chr12,Bn44934,50081900,57657375,7575475,RLK
chr12,Bn44935,56659703,63376210,6716507,CNL
chr12,Bn44936,56358109,84671254,28313145,CN
chr12,Bn44937,78282496,90347297,12064801,RLK
chr12,Bn44938,77151705,97316755,20165050,RLP
chr12,Bn44939,84002564,85908338,1905774,TN
chr12,Bn44940,79755259,98235395,18480136,RLK
chr12,Bn44941,23362340,39139092,15776752,TNL
chr12,Bn44942,60220402,88792149,28571747,TNL
chr12,Bn44943,86569464,88846234,2276770,RLK
chr12,Bn44944,33370600,72529270,39158670,CNL
chr12,Bn44945,78157498,79640042,1482544,RLK
chr12,Bn44946,73245046,77664248,4419202,RLK
chr12,Bn44947,30065647,66714401,36648754,TN
chr12,Bn44948,25866535,90663917,64797382,TN
chr12,Bn44949,46584935,53933816,7348881,TN
chr12,Bn44950,65588547,77012927,11424380,TN
chr12,Bn44951,2760840,14478783,11717943,TN
chr12,Bn44952,39676344,45615791,5939447,TN
chr12,Bn44953,33294947,97968870,64673923,CN
chr12,Bn44954,68238257,69373309,1135052,RLK
chr12,Bn44955,27182348,31142259,3959911,TNL
chr12,Bn44956,74708721,96044114,21335393,CNL
chr12,Bn44957,76255405,94370144,18114739,CN
chr12,Bn44958,1300223,1486300,186077,NBS
chr12,Bn44959,97520430,99006933,1486503,TNL
chr12,Bn44960,65315305,97581107,32265802,TN
chr12,Bn44961,19743926,34812637,15068711,CN
chr12,Bn44962,30920529,54047849,23127320,NBS
chr12,Bn44963,34383901,97527685,63143784,CN
chr12,Bn44964,96229566,99609077,3379511,NBS
chr12,Bn44965,85291203,99897964,14606761,RLK
chr12,Bn44966,27164698,47542087,20377389,NBS
chr12,Bn44967,33425141,49329929,15904788,CN
chr12,Bn44968,20026706,28146644,8119938,TNL
chr12,Bn44969,65842523,81176018,15333495,TNL
chr12,Bn44970,53834239,93834367,40000128,RLP
chr12,Bn44971,28114718,67653256,39538538,CN
chr12,Bn44972,88191759,97046054,8854295,RLK
chr12,Bn44973,8011773,21265798,13254025,CN
chr12,Bn44974,21229747,61420795,40191048,CN
chr12,Bn44975,78192306,83821389,5629083,TN
chr12,Bn44976,78886606,86547398,7660792,RLK
chr12,Bn44977,75952471,87262046,11309575,NBS
chr12,Bn44978,88018847,90017204,1998357,CN
chr12,Bn44979,8776907,13980105,5203198,TNL
chr12,Bn44980,70969465,87421288,16451823,RLK
chr12,Bn44981,69775895,85293919,15518024,RLK
chr12,Bn44982,96408019,98240695,1832676,TN
chr12,Bn44983,28977168,30892516,1915348,CNL
chr12,Bn44984,86346362,93628954,7282592,TNL
chr12,Bn44985,85837928,88616647,2778719,RLP
chr12,Bn44986,55256099,73632485,18376386,NBS
chr12,Bn44987,1266193,23615697,22349504,TNL
chr12,Bn44988,91139140,99546565,8407425,NBS
chr12,Bn44989,6241852,29363159,23121307,NBS
chr12,Bn44990,32176195,93552703,61376508,TNL
chr12,Bn44991,12128180,16502909,4374729,NBS
chr12,Bn44992,63207446,91687440,28479994,CNL
chr12,Bn44993,11829516,80900831,69071315,CN
chr12,Bn44994,31591792,88485773,56893981,RLP
chr12,Bn44995,89738367,95689954,5951587,RLK
chr12,Bn44996,5647987,23880995,18233008,CNL
chr12,Bn44997,2062857,40044664,37981807,NBS
chr12,Bn44998,29236685,55888564,26651879,TNL
chr12,Bn44999,87157457,98441985,11284528,TNL
chr12,Bn45000,40381329,81026241,40644912,TN
chr12,Bn45001,73437021,82041607,8604586,TNL
chr12,Bn45002,25890213,60500432,34610219,CNL
chr12,Bn45003,63510360,65944662,2434302,NBS
chr12,Bn45004,5154707,80423388,75268681,RLK
chr12,Bn45005,35138583,39652265,4513682,NBS
chr12,Bn45006,17501159,21793523,4292364,NBS
chr12,Bn45007,30838708,49697283,18858575,NBS
chr12,Bn45008,68611143,79932986,11321843,RLK
chr12,Bn45009,82390310,92227660,9837350,RLK
chr12,Bn45010,38534488,88249179,49714691,TN
chr12,Bn45011,50460555,90224900,39764345,NBS
chr12,Bn45012,39678976,61318656,21639680,TN
chr12,Bn45013,86561389,98034873,11473484,NBS
chr12,Bn45014,12521602,33726844,21205242,CNL
chr12,Bn45015,40320579,45663894,5343315,RLP
chr12,Bn45016,32709163,90295943,57586780,CNL
chr12,Bn45017,13797900,98209531,84411631,RLK
chr12,Bn45018,3755439,88068202,84312763,NBS
chr12,Bn45019,92560071,95115551,2555480,TN
chr12,Bn45020,37698299,94675671,56977372,CN
chr12,Bn45021,4612278,14874855,10262577,CNL
chr12,Bn45022,62092400,88277798,26185398,RLK
chr12,Bn45023,35596455,97178940,61582485,CNL
chr12,Bn45024,18818621,63435673,44617052,TNL
chr12,Bn45025,20805018,77075510,56270492,TN
chr12,Bn45026,78621918,93986296,15364378,NBS
chr12,Bn45027,92650101,98898184,6248083,CN
chr12,Bn45028,36495644,64753872,28258228,TN
chr12,Bn45029,23851958,55156598,31304640,TNL
chr12,Bn45030,7586651,40990099,33403448,CN
chr12,Bn45031,82638724,86139994,3501270,RLP
chr12,Bn45032,73661833,76606822,2944989,CNL
chr12,Bn45033,4016796,90141199,86124403,TNL
chr12,Bn45034,82585905,84217628,1631723,CNL
chr12,Bn45035,37370391,49292180,11921789,TN
chr12,Bn45036,19689703,68399937,48710234,TN
chr12,Bn45037,56006343,70127391,14121048,TN
chr12,Bn45038,86761129,88105562,1344433,RLK
chr12,Bn45039,55667420,91114004,35446584,TNL
chr12,Bn45040,59521208,71226574,11705366,CNL
chr12,Bn45041,53613176,88596004,34982828,CNL
chr12,Bn45042,16591171,79644039,63052868,NBS
chr12,Bn45043,19097744,69653542,50555798,TNL
chr12,Bn45044,27098808,53641704,26542896,CN
chr12,Bn45045,14650084,62237678,47587594,RLK
chr12,Bn45046,32489976,63450176,30960200,CNL
chr12,Bn45047,17442874,74587979,57145105,NBS
chr12,Bn45048,91605312,99668900,8063588,RLK
chr12,Bn45049,85236723,96146506,10909783,RLP
chr12,Bn45050,3617655,43566501,39948846,CNL
chr12,Bn45051,30098298,73047698,42949400,RLK
chr12,Bn45052,59273198,71420906,12147708,NBS
chr12,Bn45053,16229341,65171694,48942353,CN
chr12,Bn45054,14910312,33474298,18563986,CN
chr12,Bn45055,58543058,64097712,5554654,CNL
chr12,Bn45056,33863680,39110588,5246908,CNL
chr12,Bn45057,16580849,87896597,71315748,RLK
chr12,Bn45058,22874910,59454461,36579551,NBS
chr12,Bn45059,52854123,52886563,32440,CNL
chr12,Bn45060,24542192,61326855,36784663,NBS
chr12,Bn45061,23926059,60202068,36276009,RLP
chr12,Bn45062,16260037,74888583,58628546,NBS
chr12,Bn45063,29687076,53439056,23751980,NBS
chr12,Bn45064,99050349,99188021,137672,TNL
chr12,Bn45065,16326076,20669511,4343435,RLK
chr12,Bn45066,26949833,83951581,57001748,CN
chr12,Bn45067,47483663,99308716,51825053,TN
chr12,Bn45068,22466687,74748686,52281999,TN
chr12,Bn45069,26597097,80684891,54087794,RLP
chr12,Bn45070,14499660,80769913,66270253,NBS
chr12,Bn45071,33105597,59163824,26058227,NBS
chr12,Bn45072,94615081,98427374,3812293,RLK
chr12,Bn45073,7922507,75846819,67924312,CN
chr12,Bn45074,98747026,99591779,844753,RLP
chr12,Bn45075,37384946,83904857,46519911,TN
chr12,Bn45076,59707057,60109590,402533,NBS
chr12,Bn45077,77292715,77624307,331592,TN
chr12,Bn45078,13112601,88397900,75285299,CN
chr12,Bn45079,2328110,46251130,43923020,CNL
chr12,Bn45080,22566909,73156918,50590009,CN
chr12,Bn45081,66818680,95233700,28415020,RLK
chr12,Bn45082,93547468,99011439,5463971,TN
chr12,Bn45083,13577452,21277000,7699548,CNL
chr12,Bn45084,51087866,85019177,33931311,TN
chr12,Bn45085,38627909,53743190,15115281,TNL
chr12,Bn45086,17011155,57511625,40500470,RLP
chr12,Bn45087,98216474,99900092,1683618,CNL
chr12,Bn45088,17835938,31177842,13341904,CNL
chr12,Bn45089,63284411,84934107,21649696,NBS
chr12,Bn45090,38923715,40246684,1322969,RLP
chr12,Bn45091,64150637,65965187,1814550,TN
chr12,Bn45092,25532211,70847183,45314972,RLK
chr12,Bn45093,40649232,92136325,51487093,NBS
chr12,Bn45094,48411028,91343874,42932846,RLK
chr12,Bn45095,25292143,99003119,73710976,TNL
chr12,Bn45096,50555374,64392093,13836719,TN
chr12,Bn45097,22007798,35018215,13010417,CNL
chr12,Bn45098,97456785,98370616,913831,TNL
chr12,Bn45099,33259489,64855467,31595978,NBS
chr12,Bn45100,18537413,85037911,66500498,NBS
chr12,Bn45101,56328262,74212103,17883841,CN
chr12,Bn45102,65014431,70375246,5360815,NBS
chr12,Bn45103,15578580,77580110,62001530,RLK
chr12,Bn45104,80043605,97523466,17479861,NBS
chr12,Bn45105,75302800,91963625,16660825,RLP
chr12,Bn45106,93144197,98629970,5485773,NBS
chr12,Bn45107,7412733,52677785,45265052,NBS
chr12,Bn45108,62278246,85134192,22855946,CN
chr12,Bn45109,3351467,8982915,5631448,RLK
chr12,Bn45110,68206453,79435334,11228881,CNL
chr12,Bn45111,57823897,83512816,25688919,NBS
chr12,Bn45112,80065067,95487883,15422816,TN
chr12,Bn45113,95125525,97921844,2796319,NBS
chr12,Bn45114,5063870,65009478,59945608,TN
chr12,Bn45115,8471137,54717785,46246648,CNL
chr12,Bn45116,97106059,98870618,1764559,CN
chr12,Bn45117,86763014,92934805,6171791,TN
chr12,Bn45118,87557815,93591224,6033409,TN
chr12,Bn45119,89330652,90895732,1565080,NBS
chr12,Bn45120,81195474,97599000,16403526,TN
chr12,Bn45121,8509622,63495854,54986232,RLK
chr12,Bn45122,17360382,88719268,71358886,CN
chr12,Bn45123,23088709,89420679,66331970,TNL
chr12,Bn45124,87920205,94146395,6226190,RLK
chr12,Bn45125,59881763,94095125,34213362,CN
chr12,Bn45126,52453463,61923526,9470063,RLP
chr12,Bn45127,14457418,31091397,16633979,NBS
chr12,Bn45128,66261619,71572105,5310486,RLP
chr12,Bn45129,58162459,69979516,11817057,TN
chr12,Bn45130,47293974,76992053,29698079,CN
chr12,Bn45131,81047181,88726653,7679472,CN
chr12,Bn45132,33227879,67755002,34527123,TN
chr12,Bn45133,49953897,84212920,34259023,CN
chr12,Bn45134,75071295,92241236,17169941,RLK
chr12,Bn45135,72933451,96043202,23109751,CN
chr12,Bn45136,21969974,65124860,43154886,TNL
chr12,Bn45137,27747817,91990086,64242269,RLK
chr12,Bn45138,61186134,87237867,26051733,RLK
chr12,Bn45139,26274785,50826660,24551875,NBS
chr12,Bn45140,47301957,82334193,35032236,RLP
chr12,Bn45141,1372587,25530295,24157708,TNL
chr12,Bn45142,35904988,58766766,22861778,RLK
chr12,Bn45143,70174802,94893539,24718737,RLP
chr12,Bn45144,75427605,93458567,18030962,RLP
chr12,Bn45145,57444635,74928325,17483690,NBS
chr12,Bn45146,4029503,90608740,86579237,CN
chr12,Bn45147,31445328,38399498,6954170,CNL
chr12,Bn45148,79226603,92599401,13372798,RLK
chr12,Bn45149,90923287,92344523,1421236,TNL
chr12,Bn45150,2316014,51871542,49555528,TN
chr12,Bn45151,45353955,67639813,22285858,CN
chr12,Bn45152,94679307,98092492,3413185,RLP
chr12,Bn45153,52244145,74464783,22220638,RLP
chr12,Bn45154,57410018,89177847,31767829,TNL
chr12,Bn45155,60287382,60992210,704828,TNL
chr12,Bn45156,14997787,69977099,54979312,CN
chr12,Bn45157,29433259,79380368,49947109,TN
chr12,Bn45158,78347480,99467039,21119559,NBS
chr12,Bn45159,29399390,37087530,7688140,TNL
chr12,Bn45160,71745337,98057000,26311663,TNL
chr12,Bn45161,81868166,91010456,9142290,RLK
chr12,Bn45162,52702323,70339551,17637228,CN
chr12,Bn45163,47638492,52036927,4398435,NBS
chr12,Bn45164,74010605,87416264,13405659,RLP
chr12,Bn45165,90727557,91093579,366022,RLP
chr12,Bn45166,38598376,65019384,26421008,RLK
chr12,Bn45167,33803382,69704255,35900873,NBS
chr12,Bn45168,96683941,96990334,306393,RLP
chr12,Bn45169,5286966,70155427,64868461,CNL
chr12,Bn45170,26543386,90292911,63749525,CN
chr12,Bn45171,84447675,97278951,12831276,RLK
chr12,Bn45172,63884298,82891633,19007335,RLP
chr12,Bn45173,94041032,97946365,3905333,RLP
chr12,Bn45174,8290014,73187419,64897405,TN
chr12,Bn45175,12813040,35245951,22432911,TNL
chr12,Bn45176,44208177,60909655,16701478,CNL
chr12,Bn45177,23302057,70427616,47125559,TN
chr12,Bn45178,59241483,92969165,33727682,RLK
chr12,Bn45179,27718754,34946170,7227416,RLP
chr12,Bn45180,57729666,97555088,39825422,TN
chr12,Bn45181,88640535,92014276,3373741,TN
chr12,Bn45182,57996128,61170691,3174563,RLP
chr12,Bn45183,68180850,95252093,27071243,TN
chr12,Bn45184,75873625,78882674,3009049,CN
chr12,Bn45185,53884667,75224427,21339760,RLP
chr12,Bn45186,15471259,79103586,63632327,RLP
chr12,Bn45187,45386654,52749708,7363054,CN
chr12,Bn45188,40998466,56689489,15691023,TNL
chr12,Bn45189,55247159,80212785,24965626,CNL
chr12,Bn45190,34490415,62054319,27563904,TN
chr12,Bn45191,84075033,89304102,5229069,TNL
chr12,Bn45192,22706795,26165948,3459153,TN
chr12,Bn45193,60349085,91599822,31250737,RLK
chr12,Bn45194,92758382,98302781,5544399,RLK
chr12,Bn45195,28254607,52860294,24605687,NBS
chr12,Bn45196,63561479,95917289,32355810,RLK
chr12,Bn45197,71214403,74780891,3566488,CNL
chr12,Bn45198,92929367,99118536,6189169,RLP
chr12,Bn45199,42307874,96630415,54322541,TNL
chr12,Bn45200,13978880,36612247,22633367,CN
chr12,Bn45201,4270654,86390968,82120314,TNL
chr12,Bn45202,23712428,44670240,20957812,NBS
chr12,Bn45203,56006658,69598809,13592151,RLK
chr12,Bn45204,44030851,54557414,10526563,TN
chr12,Bn45205,53633010,79427239,25794229,TN
chr12,Bn45206,21282239,55370292,34088053,TNL
chr12,Bn45207,35112125,93875934,58763809,CN
chr12,Bn45208,31361498,52019493,20657995,NBS
chr12,Bn45209,68572679,82536768,13964089,TNL
chr12,Bn45210,38878085,78626504,39748419,TN
chr12,Bn45211,28645130,98572815,69927685,CN
chr12,Bn45212,72058308,81435743,9377435,NBS
chr12,Bn45213,3582639,32758629,29175990,RLP
chr12,Bn45214,84730557,89147767,4417210,RLP
chr12,Bn45215,99557267,99760963,203696,RLK
chr12,Bn45216,56777295,62497737,5720442,RLP
chr12,Bn45217,76699578,87299515,10599937,TNL
chr12,Bn45218,79346077,89172969,9826892,NBS
chr12,Bn45219,98698547,99973693,1275146,TN
chr12,Bn45220,58565401,66753839,8188438,RLP
chr12,Bn45221,94046429,99929170,5882741,TNL
chr12,Bn45222,54481771,54863314,381543,TNL
chr12,Bn45223,68463509,87817137,19353628,RLP
chr12,Bn45224,79983977,89397476,9413499,TN
chr12,Bn45225,4360995,72433831,68072836,TNL
chr12,Bn45226,76835255,84685686,7850431,CN
chr12,Bn45227,78233538,95250524,17016986,TNL
chr12,Bn45228,7514561,20221914,12707353,TN
chr12,Bn45229,50299880,95644527,45344647,CN
chr12,Bn45230,2835961,58070464,55234503,CNL
chr12,Bn45231,11014977,69428753,58413776,NBS
chr12,Bn45232,23037563,43856648,20819085,CN
chr12,Bn45233,3895710,96592518,92696808,NBS
chr12,Bn45234,99208947,99834360,625413,TN
chr12,Bn45235,30677380,39277475,8600095,RLK
chr12,Bn45236,57765715,62293495,4527780,CNL
chr12,Bn45237,85654273,99462780,13808507,RLP
chr12,Bn45238,1252908,7378306,6125398,RLK
chr12,Bn45239,49732242,79520762,29788520,RLK
chr12,Bn45240,98444543,99528245,1083702,RLK
chr12,Bn45241,95480330,99229452,3749122,CN
chr12,Bn45242,91713690,94051023,2337333,TNL
chr12,Bn45243,18494338,75657171,57162833,CN
chr12,Bn45244,38942016,41201769,2259753,RLP
chr12,Bn45245,89129876,99439417,10309541,RLK
chr12,Bn45246,22991774,36278882,13287108,TN
chr12,Bn45247,25894786,54497355,28602569,RLP
chr12,Bn45248,53473931,64701489,11227558,NBS
chr12,Bn45249,74137920,96409837,22271917,RLK
chr12,Bn45250,63711310,92915858,29204548,RLK
chr12,Bn45251,25028257,87630483,62602226,TNL
chr12,Bn45252,24796196,59919467,35123271,RLP
chr12,Bn45253,66042563,74271011,8228448,CN
chr12,Bn45254,88940894,91062120,2121226,RLP
chr12,Bn45255,33724192,89231866,55507674,RLP
chr12,Bn45256,76769282,88165012,11395730,CN
chr12,Bn45257,67778122,68267923,489801,TN
chr12,Bn45258,68598185,75778441,7180256,RLK
chr12,Bn45259,71616440,83973021,12356581,CN
chr12,Bn45260,42930567,53577181,10646614,NBS
chr12,Bn45261,66368032,85234864,18866832,TN
chr12,Bn45262,49656009,80707242,31051233,TN
chr12,Bn45263,22641336,35334914,12693578,TN
chr12,Bn45264,6635655,36886719,30251064,TN
chr12,Bn45265,63749296,88511665,24762369,CNL
chr12,Bn45266,37462326,40874795,3412469,CNL
chr12,Bn45267,39613337,56498368,16885031,RLP
chr12,Bn45268,57912814,99854959,41942145,NBS
chr12,Bn45269,34811262,80038248,45226986,CNL
chr12,Bn45270,70616135,85544382,14928247,NBS
chr12,Bn45271,93476079,95360170,1884091,TN
chr12,Bn45272,73734927,82409404,8674477,CN
chr12,Bn45273,12863463,48035170,35171707,CN
chr12,Bn45274,22012673,62862993,40850320,CNL
chr12,Bn45275,57375106,85153116,27778010,CN
chr12,Bn45276,47557513,96399282,48841769,CNL
chr12,Bn45277,74701710,87395778,12694068,NBS
chr12,Bn45278,2319629,64539709,62220080,CN
chr12,Bn45279,85934261,88995536,3061275,TNL
chr12,Bn45280,76309438,86758925,10449487,CN
chr12,Bn45281,74697143,74744270,47127,NBS
chr12,Bn45282,1923023,12897626,10974603,CNL
chr12,Bn45283,63255778,99132153,35876375,NBS
chr12,Bn45284,96299694,98476038,2176344,TNL
chr12,Bn45285,31231135,67177258,35946123,RLP
chr12,Bn45286,95533307,98476982,2943675,CNL
chr12,Bn45287,50920156,75978912,25058756,CNL
chr12,Bn45288,93780118,95969827,2189709,TN
chr12,Bn45289,46609835,55381421,8771586,RLK
chr12,Bn45290,52333833,91514673,39180840,NBS
chr12,Bn45291,59312499,82457015,23144516,RLP
chr12,Bn45292,77138062,81237050,4098988,CN
chr12,Bn45293,44992729,48561854,3569125,CNL
chr12,Bn45294,44732644,89564472,44831828,CN
chr12,Bn45295,42903266,69830140,26926874,CN
chr12,Bn45296,19818803,63611406,43792603,RLP
chr12,Bn45297,28717919,60573785,31855866,NBS
chr12,Bn45298,19373668,75626348,56252680,CNL
chr12,Bn45299,56010430,70645424,14634994,RLK
chr12,Bn45300,38973932,49618017,10644085,RLP
chr12,Bn45301,73235309,78145997,4910688,RLP
chr12,Bn45302,82458251,90796451,8338200,TNL
chr12,Bn45303,53636921,67057880,13420959,TNL
chr12,Bn45304,3851756,33121035,29269279,RLK
chr12,Bn45305,22336047,52030966,29694919,RLP
chr12,Bn45306,85464467,91586229,6121762,TNL
chr12,Bn45307,35327111,50045007,14717896,CNL
chr12,Bn45308,51864357,82839670,30975313,NBS
chr12,Bn45309,23239948,95164020,71924072,RLP
chr12,Bn45310,94393454,98252806,3859352,RLP
chr12,Bn45311,1981630,30484202,28502572,NBS
chr12,Bn45312,70589403,90940003,20350600,NBS
chr12,Bn45313,79547377,80608405,1061028,TN
chr12,Bn45314,13931488,79408542,65477054,CNL
chr12,Bn45315,56473770,92921232,36447462,CNL
chr12,Bn45316,50939898,90318963,39379065,CN
chr12,Bn45317,73270350,75363685,2093335,TN
chr12,Bn45318,96191316,97807309,1615993,RLP
chr12,Bn45319,95239446,97594032,2354586,TN
chr12,Bn45320,94109298,97076172,2966874,TN
chr12,Bn45321,79779334,85613148,5833814,CN
chr12,Bn45322,35131629,38992397,3860768,NBS
chr12,Bn45323,20966629,76263152,55296523,RLK
chr12,Bn45324,86371024,87224390,853366,CNL
chr12,Bn45325,69771400,94073396,24301996,NBS
chr12,Bn45326,54591301,62083737,7492436,TN
chr12,Bn45327,28731440,91209588,62478148,TN
chr12,Bn45328,62589819,89275567,26685748,CNL
chr12,Bn45329,99666123,99696994,30871,CNL
chr12,Bn45330,75344672,87498250,12153578,CNL
chr12,Bn45331,46603249,81784072,35180823,RLP
chr12,Bn45332,65367349,97047475,31680126,RLP
chr12,Bn45333,65618975,96312515,30693540,TNL
chr12,Bn45334,56112588,77799924,21687336,TNL
chr12,Bn45335,40385279,86670264,46284985,NBS
chr12,Bn45336,26198295,84856629,58658334,CN
chr12,Bn45337,16682806,89274760,72591954,TNL
chr12,Bn45338,18643691,43631668,24987977,RLK
chr12,Bn45339,8088876,61280439,53191563,RLK
chr12,Bn45340,18124026,93603943,75479917,CNL
chr12,Bn45341,19661846,55896252,36234406,NBS
chr12,Bn45342,32908781,83952348,51043567,NBS
chr12,Bn45343,45500525,51210545,5710020,CNL
chr12,Bn45344,21518384,28690596,7172212,CNL
chr12,Bn45345,72815661,85869455,13053794,TNL
chr12,Bn45346,43273701,63868106,20594405,NBS
chr12,Bn45347,73817478,81832379,8014901,TN
chr12,Bn45348,40839311,78139743,37300432,RLK
chr12,Bn45349,16010352,36001148,19990796,CNL
chr12,Bn45350,97716822,97812582,95760,RLP
chr12,Bn45351,2509273,81078074,78568801,NBS
chr12,Bn45352,69087919,91180855,22092936,NBS
chr12,Bn45353,20179124,78716100,58536976,NBS
chr12,Bn45354,33687844,70534584,36846740,RLP
chr12,Bn45355,27332264,44988445,17656181,CNL
chr12,Bn45356,76468236,98172253,21704017,TN
chr12,Bn45357,28550476,69205497,40655021,TNL
chr12,Bn45358,27443398,30888559,3445161,RLK
chr12,Bn45359,21764843,84757304,62992461,TNL
chr12,Bn45360,85779278,98039908,12260630,RLP
chr12,Bn45361,66995707,88913169,21917462,CN
chr12,Bn45362,41375836,73619745,32243909,RLK
chr12,Bn45363,13136955,94855118,81718163,CN
chr12,Bn45364,77982920,89037240,11054320,CN
chr12,Bn45365,14105977,95446582,81340605,TNL
chr12,Bn45366,91592143,99119188,7527045,RLK
chr12,Bn45367,80228335,82774401,2546066,TN
chr12,Bn45368,23519364,72578328,49058964,RLK
chr12,Bn45369,73817272,88785766,14968494,NBS
chr12,Bn45370,10933426,70726676,59793250,TNL
chr12,Bn45371,37016710,45943187,8926477,RLK
chr12,Bn45372,27090940,65529273,38438333,RLK
chr12,Bn45373,11248496,57674819,46426323,RLK
chr12,Bn45374,77371821,83700231,6328410,NBS
chr12,Bn45375,84062914,86611547,2548633,TN
chr12,Bn45376,46627783,56837859,10210076,NBS
chr12,Bn45377,7049095,56750727,49701632,RLK
chr12,Bn45378,1790466,81239402,79448936,TN
chr12,Bn45379,76569812,83018302,6448490,RLK
chr12,Bn45380,32811633,97161653,64350020,NBS
chr12,Bn45381,39664088,41801990,2137902,TNL
chr12,Bn45382,66053517,97912334,31858817,CNL
chr12,Bn45383,73412078,85959331,12547253,TNL
chr12,Bn45384,51002335,92246889,41244554,NBS
chr12,Bn45385,33050742,42315302,9264560,RLK
chr12,Bn45386,97495394,99984236,2488842,CNL
chr12,Bn45387,35458436,41054442,5596006,TNL
chr12,Bn45388,52784796,86231775,33446979,RLP
chr12,Bn45389,8292419,63035999,54743580,TN
chr12,Bn45390,12759216,73962660,61203444,NBS
chr12,Bn45391,15942186,19369837,3427651,CNL
chr12,Bn45392,49793043,86341985,36548942,NBS
chr12,Bn45393,10633105,48939251,38306146,CNL
chr12,Bn45394,55757954,75013030,19255076,NBS
chr12,Bn45395,24592379,42516004,17923625,NBS
chr12,Bn45396,63734719,90112075,26377356,RLK
chr12,Bn45397,5896762,46835230,40938468,TN
chr12,Bn45398,28865634,45530182,16664548,TN
chr12,Bn45399,22848282,47991433,25143151,NBS
chr12,Bn45400,67235864,90187157,22951293,TN
chr12,Bn45401,33287090,72687845,39400755,TNL
chr12,Bn45402,84365245,92789021,8423776,NBS
chr12,Bn45403,40684754,43998656,3313902,RLP
chr12,Bn45404,26944212,75854779,48910567,RLK
chr12,Bn45405,59656510,71945160,12288650,TNL
chr12,Bn45406,74703385,74971694,268309,TNL
chr12,Bn45407,21528870,86623404,65094534,TNL
chr12,Bn45408,29143884,72741794,43597910,NBS
chr12,Bn45409,85440950,90110792,4669842,TN
chr12,Bn45410,42975881,79352738,36376857,TN
chr12,Bn45411,62589434,89664204,27074770,TN
chr12,Bn45412,95752980,99697582,3944602,CN
chr12,Bn45413,14033563,25818399,11784836,NBS
chr12,Bn45414,11746673,20249461,8502788,RLK
chr12,Bn45415,55828958,72689090,16860132,RLK
chr12,Bn45416,33871217,58795760,24924543,NBS
chr12,Bn45417,4169452,71524965,67355513,TNL
chr12,Bn45418,54536549,69361482,14824933,CN
chr12,Bn45419,73711272,95044082,21332810,RLP
chr12,Bn45420,61864119,62896673,1032554,CNL
chr12,Bn45421,81997083,89759367,7762284,RLK
chr12,Bn45422,89658981,98743936,9084955,NBS
chr12,Bn45423,91966871,96242734,4275863,CNL
chr12,Bn45424,32682421,39972662,7290241,CN
chr12,Bn45425,82074732,88434399,6359667,NBS
chr12,Bn45426,51358572,88006942,36648370,RLK
chr12,Bn45427,70518811,96729931,26211120,CN
chr12,Bn45428,20800861,50523774,29722913,TN
chr12,Bn45429,43192731,98949046,55756315,TN
chr12,Bn45430,42087314,99894424,57807110,RLP
chr12,Bn45431,42819534,59008251,16188717,CN
chr12,Bn45432,59723888,63998121,4274233,TNL
chr12,Bn45433,45232045,65567348,20335303,CNL
chr12,Bn45434,90038116,90321179,283063,RLP
chr12,Bn45435,40308587,65738833,25430246,CNL
chr12,Bn45436,83673195,98899264,15226069,CNL
chr12,Bn45437,27170314,61272806,34102492,CN
chr12,Bn45438,70443205,88030104,17586899,CN
chr12,Bn45439,8148870,84990229,76841359,RLK
chr12,Bn45440,32624817,86122974,53498157,TN
chr12,Bn45441,57676958,85230521,27553563,RLP
chr12,Bn45442,38500103,83681056,45180953,CN
chr12,Bn45443,23442366,77939382,54497016,NBS
chr12,Bn45444,11305936,43387252,32081316,RLK
chr12,Bn45445,42369154,72356198,29987044,NBS
chr12,Bn45446,46024606,73920618,27896012,CNL
chr12,Bn45447,54100935,54656217,555282,RLK
chr12,Bn45448,1483645,71771231,70287586,TNL
chr12,Bn45449,27063253,80603258,53540005,RLK
chr12,Bn45450,4290514,21662159,17371645,NBS
chr12,Bn45451,32011868,94841975,62830107,TN
chr12,Bn45452,69225451,74012575,4787124,TNL
chr12,Bn45453,86888360,90631415,3743055,RLP
chr12,Bn45454,52339304,76090744,23751440,NBS
chr12,Bn45455,64170946,64320646,149700,RLK
chr12,Bn45456,92329229,96370762,4041533,TNL
chr12,Bn45457,93640585,94477655,837070,TNL
chr12,Bn45458,96735976,97197314,461338,CN
chr12,Bn45459,28676195,92764385,64088190,RLP
chr12,Bn45460,11327430,42066380,30738950,RLP
chr12,Bn45461,48174573,87446984,39272411,CNL
chr12,Bn45462,3728372,73992347,70263975,TNL
chr12,Bn45463,60855527,69005002,8149475,TNL
chr12,Bn45464,71159689,85066113,13906424,TNL
chr12,Bn45465,45954873,46238850,283977,TNL
chr12,Bn45466,83166564,99400656,16234092,TNL
chr12,Bn45467,8593400,50544898,41951498,CN
chr12,Bn45468,61662547,70283767,8621220,NBS
chr12,Bn45469,4438811,29018717,24579906,TN
chr12,Bn45470,64664218,92752390,28088172,TN
chr12,Bn45471,87919835,95395670,7475835,NBS
chr12,Bn45472,97005904,98073105,1067201,CN
chr12,Bn45473,1184625,98536272,97351647,NBS
chr12,Bn45474,39982446,59740135,19757689,CN
chr12,Bn45475,72324455,74381465,2057010,CNL
chr12,Bn45476,62297417,76806845,14509428,NBS
chr12,Bn45477,1545460,69610281,68064821,RLP
chr12,Bn45478,49343479,52929913,3586434,CNL
chr12,Bn45479,31282097,87517170,56235073,TN
chr12,Bn45480,30870521,31836175,965654,RLP
chr12,Bn45481,80460589,81925061,1464472,RLK
chr12,Bn45482,80607368,97562973,16955605,TN
chr12,Bn45483,28735861,51854720,23118859,CN
chr12,Bn45484,5588510,66933707,61345197,CNL
chr12,Bn45485,92750688,94397504,1646816,CN
chr12,Bn45486,11646499,13750218,2103719,RLK
chr12,Bn45487,23343494,96690188,73346694,RLP
chr12,Bn45488,9599292,66340605,56741313,CN
chr12,Bn45489,81111078,94704971,13593893,TNL
chr12,Bn45490,92956651,95992417,3035766,TN
chr12,Bn45491,28160926,33893837,5732911,TN
chr12,Bn45492,72008443,90062181,18053738,CN
chr12,Bn45493,56217879,56292820,74941,RLP
chr12,Bn45494,38645008,44213434,5568426,NBS
chr12,Bn45495,12712377,99923741,87211364,CN
chr12,Bn45496,99248973,99425179,176206,RLP
chr12,Bn45497,20435013,68892446,48457433,CNL
chr12,Bn45498,50479500,60776550,10297050,TN
chr12,Bn45499,47202453,80152918,32950465,TN
chr12,Bn45500,97685984,99106856,1420872,RLK
chr12,Bn45501,94760489,95531930,771441,RLK
chr12,Bn45502,88437565,89449620,1012055,RLK
chr12,Bn45503,14457825,89159581,74701756,TNL
chr12,Bn45504,85131258,91088610,5957352,TN
chr12,Bn45505,67759014,78235488,10476474,RLP
chr12,Bn45506,86431990,87176310,744320,NBS
chr12,Bn45507,97204798,99851541,2646743,CN
chr12,Bn45508,39107889,94641642,55533753,NBS
chr12,Bn45509,1774637,47928774,46154137,CN
chr12,Bn45510,13837054,23115381,9278327,CN
chr12,Bn45511,13412103,96834668,83422565,NBS
chr12,Bn45512,14435836,83827619,69391783,CN
chr12,Bn45513,17058290,39951678,22893388,TN
chr12,Bn45514,4120337,57464653,53344316,RLK
chr12,Bn45515,75102748,89691980,14589232,CNL
chr12,Bn45516,28023830,28818079,794249,CNL
chr12,Bn45517,78951294,87283507,8332213,RLP
chr12,Bn45518,64281086,83551741,19270655,RLK
chr12,Bn45519,62345047,93791215,31446168,CNL
chr12,Bn45520,1094094,16350089,15255995,CN
chr12,Bn45521,21423494,86222679,64799185,CNL
chr12,Bn45522,65209974,66365786,1155812,NBS
chr12,Bn45523,72515768,93367229,20851461,CNL
chr12,Bn45524,82197903,93080571,10882668,CN
chr12,Bn45525,93412311,99142950,5730639,CNL
chr12,Bn45526,46504081,96473424,49969343,RLP
chr12,Bn45527,47919869,62501500,14581631,TNL
chr12,Bn45528,68612895,75796363,7183468,RLP
chr12,Bn45529,38083075,87211165,49128090,RLP
chr12,Bn45530,33601397,99237313,65635916,RLP
chr12,Bn45531,78231308,91467825,13236517,TN
chr12,Bn45532,19997309,98586832,78589523,NBS
chr12,Bn45533,90599538,95644394,5044856,CNL
chr12,Bn45534,44640999,85322550,40681551,NBS
chr12,Bn45535,80155452,85292793,5137341,CN
chr12,Bn45536,95229303,96553304,1324001,NBS
chr12,Bn45537,13469576,32836575,19366999,RLP
chr12,Bn45538,29128383,54043024,24914641,RLP
chr12,Bn45539,66590352,66679387,89035,CN
chr12,Bn45540,31257385,31750861,493476,TNL
chr12,Bn45541,40531424,40909654,378230,TNL
chr12,Bn45542,38758854,39624216,865362,TNL
chr12,Bn45543,81261987,96768313,15506326,RLP
chr12,Bn45544,36254068,92394299,56140231,NBS
chr12,Bn45545,2949421,64251727,61302306,RLK
chr12,Bn45546,51795248,55940432,4145184,CN
chr12,Bn45547,64122682,78915728,14793046,NBS
chr12,Bn45548,67565231,75286402,7721171,CN
chr12,Bn45549,26239089,39828280,13589191,CNL
chr12,Bn45550,47733387,52151688,4418301,CNL
chr12,Bn45551,29373278,76458163,47084885,TN
chr12,Bn45552,59367483,93566813,34199330,RLP
chr12,Bn45553,25026668,85287366,60260698,TN
chr12,Bn45554,95667944,98252510,2584566,RLK
chr12,Bn45555,73353392,87842416,14489024,RLK
chr12,Bn45556,74403965,77779607,3375642,CN
chr12,Bn45557,45298148,99572989,54274841,RLK
chr12,Bn45558,40494053,97358984,56864931,CNL
chr12,Bn45559,31067508,63159318,32091810,TN
chr12,Bn45560,36574660,79980651,43405991,TNL
chr12,Bn45561,12474631,45921592,33446961,RLK
chr12,Bn45562,55292514,98548066,43255552,RLK
chr12,Bn45563,96596891,98314192,1717301,RLK
chr12,Bn45564,72579635,99074618,26494983,CNL
chr12,Bn45565,58164793,64341954,6177161,RLK
chr12,Bn45566,7438180,24131631,16693451,CN
chr12,Bn45567,83318728,92645016,9326288,TNL
chr12,Bn45568,93066689,98567006,5500317,NBS
chr12,Bn45569,70562542,88367268,17804726,CN
chr12,Bn45570,97754032,99382400,1628368,CNL
chr12,Bn45571,92630655,93783264,1152609,RLP
chr12,Bn45572,73812262,74257476,445214,TN
chr12,Bn45573,4541068,10930067,6388999,RLP
chr12,Bn45574,96224550,99757314,3532764,RLK
chr12,Bn45575,94066178,96830294,2764116,RLK
chr12,Bn45576,29749794,98072259,68322465,TNL
chr12,Bn45577,3285759,82539692,79253933,TNL
chr12,Bn45578,75214256,87847946,12633690,RLP
chr12,Bn45579,52039854,81337344,29297490,NBS
chr12,Bn45580,33895810,48542417,14646607,CN
chr12,Bn45581,76682271,92778822,16096551,TN
chr12,Bn45582,38590900,66823795,28232895,RLP
chr12,Bn45583,54216048,95033509,40817461,RLP
chr12,Bn45584,4360485,6963636,2603151,RLK
chr12,Bn45585,87466422,92084480,4618058,NBS
chr12,Bn45586,18242244,78099300,59857056,TNL
chr12,Bn45587,23044791,37666768,14621977,RLK
chr12,Bn45588,63696453,69817378,6120925,TN
chr12,Bn45589,7003132,16604669,9601537,TN
chr12,Bn45590,58156192,63026001,4869809,TNL
chr12,Bn45591,43878033,57399745,13521712,CN
chr12,Bn45592,96650639,98793803,2143164,CNL
chr12,Bn45593,16448143,81486460,65038317,TN
chr12,Bn45594,38116420,54981515,16865095,TN
chr12,Bn45595,8814862,97304971,88490109,CNL
chr12,Bn45596,10334081,77762395,67428314,RLP
chr12,Bn45597,26643036,99937477,73294441,TNL
chr12,Bn45598,17096120,73990139,56894019,CNL
chr12,Bn45599,34764609,97995332,63230723,NBS
chr12,Bn45600,96082062,96403959,321897,TN
chr12,Bn45601,23153619,37236388,14082769,NBS
chr12,Bn45602,80452471,83142745,2690274,TNL
chr12,Bn45603,84179365,87767055,3587690,TNL
chr12,Bn45604,65567303,69610885,4043582,CN
chr12,Bn45605,76588283,77552543,964260,NBS
chr12,Bn45606,30851429,88201740,57350311,CNL
chr12,Bn45607,30856156,52906121,22049965,CN
chr12,Bn45608,19817315,40208411,20391096,TNL
chr12,Bn45609,66779526,69357005,2577479,RLP
chr12,Bn45610,75531081,88017795,12486714,NBS
chr12,Bn45611,2005811,13050611,11044800,CNL
chr12,Bn45612,98434216,99482871,1048655,TN
chr12,Bn45613,91568342,94761889,3193547,NBS
chr12,Bn45614,53058729,91839863,38781134,TN
chr12,Bn45615,91344096,96075743,4731647,CN
chr12,Bn45616,59959572,80291291,20331719,TNL
chr12,Bn45617,22350830,58298648,35947818,RLK
chr12,Bn45618,25835029,40172360,14337331,RLK
chr12,Bn45619,7722091,51264140,43542049,CN
chr12,Bn45620,36018045,40700873,4682828,TNL
chr12,Bn45621,80593526,81251461,657935,TN
chr12,Bn45622,57236460,64112365,6875905,CNL
chr12,Bn45623,40089389,92945707,52856318,TN
chr12,Bn45624,63428523,76330345,12901822,RLP
chr12,Bn45625,49957388,98934281,48976893,TNL
chr12,Bn45626,73439267,87609441,14170174,NBS
chr12,Bn45627,16179300,98164114,81984814,NBS
chr12,Bn45628,3686037,44436258,40750221,TNL
chr12,Bn45629,45082473,80876178,35793705,CNL
chr12,Bn45630,82883673,90999162,8115489,TN
chr12,Bn45631,55558259,56982406,1424147,RLK
chr12,Bn45632,86227168,97009871,10782703,TNL
chr12,Bn45633,20955220,83716508,62761288,NBS
chr12,Bn45634,37709334,84178689,46469355,NBS
chr12,Bn45635,7388073,99908604,92520531,CN
chr12,Bn45636,64497637,82936030,18438393,RLP
chr12,Bn45637,49086585,49661947,575362,RLK
chr12,Bn45638,47067793,92671324,45603531,TNL
chr12,Bn45639,96180279,96557465,377186,TN
chr12,Bn45640,29272023,40039118,10767095,TN
chr12,Bn45641,32030631,66069423,34038792,TN
chr12,Bn45642,87273947,99022550,11748603,NBS
chr12,Bn45643,43336800,48754420,5417620,CN
chr12,Bn45644,39909548,91223597,51314049,NBS
chr12,Bn45645,59132191,70949228,11817037,RLP
chr12,Bn45646,15538364,23142558,7604194,RLK
chr12,Bn45647,19846047,26382502,6536455,NBS
chr12,Bn45648,96945693,98407515,1461822,NBS
chr12,Bn45649,26288338,91053339,64765001,TN
chr12,Bn45650,53789626,87761380,33971754,CN
chr12,Bn45651,59971163,91957004,31985841,CNL
chr12,Bn45652,91791277,96932972,5141695,RLP
chr12,Bn45653,46985320,64692203,17706883,TN
chr12,Bn45654,38491803,97703141,59211338,CN
chr12,Bn45655,80766219,89154586,8388367,TNL
chr12,Bn45656,37056538,37683532,626994,CNL
chr12,Bn45657,31105124,46286165,15181041,NBS
chr12,Bn45658,60703588,66291550,5587962,RLP
chr12,Bn45659,59313732,80737705,21423973,CN
chr12,Bn45660,74076472,98751181,24674709,TN
chr12,Bn45661,82457375,97837770,15380395,TNL
chr12,Bn45662,64085765,83244094,19158329,TN
chr12,Bn45663,19288186,55722560,36434374,CNL
chr12,Bn45664,57962765,70578809,12616044,CN
chr12,Bn45665,36680840,75248910,38568070,CN
chr12,Bn45666,61678540,84987906,23309366,CN
chr12,Bn45667,77500148,89693734,12193586,CNL
chr12,Bn45668,63626838,78844372,15217534,NBS
chr12,Bn45669,45607512,55789621,10182109,CN
chr12,Bn45670,87003622,95656065,8652443,CNL
chr12,Bn45671,84295925,92199484,7903559,TNL
chr12,Bn45672,38765942,66425637,27659695,TN
chr12,Bn45673,23085101,38158544,15073443,TNL
chr12,Bn45674,2872503,12805932,9933429,CN
chr12,Bn45675,27631815,90633917,63002102,NBS
chr12,Bn45676,3394502,91186998,87792496,RLP
chr12,Bn45677,79131815,83991782,4859967,TNL
chr12,Bn45678,98799354,99088416,289062,TNL
chr12,Bn45679,44168689,66478903,22310214,TNL
chr12,Bn45680,29551327,57708584,28157257,CN
chr12,Bn45681,56851256,65827509,8976253,TN
chr12,Bn45682,76942258,87709486,10767228,RLK
chr12,Bn45683,21603029,27931151,6328122,TNL
chr12,Bn45684,91204125,97704092,6499967,TN
chr12,Bn45685,89062684,91477970,2415286,RLP
chr12,Bn45686,94376744,95565281,1188537,NBS
chr12,Bn45687,41465164,74470588,33005424,RLK
chr12,Bn45688,77083407,92345135,15261728,NBS
chr12,Bn45689,58201566,87562243,29360677,RLK
chr12,Bn45690,52196712,82544099,30347387,TNL
chr12,Bn45691,10045614,51802188,41756574,RLK
chr12,Bn45692,73908141,85303124,11394983,CN
chr12,Bn45693,23166746,23713776,547030,RLP
chr12,Bn45694,18816694,50080429,31263735,RLP
chr12,Bn45695,66272161,67912635,1640474,NBS
chr12,Bn45696,65171162,88720382,23549220,TNL
chr12,Bn45697,18902697,83315917,64413220,CN
chr12,Bn45698,54853662,89400013,34546351,RLP
chr12,Bn45699,89754073,95397780,5643707,CNL
chr12,Bn45700,24973880,32076795,7102915,CNL
chr12,Bn45701,7051104,9397676,2346572,CNL
chr12,Bn45702,29591251,34296492,4705241,TN
chr12,Bn45703,42442816,54316211,11873395,RLP
chr12,Bn45704,65841751,82161620,16319869,CN
chr12,Bn45705,31289683,61322505,30032822,RLK
chr12,Bn45706,17531327,54220302,36688975,CNL
chr12,Bn45707,33295916,33446840,150924,TN
chr12,Bn45708,72450000,88883466,16433466,CNL
chr12,Bn45709,59306847,97370510,38063663,RLP
chr12,Bn45710,24547629,87301497,62753868,CNL
chr12,Bn45711,73347909,92753065,19405156,NBS
chr12,Bn45712,85864756,93551674,7686918,CNL
chr12,Bn45713,16276657,45064445,28787788,TN
chr12,Bn45714,41954643,95057743,53103100,TN
chr12,Bn45715,86870332,99066396,12196064,RLK
chr12,Bn45716,81758564,82172614,414050,NBS
chr12,Bn45717,52603596,67514357,14910761,TN
chr12,Bn45718,4322754,14565707,10242953,CN
chr12,Bn45719,9466129,88190320,78724191,TNL
chr12,Bn45720,37732751,42804537,5071786,CN
chr12,Bn45721,64945049,99908774,34963725,RLP
chr12,Bn45722,29516122,90977373,61461251,CN
chr12,Bn45723,82166622,85283921,3117299,RLK
chr12,Bn45724,40523793,76198568,35674775,RLK
chr12,Bn45725,61758330,82385705,20627375,RLK
chr12,Bn45726,6437272,93393721,86956449,CN
chr12,Bn45727,72221603,81503933,9282330,TN
chr12,Bn45728,5704962,21464089,15759127,TN
chr12,Bn45729,38019719,67800762,29781043,NBS
chr12,Bn45730,33236387,75999743,42763356,CN
chr12,Bn45731,13046415,87209634,74163219,TN
chr12,Bn45732,35363178,97082768,61719590,TN
chr12,Bn45733,22781536,39350480,16568944,RLP
chr12,Bn45734,68323770,94305496,25981726,CN
chr12,Bn45735,92510100,99020486,6510386,RLK
chr12,Bn45736,9561968,13140341,3578373,CNL
chr12,Bn45737,58136425,66231377,8094952,TNL
chr12,Bn45738,5733144,97353595,91620451,RLP
chr12,Bn45739,44623188,76391018,31767830,CNL
chr12,Bn45740,79306993,83739699,4432706,RLK
chr12,Bn45741,95555299,99997583,4442284,NBS
chr12,Bn45742,65381730,74760876,9379146,RLK
chr12,Bn45743,50229490,91090786,40861296,CN
chr12,Bn45744,68305980,86819855,18513875,RLK
chr12,Bn45745,3196517,64356214,61159697,CNL
chr12,Bn45746,9524563,74325096,64800533,RLK
chr12,Bn45747,13459585,26931702,13472117,RLK
chr12,Bn45748,29990230,90297530,60307300,TN
chr12,Bn45749,46180214,68802975,22622761,CNL
chr12,Bn45750,13183048,93550351,80367303,NBS
chr12,Bn45751,14234336,25046300,10811964,CN
chr12,Bn45752,69084877,82406102,13321225,RLK
chr12,Bn45753,19315423,50294872,30979449,TN
chr12,Bn45754,63691427,80107874,16416447,TN
chr12,Bn45755,80860186,98413004,17552818,NBS
chr12,Bn45756,87881300,97210571,9329271,NBS
chr12,Bn45757,64566534,64842567,276033,NBS
chr12,Bn45758,55845476,83749295,27903819,RLP
chr12,Bn45759,73052386,92674314,19621928,TN
chr12,Bn45760,50009379,85243111,35233732,TNL
chr12,Bn45761,62687863,85322265,22634402,RLP
chr12,Bn45762,13627209,66759397,53132188,RLK
chr12,Bn45763,9346934,36492063,27145129,TNL
chr12,Bn45764,39877568,77366013,37488445,CN
chr12,Bn45765,44945758,53981313,9035555,RLK
chr12,Bn45766,11218066,46978346,35760280,TNL
chr12,Bn45767,19711324,67839067,48127743,RLK
chr12,Bn45768,78937445,84871660,5934215,TNL
chr12,Bn45769,40801567,56468328,15666761,RLP
chr12,Bn45770,99672725,99925765,253040,RLP
chr12,Bn45771,75990803,78673601,2682798,TN
chr12,Bn45772,99812223,99894881,82658,RLK
chr12,Bn45773,69987658,71717562,1729904,RLK
chr12,Bn45774,14477281,22084011,7606730,TNL
chr12,Bn45775,40146476,90332506,50186030,NBS
chr12,Bn45776,42149820,83596688,41446868,CN
chr12,Bn45777,49701118,64622608,14921490,TN
chr12,Bn45778,90511325,94461686,3950361,RLK
chr12,Bn45779,27716913,72922978,45206065,CNL
chr12,Bn45780,8047155,45551763,37504608,RLK
chr12,Bn45781,4021230,8280474,4259244,RLK
chr12,Bn45782,29695681,62127678,32431997,CNL
chr12,Bn45783,59361483,72933807,13572324,NBS
chr12,Bn45784,98141307,98319432,178125,RLK
chr12,Bn45785,87232073,92938717,5706644,RLP
chr12,Bn45786,49634632,92202210,42567578,CN
chr12,Bn45787,43103338,80795559,37692221,TNL
chr12,Bn45788,29661401,53904102,24242701,TN
chr12,Bn45789,58783126,93609898,34826772,RLP
chr12,Bn45790,91263763,94370955,3107192,CNL
chr12,Bn45791,92614484,98567149,5952665,CNL
chr12,Bn45792,39774452,62263337,22488885,TN
chr12,Bn45793,72264728,84986495,12721767,RLP
chr12,Bn45794,77473052,95611565,18138513,CNL
chr12,Bn45795,30459330,81577605,51118275,RLK
chr12,Bn45796,95871883,98528799,2656916,RLP
chr12,Bn45797,18061838,57595050,39533212,RLK
chr12,Bn45798,32107061,57733996,25626935,CN
chr12,Bn45799,30808478,44124128,13315650,TN
chr12,Bn45800,61759536,93808100,32048564,NBS
chr12,Bn45801,65222574,83091845,17869271,RLP
chr12,Bn45802,98431696,98726996,295300,TNL
chr12,Bn45803,14233022,85269972,71036950,CN
chr12,Bn45804,88377509,92800664,4423155,RLK
chr12,Bn45805,4349289,16407192,12057903,RLK
chr12,Bn45806,70413832,91490365,21076533,RLP
chr12,Bn45807,26611109,29875743,3264634,RLP
chr12,Bn45808,69146691,98209055,29062364,RLP
chr12,Bn45809,91948484,99524939,7576455,CNL
chr12,Bn45810,69636646,93927990,24291344,CN
chr12,Bn45811,13322902,57284703,43961801,CN
chr12,Bn45812,73252716,74773585,1520869,RLK
chr12,Bn45813,13828456,17198684,3370228,CN
chr12,Bn45814,37505429,41294692,3789263,RLP
chr12,Bn45815,88886767,93894601,5007834,RLK
chr12,Bn45816,54081379,81512454,27431075,NBS
chr12,Bn45817,98368940,98671555,302615,TN
chr12,Bn45818,21057553,96068852,75011299,RLP
chr12,Bn45819,4097506,44469953,40372447,TNL
chr12,Bn45820,83256026,86104943,2848917,CN
chr12,Bn45821,61427746,75307445,13879699,RLK
chr12,Bn45822,58729724,78346529,19616805,TNL
chr12,Bn45823,99273581,99899707,626126,RLP
chr12,Bn45824,38885668,71635508,32749840,TN
chr12,Bn45825,85506168,88966007,3459839,RLK
chr12,Bn45826,77162722,94150583,16987861,TNL
chr12,Bn45827,77230773,88164224,10933451,TN
chr12,Bn45828,8668945,62433501,53764556,CNL
chr12,Bn45829,78329481,89602769,11273288,TN
chr12,Bn45830,24228993,95066205,70837212,TN
chr12,Bn45831,59405414,81087523,21682109,TNL
chr12,Bn45832,84463339,96924845,12461506,TNL
chr12,Bn45833,92955574,93612543,656969,RLK
chr12,Bn45834,27081056,82450352,55369296,RLP
chr12,Bn45835,94974884,99307972,4333088,TNL
chr12,Bn45836,2576042,29018149,26442107,TNL
chr12,Bn45837,48577787,59337692,10759905,CNL
chr12,Bn45838,34128559,78904094,44775535,RLP
chr12,Bn45839,32718115,48331518,15613403,CNL
chr12,Bn45840,72399000,72469575,70575,RLK
chr12,Bn45841,25205730,30734095,5528365,TNL
chr12,Bn45842,78824249,79413310,589061,RLP
chr12,Bn45843,28746389,36080155,7333766,RLP
chr12,Bn45844,27858403,93634631,65776228,CN
chr12,Bn45845,77206064,95069613,17863549,RLP
chr12,Bn45846,94242878,98334513,4091635,TNL
chr12,Bn45847,83352935,93928047,10575112,NBS
chr12,Bn45848,89779285,94869991,5090706,NBS
chr12,Bn45849,64816597,99498321,34681724,RLK
chr12,Bn45850,64802393,97474008,32671615,TNL
chr12,Bn45851,53191420,55471280,2279860,RLP
chr12,Bn45852,41648889,64347414,22698525,CNL
chr12,Bn45853,15369041,99347603,83978562,RLP
chr12,Bn45854,52665279,79888607,27223328,NBS
chr12,Bn45855,16248288,56931040,40682752,CN
chr12,Bn45856,46601887,90423853,43821966,TNL
chr12,Bn45857,43746429,67831750,24085321,NBS
chr12,Bn45858,17441879,47687467,30245588,TNL
chr12,Bn45859,57384710,84374588,26989878,NBS
chr12,Bn45860,69409514,94165528,24756014,TNL
chr12,Bn45861,55867984,83689975,27821991,TN
chr12,Bn45862,96176872,96258414,81542,CNL
chr12,Bn45863,20602242,60419024,39816782,CN
chr12,Bn45864,49422167,55658159,6235992,TN
chr12,Bn45865,36687290,45911473,9224183,CN
chr12,Bn45866,47854256,72507343,24653087,CN
chr12,Bn45867,96184572,97798557,1613985,CN
chr12,Bn45868,22874294,92282419,69408125,CNL
chr12,Bn45869,27823189,50580121,22756932,NBS
chr12,Bn45870,74086022,84555217,10469195,NBS
chr12,Bn45871,79731506,90800232,11068726,RLP
chr12,Bn45872,27785336,90991185,63205849,RLP
chr12,Bn45873,61754696,97423424,35668728,TNL
chr12,Bn45874,74499621,94314018,19814397,TNL
chr12,Bn45875,18110188,52728112,34617924,TN
chr12,Bn45876,2607475,18715520,16108045,CN
chr12,Bn45877,33763144,77460836,43697692,CNL
chr12,Bn45878,18222296,64436894,46214598,RLP
chr12,Bn45879,4487208,45304132,40816924,CNL
chr12,Bn45880,75906459,82288674,6382215,CN
chr12,Bn45881,67027719,67314384,286665,TNL
chr12,Bn45882,41223444,45026001,3802557,RLK
chr12,Bn45883,30643424,96030489,65387065,CNL
chr12,Bn45884,23480977,44685897,21204920,TN
chr12,Bn45885,36186032,70189511,34003479,CNL
chr12,Bn45886,94072630,94534738,462108,RLK
chr12,Bn45887,8505572,71831973,63326401,RLK
chr12,Bn45888,87756796,92717726,4960930,CNL
chr12,Bn45889,22026200,36440706,14414506,RLP
chr12,Bn45890,60727905,72230289,11502384,NBS
chr12,Bn45891,93490594,96435723,2945129,TN
chr12,Bn45892,30996348,79751855,48755507,RLP
chr12,Bn45893,59410591,91356981,31946390,RLK
chr12,Bn45894,1810296,11899119,10088823,TNL
chr12,Bn45895,11722996,25383074,13660078,RLK
chr12,Bn45896,61304842,99028859,37724017,TN
chr12,Bn45897,32857874,86437294,53579420,RLK
chr12,Bn45898,39663763,69200539,29536776,TN
chr12,Bn45899,48012219,88040150,40027931,TNL
chr12,Bn45900,98972935,99217123,244188,CN
chr12,Bn45901,22147486,99954211,77806725,RLP
chr12,Bn45902,14621635,19301708,4680073,CN
chr12,Bn45903,51139438,66094491,14955053,CN
chr12,Bn45904,90058483,97695227,7636744,CNL
chr12,Bn45905,90264668,94945478,4680810,RLK
chr12,Bn45906,71504834,94248709,22743875,RLP
chr12,Bn45907,80643824,80789485,145661,RLK
chr12,Bn45908,2564802,40486024,37921222,RLP
chr12,Bn45909,85225607,87597615,2372008,TN
chr12,Bn45910,17692666,33716018,16023352,CN
chr12,Bn45911,76634140,98423209,21789069,TN
chr12,Bn45912,54357407,74697273,20339866,TN
chr12,Bn45913,75700757,80248155,4547398,RLP
chr12,Bn45914,89343013,91430744,2087731,TN
chr12,Bn45915,60083625,85693585,25609960,RLP
chr12,Bn45916,71930969,73368520,1437551,NBS
chr12,Bn45917,38174451,61153443,22978992,TN
chr12,Bn45918,69307715,82688813,13381098,TN
chr12,Bn45919,74269155,84378533,10109378,TNL
chr12,Bn45920,78417140,90651597,12234457,RLP
chr12,Bn45921,97910710,99245367,1334657,CN
chr12,Bn45922,6401204,48730561,42329357,CN
chr12,Bn45923,91806806,96997039,5190233,RLP
chr12,Bn45924,1790835,39264315,37473480,TN
chr12,Bn45925,46660643,83548195,36887552,RLK
chr12,Bn45926,62352672,67378837,5026165,RLP
chr12,Bn45927,38426777,42161642,3734865,TNL
chr12,Bn45928,48177121,50484037,2306916,RLP
chr12,Bn45929,84306366,94108895,9802529,TNL
chr12,Bn45930,27665553,50693207,23027654,TN
chr12,Bn45931,74377689,80889575,6511886,NBS
chr12,Bn45932,13460498,90588025,77127527,TNL
chr12,Bn45933,78249961,90262450,12012489,CNL
chr12,Bn45934,49161802,59778267,10616465,TN
chr12,Bn45935,88169849,90602869,2433020,CN
chr12,Bn45936,73321171,80444922,7123751,TN
chr12,Bn45937,6941428,50482694,43541266,NBS
chr12,Bn45938,9582055,42790148,33208093,CNL
chr12,Bn45939,13694067,83265667,69571600,CNL
chr12,Bn45940,24187566,70036445,45848879,CNL
chr12,Bn45941,6921760,68028043,61106283,RLK
chr12,Bn45942,83380766,88030600,4649834,NBS
chr12,Bn45943,13831957,26494390,12662433,CN
chr12,Bn45944,74867875,92707306,17839431,RLP
chr12,Bn45945,71295762,77640211,6344449,CN
chr12,Bn45946,10013919,20969877,10955958,NBS
chr12,Bn45947,86398057,94163149,7765092,NBS
chr12,Bn45948,7454004,23636783,16182779,TN
chr12,Bn45949,75492164,84215072,8722908,NBS
chr12,Bn45950,58593426,72244853,13651427,TNL
chr12,Bn45951,90987529,91426085,438556,NBS
chr12,Bn45952,78668752,96226727,17557975,NBS
chr12,Bn45953,86939853,87185179,245326,CN
chr12,Bn45954,49283170,60153236,10870066,RLP
chr12,Bn45955,86062751,87296473,1233722,RLP
chr12,Bn45956,52346215,94111849,41765634,RLP
chr12,Bn45957,8608103,8885475,277372,RLK
chr12,Bn45958,45580241,80349750,34769509,TN
chr12,Bn45959,66633753,69646140,3012387,TNL
chr12,Bn45960,67665188,90365265,22700077,TN
chr12,Bn45961,80169471,87218903,7049432,CNL
chr12,Bn45962,14688823,37183640,22494817,TNL
chr12,Bn45963,11887541,48798439,36910898,CNL
chr12,Bn45964,39212509,74563927,35351418,NBS
chr12,Bn45965,74486857,95067677,20580820,RLK
chr12,Bn45966,25354175,26421356,1067181,RLK
chr12,Bn45967,61086354,87679321,26592967,CN
chr12,Bn45968,66802749,78630169,11827420,TN
chr12,Bn45969,21934922,22480449,545527,CNL
chr12,Bn45970,97029894,99469533,2439639,CN
chr12,Bn45971,83437069,93607052,10169983,RLP
chr12,Bn45972,24539910,31566263,7026353,RLK
chr12,Bn45973,92059592,92945444,885852,RLK
chr12,Bn45974,43830345,83975837,40145492,CNL
chr12,Bn45975,34777442,55197803,20420361,TN
chr12,Bn45976,7879195,8280460,401265,NBS
chr12,Bn45977,67761563,85078379,17316816,NBS
chr12,Bn45978,57866340,65470072,7603732,NBS
chr12,Bn45979,24472508,80330189,55857681,RLK
chr12,Bn45980,4514812,17397765,12882953,RLK
chr12,Bn45981,61114144,68660033,7545889,TN
chr12,Bn45982,13398326,67758843,54360517,TNL
chr12,Bn45983,87957661,93994819,6037158,TNL
chr12,Bn45984,87903853,97480981,9577128,CNL
chr12,Bn45985,49096685,75750262,26653577,RLP
chr12,Bn45986,20883854,33419278,12535424,NBS
chr12,Bn45987,38719082,91711018,52991936,RLK
chr12,Bn45988,12926047,50270572,37344525,RLK
chr12,Bn45989,32598944,46056620,13457676,RLK
chr12,Bn45990,53983820,65976896,11993076,RLK
chr12,Bn45991,19029529,59417757,40388228,RLK
chr12,Bn45992,34194535,92488437,58293902,CNL
chr12,Bn45993,85080446,86647171,1566725,CN
chr12,Bn45994,17643889,23703824,6059935,CNL
chr12,Bn45995,72936499,91455926,18519427,NBS
chr12,Bn45996,78595160,92515118,13919958,RLK
chr12,Bn45997,35568900,96388287,60819387,TNL
chr12,Bn45998,25642214,75463972,49821758,TNL
chr12,Bn45999,82007482,92045569,10038087,TN
chr12,Bn46000,97800196,97850895,50699,RLK
chr12,Bn46001,42735888,47652668,4916780,RLP
chr12,Bn46002,42222783,76740327,34517544,NBS
chr12,Bn46003,79708249,97578929,17870680,CNL
chr12,Bn46004,23740555,62719627,38979072,RLP
chr12,Bn46005,91087506,98856438,7768932,NBS
chr12,Bn46006,3809550,28404843,24595293,NBS
chr12,Bn46007,65127138,76282407,11155269,NBS
chr12,Bn46008,71177669,94042568,22864899,CNL
chr12,Bn46009,61840147,87799662,25959515,TNL
chr12,Bn46010,42430052,43893172,1463120,RLK
chr12,Bn46011,4650926,10715994,6065068,NBS
chr12,Bn46012,41872985,78968912,37095927,CN
chr12,Bn46013,68533433,97904447,29371014,RLK
chr12,Bn46014,27960316,88387985,60427669,CN
chr12,Bn46015,17452880,89423192,71970312,RLK
chr12,Bn46016,11038516,50953441,39914925,CN
chr12,Bn46017,12894432,56821263,43926831,TN
chr12,Bn46018,81250818,97241033,15990215,CNL
chr12,Bn46019,67692197,84722190,17029993,CN
chr12,Bn46020,89876326,92863292,2986966,NBS
chr12,Bn46021,59523732,79497101,19973369,RLK
chr12,Bn46022,54726423,63073778,8347355,CN
chr12,Bn46023,11518175,42196335,30678160,TN
chr12,Bn46024,12095047,94349319,82254272,TN
chr12,Bn46025,5277432,27700773,22423341,RLP
chr12,Bn46026,79677496,92253249,12575753,TNL
chr12,Bn46027,12622620,45373989,32751369,CNL
chr12,Bn46028,70666114,70718982,52868,TN
chr12,Bn46029,2103856,26804462,24700606,TNL
chr12,Bn46030,24894032,81054007,56159975,CNL
chr12,Bn46031,11962344,87041491,75079147,CNL
chr12,Bn46032,35247245,55612840,20365595,RLP
chr12,Bn46033,7553362,87549179,79995817,CN
chr12,Bn46034,35038419,78760418,43721999,CNL
chr12,Bn46035,21378367,91410814,70032447,TN
chr12,Bn46036,19441826,84248521,64806695,CNL
chr12,Bn46037,31591261,86494449,54903188,TN
chr12,Bn46038,68925293,81503840,12578547,CNL
chr12,Bn46039,85670071,87390194,1720123,TN
chr12,Bn46040,34101012,63774546,29673534,TNL
chr12,Bn46041,67772210,97541724,29769514,RLP
chr12,Bn46042,55288303,77888947,22600644,CNL
chr12,Bn46043,6076647,47839078,41762431,RLP
chr12,Bn46044,18416388,32205622,13789234,TNL
chr12,Bn46045,66684916,76558180,9873264,TN
chr12,Bn46046,45330265,68232705,22902440,CN
chr12,Bn46047,17877241,44138945,26261704,CN
chr12,Bn46048,81371836,93013165,11641329,TNL
chr12,Bn46049,5059317,34026524,28967207,TNL
chr12,Bn46050,61290145,73927898,12637753,TNL
chr12,Bn46051,72216053,86648935,14432882,CNL
chr12,Bn46052,2212070,84744349,82532279,TN
chr12,Bn46053,87681500,88586707,905207,CNL
chr12,Bn46054,29340548,39124009,9783461,CNL
chr12,Bn46055,74907143,86231624,11324481,TN
chr12,Bn46056,47993691,48349802,356111,RLP
chr12,Bn46057,90118561,96995234,6876673,RLP
chr12,Bn46058,58389696,79463194,21073498,RLK
chr12,Bn46059,63008036,64464185,1456149,NBS
chr12,Bn46060,27855897,43165085,15309188,CNL
chr12,Bn46061,35437640,70834197,35396557,RLP
chr12,Bn46062,99227426,99929752,702326,TNL
chr12,Bn46063,42586644,62278160,19691516,CN
chr12,Bn46064,88294048,93109550,4815502,RLP
chr12,Bn46065,46005842,83489009,37483167,CN
chr12,Bn46066,61002191,77583999,16581808,NBS
chr12,Bn46067,58229150,84413076,26183926,NBS
chr12,Bn46068,11449265,40392889,28943624,TNL
chr12,Bn46069,62254899,69931582,7676683,NBS
chr12,Bn46070,82295582,87075795,4780213,TN
chr12,Bn46071,37045789,70675740,33629951,CNL
chr12,Bn46072,85649366,96160717,10511351,TNL
chr12,Bn46073,46239060,59271307,13032247,TN
chr12,Bn46074,80041227,98295815,18254588,RLK
chr12,Bn46075,36682109,66093143,29411034,NBS
chr12,Bn46076,32286323,45795064,13508741,CNL
chr12,Bn46077,43782223,48085020,4302797,TN
chr12,Bn46078,47029037,59132106,12103069,RLK
chr12,Bn46079,77323716,97633083,20309367,CNL
chr12,Bn46080,63360915,72330523,8969608,TN
chr12,Bn46081,5358314,95742900,90384586,RLP
chr12,Bn46082,33636548,92344425,58707877,TNL
chr12,Bn46083,74633224,96565991,21932767,TN
chr12,Bn46084,21965994,92870604,70904610,RLP
chr12,Bn46085,39252955,52072804,12819849,CN
chr12,Bn46086,1063286,5348302,4285016,CN
chr12,Bn46087,51655301,98887036,47231735,RLK
chr12,Bn46088,29558879,55554719,25995840,RLK
chr12,Bn46089,21960037,91227229,69267192,RLP
chr12,Bn46090,90231356,93769885,3538529,CNL
chr12,Bn46091,72479894,83736505,11256611,CNL
chr12,Bn46092,17834891,42760376,24925485,RLK
chr12,Bn46093,38732925,66364987,27632062,RLK
chr12,Bn46094,89373472,97528105,8154633,RLP
chr12,Bn46095,43275413,68623051,25347638,CN
chr12,Bn46096,56198121,58692987,2494866,CNL
chr12,Bn46097,46812231,49834806,3022575,NBS
chr12,Bn46098,3865308,73166517,69301209,TN
chr12,Bn46099,95496641,96258004,761363,TN
chr12,Bn46100,61278443,84991825,23713382,RLP
chr12,Bn46101,43355552,69283410,25927858,CNL
chr12,Bn46102,51271732,65740700,14468968,CNL
chr12,Bn46103,10238899,68717235,58478336,CN
chr12,Bn46104,2465064,97663436,95198372,TNL
chr12,Bn46105,20716090,58633570,37917480,CN
chr12,Bn46106,98441923,98530499,88576,RLP
chr12,Bn46107,32924430,34005225,1080795,TNL
chr12,Bn46108,58034773,63302691,5267918,NBS
chr12,Bn46109,31209821,42603708,11393887,RLK
chr12,Bn46110,71945611,75140892,3195281,CN
chr12,Bn46111,86102035,86450077,348042,CNL
chr12,Bn46112,66833633,82764499,15930866,NBS
chr12,Bn46113,77418332,85250798,7832466,TNL
chr12,Bn46114,76507096,83143005,6635909,CN
chr12,Bn46115,85367838,98473454,13105616,NBS
chr12,Bn46116,76831301,88807074,11975773,CNL
chr12,Bn46117,50798396,65784382,14985986,RLK
chr12,Bn46118,48536779,75195628,26658849,RLP
chr12,Bn46119,67231566,96828462,29596896,TN
chr12,Bn46120,99926987,99984776,57789,CNL
chr12,Bn46121,50125237,54046983,3921746,RLK
chr12,Bn46122,77206821,87597105,10390284,RLP
chr12,Bn46123,36830860,59547191,22716331,NBS
chr12,Bn46124,99222805,99829690,606885,NBS
chr12,Bn46125,24693875,36124514,11430639,RLP
chr12,Bn46126,47813159,65734432,17921273,CN
chr12,Bn46127,58757650,63806399,5048749,RLK
chr12,Bn46128,17981600,80717428,62735828,CN
chr12,Bn46129,69194739,86337033,17142294,CNL
chr12,Bn46130,80421247,97179107,16757860,TN
chr12,Bn46131,19952848,56965431,37012583,RLP
chr12,Bn46132,54828445,73516674,18688229,NBS
chr12,Bn46133,30649487,81980428,51330941,TN
chr12,Bn46134,47009517,64770128,17760611,TN
chr12,Bn46135,17300870,38662760,21361890,TNL
chr12,Bn46136,34371694,86428414,52056720,CN
chr12,Bn46137,38182493,95463151,57280658,CNL
chr12,Bn46138,14984709,68747142,53762433,TN
chr12,Bn46139,19442239,37589813,18147574,CN
chr12,Bn46140,10893136,55572486,44679350,TN
chr12,Bn46141,89545057,94367168,4822111,CN
chr12,Bn46142,57037905,84959083,27921178,CNL
chr12,Bn46143,40944200,86006777,45062577,RLP
chr12,Bn46144,51107566,75223257,24115691,CN
chr12,Bn46145,15146870,35141626,19994756,CN
chr12,Bn46146,43201715,78387578,35185863,NBS
chr12,Bn46147,12861045,58154736,45293691,TN
chr12,Bn46148,69717059,73390610,3673551,CN
chr12,Bn46149,78236391,99143753,20907362,TNL
chr12,Bn46150,80639251,91606078,10966827,CN
chr12,Bn46151,61636021,87663181,26027160,NBS
chr12,Bn46152,58290321,83916421,25626100,TNL
chr12,Bn46153,36629062,98875387,62246325,TN
chr12,Bn46154,78440523,92568942,14128419,CN
chr12,Bn46155,22197983,94668382,72470399,NBS
chr12,Bn46156,42111929,52198013,10086084,RLK
chr12,Bn46157,39321445,56216796,16895351,TN
chr12,Bn46158,5047988,23646665,18598677,RLP
chr12,Bn46159,55182704,98100159,42917455,CN
chr12,Bn46160,6866688,11702815,4836127,RLK
chr12,Bn46161,95324937,96011448,686511,RLK
chr12,Bn46162,35601075,46821993,11220918,CN
chr12,Bn46163,7995741,53573209,45577468,RLK
chr12,Bn46164,90533600,97283500,6749900,CNL
chr12,Bn46165,79582914,88086819,8503905,TNL
chr12,Bn46166,84565279,98141834,13576555,TN
chr12,Bn46167,84674629,90628735,5954106,TN
chr12,Bn46168,21314943,25830455,4515512,CNL
chr12,Bn46169,88040361,94391058,6350697,NBS
chr12,Bn46170,13293876,28208541,14914665,NBS
chr12,Bn46171,95714448,99069607,3355159,CNL
chr12,Bn46172,15550351,86933459,71383108,NBS
chr12,Bn46173,4593137,7654896,3061759,TNL
chr12,Bn46174,23396440,90652830,67256390,TNL
chr12,Bn46175,28050929,65495110,37444181,TNL
chr12,Bn46176,30157270,49929941,19772671,CNL
chr12,Bn46177,52680178,92136212,39456034,RLP
chr12,Bn46178,92276163,93187665,911502,CNL
chr12,Bn46179,67479167,90188381,22709214,CNL
chr12,Bn46180,92887164,94650259,1763095,RLP
chr12,Bn46181,82108271,96458199,14349928,RLK
chr12,Bn46182,23822032,49928456,26106424,NBS
chr12,Bn46183,58390345,70969813,12579468,TN
chr12,Bn46184,57762360,95023229,37260869,RLP
chr12,Bn46185,83111683,83307226,195543,CNL
chr12,Bn46186,84691740,99390543,14698803,CN
chr12,Bn46187,70191527,95107454,24915927,TNL
chr12,Bn46188,7653149,14128181,6475032,CN
chr12,Bn46189,26181653,62215136,36033483,CN
chr12,Bn46190,53457734,57583140,4125406,CN
chr12,Bn46191,53802928,93609138,39806210,TN
chr12,Bn46192,91062911,97746889,6683978,TN
chr12,Bn46193,32616168,46092994,13476826,CN
chr12,Bn46194,19405480,26966832,7561352,CN
chr12,Bn46195,23648148,87889659,64241511,CNL
chr12,Bn46196,66262182,88677494,22415312,NBS
chr12,Bn46197,80686289,81202315,516026,NBS
chr12,Bn46198,11483706,85528392,74044686,RLP
chr12,Bn46199,65547368,78732301,13184933,RLP
chr12,Bn46200,66158087,92795326,26637239,TNL
chr12,Bn46201,43700984,91793740,48092756,RLP
chr12,Bn46202,58318444,64640826,6322382,TNL
chr12,Bn46203,7642740,11692985,4050245,RLP
chr12,Bn46204,3515408,25733787,22218379,TN
chr12,Bn46205,65664593,76803848,11139255,CN
chr12,Bn46206,14582683,57894139,43311456,RLP
chr12,Bn46207,59464514,59910825,446311,RLP
chr12,Bn46208,98870783,99965727,1094944,TNL
chr12,Bn46209,40871859,54552496,13680637,NBS
chr12,Bn46210,43247011,47034505,3787494,RLP
chr12,Bn46211,93259925,93550946,291021,RLP
chr12,Bn46212,33431809,91545149,58113340,NBS
chr12,Bn46213,42545499,62668266,20122767,CN
chr12,Bn46214,51530892,63378341,11847449,CNL
chr12,Bn46215,90352808,95248515,4895707,TNL
chr12,Bn46216,47172477,56580910,9408433,TN
chr12,Bn46217,1870935,66353603,64482668,TN
chr12,Bn46218,99269313,99655542,386229,CN
chr12,Bn46219,72969154,92820942,19851788,NBS
chr12,Bn46220,36244362,58652735,22408373,TNL
chr12,Bn46221,41416690,42099787,683097,CNL
chr12,Bn46222,55386125,83626181,28240056,TN
chr12,Bn46223,89554707,98180335,8625628,TN
chr12,Bn46224,57754971,93560392,35805421,CN
chr12,Bn46225,8443394,40386198,31942804,TNL
chr12,Bn46226,57764775,70894644,13129869,RLK
chr12,Bn46227,33872156,54568032,20695876,NBS
chr12,Bn46228,52183873,58405430,6221557,CN
chr12,Bn46229,99437904,99762329,324425,TNL
chr12,Bn46230,25039624,45618403,20578779,TN
chr12,Bn46231,59561350,92881300,33319950,TNL
chr12,Bn46232,55446876,60905898,5459022,TN
chr12,Bn46233,41772308,49133582,7361274,RLK
chr12,Bn46234,64819985,82314481,17494496,RLP
chr12,Bn46235,36533260,94524645,57991385,TNL
chr12,Bn46236,93423812,98371556,4947744,NBS
chr12,Bn46237,68187491,98468707,30281216,RLK
chr12,Bn46238,78526230,89728480,11202250,NBS
chr12,Bn46239,62082993,73491316,11408323,RLP
chr12,Bn46240,41842587,91356704,49514117,RLK
chr12,Bn46241,42160722,72814710,30653988,CN
chr12,Bn46242,59575340,87658988,28083648,NBS
chr12,Bn46243,75275940,95175463,19899523,NBS
chr12,Bn46244,56850667,70041055,13190388,RLP
chr12,Bn46245,74520103,86623447,12103344,CNL
chr12,Bn46246,59080346,82802066,23721720,NBS
chr12,Bn46247,89021354,94472677,5451323,RLP
chr12,Bn46248,12503234,33387203,20883969,RLK
chr12,Bn46249,7549836,48320311,40770475,TNL
chr12,Bn46250,94653843,94703465,49622,NBS
chr12,Bn46251,60488072,65468134,4980062,RLK
chr12,Bn46252,62501774,79906455,17404681,NBS
chr12,Bn46253,69603374,88575018,18971644,CN
chr12,Bn46254,79396264,89062847,9666583,NBS
chr12,Bn46255,1020717,44011718,42991001,RLK
chr12,Bn46256,8962849,44908945,35946096,CNL
chr12,Bn46257,80438466,89202138,8763672,TNL
chr12,Bn46258,62196359,63515936,1319577,RLK
chr12,Bn46259,90615666,97400840,6785174,CN
chr12,Bn46260,64661647,70097580,5435933,RLP
chr12,Bn46261,2668840,62858689,60189849,TNL
chr12,Bn46262,15956049,32768451,16812402,RLP
chr12,Bn46263,26709580,79594283,52884703,RLP
chr12,Bn46264,31080353,33003541,1923188,RLP
chr12,Bn46265,82360514,95474389,13113875,TN
chr12,Bn46266,69444218,70062791,618573,RLP
chr12,Bn46267,17202860,61137804,43934944,TNL
chr12,Bn46268,46363325,82129550,35766225,TN
chr12,Bn46269,2303602,52208362,49904760,NBS
chr12,Bn46270,44635508,75060981,30425473,NBS
chr12,Bn46271,20139477,33164815,13025338,TN
chr12,Bn46272,8105192,54255167,46149975,RLK
chr12,Bn46273,17359963,88292134,70932171,TNL
chr12,Bn46274,81589237,82628670,1039433,CNL
chr12,Bn46275,89836317,96196027,6359710,CNL
chr12,Bn46276,78295502,86819644,8524142,RLK
chr12,Bn46277,25357345,55821385,30464040,NBS
chr12,Bn46278,57971781,63452375,5480594,NBS
chr12,Bn46279,13311052,96758906,83447854,TN
chr12,Bn46280,94187120,97588020,3400900,TN
chr12,Bn46281,7253816,91497765,84243949,TNL
chr12,Bn46282,19079720,91285277,72205557,RLK
chr12,Bn46283,90694109,91820274,1126165,CNL
chr12,Bn46284,8737885,95288102,86550217,CN
chr12,Bn46285,73868252,83269927,9401675,TNL
chr12,Bn46286,1948209,66730357,64782148,RLP
chr12,Bn46287,54027557,98853610,44826053,RLK
chr12,Bn46288,5086756,73024644,67937888,CNL
chr12,Bn46289,51979369,64860221,12880852,RLP
chr12,Bn46290,31424785,35608582,4183797,CNL
chr12,Bn46291,41166449,56579676,15413227,CN
chr12,Bn46292,64035138,82839305,18804167,TNL
chr12,Bn46293,43542644,76455404,32912760,RLK
chr12,Bn46294,3381588,29583374,26201786,CN
chr12,Bn46295,83373818,96387127,13013309,TN
chr12,Bn46296,46661430,83071033,36409603,TNL
chr12,Bn46297,24730231,25949986,1219755,TN
chr12,Bn46298,49699150,82483769,32784619,CN
chr12,Bn46299,9970381,99456394,89486013,RLK
chr12,Bn46300,24152058,35208580,11056522,TNL
chr12,Bn46301,7731998,51652837,43920839,TNL
chr12,Bn46302,13799615,18327563,4527948,RLP
chr12,Bn46303,96318525,99220333,2901808,CN
chr12,Bn46304,11816790,88912720,77095930,RLK
chr12,Bn46305,67658737,67689962,31225,NBS
chr12,Bn46306,22926185,31865256,8939071,RLP
chr12,Bn46307,99439308,99599409,160101,RLK
chr12,Bn46308,25861131,48057683,22196552,TNL
chr12,Bn46309,99286051,99804959,518908,RLK
chr12,Bn46310,88949278,91837910,2888632,TNL
chr12,Bn46311,57940915,84578113,26637198,TN
chr12,Bn46312,66225463,70688605,4463142,TN
chr12,Bn46313,14111209,46294953,32183744,TN
chr12,Bn46314,68281757,85117138,16835381,RLP
chr12,Bn46315,77981324,90431330,12450006,NBS
chr12,Bn46316,63222801,98020125,34797324,TNL
chr12,Bn46317,44340773,99100538,54759765,TN
chr12,Bn46318,90744821,95804334,5059513,RLP
chr12,Bn46319,43714300,97459766,53745466,RLP
chr12,Bn46320,50287305,82299218,32011913,TN
chr12,Bn46321,40133343,68803711,28670368,NBS
chr12,Bn46322,77296039,94485331,17189292,TN
chr12,Bn46323,86459704,87990209,1530505,NBS
chr12,Bn46324,61466776,96611737,35144961,TN
chr12,Bn46325,63840152,77652106,13811954,CNL
chr12,Bn46326,98832791,99533730,700939,CNL
chr12,Bn46327,37845619,43965859,6120240,CN
chr12,Bn46328,10971963,36619809,25647846,RLK
chr12,Bn46329,19290263,64957764,45667501,NBS
chr12,Bn46330,13988848,58037906,44049058,CNL
chr12,Bn46331,84453512,88414949,3961437,TN
chr12,Bn46332,31991190,93821538,61830348,CNL
chr12,Bn46333,44451206,82246195,37794989,TN
chr12,Bn46334,5617616,6640209,1022593,TN
chr12,Bn46335,45053698,62412098,17358400,CN
chr12,Bn46336,45327524,89714797,44387273,TN
chr12,Bn46337,21830069,89542153,67712084,NBS
chr12,Bn46338,53105990,82848750,29742760,TNL
chr12,Bn46339,10516205,84531829,74015624,NBS
chr12,Bn46340,37304335,79789102,42484767,TN
chr12,Bn46341,16781069,41148836,24367767,CNL
chr12,Bn46342,78300290,87849740,9549450,CNL
chr12,Bn46343,98721819,98865772,143953,NBS
chr12,Bn46344,7836480,36333691,28497211,RLK
chr12,Bn46345,45175862,92151371,46975509,TN
chr12,Bn46346,31797280,99171871,67374591,CNL
chr12,Bn46347,14614015,66951097,52337082,CN
chr12,Bn46348,21730839,94307099,72576260,RLK
chr12,Bn46349,3451716,74250095,70798379,CNL
chr12,Bn46350,13675559,54691097,41015538,RLK
chr12,Bn46351,97665962,99163098,1497136,RLK
chr12,Bn46352,87221011,99614024,12393013,RLP
chr12,Bn46353,32361636,71173938,38812302,NBS
chr12,Bn46354,72610134,98636290,26026156,CNL
chr12,Bn46355,83825188,97858418,14033230,CNL
chr12,Bn46356,94096312,98445986,4349674,RLP
chr12,Bn46357,73876529,81208609,7332080,NBS
chr12,Bn46358,73999172,95084150,21084978,TNL
chr12,Bn46359,97840198,98972068,1131870,NBS
chr12,Bn46360,95024046,96744016,1719970,RLP
chr12,Bn46361,69318301,86715314,17397013,CN
chr12,Bn46362,9661977,21414184,11752207,TNL
chr12,Bn46363,18078827,22663822,4584995,RLP
chr12,Bn46364,23228138,63093127,39864989,RLK
chr12,Bn46365,17842301,91448897,73606596,NBS
chr12,Bn46366,78298915,86629363,8330448,RLK
chr12,Bn46367,18940627,68856250,49915623,CNL
chr12,Bn46368,40125203,59704135,19578932,RLP
chr12,Bn46369,90000538,96295541,6295003,TN
chr12,Bn46370,7697820,38307117,30609297,NBS
chr12,Bn46371,4202431,47816807,43614376,CNL
chr12,Bn46372,19514476,98822648,79308172,TN
chr12,Bn46373,49750952,54759659,5008707,CN
chr12,Bn46374,29348629,94537700,65189071,TN
chr12,Bn46375,64419496,82376515,17957019,NBS
chr12,Bn46376,38583815,44188314,5604499,CNL
chr12,Bn46377,25936716,91270145,65333429,RLK
chr12,Bn46378,98461229,98887623,426394,NBS
chr12,Bn46379,22902770,60696510,37793740,RLK
chr12,Bn46380,12052268,79358855,67306587,RLK
chr12,Bn46381,68209799,95567852,27358053,CNL
chr12,Bn46382,29516398,93239380,63722982,TNL
chr12,Bn46383,50744058,83275608,32531550,TNL
chr12,Bn46384,80681246,92978318,12297072,TN
chr12,Bn46385,79753182,84884909,5131727,NBS
chr12,Bn46386,69912322,77772981,7860659,RLP
chr12,Bn46387,6835158,79820164,72985006,CN
chr12,Bn46388,98622695,99043590,420895,RLP
chr12,Bn46389,83659334,83715539,56205,TNL
chr12,Bn46390,11029471,95031412,84001941,NBS
chr12,Bn46391,4817855,32317303,27499448,RLK
chr12,Bn46392,6529360,36866571,30337211,RLK
chr12,Bn46393,81459816,93164102,11704286,TN
chr12,Bn46394,90703190,99604194,8901004,CN
chr12,Bn46395,68016662,81397946,13381284,RLK
chr12,Bn46396,66142419,73746841,7604422,TNL
chr12,Bn46397,15879633,92801910,76922277,RLP
chr12,Bn46398,77359424,86644387,9284963,CNL
chr12,Bn46399,28633094,49523639,20890545,TN
chr12,Bn46400,55762356,58861317,3098961,NBS
chr12,Bn46401,61976143,91764650,29788507,RLP
chr12,Bn46402,54403739,84867056,30463317,CN
chr12,Bn46403,48040236,54187880,6147644,NBS
chr12,Bn46404,52305015,95594824,43289809,RLK
chr12,Bn46405,4196945,85671507,81474562,RLK
chr12,Bn46406,77446444,88612589,11166145,TN
chr12,Bn46407,5829612,36252462,30422850,CNL
chr12,Bn46408,80179214,93951617,13772403,RLK
chr12,Bn46409,56604659,77916896,21312237,NBS
chr12,Bn46410,98827265,99664439,837174,TN
chr12,Bn46411,71329033,74898106,3569073,NBS
chr12,Bn46412,1599811,72094141,70494330,RLP
chr12,Bn46413,46795906,96955186,50159280,CN
chr12,Bn46414,71473214,79709328,8236114,RLP
chr12,Bn46415,79752191,86525385,6773194,RLK
chr12,Bn46416,85186531,99176520,13989989,TN
chr12,Bn46417,80529268,82258741,1729473,NBS
chr12,Bn46418,45133287,92787380,47654093,CN
chr12,Bn46419,84429964,99274493,14844529,TN
chr12,Bn46420,10820581,33805262,22984681,RLP
chr12,Bn46421,36286956,40358164,4071208,TNL
chr12,Bn46422,81878684,99305008,17426324,CNL
chr12,Bn46423,4493167,88473927,83980760,TN
chr12,Bn46424,26080758,79250465,53169707,RLK
chr12,Bn46425,2736749,11135442,8398693,TNL
chr12,Bn46426,8383915,40328249,31944334,RLK
chr12,Bn46427,55673660,64313512,8639852,RLK
chr12,Bn46428,8612202,82634767,74022565,NBS
chr12,Bn46429,4380833,55445462,51064629,CNL
chr12,Bn46430,61395815,62455916,1060101,CN
chr12,Bn46431,34924704,66424271,31499567,TN
chr12,Bn46432,67832468,93024973,25192505,RLK
chr12,Bn46433,13945706,83848246,69902540,RLK
chr12,Bn46434,50638607,55367510,4728903,CNL
chr12,Bn46435,10965039,20927453,9962414,CN
chr12,Bn46436,60821174,95109516,34288342,RLP
chr12,Bn46437,79712951,84418905,4705954,CNL
chr12,Bn46438,17828886,26303798,8474912,NBS
chr12,Bn46439,56900016,96562973,39662957,NBS
chr12,Bn46440,95021503,95782667,761164,TN
chr12,Bn46441,4473642,19219145,14745503,NBS
chr12,Bn46442,13857661,74408092,60550431,TNL
chr12,Bn46443,2269395,61244187,58974792,RLP
chr12,Bn46444,56028462,65562412,9533950,TNL
chr12,Bn46445,53213436,57097913,3884477,NBS
chr12,Bn46446,24653578,77955068,53301490,CNL
chr12,Bn46447,13796793,58630465,44833672,TNL
chr12,Bn46448,38552604,99008861,60456257,NBS
chr12,Bn46449,30498515,61928704,31430189,RLP
chr12,Bn46450,85869879,88990702,3120823,RLK
chr12,Bn46451,73810749,77067266,3256517,CN
chr12,Bn46452,3997200,8608421,4611221,CNL
chr12,Bn46453,88389953,88651059,261106,RLK
chr12,Bn46454,11348302,73008580,61660278,TN
chr12,Bn46455,3106667,6407994,3301327,CNL
chr12,Bn46456,8264694,10654109,2389415,NBS
chr12,Bn46457,71843958,82868635,11024677,CNL
chr12,Bn46458,86214514,89532206,3317692,CNL
chr12,Bn46459,98016301,99163711,1147410,RLP
chr12,Bn46460,69090139,77086002,7995863,TN
chr12,Bn46461,46903846,68336748,21432902,RLK
chr12,Bn46462,32320040,90951896,58631856,TN
chr12,Bn46463,2072288,15642610,13570322,CNL
chr12,Bn46464,14551052,24773968,10222916,RLK
chr12,Bn46465,69342659,86935796,17593137,NBS
chr12,Bn46466,29399601,32156630,2757029,NBS
chr12,Bn46467,9001403,37650350,28648947,RLK
chr12,Bn46468,52216384,82824668,30608284,TN
chr12,Bn46469,20742256,22102052,1359796,TN
chr12,Bn46470,37396951,87496418,50099467,NBS
chr12,Bn46471,30354843,73703940,43349097,CN
chr12,Bn46472,48071956,70906197,22834241,TNL
chr12,Bn46473,23163407,50069678,26906271,RLP
chr12,Bn46474,96098694,98405717,2307023,CN
chr12,Bn46475,79028869,84958208,5929339,RLK
chr12,Bn46476,81966988,85260721,3293733,RLP
chr12,Bn46477,89844908,92317712,2472804,CN
chr12,Bn46478,81259662,97404546,16144884,CN
chr12,Bn46479,62477248,76175486,13698238,RLK
chr12,Bn46480,43982509,87088701,43106192,CN
chr12,Bn46481,40456784,91397783,50940999,TNL
chr12,Bn46482,12912249,61891554,48979305,RLP
chr12,Bn46483,89728547,89771167,42620,TN
chr12,Bn46484,74457900,95154699,20696799,NBS
chr12,Bn46485,30214482,82233517,52019035,TN
chr12,Bn46486,43943508,62264165,18320657,TNL
chr12,Bn46487,19229131,91628073,72398942,RLK
chr12,Bn46488,66673089,96378456,29705367,CN
chr12,Bn46489,25276949,63252337,37975388,RLK
chr12,Bn46490,69649396,79881944,10232548,NBS
chr12,Bn46491,37638200,75193959,37555759,RLP
chr12,Bn46492,74079913,79231901,5151988,TN
chr12,Bn46493,36066975,69810245,33743270,TNL
chr12,Bn46494,28537902,64051335,35513433,NBS
chr12,Bn46495,51746980,84256748,32509768,NBS
chr12,Bn46496,5651318,25841182,20189864,CN
chr12,Bn46497,24811789,97030090,72218301,RLP
chr12,Bn46498,8840000,55725756,46885756,TN
chr12,Bn46499,30859883,58812667,27952784,TNL
chr12,Bn46500,9776404,63054074,53277670,NBS
chr12,Bn46501,58963041,95882679,36919638,NBS
chr12,Bn46502,93383125,98370520,4987395,CNL
chr12,Bn46503,27233290,78139938,50906648,TN
chr12,Bn46504,81140926,87239924,6098998,CNL
chr12,Bn46505,25595062,97684673,72089611,TNL
chr12,Bn46506,22502507,30461297,7958790,CN
chr12,Bn46507,17887331,97506431,79619100,TN
chr12,Bn46508,34905541,45832834,10927293,NBS
chr12,Bn46509,68370460,69862271,1491811,NBS
chr12,Bn46510,56838533,99830513,42991980,RLK
chr12,Bn46511,72808400,82525131,9716731,NBS
chr12,Bn46512,1035605,95782286,94746681,TN
chr12,Bn46513,18425752,94575607,76149855,NBS
chr12,Bn46514,92498924,98386013,5887089,TN
chr12,Bn46515,30901954,33765753,2863799,TNL
chr12,Bn46516,77206712,85812719,8606007,RLP
chr12,Bn46517,1963400,38628032,36664632,TNL
chr12,Bn46518,24599614,33189176,8589562,RLK
chr12,Bn46519,71901435,82322420,10420985,TN
chr12,Bn46520,42974123,67505345,24531222,RLK
chr12,Bn46521,65111822,99643429,34531607,TN
chr12,Bn46522,74914664,90745031,15830367,CN
chr12,Bn46523,36351876,39086015,2734139,TN
chr12,Bn46524,15770392,90983088,75212696,CN
chr12,Bn46525,99864327,99894014,29687,RLP
chr12,Bn46526,79965133,93841160,13876027,RLP
chr12,Bn46527,7001158,39217108,32215950,CN
chr12,Bn46528,31912180,36780008,4867828,RLP
chr12,Bn46529,62404038,85135134,22731096,RLK
chr12,Bn46530,70347887,76038171,5690284,RLK
chr12,Bn46531,43159994,52531226,9371232,RLK
chr12,Bn46532,33246825,70429173,37182348,TNL
chr12,Bn46533,77534626,96494217,18959591,TN
chr12,Bn46534,38308492,87154418,48845926,TN
chr12,Bn46535,8238598,22626316,14387718,TN
chr12,Bn46536,26852936,83047763,56194827,CN
chr12,Bn46537,40790914,93713954,52923040,RLK
chr12,Bn46538,10882108,86585582,75703474,RLK
chr12,Bn46539,96789572,99594556,2804984,RLP
chr12,Bn46540,87202834,89626412,2423578,TNL
chr12,Bn46541,1841124,46467807,44626683,NBS
chr12,Bn46542,50764740,57155641,6390901,RLK
chr12,Bn46543,88518627,95261363,6742736,RLK
chr12,Bn46544,4229078,40832395,36603317,CNL
chr12,Bn46545,86734102,90992323,4258221,NBS
chr12,Bn46546,91982572,95606910,3624338,TN
chr12,Bn46547,66159535,68870879,2711344,NBS
chr12,Bn46548,90186090,96895128,6709038,TN
chr12,Bn46549,48721574,64645790,15924216,NBS
chr12,Bn46550,68501900,90753355,22251455,RLK
chr12,Bn46551,45761296,84816834,39055538,NBS
chr12,Bn46552,93283407,95489632,2206225,TNL
chr12,Bn46553,15701137,99438760,83737623,TNL
chr12,Bn46554,21632658,74246600,52613942,TN
chr12,Bn46555,93176881,93991199,814318,TN
chr12,Bn46556,55851291,99313208,43461917,TN
chr12,Bn46557,85305104,97723299,12418195,CN
chr12,Bn46558,36529676,84864371,48334695,CN
chr12,Bn46559,76575444,96329104,19753660,TNL
chr12,Bn46560,48222941,74082619,25859678,RLK
chr12,Bn46561,23634617,87297236,63662619,RLK
chr12,Bn46562,61164875,97093918,35929043,TNL
chr12,Bn46563,34018556,95538125,61519569,CNL
chr12,Bn46564,21180467,66281986,45101519,TNL
chr12,Bn46565,94188065,95359162,1171097,TN
chr12,Bn46566,24109752,71515587,47405835,TN
chr12,Bn46567,79731394,93296178,13564784,RLP
chr12,Bn46568,81441422,94965821,13524399,RLK
chr12,Bn46569,97473825,97653724,179899,RLK
chr12,Bn46570,19381848,31895064,12513216,TN
chr12,Bn46571,46067092,97232219,51165127,CN
chr12,Bn46572,76311847,91484864,15173017,NBS
chr12,Bn46573,5072366,61404520,56332154,TNL
chr12,Bn46574,80605096,82378045,1772949,RLP
chr12,Bn46575,25873549,53976531,28102982,RLP
chr12,Bn46576,78718515,81778833,3060318,RLP
chr12,Bn46577,46869456,85371787,38502331,RLK
chr12,Bn46578,39642873,58330077,18687204,TNL
chr12,Bn46579,60043166,71439764,11396598,TN
chr12,Bn46580,8321529,15169899,6848370,CNL
chr12,Bn46581,88941955,94978701,6036746,TN
chr12,Bn46582,89947240,89969946,22706,TNL
chr12,Bn46583,67559347,79085600,11526253,TNL
chr12,Bn46584,41138963,67983094,26844131,CN
chr12,Bn46585,69759986,76846835,7086849,CN
chr12,Bn46586,4549603,31897098,27347495,CNL
chr12,Bn46587,81232229,94881042,13648813,CN
chr12,Bn46588,43871884,90868727,46996843,TN
chr12,Bn46589,87609242,99133379,11524137,NBS
chr12,Bn46590,81936361,91663229,9726868,TN
chr12,Bn46591,2603635,29090885,26487250,CNL
chr12,Bn46592,50119293,74579715,24460422,TNL
chr12,Bn46593,75398388,91546448,16148060,RLK
chr12,Bn46594,75805278,99702511,23897233,TNL
chr12,Bn46595,43242659,92505905,49263246,TNL
chr12,Bn46596,82053584,95994590,13941006,RLP
chr12,Bn46597,20294704,35400352,15105648,TN
chr12,Bn46598,78759957,96945958,18186001,NBS
chr12,Bn46599,73499861,92937382,19437521,RLP
chr12,Bn46600,26718452,50279232,23560780,RLK
chr12,Bn46601,78861557,81237026,2375469,TN
chr12,Bn46602,85306967,93433652,8126685,NBS
chr12,Bn46603,54752923,61497945,6745022,TNL
chr12,Bn46604,33773384,43431960,9658576,TNL
chr12,Bn46605,98881471,98905264,23793,RLP
chr12,Bn46606,27908840,66322794,38413954,TNL
chr12,Bn46607,21034041,63470628,42436587,NBS
chr12,Bn46608,21253576,82274450,61020874,NBS
chr12,Bn46609,16272629,80266213,63993584,TNL
chr12,Bn46610,22952176,28743884,5791708,CNL
chr12,Bn46611,94247498,99027196,4779698,TN
chr12,Bn46612,71579764,88487971,16908207,NBS
chr12,Bn46613,66211886,79899385,13687499,TNL
chr12,Bn46614,56599903,79008025,22408122,CN
chr12,Bn46615,88960703,95451861,6491158,CNL
chr12,Bn46616,49313575,80853284,31539709,CNL
chr12,Bn46617,81077736,84581373,3503637,NBS
chr12,Bn46618,13131667,56501701,43370034,CN
chr12,Bn46619,8347686,8605632,257946,TNL
chr12,Bn46620,5570159,77467040,71896881,TNL
chr12,Bn46621,40932020,69654243,28722223,CN
chr12,Bn46622,93811961,95603370,1791409,TNL
chr12,Bn46623,18852310,37007766,18155456,TNL
chr12,Bn46624,18330198,25476964,7146766,TN
chr12,Bn46625,62351306,84739983,22388677,CNL
chr12,Bn46626,82065921,87467550,5401629,CNL
chr12,Bn46627,8184617,36147861,27963244,CN
chr12,Bn46628,13031943,83772880,70740937,RLP
chr12,Bn46629,18677112,22322565,3645453,CN
chr12,Bn46630,25714708,40578227,14863519,CNL
chr12,Bn46631,5562634,39840420,34277786,RLK
chr12,Bn46632,20997545,59155142,38157597,NBS
chr12,Bn46633,44757365,72886507,28129142,CNL
chr12,Bn46634,48595563,55980353,7384790,RLP
chr12,Bn46635,1882604,74200785,72318181,CNL
chr12,Bn46636,72129888,87153331,15023443,CN
chr12,Bn46637,15557038,99314475,83757437,TN
chr12,Bn46638,96787265,97508167,720902,NBS
chr12,Bn46639,69362929,78597140,9234211,RLK
chr12,Bn46640,63633375,68704981,5071606,TNL
chr12,Bn46641,17620670,95253063,77632393,TN
chr12,Bn46642,49257738,50940886,1683148,RLP
chr12,Bn46643,8044651,23613204,15568553,TN
chr12,Bn46644,66461559,94931569,28470010,TN
chr12,Bn46645,48170972,80173450,32002478,NBS
chr12,Bn46646,34495086,64186312,29691226,CNL
chr12,Bn46647,18508719,42101943,23593224,CN
chr12,Bn46648,79334441,80872995,1538554,RLP
chr12,Bn46649,8112436,69160965,61048529,TN
chr12,Bn46650,37822094,81004739,43182645,CN
chr12,Bn46651,40138769,64032271,23893502,CN
chr12,Bn46652,67514455,83065077,15550622,TNL
chr12,Bn46653,30774765,40759229,9984464,TN
chr12,Bn46654,9630938,72922904,63291966,RLK
chr12,Bn46655,10799652,55771000,44971348,RLK
chr12,Bn46656,30173588,31169117,995529,CNL
chr12,Bn46657,46707363,48802780,2095417,TN
chr12,Bn46658,4700915,54946116,50245201,RLK
chr12,Bn46659,23282588,88387894,65105306,TN
chr12,Bn46660,59504644,82745299,23240655,TN
chr12,Bn46661,84631000,86848165,2217165,CN
chr12,Bn46662,46772563,60003264,13230701,TN
chr12,Bn46663,76675306,93200548,16525242,CN
chr12,Bn46664,9926187,45390345,35464158,RLP
chr12,Bn46665,16021900,82838102,66816202,RLP
chr12,Bn46666,37147835,71938607,34790772,RLP
chr12,Bn46667,95062135,97620679,2558544,CN
chr12,Bn46668,80484695,81779218,1294523,TN
chr12,Bn46669,89494170,98703588,9209418,TNL
chr12,Bn46670,45532290,67302663,21770373,CN
chr12,Bn46671,2275599,98443876,96168277,CN
chr12,Bn46672,88306174,94423245,6117071,NBS
chr12,Bn46673,97037778,97128115,90337,TN
chr12,Bn46674,11215452,61511284,50295832,CN
chr12,Bn46675,63356698,99341742,35985044,TNL
chr12,Bn46676,21435422,72587625,51152203,TNL
chr12,Bn46677,28463458,66934904,38471446,RLK
chr12,Bn46678,43802206,74724293,30922087,TN
chr12,Bn46679,21221213,72466247,51245034,RLP
chr12,Bn46680,79981768,83194368,3212600,NBS
chr12,Bn46681,59536442,87371209,27834767,NBS
chr12,Bn46682,34019963,34964993,945030,TNL
chr12,Bn46683,30258221,60551879,30293658,TN
chr12,Bn46684,69215607,88869526,19653919,TN
chr12,Bn46685,37438867,70343529,32904662,RLK
chr12,Bn46686,33898500,50127346,16228846,RLK
chr12,Bn46687,61809204,66869613,5060409,CNL
chr12,Bn46688,46279981,80668116,34388135,TN
chr12,Bn46689,39867404,57645496,17778092,TN
chr12,Bn46690,14987378,27218798,12231420,CNL
chr12,Bn46691,31607849,36967629,5359780,RLP
chr12,Bn46692,72899113,92516645,19617532,CNL
chr12,Bn46693,81980559,99216293,17235734,CNL
chr12,Bn46694,39865026,72050887,32185861,RLK
chr12,Bn46695,38518878,97239265,58720387,TNL
chr12,Bn46696,26242524,48482185,22239661,RLP
chr12,Bn46697,27699341,54359162,26659821,TN
chr12,Bn46698,16777125,81584549,64807424,CNL
chr12,Bn46699,61610184,92000554,30390370,CNL
chr12,Bn46700,43465169,79482732,36017563,NBS
chr12,Bn46701,97778721,99718877,1940156,NBS
chr12,Bn46702,33735311,47492807,13757496,NBS
chr12,Bn46703,17146810,75797667,58650857,CN
chr12,Bn46704,1221270,50898798,49677528,NBS
chr12,Bn46705,71465913,77867009,6401096,RLP
chr12,Bn46706,92311727,94414653,2102926,TNL
chr12,Bn46707,65671728,76565895,10894167,TNL
chr12,Bn46708,47694546,47916153,221607,TN
chr12,Bn46709,82341375,86869746,4528371,RLP
chr12,Bn46710,78041697,94300098,16258401,CN
chr12,Bn46711,66720210,85049888,18329678,TN
chr12,Bn46712,39800850,71549300,31748450,CN
chr12,Bn46713,48275969,71097339,22821370,NBS
chr12,Bn46714,31034133,35045560,4011427,CNL
chr12,Bn46715,71934311,74828983,2894672,RLK
chr12,Bn46716,75460719,84047555,8586836,TN
chr12,Bn46717,74949993,92092410,17142417,TN
chr12,Bn46718,34499130,80836383,46337253,CNL
chr12,Bn46719,46626914,77615859,30988945,CNL
chr12,Bn46720,19831146,23034957,3203811,CNL
chr12,Bn46721,29025235,46641096,17615861,CNL
chr12,Bn46722,19417900,67045325,47627425,TN
chr12,Bn46723,31334398,64347787,33013389,TN
chr12,Bn46724,98971803,99159434,187631,CNL
chr12,Bn46725,71938923,82863728,10924805,CN
chr12,Bn46726,27605879,48681666,21075787,NBS
chr12,Bn46727,64792568,90222514,25429946,TNL
chr12,Bn46728,66663394,84098053,17434659,CN
chr12,Bn46729,24977486,80517267,55539781,NBS
chr12,Bn46730,99453604,99467443,13839,RLP
chr12,Bn46731,12776123,89640204,76864081,TNL
chr12,Bn46732,12790978,55274026,42483048,TNL
chr12,Bn46733,21671678,67618342,45946664,TN
chr12,Bn46734,30243026,56429532,26186506,TN
chr12,Bn46735,75124403,75168226,43823,TN
chr12,Bn46736,82108520,96418828,14310308,TNL
chr12,Bn46737,89406763,98965567,9558804,RLK
chr12,Bn46738,2305568,97796841,95491273,RLP
chr12,Bn46739,31448530,56598764,25150234,RLP
chr12,Bn46740,61897158,68749339,6852181,CNL
chr12,Bn46741,62573662,67833801,5260139,RLK
chr12,Bn46742,37218381,70139039,32920658,NBS
chr12,Bn46743,32842772,40419553,7576781,TNL
chr12,Bn46744,39687545,49533736,9846191,CNL
chr12,Bn46745,19543394,46215218,26671824,RLK
chr12,Bn46746,33041471,64667448,31625977,CN
chr12,Bn46747,99175494,99837831,662337,TN
chr12,Bn46748,64595807,68040470,3444663,TNL
chr12,Bn46749,24371422,96726771,72355349,CNL
chr12,Bn46750,51317431,82573204,31255773,CNL
chr12,Bn46751,3339100,27797266,24458166,TN
chr12,Bn46752,72764878,91685228,18920350,CNL
chr12,Bn46753,5715294,55811602,50096308,TN
chr12,Bn46754,14903127,79173876,64270749,CNL
chr12,Bn46755,35878779,79151512,43272733,TNL
chr12,Bn46756,88842427,99292781,10450354,RLP
chr12,Bn46757,57731254,96092856,38361602,NBS
chr12,Bn46758,85593702,98527138,12933436,NBS
chr12,Bn46759,82350406,97461695,15111289,TN
chr12,Bn46760,39136197,74398676,35262479,CNL
chr12,Bn46761,81616427,81836553,220126,RLK
chr12,Bn46762,59467792,72750887,13283095,RLP
chr12,Bn46763,27613983,39823741,12209758,TNL
chr12,Bn46764,98784559,98787098,2539,RLK
chr12,Bn46765,19833302,96838260,77004958,TN
chr12,Bn46766,81710563,97458079,15747516,CNL
chr12,Bn46767,63542756,86009088,22466332,NBS
chr12,Bn46768,7979823,40071288,32091465,RLP
chr12,Bn46769,95090220,97854183,2763963,CN
chr12,Bn46770,40283076,91395034,51111958,TN
chr12,Bn46771,15645739,24593624,8947885,NBS
chr12,Bn46772,62749420,74521501,11772081,CN
chr12,Bn46773,96428671,99163033,2734362,TN
chr12,Bn46774,65008547,75689974,10681427,NBS
chr12,Bn46775,47510113,59274564,11764451,CN
chr12,Bn46776,94428584,97607717,3179133,CNL
chr12,Bn46777,56908258,87755966,30847708,TN
chr12,Bn46778,5631560,63044161,57412601,TNL
chr12,Bn46779,2910473,34438954,31528481,TN
chr12,Bn46780,6717985,89109682,82391697,NBS
chr12,Bn46781,22890617,61083940,38193323,TN
chr12,Bn46782,49119673,49446235,326562,NBS
chr12,Bn46783,7545967,55715843,48169876,TN
chr12,Bn46784,70253542,80078017,9824475,RLP
chr12,Bn46785,62642856,99839655,37196799,TN
chr12,Bn46786,56197387,87260542,31063155,CN
chr12,Bn46787,86600436,93891679,7291243,CN
chr12,Bn46788,94156794,95657253,1500459,CN
chr12,Bn46789,63722786,91654161,27931375,RLK
chr12,Bn46790,63414811,70792529,7377718,TN
chr12,Bn46791,62899484,69965218,7065734,RLK
chr12,Bn46792,14704965,42860889,28155924,RLP
chr12,Bn46793,18737856,94554600,75816744,TNL
chr12,Bn46794,83597006,93023694,9426688,CNL
chr12,Bn46795,97820827,99806677,1985850,RLP
chr12,Bn46796,79264475,91131626,11867151,NBS
chr12,Bn46797,75016107,84295909,9279802,TN
chr12,Bn46798,1148483,66780970,65632487,CN
chr12,Bn46799,57541622,67143536,9601914,TNL
chr12,Bn46800,10135996,44584420,34448424,RLP
chr12,Bn46801,75142083,94032504,18890421,RLP
chr12,Bn46802,76511760,80187701,3675941,CNL
chr12,Bn46803,79931658,82656948,2725290,CNL
chr12,Bn46804,3534858,19511903,15977045,TNL
chr12,Bn46805,9937081,79283637,69346556,RLP
chr12,Bn46806,66745170,76020095,9274925,NBS
chr12,Bn46807,72452234,82133414,9681180,RLK
chr12,Bn46808,67162640,99454180,32291540,RLP
chr12,Bn46809,55305385,90511167,35205782,RLP
chr12,Bn46810,74257844,94895446,20637602,TNL
chr12,Bn46811,96654381,97110546,456165,TNL
chr12,Bn46812,30395073,39657834,9262761,RLP
chr12,Bn46813,83145087,94685310,11540223,RLP
chr12,Bn46814,1427609,34903116,33475507,CNL
chr12,Bn46815,69091640,83370469,14278829,NBS
chr12,Bn46816,59302159,97155731,37853572,CNL
chr12,Bn46817,80668544,82424793,1756249,CNL
chr12,Bn46818,92784082,93211923,427841,CNL
chr12,Bn46819,7343756,57910693,50566937,RLK
chr12,Bn46820,88083176,92879692,4796516,RLK
chr12,Bn46821,5499399,44395054,38895655,RLP
chr12,Bn46822,41857718,74147284,32289566,RLP
chr12,Bn46823,7161416,51890596,44729180,RLP
chr12,Bn46824,91199727,94897131,3697404,RLK
chr12,Bn46825,47742847,53454022,5711175,TNL
chr12,Bn46826,78136212,78525877,389665,CNL
chr12,Bn46827,41688422,65844893,24156471,RLK
chr12,Bn46828,46460851,67243309,20782458,CN
chr12,Bn46829,5441130,82098287,76657157,RLP
chr12,Bn46830,50366558,82081198,31714640,RLK
chr12,Bn46831,33868012,97583370,63715358,CNL
chr12,Bn46832,81379320,97550929,16171609,RLK
chr12,Bn46833,95513194,97623764,2110570,RLK
chr12,Bn46834,11576782,63959714,52382932,TN
chr12,Bn46835,85361753,98619642,13257889,RLP
chr12,Bn46836,57928545,72900921,14972376,CNL
chr12,Bn46837,13237532,62295309,49057777,RLK
chr12,Bn46838,30281562,52337207,22055645,RLK
chr12,Bn46839,82901323,96174103,13272780,RLP
chr12,Bn46840,8930997,14887218,5956221,RLP
chr12,Bn46841,80109883,98650427,18540544,RLK
chr12,Bn46842,49993009,81206626,31213617,RLP
chr12,Bn46843,69034500,71140225,2105725,TNL
chr12,Bn46844,51603928,65956532,14352604,TN
chr12,Bn46845,87825553,92929641,5104088,RLK
chr12,Bn46846,29865394,71534724,41669330,TNL
chr12,Bn46847,82707833,84707837,2000004,CN
chr12,Bn46848,55819021,73717200,17898179,CNL
chr12,Bn46849,26870904,43234758,16363854,RLK
chr12,Bn46850,68088176,83086062,14997886,TN
chr12,Bn46851,2548212,23109777,20561565,TN
chr12,Bn46852,59671932,79122200,19450268,NBS
chr12,Bn46853,8124899,33912964,25788065,CNL
chr12,Bn46854,77458986,88495181,11036195,CNL
chr12,Bn46855,63753366,74064186,10310820,RLK
chr12,Bn46856,90266830,99682561,9415731,RLK
chr12,Bn46857,12484586,62552932,50068346,RLK
chr12,Bn46858,25060651,71580791,46520140,NBS
chr12,Bn46859,76278342,80387817,4109475,TNL
chr12,Bn46860,54440368,81875036,27434668,RLK
chr12,Bn46861,72945034,77914170,4969136,NBS
chr12,Bn46862,50587490,58510895,7923405,RLK
chr12,Bn46863,38794251,47863908,9069657,NBS
chr12,Bn46864,35222272,57417091,22194819,CNL
chr12,Bn46865,35881968,99128557,63246589,CNL
chr12,Bn46866,69690701,95245541,25554840,TNL
chr12,Bn46867,21147910,64817402,43669492,CNL
chr12,Bn46868,42184976,44977396,2792420,NBS
chr12,Bn46869,68115936,89038698,20922762,CN
chr12,Bn46870,75167939,87363639,12195700,CN
chr12,Bn46871,97882623,98078535,195912,TNL
chr12,Bn46872,49366753,84949909,35583156,TNL
chr12,Bn46873,68696548,86866776,18170228,TN
chr12,Bn46874,83194733,94959879,11765146,CN
chr12,Bn46875,98104298,98195905,91607,RLP
chr12,Bn46876,89734845,96679095,6944250,CN
chr12,Bn46877,88739533,96942166,8202633,NBS
chr12,Bn46878,72718025,88536023,15817998,TN
chr12,Bn46879,14605172,92850640,78245468,TN
chr12,Bn46880,12195816,50426936,38231120,CNL
chr12,Bn46881,51585304,98849028,47263724,RLK
chr12,Bn46882,78832759,97015659,18182900,RLK
chr12,Bn46883,89134951,89588093,453142,TN
chr12,Bn46884,13472879,15760829,2287950,CNL
chr12,Bn46885,59717840,95645616,35927776,TN
chr12,Bn46886,21153660,98344014,77190354,CN
chr12,Bn46887,93694467,98272502,4578035,CN
chr12,Bn46888,47429950,49955467,2525517,TN
chr12,Bn46889,17127598,50104740,32977142,NBS
chr12,Bn46890,5778998,38192947,32413949,RLP
chr12,Bn46891,27728923,74371181,46642258,NBS
chr12,Bn46892,92491764,99909404,7417640,CNL
chr12,Bn46893,37613930,53955525,16341595,TN
chr12,Bn46894,42783205,51556134,8772929,CNL
chr12,Bn46895,48659242,59510860,10851618,CN
chr12,Bn46896,48268597,77629054,29360457,RLK
chr12,Bn46897,31503349,46706726,15203377,TNL
chr12,Bn46898,74460506,89695557,15235051,RLK
chr12,Bn46899,33651420,59609053,25957633,RLP
chr12,Bn46900,11459709,76946422,65486713,TN
chr12,Bn46901,37366516,86615025,49248509,CNL
chr12,Bn46902,45246973,54373170,9126197,TNL
chr12,Bn46903,75689632,81794001,6104369,NBS
chr12,Bn46904,66459605,98523502,32063897,RLP
chr12,Bn46905,21299958,97704075,76404117,TN
chr12,Bn46906,19715981,56220862,36504881,RLP
chr12,Bn46907,44839600,74330261,29490661,TNL
chr12,Bn46908,20783377,24741863,3958486,RLP
chr12,Bn46909,6687870,11932302,5244432,CNL
chr12,Bn46910,59637643,77972196,18334553,CN
chr12,Bn46911,48972949,95336046,46363097,TNL
chr12,Bn46912,40355991,58776513,18420522,RLK
chr12,Bn46913,86698894,96065198,9366304,TNL
chr12,Bn46914,77011059,78591057,1579998,CN
chr12,Bn46915,58496672,74989681,16493009,CN
chr12,Bn46916,31918901,89801654,57882753,TNL
chr12,Bn46917,59060409,90065542,31005133,CNL
chr12,Bn46918,27476596,78221134,50744538,NBS
chr12,Bn46919,76258770,90387223,14128453,RLK
chr12,Bn46920,91181490,99328417,8146927,TNL
chr12,Bn46921,93693088,96673728,2980640,TN
chr12,Bn46922,66322785,94070167,27747382,TNL
chr12,Bn46923,53361235,54003059,641824,TN
chr12,Bn46924,60595942,93949378,33353436,TNL
chr12,Bn46925,61156754,76730387,15573633,TN
chr12,Bn46926,38489175,56341788,17852613,CN
chr12,Bn46927,85620006,89873559,4253553,RLP
chr12,Bn46928,11367894,79309397,67941503,NBS
chr12,Bn46929,57094902,59873778,2778876,RLK
chr12,Bn46930,57145552,81574777,24429225,CNL
chr12,Bn46931,40786274,41275105,488831,NBS
chr12,Bn46932,56975477,64441131,7465654,CN
chr12,Bn46933,38546912,72682755,34135843,CN
chr12,Bn46934,98527609,99225874,698265,RLP
chr12,Bn46935,78129756,97066917,18937161,NBS
chr12,Bn46936,7717080,17743551,10026471,RLK
chr12,Bn46937,28330790,77325398,48994608,NBS
chr12,Bn46938,75676543,86040045,10363502,RLP
chr12,Bn46939,43429852,85561690,42131838,TN
chr12,Bn46940,94284501,96878603,2594102,NBS
chr12,Bn46941,45939188,80387333,34448145,RLP
chr12,Bn46942,67840814,79552701,11711887,TNL
chr12,Bn46943,59642615,95462994,35820379,RLP
chr12,Bn46944,81019390,97044235,16024845,RLK
chr12,Bn46945,11746653,22291341,10544688,RLK
chr12,Bn46946,47848140,49132346,1284206,TNL
chr12,Bn46947,46085046,65328139,19243093,TNL
chr12,Bn46948,40503960,54348147,13844187,NBS
chr12,Bn46949,62436606,91984687,29548081,RLK
chr12,Bn46950,7356551,22553854,15197303,CNL
chr12,Bn46951,96637261,98898156,2260895,TNL
chr12,Bn46952,15292760,65220781,49928021,TN
chr12,Bn46953,65713976,88159473,22445497,TN
chr12,Bn46954,26701932,36917268,10215336,RLP
chr12,Bn46955,97106381,99659345,2552964,CNL
chr12,Bn46956,59977464,62108394,2130930,TNL
chr12,Bn46957,29361025,82206774,52845749,NBS
chr12,Bn46958,58490912,72608849,14117937,CN
chr12,Bn46959,39982707,60867138,20884431,CNL
chr12,Bn46960,18608277,65410688,46802411,TNL
chr12,Bn46961,13631710,33659202,20027492,TN
chr12,Bn46962,56770149,88123966,31353817,NBS
chr12,Bn46963,89922841,98653652,8730811,RLP
chr12,Bn46964,73748897,96843123,23094226,CNL
chr12,Bn46965,48767777,68106010,19338233,TN
chr12,Bn46966,69420194,72803238,3383044,CNL
chr12,Bn46967,51964788,58370952,6406164,RLP
chr12,Bn46968,72165668,87414304,15248636,RLK
chr12,Bn46969,2518263,83388104,80869841,TNL
chr12,Bn46970,39295673,76836661,37540988,RLP
chr12,Bn46971,12933181,43265817,30332636,TN
chr12,Bn46972,21330538,48844568,27514030,NBS
chr12,Bn46973,42940571,85555715,42615144,RLK
chr12,Bn46974,24058291,85732055,61673764,RLP
chr12,Bn46975,92889148,96372805,3483657,RLK
chr12,Bn46976,19050773,70501725,51450952,RLP
chr12,Bn46977,12422027,91939161,79517134,CNL
chr12,Bn46978,92857615,93382485,524870,CN
chr12,Bn46979,13525933,14513829,987896,CN
chr12,Bn46980,70587634,73803301,3215667,TN
chr12,Bn46981,87578396,88175114,596718,RLP
chr12,Bn46982,80302469,88566120,8263651,RLK
chr12,Bn46983,43386197,94925834,51539637,RLP
chr12,Bn46984,95147036,99864872,4717836,TNL
chr12,Bn46985,86428021,91664087,5236066,CN
chr12,Bn46986,10270756,79959643,69688887,CNL
chr12,Bn46987,58589494,83711743,25122249,CNL
chr12,Bn46988,1028676,9257334,8228658,NBS
chr12,Bn46989,74345447,86449039,12103592,RLP
chr12,Bn46990,17474436,59300892,41826456,CN
chr12,Bn46991,91008328,94078301,3069973,TNL
chr12,Bn46992,85374973,99303863,13928890,NBS
chr12,Bn46993,33919942,71471672,37551730,RLP
chr12,Bn46994,47196549,84831175,37634626,TN
chr12,Bn46995,33329805,66183750,32853945,RLP
chr12,Bn46996,42044620,66141252,24096632,TN
chr12,Bn46997,87186732,91993677,4806945,CNL
chr12,Bn46998,4445764,51355125,46909361,CNL
chr12,Bn46999,50427004,96693272,46266268,RLP
chr12,Bn47000,43947985,67478423,23530438,NBS
chr12,Bn47001,27428299,71308136,43879837,NBS
chr12,Bn47002,69563412,70119072,555660,CNL
chr12,Bn47003,45607315,81278536,35671221,RLP
chr12,Bn47004,54074693,85550594,31475901,RLP
chr12,Bn47005,97606156,99127269,1521113,RLP
chr12,Bn47006,89579284,93765693,4186409,TNL
chr12,Bn47007,30941522,65095242,34153720,NBS
chr12,Bn47008,39608325,74736559,35128234,RLK
chr12,Bn47009,99586081,99626647,40566,CNL
chr12,Bn47010,70303814,83153366,12849552,RLP
chr12,Bn47011,3536160,47516823,43980663,RLK
chr12,Bn47012,73791543,92708775,18917232,RLK
chr12,Bn47013,22201771,46383334,24181563,RLK
chr12,Bn47014,36623565,40152083,3528518,CNL
chr12,Bn47015,11065438,76635839,65570401,CNL
chr12,Bn47016,91961465,94296360,2334895,TNL
chr12,Bn47017,6093866,70756566,64662700,CNL
chr12,Bn47018,64929074,82459215,17530141,TN
chr12,Bn47019,72602759,73900432,1297673,TNL
chr12,Bn47020,12162160,24707670,12545510,TN
chr12,Bn47021,46258012,47756777,1498765,TN
chr12,Bn47022,74105544,99092635,24987091,CNL
chr12,Bn47023,60802622,61302514,499892,TNL
chr12,Bn47024,6668888,72234114,65565226,RLK
chr12,Bn47025,71283478,95707868,24424390,CN
chr12,Bn47026,57142095,64911303,7769208,RLP
chr12,Bn47027,8405645,76506018,68100373,RLK
chr12,Bn47028,51317800,79334271,28016471,TNL
chr12,Bn47029,24110942,72635409,48524467,RLK
chr12,Bn47030,5679667,12942951,7263284,TNL
chr12,Bn47031,21178808,38023614,16844806,CNL
chr12,Bn47032,33494339,99722054,66227715,TNL
chr12,Bn47033,53338757,94917857,41579100,TN
chr12,Bn47034,78543554,82401896,3858342,RLK
chr12,Bn47035,73195324,76714332,3519008,NBS
chr12,Bn47036,90004500,99345587,9341087,TN
chr12,Bn47037,20663027,99066833,78403806,TN
chr12,Bn47038,97420121,98053550,633429,RLK
chr12,Bn47039,58679816,94866307,36186491,RLP
chr12,Bn47040,91713549,95774635,4061086,CN
chr12,Bn47041,86547336,99033586,12486250,RLP
chr12,Bn47042,66259856,78150309,11890453,RLK
chr12,Bn47043,43047689,48350459,5302770,TNL
chr12,Bn47044,27556084,80454477,52898393,NBS
chr12,Bn47045,9525977,64385345,54859368,CNL
chr12,Bn47046,21549097,39896956,18347859,CNL
chr12,Bn47047,48673468,50092489,1419021,CNL
chr12,Bn47048,15634093,54815622,39181529,CNL
chr12,Bn47049,94599232,98239951,3640719,RLP
chr12,Bn47050,97761938,99608736,1846798,TNL
chr12,Bn47051,47044339,82154178,35109839,CN
chr12,Bn47052,65496735,68589040,3092305,RLK
chr12,Bn47053,49080357,81914160,32833803,CNL
chr12,Bn47054,79630204,87237070,7606866,CNL
chr12,Bn47055,45911149,60742139,14830990,RLP
chr12,Bn47056,27038245,96899549,69861304,RLK
chr12,Bn47057,64580106,74774702,10194596,CNL
chr12,Bn47058,24589772,66391235,41801463,CNL
chr12,Bn47059,6933719,98805724,91872005,TNL
chr12,Bn47060,13997232,57451957,43454725,TN
chr12,Bn47061,17389019,60841440,43452421,NBS
chr12,Bn47062,62263044,86361370,24098326,CN
chr12,Bn47063,30478449,77414499,46936050,CN
chr12,Bn47064,84769964,96644545,11874581,RLK
chr12,Bn47065,35005496,67595696,32590200,RLP
chr12,Bn47066,23224197,84952375,61728178,TN
chr12,Bn47067,30148599,83235378,53086779,NBS
chr12,Bn47068,59008218,74572092,15563874,RLK
chr12,Bn47069,44879204,85803208,40924004,RLK
chr12,Bn47070,40513619,63218726,22705107,RLK
chr12,Bn47071,9249854,94108065,84858211,TN
chr12,Bn47072,70043522,71475215,1431693,CNL
chr12,Bn47073,89535833,99063419,9527586,CN
chr12,Bn47074,48869924,95297106,46427182,RLK
chr12,Bn47075,56027303,59079571,3052268,RLK
chr12,Bn47076,40561324,55268159,14706835,CN
chr12,Bn47077,69628817,75163590,5534773,NBS
chr12,Bn47078,20176561,44332029,24155468,CNL
chr12,Bn47079,89351567,98288257,8936690,CN
chr12,Bn47080,35791747,60954753,25163006,TN
chr12,Bn47081,10181496,36969535,26788039,NBS
chr12,Bn47082,16439491,16606716,167225,RLP
chr12,Bn47083,75423755,92902926,17479171,CNL
chr12,Bn47084,89939442,96796359,6856917,TN
chr12,Bn47085,30790878,84247282,53456404,TNL
chr12,Bn47086,83195539,99712458,16516919,RLP
chr12,Bn47087,53180358,98960525,45780167,CN
chr12,Bn47088,88380146,89630597,1250451,CNL
chr12,Bn47089,30339251,55968342,25629091,TNL
chr12,Bn47090,28192857,74856433,46663576,CNL
chr12,Bn47091,77167937,96469157,19301220,TNL
chr12,Bn47092,59770615,73989214,14218599,NBS
chr12,Bn47093,71146328,91698324,20551996,RLK
chr12,Bn47094,71250811,95682174,24431363,NBS
chr12,Bn47095,63272374,82884699,19612325,CN
chr12,Bn47096,86684250,99998879,13314629,CN
chr12,Bn47097,21052300,42682454,21630154,CNL
chr12,Bn47098,25380890,40655399,15274509,RLP
chr12,Bn47099,38817323,81800418,42983095,CNL
chr12,Bn47100,45448159,68142638,22694479,NBS
chr12,Bn47101,96249238,96434977,185739,TNL
chr12,Bn47102,18996538,50518402,31521864,TNL
chr12,Bn47103,72722646,78284261,5561615,RLK
chr12,Bn47104,12612871,76288428,63675557,CN
chr12,Bn47105,28389299,63167509,34778210,TNL
chr12,Bn47106,99427784,99442143,14359,CN
chr12,Bn47107,62206303,77278888,15072585,TNL
chr12,Bn47108,92434673,97888229,5453556,RLK
chr12,Bn47109,57473372,99871599,42398227,RLP
chr12,Bn47110,76089318,96029866,19940548,RLK
chr12,Bn47111,1283975,63391950,62107975,TNL
chr12,Bn47112,40398765,57166533,16767768,NBS
chr12,Bn47113,50289121,51909472,1620351,NBS
chr12,Bn47114,15464177,59639205,44175028,CN
chr12,Bn47115,66646293,73898252,7251959,RLP
chr12,Bn47116,65017062,93887460,28870398,TN
chr12,Bn47117,78765922,93282853,14516931,CNL
chr12,Bn47118,29954735,46659805,16705070,TN
chr12,Bn47119,26628001,76834973,50206972,NBS
chr12,Bn47120,59319952,71754097,12434145,TNL
chr12,Bn47121,27608239,55161401,27553162,CNL
chr12,Bn47122,30765348,71500566,40735218,TN
chr12,Bn47123,37031125,78180213,41149088,RLP
chr12,Bn47124,66166829,79058779,12891950,TN
chr12,Bn47125,80033732,99372731,19338999,CNL
chr12,Bn47126,42692705,48807773,6115068,RLK
chr12,Bn47127,26881221,58622334,31741113,TN
chr12,Bn47128,29694651,30115154,420503,CN
chr12,Bn47129,68345788,72654349,4308561,RLK
chr12,Bn47130,53419283,83855419,30436136,NBS
chr12,Bn47131,29155860,57091259,27935399,NBS
chr12,Bn47132,10176295,59597602,49421307,CNL
chr12,Bn47133,37147086,65722798,28575712,CN
chr12,Bn47134,99452258,99454253,1995,RLK
chr12,Bn47135,75494384,80378792,4884408,CN
chr12,Bn47136,92026252,97411156,5384904,TN
chr12,Bn47137,83746372,97330805,13584433,TN
chr12,Bn47138,6724528,62361206,55636678,CNL
chr12,Bn47139,28240546,66817523,38576977,TN
chr12,Bn47140,68014347,96261992,28247645,NBS
chr12,Bn47141,86766405,87965076,1198671,CN
chr12,Bn47142,98306902,99917298,1610396,CNL
chr12,Bn47143,63945957,75760730,11814773,CNL
chr12,Bn47144,84953811,92236287,7282476,TNL
chr12,Bn47145,4571674,96943245,92371571,CN
chr12,Bn47146,47078694,70692950,23614256,NBS
chr12,Bn47147,44794281,83818297,39024016,RLP
chr12,Bn47148,34963757,53888665,18924908,TN
chr12,Bn47149,18071185,24921896,6850711,CN
chr12,Bn47150,64762687,66141932,1379245,TN
chr12,Bn47151,29925710,95450357,65524647,TN
chr12,Bn47152,54506636,93359953,38853317,RLK
chr12,Bn47153,81692524,83226902,1534378,RLP
chr12,Bn47154,45314094,48483782,3169688,NBS
chr12,Bn47155,2314958,77773596,75458638,TN
chr12,Bn47156,83180279,89851735,6671456,TNL
chr12,Bn47157,47785724,57565584,9779860,RLP
chr12,Bn47158,21291714,50325910,29034196,CNL
chr12,Bn47159,83163319,86867847,3704528,RLP
chr12,Bn47160,9677933,88878618,79200685,CNL
chr12,Bn47161,84993657,98739115,13745458,NBS
chr12,Bn47162,91248911,99627219,8378308,RLP
chr12,Bn47163,52234337,82504583,30270246,TNL
chr12,Bn47164,21593482,54948991,33355509,RLP
chr12,Bn47165,68371955,98908978,30537023,CN
chr12,Bn47166,29390236,88173766,58783530,RLP
chr12,Bn47167,51737607,58228964,6491357,TN
chr12,Bn47168,62919911,90741244,27821333,RLK
chr12,Bn47169,94216053,94606375,390322,TNL
chr12,Bn47170,87830049,97352447,9522398,CNL
chr12,Bn47171,42182939,94875687,52692748,RLK
chr12,Bn47172,91889035,93824253,1935218,TN
chr12,Bn47173,70737537,77860410,7122873,TNL
chr12,Bn47174,55401848,68888958,13487110,TN
chr12,Bn47175,32317667,73703702,41386035,CN
chr12,Bn47176,6793469,21852152,15058683,TN
chr12,Bn47177,43070802,46137510,3066708,CN
chr12,Bn47178,19391480,75337101,55945621,TNL
chr12,Bn47179,73563231,82909674,9346443,RLK
chr12,Bn47180,93165033,93955482,790449,CN
chr12,Bn47181,48374524,97333962,48959438,RLK
chr12,Bn47182,44118264,63184197,19065933,NBS
chr12,Bn47183,71289430,73750587,2461157,RLK
chr12,Bn47184,21934770,88924821,66990051,TN
chr12,Bn47185,99448877,99602428,153551,CNL
chr12,Bn47186,53839707,85830033,31990326,CN
chr12,Bn47187,86903005,99026052,12123047,TN
chr12,Bn47188,9965693,47002075,37036382,NBS
chr12,Bn47189,75582684,99738505,24155821,TN
chr12,Bn47190,11934820,80179215,68244395,TN
chr12,Bn47191,17707537,59839824,42132287,NBS
chr12,Bn47192,12004540,94377491,82372951,RLP
chr12,Bn47193,92234958,97218879,4983921,NBS
chr12,Bn47194,78546831,96297567,17750736,TNL
chr12,Bn47195,32230743,48513980,16283237,NBS
chr12,Bn47196,69682655,81087939,11405284,CN
chr12,Bn47197,86915812,92053368,5137556,CNL
chr12,Bn47198,21014981,92339394,71324413,CN
chr12,Bn47199,66196359,97584764,31388405,NBS
chr12,Bn47200,20446626,76042463,55595837,RLK
chr12,Bn47201,64272663,80145981,15873318,CNL
chr12,Bn47202,92839422,95911730,3072308,TN
chr12,Bn47203,42145573,63871760,21726187,CNL
chr12,Bn47204,14982772,96102858,81120086,NBS
chr12,Bn47205,2564965,42902309,40337344,CN
chr12,Bn47206,40914525,69357382,28442857,CNL
chr12,Bn47207,70249171,95794189,25545018,CNL
chr12,Bn47208,11177504,97682605,86505101,CN
chr12,Bn47209,59542547,97894710,38352163,TN
chr12,Bn47210,12750731,45819834,33069103,NBS
chr12,Bn47211,66165942,96419440,30253498,CN
chr12,Bn47212,47316492,49486819,2170327,NBS
chr12,Bn47213,7145857,69993173,62847316,RLP
chr12,Bn47214,43381602,48968084,5586482,CN
chr12,Bn47215,16976798,31509001,14532203,RLK
chr12,Bn47216,86000616,98514223,12513607,TNL
chr12,Bn47217,89621311,94295738,4674427,RLK
chr12,Bn47218,99080319,99554169,473850,RLP
chr12,Bn47219,43882412,90934137,47051725,TNL
chr12,Bn47220,12425076,61074897,48649821,CNL
chr12,Bn47221,3083938,35758607,32674669,TN
chr12,Bn47222,86409990,95022974,8612984,RLP
chr12,Bn47223,23795776,26481476,2685700,NBS
chr12,Bn47224,14670351,50963704,36293353,CNL
chr12,Bn47225,97266391,97594592,328201,TNL
chr12,Bn47226,33136617,65352240,32215623,RLP
chr12,Bn47227,74454217,98793296,24339079,TN
chr12,Bn47228,72688813,95803438,23114625,TNL
chr12,Bn47229,46572500,76936158,30363658,NBS
chr12,Bn47230,9306227,52713390,43407163,RLP
chr12,Bn47231,93008555,98159195,5150640,NBS
chr12,Bn47232,96894380,98222991,1328611,RLK
chr12,Bn47233,63180375,67584507,4404132,RLK
chr12,Bn47234,82726364,84121736,1395372,CN
chr12,Bn47235,30112567,31760664,1648097,TN
chr12,Bn47236,99844468,99863594,19126,CN
chr12,Bn47237,47037174,85289346,38252172,TNL
chr12,Bn47238,79572925,94769403,15196478,NBS
chr12,Bn47239,92420830,94139623,1718793,TNL
chr12,Bn47240,83189276,97647304,14458028,RLP
chr12,Bn47241,14701009,52171608,37470599,TN
chr12,Bn47242,75322465,92186976,16864511,RLK
chr12,Bn47243,15136271,98187051,83050780,CNL
chr12,Bn47244,30774843,70005765,39230922,CNL
chr12,Bn47245,26528332,34353288,7824956,RLK
chr12,Bn47246,69020764,75752443,6731679,TNL
chr12,Bn47247,81105048,98831568,17726520,CNL
chr12,Bn47248,42912626,57882715,14970089,NBS
chr12,Bn47249,75500558,85895986,10395428,RLP
chr12,Bn47250,58615360,91986423,33371063,CN
chr12,Bn47251,21893722,85877827,63984105,RLK
chr12,Bn47252,8730486,67518846,58788360,TNL
chr12,Bn47253,26323538,43091781,16768243,CN
chr12,Bn47254,20108948,43829569,23720621,NBS
chr12,Bn47255,19371163,63740128,44368965,NBS
chr12,Bn47256,1073445,40883385,39809940,RLP
chr12,Bn47257,62711662,63188760,477098,TNL
chr12,Bn47258,84432502,87772018,3339516,CNL
chr12,Bn47259,66290277,83466044,17175767,CN
chr12,Bn47260,66224736,98830681,32605945,NBS
chr12,Bn47261,99940184,99943928,3744,NBS
chr12,Bn47262,67604688,83840427,16235739,CNL
chr12,Bn47263,70318654,77465333,7146679,TN
chr12,Bn47264,8636841,66631093,57994252,RLP
chr12,Bn47265,54879880,90534153,35654273,TNL
chr12,Bn47266,82942575,95240235,12297660,CNL
chr12,Bn47267,56076191,85763909,29687718,CN
chr12,Bn47268,47199251,53255649,6056398,TN
chr12,Bn47269,57823307,88861294,31037987,RLK
chr12,Bn47270,65529349,65763067,233718,TN
chr12,Bn47271,44870027,78649963,33779936,CN
chr12,Bn47272,90461656,99159831,8698175,TN
chr12,Bn47273,19848623,20107591,258968,TNL
chr12,Bn47274,89924563,98210010,8285447,RLP
chr12,Bn47275,9461258,87413390,77952132,NBS
chr12,Bn47276,65534130,86827320,21293190,RLP
chr12,Bn47277,44310065,58420584,14110519,CNL
chr12,Bn47278,67557768,95670802,28113034,TNL
chr12,Bn47279,23545069,87891241,64346172,NBS
chr12,Bn47280,61564316,93549231,31984915,TN
chr12,Bn47281,40083190,80005048,39921858,RLP
chr12,Bn47282,43357131,59570498,16213367,RLP
chr12,Bn47283,71062953,98860994,27798041,NBS
chr12,Bn47284,23832421,92574759,68742338,TNL
chr12,Bn47285,86807445,92688283,5880838,RLP
chr12,Bn47286,90455470,94879062,4423592,RLK
chr12,Bn47287,21629402,79143169,57513767,NBS
chr12,Bn47288,51227464,59383988,8156524,CN
chr12,Bn47289,72721408,95840639,23119231,RLK
chr12,Bn47290,75670758,88559340,12888582,TNL
chr12,Bn47291,65688221,81953417,16265196,CNL
chr12,Bn47292,32223828,94217489,61993661,TN
chr12,Bn47293,67750668,85584127,17833459,NBS
chr12,Bn47294,51787477,76563753,24776276,NBS
chr12,Bn47295,57558891,90975595,33416704,CNL
chr12,Bn47296,58113022,93894251,35781229,CN
chr12,Bn47297,18674165,35315357,16641192,NBS
chr12,Bn47298,49105266,73012773,23907507,NBS
chr12,Bn47299,73358305,75738354,2380049,RLP
chr12,Bn47300,60586319,78397769,17811450,TN
chr12,Bn47301,57275914,60425704,3149790,CN
chr12,Bn47302,77931567,83215154,5283587,CN
chr12,Bn47303,53847401,89523746,35676345,TNL
chr12,Bn47304,34180582,46548091,12367509,RLP
chr12,Bn47305,12579171,74840488,62261317,RLP
chr12,Bn47306,62622619,62693497,70878,CNL
chr12,Bn47307,47547125,62844361,15297236,CNL
chr12,Bn47308,56766016,75036395,18270379,TN
chr12,Bn47309,55629109,93771542,38142433,TNL
chr12,Bn47310,29229072,46806054,17576982,TN
chr12,Bn47311,86960032,90653559,3693527,CNL
chr12,Bn47312,45107444,47419910,2312466,RLK
chr12,Bn47313,76984788,98134761,21149973,CNL
chr12,Bn47314,34048173,40626971,6578798,TN
chr12,Bn47315,8949809,23267241,14317432,NBS
chr12,Bn47316,27794522,94739105,66944583,RLP
chr12,Bn47317,53285985,79184987,25899002,CN
chr12,Bn47318,9713142,49871350,40158208,TN
chr12,Bn47319,61679978,63721791,2041813,NBS
chr12,Bn47320,29535006,50433076,20898070,TNL
chr12,Bn47321,53251291,87885184,34633893,TN
chr12,Bn47322,27653190,57994107,30340917,CNL
chr12,Bn47323,43359523,79460453,36100930,NBS
chr12,Bn47324,52101184,80197341,28096157,TN
chr12,Bn47325,52972554,92287299,39314745,NBS
chr12,Bn47326,28222016,86296712,58074696,RLK
chr12,Bn47327,79120511,92458882,13338371,CN
chr12,Bn47328,47033821,55893198,8859377,CN
chr12,Bn47329,58252835,86563154,28310319,RLP
chr12,Bn47330,5952118,36527135,30575017,CN
chr12,Bn47331,96037893,97718272,1680379,NBS
chr12,Bn47332,1425651,43910326,42484675,CN
chr12,Bn47333,26565414,90719825,64154411,RLK
chr12,Bn47334,31741729,87701580,55959851,RLP
chr12,Bn47335,33663193,37076215,3413022,TN
chr12,Bn47336,59573117,65513234,5940117,RLK
chr12,Bn47337,4149831,61773718,57623887,CNL
chr12,Bn47338,82757822,95577636,12819814,TNL
chr12,Bn47339,35487456,94160177,58672721,RLK
chr12,Bn47340,72061682,90957629,18895947,NBS
chr12,Bn47341,6308638,39746432,33437794,RLP
chr12,Bn47342,77740638,98154161,20413523,TNL
chr12,Bn47343,16265160,24548813,8283653,RLK
chr12,Bn47344,4627828,33737324,29109496,CN
chr12,Bn47345,32290195,88796553,56506358,RLK
chr12,Bn47346,70462148,86169160,15707012,RLP
chr12,Bn47347,37269639,79106698,41837059,TN
chr12,Bn47348,35135500,81455541,46320041,RLP
chr12,Bn47349,20056938,38973208,18916270,TNL
chr12,Bn47350,33242077,81622760,48380683,TN
chr12,Bn47351,4812322,90437551,85625229,CN
chr12,Bn47352,19297108,85724984,66427876,NBS
chr12,Bn47353,51901267,62280312,10379045,NBS
chr12,Bn47354,84736405,91483403,6746998,TNL
chr12,Bn47355,81440090,94930315,13490225,RLK
chr12,Bn47356,68667380,78157079,9489699,CN
chr12,Bn47357,67547366,81677310,14129944,NBS
chr12,Bn47358,2819376,60632267,57812891,CNL
chr12,Bn47359,70280484,72322910,2042426,NBS
chr12,Bn47360,37870944,77129599,39258655,RLP
chr12,Bn47361,98720565,99744599,1024034,CN
chr12,Bn47362,28057669,72346483,44288814,TNL
chr12,Bn47363,40759194,85196992,44437798,TN
chr12,Bn47364,46858891,52448601,5589710,RLP
chr12,Bn47365,90595901,96419357,5823456,TNL
chr12,Bn47366,52433594,55105559,2671965,NBS
chr12,Bn47367,7500275,57095847,49595572,NBS
chr12,Bn47368,82826371,86055580,3229209,TN
chr12,Bn47369,13741076,28953029,15211953,TN
chr12,Bn47370,1998720,52338248,50339528,RLP
chr12,Bn47371,32913575,52137619,19224044,RLK
chr12,Bn47372,40539303,96095451,55556148,RLK
chr12,Bn47373,5642942,70084987,64442045,RLP
chr12,Bn47374,60407813,60649037,241224,NBS
chr12,Bn47375,56662921,83468880,26805959,CN
chr12,Bn47376,57515206,83990867,26475661,TNL
chr12,Bn47377,88109056,95511696,7402640,RLP
chr12,Bn47378,16646078,51864294,35218216,RLP
chr12,Bn47379,97308844,98316415,1007571,CNL
chr12,Bn47380,42866765,97734497,54867732,CN
chr12,Bn47381,93179741,93873039,693298,CNL
chr12,Bn47382,94315607,97302365,2986758,CN
chr12,Bn47383,67047714,75537694,8489980,NBS
chr12,Bn47384,15690087,38044649,22354562,CN
chr12,Bn47385,4459817,28108792,23648975,TNL
chr12,Bn47386,19861968,97518618,77656650,TNL
chr12,Bn47387,1728752,37130223,35401471,TN
chr12,Bn47388,58872187,61947795,3075608,RLP
chr12,Bn47389,34146129,86932489,52786360,TNL
chr12,Bn47390,68963400,71667371,2703971,TN
chr12,Bn47391,14799991,90251755,75451764,CN
chr12,Bn47392,8302834,70798731,62495897,CNL
chr12,Bn47393,37789497,60065945,22276448,TN
chr12,Bn47394,22570332,68071334,45501002,CN
chr12,Bn47395,90848988,92062143,1213155,RLK
chr12,Bn47396,18525090,52944662,34419572,NBS
chr12,Bn47397,31532458,88105168,56572710,CN
chr12,Bn47398,74288417,97071427,22783010,TN
chr12,Bn47399,30184181,77343005,47158824,TN
chr12,Bn47400,48332409,78236762,29904353,NBS
chr12,Bn47401,73658867,96358230,22699363,NBS
chr12,Bn47402,54300081,58886093,4586012,NBS
chr12,Bn47403,62169150,78146231,15977081,RLK
chr12,Bn47404,66663497,85737745,19074248,TN
chr12,Bn47405,59047456,69027835,9980379,CNL
chr12,Bn47406,19252074,32203005,12950931,CNL
chr12,Bn47407,10975306,33174569,22199263,TN
chr12,Bn47408,6925147,89824647,82899500,RLP
chr12,Bn47409,7626811,62291753,54664942,TNL
chr12,Bn47410,1557326,99899667,98342341,RLK
chr12,Bn47411,9532383,48558637,39026254,CN
chr12,Bn47412,33218575,76994479,43775904,RLP
chr12,Bn47413,43869871,60748941,16879070,TN
chr12,Bn47414,92063399,98065392,6001993,CNL
chr12,Bn47415,48819498,98451861,49632363,RLK
chr12,Bn47416,76638759,98165122,21526363,TNL
chr12,Bn47417,71621802,88055845,16434043,CN
chr12,Bn47418,35799246,89667345,53868099,RLP
chr12,Bn47419,14118825,53494215,39375390,RLP
chr12,Bn47420,97243561,97270402,26841,NBS
chr12,Bn47421,25980290,49089956,23109666,TNL
chr12,Bn47422,76366765,77337939,971174,CNL
chr12,Bn47423,18409865,87810158,69400293,TN
chr12,Bn47424,23345267,35376450,12031183,CN
chr12,Bn47425,96997952,99696317,2698365,RLK
chr12,Bn47426,88653208,97665230,9012022,NBS
chr12,Bn47427,15868346,58033029,42164683,RLP
chr12,Bn47428,6790898,51125479,44334581,NBS
chr12,Bn47429,95594238,96023624,429386,RLP
chr12,Bn47430,30863806,38424245,7560439,TNL
chr12,Bn47431,5526029,33863469,28337440,RLK
chr12,Bn47432,81393057,85560141,4167084,TN
chr12,Bn47433,16334368,76975427,60641059,TN
chr12,Bn47434,88298594,97849224,9550630,RLK
chr12,Bn47435,89879235,99047558,9168323,CN
chr12,Bn47436,90191921,92037490,1845569,CNL
chr12,Bn47437,52143616,71724040,19580424,RLK
chr12,Bn47438,55583377,92154033,36570656,CNL
chr12,Bn47439,47298493,96920425,49621932,CN
chr12,Bn47440,74070702,86423762,12353060,TN
chr12,Bn47441,75701286,84529131,8827845,CNL
chr12,Bn47442,69833813,99918602,30084789,TNL
chr12,Bn47443,96005081,98672903,2667822,RLK
chr12,Bn47444,39749522,91767815,52018293,RLP
chr12,Bn47445,65712170,66891507,1179337,NBS
chr12,Bn47446,41739854,58432372,16692518,RLP
chr12,Bn47447,12137798,35809308,23671510,RLK
chr12,Bn47448,5848688,7823152,1974464,NBS
chr12,Bn47449,16803807,93799811,76996004,CNL
chr12,Bn47450,23477258,48806863,25329605,TNL
chr12,Bn47451,83795851,99797786,16001935,TN
chr12,Bn47452,77194513,94653000,17458487,RLK
chr12,Bn47453,88955049,99587531,10632482,CNL
chr12,Bn47454,33774508,90362307,56587799,NBS
chr12,Bn47455,75191941,94755408,19563467,CNL
chr12,Bn47456,31102975,73088941,41985966,RLP
chr12,Bn47457,50060781,80501324,30440543,NBS
chr12,Bn47458,89266050,93330354,4064304,TNL
chr12,Bn47459,29915073,69337523,39422450,TN
chr12,Bn47460,91937652,93029525,1091873,TNL
chr12,Bn47461,30924746,64305602,33380856,TNL
chr12,Bn47462,35146623,39587577,4440954,NBS
chr12,Bn47463,96343706,97926563,1582857,RLP
chr12,Bn47464,61278967,69080927,7801960,CN
chr12,Bn47465,30444527,63645151,33200624,TN
chr12,Bn47466,44480461,73385525,28905064,TNL
chr12,Bn47467,32608715,62829208,30220493,RLK
chr12,Bn47468,77100850,81937945,4837095,RLK
chr12,Bn47469,29635693,70385479,40749786,CNL
chr12,Bn47470,22082615,73215157,51132542,NBS
chr12,Bn47471,14034189,55929971,41895782,RLP
chr12,Bn47472,19998873,74581858,54582985,CN
chr12,Bn47473,22166155,98967443,76801288,CN
chr12,Bn47474,15840731,79140697,63299966,CN
chr12,Bn47475,96058832,97345592,1286760,NBS
chr12,Bn47476,60167415,83547047,23379632,RLK
chr12,Bn47477,19120313,59596104,40475791,RLK
chr12,Bn47478,69620444,72896107,3275663,RLK
chr12,Bn47479,99402597,99627038,224441,TN
chr12,Bn47480,77109298,92038940,14929642,TNL
chr12,Bn47481,78622143,97030130,18407987,NBS
chr12,Bn47482,58608572,99113355,40504783,CNL
chr12,Bn47483,2702353,76812448,74110095,NBS
chr12,Bn47484,73592131,98101198,24509067,RLK
chr12,Bn47485,48451506,67483390,19031884,TNL
chr12,Bn47486,86650344,99884243,13233899,NBS
chr12,Bn47487,82325706,94679723,12354017,RLP
chr12,Bn47488,64140623,83333552,19192929,TNL
chr12,Bn47489,36995024,97353555,60358531,NBS
chr12,Bn47490,70284503,90246468,19961965,RLK
chr12,Bn47491,2468360,89383317,86914957,CN
chr12,Bn47492,83519184,97871426,14352242,NBS
chr12,Bn47493,7093182,71402384,64309202,RLK
chr12,Bn47494,54537490,78597681,24060191,TN
chr12,Bn47495,42272569,94808395,52535826,RLP
chr12,Bn47496,41240900,43293864,2052964,CNL
chr12,Bn47497,16311901,29793305,13481404,TNL
chr12,Bn47498,94126996,99629065,5502069,RLK
chr12,Bn47499,22826041,54505412,31679371,TNL
chr12,Bn47500,58332849,92919451,34586602,CN
chr12,Bn47501,82989652,86873965,3884313,TNL
chr12,Bn47502,62062291,76584635,14522344,TNL
chr12,Bn47503,31261220,79706320,48445100,NBS
chr12,Bn47504,47442486,93269303,45826817,CNL
chr12,Bn47505,98518138,99825758,1307620,TNL
chr12,Bn47506,46602726,72135954,25533228,CNL
chr12,Bn47507,60951599,70782443,9830844,RLK
chr12,Bn47508,16935433,73851259,56915826,RLK
chr12,Bn47509,69528379,90439547,20911168,CNL
chr12,Bn47510,9893430,95340456,85447026,TNL
chr12,Bn47511,94481264,98211537,3730273,TNL
chr12,Bn47512,96218484,97865086,1646602,CNL
chr12,Bn47513,90213830,91264929,1051099,CNL
chr12,Bn47514,69207046,79325397,10118351,TNL
chr12,Bn47515,70019848,85234372,15214524,TNL
chr12,Bn47516,99698766,99811650,112884,RLP
chr12,Bn47517,91959208,92540764,581556,CN
chr12,Bn47518,71178220,83913474,12735254,TN
chr12,Bn47519,74202962,97258982,23056020,CN
chr12,Bn47520,47312876,51081233,3768357,TNL
chr12,Bn47521,40447638,64328482,23880844,CN
chr12,Bn47522,27539981,39983680,12443699,RLK
chr12,Bn47523,52947272,98569205,45621933,TNL
chr12,Bn47524,71593501,97577480,25983979,TNL
chr12,Bn47525,18704609,81999596,63294987,TN
chr12,Bn47526,73256690,88551656,15294966,CN
chr12,Bn47527,58211419,91083599,32872180,TN
chr12,Bn47528,6442712,6604739,162027,CN
chr12,Bn47529,45981174,99225936,53244762,RLK
chr12,Bn47530,97124184,98293881,1169697,NBS
chr12,Bn47531,92638619,95323217,2684598,CNL
chr12,Bn47532,17988210,93117296,75129086,RLK
chr12,Bn47533,22901836,71354311,48452475,TNL
chr12,Bn47534,31985164,63504113,31518949,RLK
chr12,Bn47535,64898194,89734331,24836137,TNL
chr12,Bn47536,43820462,62579986,18759524,RLK
chr12,Bn47537,33475082,37662845,4187763,CN
chr12,Bn47538,97547210,98590487,1043277,NBS
chr12,Bn47539,93588896,95210304,1621408,TN
chr12,Bn47540,11879243,58555319,46676076,RLK
chr12,Bn47541,53509273,92292763,38783490,NBS
chr12,Bn47542,55870144,58959399,3089255,CN
chr12,Bn47543,44527210,82205046,37677836,CN
chr12,Bn47544,93966267,99678768,5712501,CN
chr12,Bn47545,59097676,84414656,25316980,CNL
chr12,Bn47546,77348036,82042700,4694664,TN
chr12,Bn47547,29898404,48371722,18473318,RLP
chr12,Bn47548,60889824,67231305,6341481,TNL
chr12,Bn47549,12030491,50144507,38114016,CNL
chr12,Bn47550,50987166,55395951,4408785,TNL
chr12,Bn47551,3076665,19440447,16363782,TNL
chr12,Bn47552,60282124,86476858,26194734,CNL
chr12,Bn47553,5977222,97723050,91745828,TNL
chr12,Bn47554,58993047,88890469,29897422,RLK
chr12,Bn47555,93149373,95084544,1935171,RLP
chr12,Bn47556,76140346,85329606,9189260,TNL
chr12,Bn47557,16904302,68549053,51644751,TNL
chr12,Bn47558,27032233,90672890,63640657,RLP
chr12,Bn47559,74577859,89509940,14932081,CNL
chr12,Bn47560,58262140,85037812,26775672,TN
chr12,Bn47561,45132858,49699864,4567006,TN
chr12,Bn47562,98224225,99354066,1129841,TNL
chr12,Bn47563,33036253,50837439,17801186,CNL
chr12,Bn47564,38426551,49502545,11075994,CN
chr12,Bn47565,26724059,28364817,1640758,NBS
chr12,Bn47566,8064400,28577401,20513001,CNL
chr12,Bn47567,74219949,74571689,351740,CN
chr12,Bn47568,3539027,16240430,12701403,RLK
chr12,Bn47569,27005394,64518883,37513489,CN
chr12,Bn47570,87433818,93313688,5879870,RLP
chr12,Bn47571,19973363,35245350,15271987,TNL
chr12,Bn47572,9976387,27544220,17567833,TNL
chr12,Bn47573,62924828,81636301,18711473,RLP
chr12,Bn47574,62776162,81403166,18627004,TNL
chr12,Bn47575,57668875,68958992,11290117,TNL
chr12,Bn47576,16240823,82917244,66676421,TN
chr12,Bn47577,63592408,76511747,12919339,TN
chr12,Bn47578,11192653,99604250,88411597,NBS
chr12,Bn47579,42171872,62089457,19917585,RLK
chr12,Bn47580,81904062,84172543,2268481,CNL
chr12,Bn47581,66305350,71215404,4910054,RLK
chr12,Bn47582,80461947,81767320,1305373,RLP
chr12,Bn47583,17395882,95975234,78579352,RLK
chr12,Bn47584,56862494,99012013,42149519,CNL
chr12,Bn47585,80275190,95324911,15049721,CN
chr12,Bn47586,69379853,71654757,2274904,CN
chr12,Bn47587,54606542,96404514,41797972,TNL
chr12,Bn47588,91825738,97628591,5802853,RLK
chr12,Bn47589,53350116,70694444,17344328,TNL
chr12,Bn47590,49706391,63766908,14060517,RLK
chr12,Bn47591,14141577,94965483,80823906,RLK
chr12,Bn47592,24212007,43938612,19726605,CNL
chr12,Bn47593,91829818,94231405,2401587,TN
chr12,Bn47594,2232386,30333221,28100835,TN
chr12,Bn47595,48420272,92460795,44040523,NBS
chr12,Bn47596,82997145,93827841,10830696,TN
chr12,Bn47597,17978602,69679383,51700781,NBS
chr12,Bn47598,78911296,85092952,6181656,CNL
chr12,Bn47599,33278755,95390506,62111751,TN
chr12,Bn47600,53111925,68257637,15145712,CN
chr12,Bn47601,41190613,63512640,22322027,NBS
chr12,Bn47602,35238943,64981175,29742232,NBS
chr12,Bn47603,64106259,81810163,17703904,TN
chr12,Bn47604,35390992,93516660,58125668,NBS
chr12,Bn47605,61243541,78857336,17613795,TN
chr12,Bn47606,81794071,84961543,3167472,TNL
chr12,Bn47607,97475913,98409880,933967,CN
chr12,Bn47608,77169174,86800222,9631048,TNL
chr12,Bn47609,12363022,85397821,73034799,CN
chr12,Bn47610,87860464,98196739,10336275,TNL
chr12,Bn47611,34434117,75673294,41239177,NBS
chr12,Bn47612,28428324,85765686,57337362,NBS
chr12,Bn47613,9286361,95254837,85968476,RLP
chr12,Bn47614,14709018,68053169,53344151,RLK
chr12,Bn47615,22038184,77101969,55063785,CN
chr12,Bn47616,40969308,51875066,10905758,TNL
chr12,Bn47617,92183585,96822847,4639262,RLP
chr12,Bn47618,73360444,76822411,3461967,NBS
chr12,Bn47619,17957690,43123855,25166165,CNL
chr12,Bn47620,13833584,62041914,48208330,NBS
chr12,Bn47621,67613433,75982549,8369116,NBS
chr12,Bn47622,19259722,72532390,53272668,TN
chr12,Bn47623,80546807,97601614,17054807,RLP
chr12,Bn47624,86511162,99128170,12617008,RLK
chr12,Bn47625,36164771,65320484,29155713,TN
chr12,Bn47626,11180641,18415270,7234629,NBS
chr12,Bn47627,28943550,29304776,361226,CN
chr12,Bn47628,34663581,68938440,34274859,NBS
chr12,Bn47629,19924377,86127095,66202718,CNL
chr12,Bn47630,54068605,65343920,11275315,TN
chr12,Bn47631,8560013,92525972,83965959,RLK
chr12,Bn47632,13138901,43719577,30580676,CN
chr12,Bn47633,72743227,83916145,11172918,NBS
chr12,Bn47634,29307273,77096998,47789725,TNL
chr12,Bn47635,34930721,45401713,10470992,CN
chr12,Bn47636,86982470,93695738,6713268,CNL
chr12,Bn47637,70701893,84892089,14190196,CNL
chr12,Bn47638,67742844,90166543,22423699,CNL
chr12,Bn47639,49964865,55996301,6031436,RLK
chr12,Bn47640,57756353,80728084,22971731,TNL
chr12,Bn47641,60879609,79833072,18953463,RLP
chr12,Bn47642,69177117,77548967,8371850,RLK
chr12,Bn47643,20864948,71001650,50136702,TNL
chr12,Bn47644,47803362,69960900,22157538,CNL
chr12,Bn47645,55242555,84455930,29213375,TN
chr12,Bn47646,73751634,86945876,13194242,RLK
chr12,Bn47647,35015400,84719310,49703910,TN
chr12,Bn47648,35755150,93939661,58184511,RLK
chr12,Bn47649,41206809,50086005,8879196,CN
chr12,Bn47650,20957396,49193357,28235961,CNL
chr12,Bn47651,87169804,99407150,12237346,RLK
chr12,Bn47652,96048358,99094472,3046114,TNL
chr12,Bn47653,50003905,53167349,3163444,TNL
chr12,Bn47654,6084164,86910582,80826418,CNL
chr12,Bn47655,16238876,99113632,82874756,CN
chr12,Bn47656,43907735,89617297,45709562,RLK
chr12,Bn47657,23079870,94718571,71638701,CN
chr12,Bn47658,37652863,94422518,56769655,CN
chr12,Bn47659,27662488,36905655,9243167,NBS
chr12,Bn47660,32418914,90874252,58455338,RLP
chr12,Bn47661,19105767,88100698,68994931,NBS
chr12,Bn47662,94071579,94570157,498578,RLP
chr12,Bn47663,13849993,46928705,33078712,NBS
chr12,Bn47664,43605777,55686041,12080264,CNL
chr12,Bn47665,86188368,87677908,1489540,CN
chr12,Bn47666,77545229,90642485,13097256,RLK
chr12,Bn47667,76171746,89277366,13105620,RLK
chr12,Bn47668,49253561,82922729,33669168,TNL
chr12,Bn47669,10329185,69195317,58866132,CNL
chr12,Bn47670,73763011,91599344,17836333,TNL
chr12,Bn47671,85166836,85710793,543957,CNL
chr12,Bn47672,64805059,96032719,31227660,NBS
chr12,Bn47673,92176061,99388197,7212136,RLK
chr12,Bn47674,11060760,17050029,5989269,RLK
chr12,Bn47675,24478599,44459859,19981260,TNL
chr12,Bn47676,32808710,99365047,66556337,CN
chr12,Bn47677,7215360,88259456,81044096,TNL
chr12,Bn47678,18823578,48324873,29501295,NBS
chr12,Bn47679,69150373,76543440,7393067,TNL
chr12,Bn47680,83239752,87830307,4590555,CN
chr12,Bn47681,57293090,66903994,9610904,CNL
chr12,Bn47682,98210472,98457266,246794,TNL
chr12,Bn47683,77788683,91567332,13778649,CN
chr12,Bn47684,84410199,87753601,3343402,TN
chr12,Bn47685,93290461,97485472,4195011,NBS
chr12,Bn47686,83677828,91229419,7551591,TNL
chr12,Bn47687,57445221,95764112,38318891,NBS
chr12,Bn47688,44097202,89716552,45619350,CNL
chr12,Bn47689,31787716,90318339,58530623,RLP
chr12,Bn47690,73085486,78306128,5220642,RLP
chr12,Bn47691,19367613,99236315,79868702,NBS
chr12,Bn47692,47693490,58962954,11269464,TNL
chr12,Bn47693,64312460,92581167,28268707,NBS
chr12,Bn47694,16944184,31013133,14068949,TN
chr12,Bn47695,50673607,59820249,9146642,RLK
chr12,Bn47696,13131717,70006592,56874875,CN
chr12,Bn47697,76840457,85195783,8355326,CNL
chr12,Bn47698,86341255,97007933,10666678,TNL
chr12,Bn47699,21921183,86954414,65033231,CN
chr12,Bn47700,96365412,98727770,2362358,CN
chr12,Bn47701,6671425,37562923,30891498,RLK
chr12,Bn47702,95784235,97938233,2153998,CNL
chr12,Bn47703,10517313,55637366,45120053,NBS
chr12,Bn47704,98665436,99714101,1048665,TNL
chr12,Bn47705,92006275,98767985,6761710,TNL
chr12,Bn47706,34869774,75971560,41101786,CNL
chr12,Bn47707,1085851,80278670,79192819,RLP
chr12,Bn47708,57363081,98479400,41116319,RLP
chr12,Bn47709,64828572,89187489,24358917,TN
chr12,Bn47710,23092684,25671181,2578497,CNL
chr12,Bn47711,25556997,77991092,52434095,RLK
chr12,Bn47712,16787846,33123343,16335497,CNL
chr12,Bn47713,68997089,80013485,11016396,CNL
chr12,Bn47714,32661902,39881193,7219291,TNL
chr12,Bn47715,75022748,76501812,1479064,TN
chr12,Bn47716,12573106,36187214,23614108,CN
chr12,Bn47717,44459160,89840506,45381346,RLP
chr12,Bn47718,45045831,71473660,26427829,RLP
chr12,Bn47719,23634911,34070184,10435273,TN
chr12,Bn47720,13997426,64023106,50025680,TN
chr12,Bn47721,63238470,96501733,33263263,RLP
chr12,Bn47722,28795049,64735699,35940650,TNL
chr12,Bn47723,64931112,89677981,24746869,CNL
chr12,Bn47724,98909272,99153413,244141,RLP
chr12,Bn47725,87079209,92019187,4939978,RLK
chr12,Bn47726,86635845,90698366,4062521,CNL
chr12,Bn47727,70543900,98925590,28381690,CNL
chr12,Bn47728,2588091,47767480,45179389,TNL
chr12,Bn47729,38269621,74845781,36576160,RLP
chr12,Bn47730,59414586,87173122,27758536,NBS
chr12,Bn47731,71367736,82087840,10720104,NBS
chr12,Bn47732,42311276,95061484,52750208,CNL
chr12,Bn47733,7873225,18137357,10264132,CNL
chr12,Bn47734,62601221,63947392,1346171,CNL
chr12,Bn47735,62582897,78470008,15887111,NBS
chr12,Bn47736,64905509,86229935,21324426,TNL
chr12,Bn47737,96350406,98016945,1666539,RLK
chr12,Bn47738,37883888,58538879,20654991,NBS
chr12,Bn47739,23480112,31778040,8297928,CNL
chr12,Bn47740,75705471,99038822,23333351,TN
chr12,Bn47741,78593892,88748758,10154866,RLP
chr12,Bn47742,73200473,78559132,5358659,TNL
chr12,Bn47743,60207922,96627131,36419209,CN
chr12,Bn47744,4242256,22912919,18670663,TNL
chr12,Bn47745,86518856,94465955,7947099,NBS
chr12,Bn47746,44067846,56677852,12610006,CNL
chr12,Bn47747,74118701,98296761,24178060,CN
chr12,Bn47748,12813741,84902620,72088879,RLK
chr12,Bn47749,48473334,78726489,30253155,CN
chr12,Bn47750,16473402,98599315,82125913,CN
chr12,Bn47751,54285696,80166915,25881219,NBS
chr12,Bn47752,86340381,98760046,12419665,NBS
chr12,Bn47753,71476276,94484964,23008688,RLK
chr12,Bn47754,34092805,46521523,12428718,CN
chr12,Bn47755,86413985,92325590,5911605,TN
chr12,Bn47756,99105751,99638427,532676,TN
chr12,Bn47757,26861316,79856340,52995024,TN
chr12,Bn47758,56156748,98804848,42648100,NBS
chr12,Bn47759,79264289,92953758,13689469,RLP
chr12,Bn47760,21915426,83105064,61189638,RLP
chr12,Bn47761,77607882,82045452,4437570,RLP
chr12,Bn47762,3386248,7708055,4321807,NBS
chr12,Bn47763,44816074,53886825,9070751,CNL
chr12,Bn47764,83890474,90029059,6138585,CNL
chr12,Bn47765,39494240,73020253,33526013,TNL
chr12,Bn47766,72332452,90806295,18473843,CNL
chr12,Bn47767,37184761,42609247,5424486,TNL
chr12,Bn47768,8674263,46300257,37625994,TN
chr12,Bn47769,55243110,78397262,23154152,CNL
chr12,Bn47770,51624014,73425415,21801401,CNL
chr12,Bn47771,64115029,98656713,34541684,TNL
chr12,Bn47772,93725781,97799505,4073724,TN
chr12,Bn47773,53423534,76350469,22926935,RLK
chr12,Bn47774,63859124,70890158,7031034,RLK
chr12,Bn47775,85387242,89020191,3632949,RLK
chr12,Bn47776,50177299,83756785,33579486,TN
chr12,Bn47777,1060849,70388306,69327457,RLK
chr12,Bn47778,19416263,42833086,23416823,RLK
chr12,Bn47779,14906572,43173775,28267203,CNL
chr12,Bn47780,16017278,91964301,75947023,RLP
chr12,Bn47781,65057825,84972784,19914959,RLK
chr12,Bn47782,58518305,59920790,1402485,CNL
chr12,Bn47783,2219459,87631846,85412387,TN
chr12,Bn47784,35106851,44604911,9498060,TNL
chr12,Bn47785,76443376,90633689,14190313,CN
chr12,Bn47786,27790678,76701749,48911071,RLP
chr12,Bn47787,74856067,90509020,15652953,TN
chr12,Bn47788,86917871,92047413,5129542,RLP
chr12,Bn47789,93532529,99763521,6230992,CN
chr12,Bn47790,16061640,80238682,64177042,NBS
chr12,Bn47791,16173333,28204310,12030977,RLK
chr12,Bn47792,59408072,73010257,13602185,TNL
chr12,Bn47793,83335006,94275110,10940104,RLP
chr12,Bn47794,31754238,65889331,34135093,TNL
chr12,Bn47795,54871794,98903775,44031981,TNL
chr12,Bn47796,85256270,96489973,11233703,RLK
chr12,Bn47797,43047925,59980256,16932331,NBS
chr12,Bn47798,53426005,78446242,25020237,TNL
chr12,Bn47799,17477968,51764443,34286475,CNL
chr12,Bn47800,35813077,61249442,25436365,CNL
chr12,Bn47801,77120499,81688196,4567697,NBS
chr12,Bn47802,55910345,65939813,10029468,TNL
chr12,Bn47803,47104080,82988070,35883990,RLP
chr12,Bn47804,7474018,16188188,8714170,CN
chr12,Bn47805,40888002,86534819,45646817,RLP
chr12,Bn47806,87082238,95232814,8150576,NBS
chr12,Bn47807,80721543,97959877,17238334,RLP
chr12,Bn47808,76325526,78760033,2434507,TN
chr12,Bn47809,36945984,94346043,57400059,RLK
chr12,Bn47810,35876375,57561920,21685545,RLK
chr12,Bn47811,67709750,86289735,18579985,RLP
chr12,Bn47812,30464129,59532145,29068016,TN
chr12,Bn47813,45640079,93726248,48086169,RLK
chr12,Bn47814,70211759,84577005,14365246,TNL
chr12,Bn47815,15124568,84000833,68876265,CNL
chr12,Bn47816,25799560,27745179,1945619,NBS
chr12,Bn47817,41799256,96313780,54514524,TN
chr12,Bn47818,96120341,97910980,1790639,CNL
chr12,Bn47819,15340893,66593207,51252314,TNL
chr12,Bn47820,92389620,94634804,2245184,NBS
chr12,Bn47821,26141847,98318451,72176604,CNL
chr12,Bn47822,23066475,66245700,43179225,CNL
chr12,Bn47823,72787402,91651888,18864486,RLP
chr12,Bn47824,63336898,95911080,32574182,CN
chr12,Bn47825,44880484,99165481,54284997,RLK
chr12,Bn47826,48913250,82998344,34085094,CN
chr12,Bn47827,66275966,74784866,8508900,CN
chr12,Bn47828,78625552,95710545,17084993,NBS
chr12,Bn47829,69222645,85695761,16473116,RLK
chr12,Bn47830,96597883,98101864,1503981,NBS
chr12,Bn47831,26909874,65723298,38813424,RLK
chr12,Bn47832,26714182,66225421,39511239,CNL
chr12,Bn47833,67758259,83261395,15503136,RLK
chr12,Bn47834,58445477,59357558,912081,RLP
chr12,Bn47835,24605530,90094791,65489261,CNL
chr12,Bn47836,78705587,87637953,8932366,NBS
chr12,Bn47837,26757034,75715443,48958409,CN
chr12,Bn47838,65396867,82572522,17175655,CN
chr12,Bn47839,25403374,71116756,45713382,TN
chr12,Bn47840,53857786,81837257,27979471,CN
chr12,Bn47841,37141432,96943086,59801654,RLP
chr12,Bn47842,85355966,89825793,4469827,CNL
chr12,Bn47843,84207937,90203126,5995189,TNL
chr12,Bn47844,32732065,75767656,43035591,NBS
chr12,Bn47845,69426833,89087718,19660885,CNL
chr12,Bn47846,51293602,82020557,30726955,NBS
chr12,Bn47847,5496358,31814417,26318059,CN
chr12,Bn47848,8028127,19879298,11851171,CN
chr12,Bn47849,15502448,51127975,35625527,RLK
chr12,Bn47850,58054850,79173033,21118183,TN
chr12,Bn47851,33944061,37326743,3382682,RLP
chr12,Bn47852,97817298,99156550,1339252,NBS
chr12,Bn47853,27606005,67729595,40123590,NBS
chr12,Bn47854,98933456,99427347,493891,TNL
chr12,Bn47855,15345563,74475913,59130350,TN
chr12,Bn47856,41847814,86050057,44202243,RLK
chr12,Bn47857,35131579,69242289,34110710,RLK
chr12,Bn47858,99803086,99956618,153532,NBS
chr12,Bn47859,20679447,75835845,55156398,RLK
chr12,Bn47860,46799215,67163837,20364622,RLK
chr12,Bn47861,87053305,99225287,12171982,TNL
chr12,Bn47862,72998767,99982414,26983647,TNL
chr12,Bn47863,31215192,83286809,52071617,CNL
chr12,Bn47864,10294302,32172898,21878596,CN
chr12,Bn47865,44012629,87981179,43968550,CN
chr12,Bn47866,4447817,11182704,6734887,TN
chr12,Bn47867,58087402,62300026,4212624,TN
chr12,Bn47868,35417952,44118549,8700597,CNL
chr12,Bn47869,78525977,89770749,11244772,RLK
chr12,Bn47870,66912421,68796369,1883948,NBS
chr12,Bn47871,79316362,84517791,5201429,CN
chr12,Bn47872,85561753,93540805,7979052,TNL
chr12,Bn47873,59366780,93790416,34423636,TN
chr12,Bn47874,40244571,49303643,9059072,CN
chr12,Bn47875,80899621,90304543,9404922,RLP
chr12,Bn47876,54515808,83135347,28619539,CN
chr12,Bn47877,65997082,66295798,298716,TNL
chr12,Bn47878,6277430,96473038,90195608,CN
chr12,Bn47879,10666736,75243235,64576499,TNL
chr12,Bn47880,62369451,78505793,16136342,RLK
chr12,Bn47881,98539046,99792250,1253204,CNL
chr12,Bn47882,89973020,96661813,6688793,CN
chr12,Bn47883,73417844,87470110,14052266,CN
chr12,Bn47884,89551567,90699589,1148022,RLK
chr12,Bn47885,76223894,99544878,23320984,RLP
chr12,Bn47886,34256809,38359642,4102833,CN
chr12,Bn47887,85975844,96139847,10164003,TN
chr12,Bn47888,37926990,90447636,52520646,TNL
chr12,Bn47889,74933501,77741670,2808169,NBS
chr12,Bn47890,91033861,97927458,6893597,CN
chr12,Bn47891,1357649,57634526,56276877,CNL
chr12,Bn47892,47878174,71854342,23976168,CNL
chr12,Bn47893,29518018,91687680,62169662,TNL
chr12,Bn47894,17948411,58955295,41006884,NBS
chr12,Bn47895,62741980,99750326,37008346,CNL
chr12,Bn47896,75588496,83432392,7843896,RLK
chr12,Bn47897,34262566,78585303,44322737,CNL
chr12,Bn47898,2602994,11480699,8877705,RLK
chr12,Bn47899,40090507,92520164,52429657,TNL
chr12,Bn47900,48604117,87237741,38633624,TN
chr12,Bn47901,99307734,99356397,48663,RLK
chr12,Bn47902,19073127,28573035,9499908,TNL
chr12,Bn47903,16259849,54596723,38336874,TN
chr12,Bn47904,40167145,98368401,58201256,TN
chr12,Bn47905,33396984,88351439,54954455,CNL
chr12,Bn47906,77979220,89360949,11381729,NBS
chr12,Bn47907,22604739,98972934,76368195,TN
chr12,Bn47908,20834874,41505670,20670796,CN
chr12,Bn47909,35802965,93064781,57261816,RLK
chr12,Bn47910,12483338,46468646,33985308,RLK
chr12,Bn47911,27986675,28631706,645031,CNL
chr12,Bn47912,2098646,28875940,26777294,TN
chr12,Bn47913,5487491,66090701,60603210,CN
chr12,Bn47914,92247101,99061112,6814011,CN
chr12,Bn47915,31795081,56509434,24714353,TNL
chr12,Bn47916,53827120,76898355,23071235,TN
chr12,Bn47917,89143176,96543089,7399913,RLP
chr12,Bn47918,58952632,77429794,18477162,TN
chr12,Bn47919,43686744,57399490,13712746,CN
chr12,Bn47920,35625599,96697114,61071515,RLK
chr12,Bn47921,1575868,98248355,96672487,NBS
chr12,Bn47922,43184227,88381531,45197304,TN
chr12,Bn47923,82739170,92896930,10157760,RLP
chr12,Bn47924,86124019,90878064,4754045,RLK
chr12,Bn47925,3742144,36992121,33249977,TN
chr12,Bn47926,40093607,61797602,21703995,TN
chr12,Bn47927,21471290,78612426,57141136,TN
chr12,Bn47928,31902193,81345817,49443624,TN
chr12,Bn47929,81846134,85681800,3835666,RLK
chr12,Bn47930,74267926,87601519,13333593,NBS
chr12,Bn47931,14598892,71405044,56806152,CNL
chr12,Bn47932,93937634,94625949,688315,TN
chr12,Bn47933,23916657,46013914,22097257,CNL
chr12,Bn47934,61090668,87925176,26834508,CNL
chr12,Bn47935,55116443,62981117,7864674,CN
chr12,Bn47936,80252723,98404597,18151874,CNL
chr12,Bn47937,72502636,89410929,16908293,CNL
chr12,Bn47938,95181259,96299738,1118479,RLP
chr12,Bn47939,1621368,81676429,80055061,NBS
chr12,Bn47940,46000674,46834986,834312,TN
chr12,Bn47941,14164065,80858634,66694569,TN
chr12,Bn47942,5107245,30115037,25007792,CNL
chr12,Bn47943,76033826,97097900,21064074,RLP
chr12,Bn47944,18144126,78231588,60087462,RLK
chr12,Bn47945,28974447,93822396,64847949,TNL
chr12,Bn47946,51216838,80181016,28964178,CNL
chr12,Bn47947,22457777,60095065,37637288,CN
chr12,Bn47948,39980670,74207904,34227234,TN
chr12,Bn47949,37347156,54115901,16768745,CN
chr12,Bn47950,30344885,84914374,54569489,CNL
chr12,Bn47951,32224757,89142123,56917366,NBS
chr12,Bn47952,69424543,75724205,6299662,CN
chr12,Bn47953,13289658,47395372,34105714,RLP
chr12,Bn47954,45360687,95658662,50297975,RLK
chr12,Bn47955,83200716,95699810,12499094,NBS
chr12,Bn47956,82686262,83729549,1043287,TN
chr12,Bn47957,37785651,59942362,22156711,CNL
chr12,Bn47958,93811513,95194165,1382652,CN
chr12,Bn47959,16485320,24042392,7557072,TN
chr12,Bn47960,99388825,99901466,512641,TN
chr12,Bn47961,28902231,56651472,27749241,RLK
chr12,Bn47962,34497131,96859840,62362709,CNL
chr12,Bn47963,96856016,97559768,703752,TN
chr12,Bn47964,40433674,91746272,51312598,RLP
chr12,Bn47965,8704238,75664385,66960147,RLK
chr12,Bn47966,44442037,92086142,47644105,CN
chr12,Bn47967,37028427,64293883,27265456,TN
chr12,Bn47968,36207017,41683374,5476357,RLK
chr12,Bn47969,8664174,9385894,721720,NBS
chr12,Bn47970,98113621,99817991,1704370,CN
chr12,Bn47971,31956288,82415944,50459656,CNL
chr12,Bn47972,92477632,96034791,3557159,CN
chr12,Bn47973,14279353,66138496,51859143,TNL
chr12,Bn47974,24450228,80070674,55620446,RLP
chr12,Bn47975,59836170,69053885,9217715,RLP
chr12,Bn47976,4713748,21190865,16477117,CN
chr12,Bn47977,55038207,99628294,44590087,NBS
chr12,Bn47978,20713319,76630824,55917505,CNL
chr12,Bn47979,52997662,81523366,28525704,TN
chr12,Bn47980,16022270,68054016,52031746,TNL
chr12,Bn47981,22245190,31057624,8812434,TNL
chr12,Bn47982,26565457,39645358,13079901,TN
chr12,Bn47983,7173414,16574536,9401122,CNL
chr12,Bn47984,4876360,82665148,77788788,CNL
chr12,Bn47985,30791187,42721944,11930757,CNL
chr12,Bn47986,8092455,19112640,11020185,TN
chr12,Bn47987,16391939,75919136,59527197,RLK
chr12,Bn47988,82255944,93443014,11187070,TN
chr12,Bn47989,7285386,61873131,54587745,RLK
chr12,Bn47990,5791084,36639141,30848057,CNL
chr12,Bn47991,77262142,87233169,9971027,TNL
chr12,Bn47992,76364224,79222390,2858166,NBS
chr12,Bn47993,50845830,99857469,49011639,RLP
chr12,Bn47994,21448237,96916160,75467923,CNL
chr12,Bn47995,49825311,56077437,6252126,CN
chr12,Bn47996,83101493,97385203,14283710,TNL
chr12,Bn47997,20136579,24369563,4232984,NBS
chr12,Bn47998,28898591,54170416,25271825,RLP
chr12,Bn47999,79117634,93105823,13988189,CN
chr12,Bn48000,48895055,74669654,25774599,CN
chr12,Bn48001,90599204,95877869,5278665,CNL
chr12,Bn48002,52197570,80663403,28465833,NBS
chr12,Bn48003,91932845,93972997,2040152,CN
chr12,Bn48004,42992517,88024292,45031775,CN
chr12,Bn48005,57291928,68853967,11562039,NBS
chr12,Bn48006,89985169,97134897,7149728,RLK
chr12,Bn48007,37208993,62576519,25367526,TN
chr12,Bn48008,42955590,49466449,6510859,RLP
chr12,Bn48009,71866240,73921016,2054776,CNL
chr12,Bn48010,69128880,84499398,15370518,CNL
chr12,Bn48011,31229659,81752048,50522389,CN
chr12,Bn48012,58942241,90231252,31289011,RLP
chr12,Bn48013,68694757,96190486,27495729,RLP
chr12,Bn48014,55646844,74968517,19321673,TNL
chr12,Bn48015,14897620,36831050,21933430,NBS
chr12,Bn48016,65934574,81307274,15372700,CN
chr12,Bn48017,98361914,99757002,1395088,RLP
chr12,Bn48018,35434456,60964283,25529827,RLP
chr12,Bn48019,58620799,94557216,35936417,CN
chr12,Bn48020,92246318,93855019,1608701,RLK
chr12,Bn48021,70842952,91055033,20212081,CN
chr12,Bn48022,65548400,69706558,4158158,RLK
chr12,Bn48023,14813583,79263548,64449965,CN
chr12,Bn48024,77462494,94777875,17315381,RLK
chr12,Bn48025,86632614,88708691,2076077,CN
chr12,Bn48026,81402284,88420568,7018284,TNL
chr12,Bn48027,77684173,94536905,16852732,NBS
chr12,Bn48028,29779015,62710110,32931095,RLK
chr12,Bn48029,24710949,72393802,47682853,NBS
chr12,Bn48030,28245622,71719467,43473845,NBS
chr12,Bn48031,33186401,41145188,7958787,NBS
chr12,Bn48032,76711445,78311792,1600347,TNL
chr12,Bn48033,42166855,97781003,55614148,TN
chr12,Bn48034,46693197,49973078,3279881,CN
chr12,Bn48035,41026908,63722560,22695652,RLP
chr12,Bn48036,15109157,70426097,55316940,RLK
chr12,Bn48037,94128654,99969646,5840992,RLK
chr12,Bn48038,73898852,98382765,24483913,CNL
chr12,Bn48039,39490989,55917530,16426541,NBS
chr12,Bn48040,22219356,27857101,5637745,NBS
chr12,Bn48041,91722723,96908374,5185651,NBS
chr12,Bn48042,84138047,91233523,7095476,NBS
chr12,Bn48043,55202932,79108411,23905479,RLP
chr12,Bn48044,15734254,50920256,35186002,CNL
chr12,Bn48045,45517985,78912763,33394778,TN
chr12,Bn48046,53782045,57987229,4205184,CNL
chr12,Bn48047,66160418,90333951,24173533,RLK
chr12,Bn48048,89211729,98640260,9428531,CNL
chr12,Bn48049,72847156,95369314,22522158,CNL
chr12,Bn48050,21553631,23356012,1802381,TN
chr12,Bn48051,37068595,43940178,6871583,RLK
chr12,Bn48052,80619952,84716551,4096599,RLP
chr12,Bn48053,39059185,57330229,18271044,CN
chr12,Bn48054,75584093,83077831,7493738,CNL
chr12,Bn48055,68634892,79786159,11151267,RLK
chr12,Bn48056,13750148,41265281,27515133,NBS
chr12,Bn48057,19162451,40656327,21493876,RLP
chr12,Bn48058,46396336,64175471,17779135,CN
chr12,Bn48059,86271404,98642761,12371357,TN
chr12,Bn48060,37766857,38198356,431499,NBS
chr12,Bn48061,68734744,85264980,16530236,CN
chr12,Bn48062,18652191,37787224,19135033,RLK
chr12,Bn48063,62259389,68578866,6319477,RLK
chr12,Bn48064,50575356,79182888,28607532,CN
chr12,Bn48065,27771440,96515589,68744149,NBS
chr12,Bn48066,55398338,77472394,22074056,RLP
chr12,Bn48067,4745465,14834643,10089178,CN
chr12,Bn48068,97574361,99940406,2366045,CN
chr12,Bn48069,36229583,82344624,46115041,NBS
chr12,Bn48070,76324613,85119045,8794432,RLP
chr12,Bn48071,66892275,98010005,31117730,RLP
chr12,Bn48072,28297465,69147920,40850455,CN
chr12,Bn48073,6258664,86734911,80476247,RLP
chr12,Bn48074,15340821,36786140,21445319,CN
chr12,Bn48075,79080303,95542293,16461990,CN
chr12,Bn48076,18132597,76090134,57957537,NBS
chr12,Bn48077,64454913,82083947,17629034,NBS
chr12,Bn48078,79240389,88757991,9517602,RLK
chr12,Bn48079,9556629,96383389,86826760,RLP
chr12,Bn48080,90146124,93554830,3408706,RLK
chr12,Bn48081,64443719,66823581,2379862,TN
chr12,Bn48082,38179872,90698523,52518651,CNL
chr12,Bn48083,96694471,99571502,2877031,CN
chr12,Bn48084,50455271,62152706,11697435,RLP
chr12,Bn48085,69540882,96323648,26782766,CNL
chr12,Bn48086,66494755,84128543,17633788,CNL
chr12,Bn48087,40839560,75903626,35064066,CNL
chr12,Bn48088,3075078,31322953,28247875,CNL
chr12,Bn48089,73344471,97276622,23932151,TNL
chr12,Bn48090,32754722,52297852,19543130,CN
chr12,Bn48091,40663242,94733303,54070061,NBS
chr12,Bn48092,69044843,69237303,192460,NBS
chr12,Bn48093,93958461,99759190,5800729,CN
chr12,Bn48094,70683425,78901427,8218002,CNL
chr12,Bn48095,62339319,88080579,25741260,RLK
chr12,Bn48096,49284880,79365737,30080857,RLP
chr12,Bn48097,41125252,85879337,44754085,RLK
chr12,Bn48098,53019302,93827838,40808536,TNL
chr12,Bn48099,96068769,96575858,507089,NBS
chr12,Bn48100,46847844,90929200,44081356,NBS
chr12,Bn48101,51659941,92032763,40372822,RLK
chr12,Bn48102,84114514,87658457,3543943,TN
chr12,Bn48103,71155849,87492475,16336626,RLP
chr12,Bn48104,35476172,93017377,57541205,RLP
chr12,Bn48105,83790782,87969833,4179051,RLK
chr12,Bn48106,22332627,83782344,61449717,RLP
chr12,Bn48107,94110714,99866455,5755741,TN
chr12,Bn48108,91558303,94531938,2973635,CN
chr12,Bn48109,71198654,76846572,5647918,NBS
chr12,Bn48110,38793053,79757258,40964205,CN
chr12,Bn48111,37787309,47830787,10043478,NBS
chr12,Bn48112,19088804,67417236,48328432,TN
chr12,Bn48113,34890729,42091626,7200897,RLP
chr12,Bn48114,92402148,98250192,5848044,CN
chr12,Bn48115,27557169,69844359,42287190,CNL
chr12,Bn48116,46299267,70865322,24566055,CN
chr12,Bn48117,23245501,69741583,46496082,NBS
chr12,Bn48118,53311922,87620042,34308120,TNL
chr12,Bn48119,65964897,71020535,5055638,CNL
chr12,Bn48120,61991004,80180816,18189812,RLP
chr12,Bn48121,18392030,84988027,66595997,TN
chr12,Bn48122,2300954,46300929,43999975,RLP
chr12,Bn48123,42734756,73079510,30344754,CN
chr12,Bn48124,81622209,87572225,5950016,TNL
chr12,Bn48125,72976083,73507441,531358,CNL
chr12,Bn48126,72163813,81256140,9092327,CN
chr12,Bn48127,66048928,66458644,409716,TNL
chr12,Bn48128,94638701,96356005,1717304,CNL
chr12,Bn48129,14096654,99723425,85626771,CN
chr12,Bn48130,7825682,68620192,60794510,TNL
chr12,Bn48131,72319311,88910409,16591098,RLP
chr12,Bn48132,70594121,80053239,9459118,NBS
chr12,Bn48133,82465170,84935742,2470572,RLP
chr12,Bn48134,19475678,53189232,33713554,TN
chr12,Bn48135,4047593,41086570,37038977,RLP
chr12,Bn48136,9759213,93815209,84055996,CN
chr12,Bn48137,22721885,25299588,2577703,NBS
chr12,Bn48138,7601233,13539152,5937919,NBS
chr12,Bn48139,51902438,82126171,30223733,TNL
chr12,Bn48140,4660970,93858628,89197658,TNL
chr12,Bn48141,85082139,98093436,13011297,TN
chr12,Bn48142,79676294,95076407,15400113,TNL
chr12,Bn48143,64280608,93678400,29397792,CNL
chr12,Bn48144,92424254,97516459,5092205,TN
chr12,Bn48145,72065248,94007085,21941837,CN
chr12,Bn48146,61383802,96098348,34714546,TN
chr12,Bn48147,83514604,86369398,2854794,NBS
chr12,Bn48148,55122513,78242333,23119820,RLP
chr12,Bn48149,25934264,42292991,16358727,TNL
chr12,Bn48150,87997308,90694844,2697536,TNL
chr12,Bn48151,95185348,96924637,1739289,CN
chr12,Bn48152,46377728,74190719,27812991,CNL
chr12,Bn48153,19353234,54580165,35226931,RLP
chr12,Bn48154,77113609,81567157,4453548,TN
chr12,Bn48155,52945861,59081248,6135387,CN
chr12,Bn48156,4290472,87350433,83059961,TN
chr12,Bn48157,19428933,82018424,62589491,TNL
chr12,Bn48158,54562747,58949262,4386515,TNL
chr12,Bn48159,59235132,80825143,21590011,RLK
chr12,Bn48160,38558943,86326235,47767292,TN
chr12,Bn48161,11215880,76456983,65241103,RLK
chr12,Bn48162,95552150,99398041,3845891,RLK
chr12,Bn48163,1903425,77212204,75308779,RLP
chr12,Bn48164,94831316,96276251,1444935,TNL
chr12,Bn48165,28385487,29164611,779124,CN
chr12,Bn48166,4520760,43918318,39397558,CN
chr12,Bn48167,57762084,88291915,30529831,NBS
chr12,Bn48168,44272647,55486853,11214206,TN
chr12,Bn48169,83852911,97069253,13216342,CNL
chr12,Bn48170,79437691,95049130,15611439,NBS
chr12,Bn48171,7966705,65215639,57248934,TN
chr12,Bn48172,22993516,43012109,20018593,CN
chr12,Bn48173,51398435,97007509,45609074,CNL
chr12,Bn48174,75199720,92357971,17158251,CN
chr12,Bn48175,11960192,35946182,23985990,TNL
chr12,Bn48176,64244188,64974124,729936,TNL
chr12,Bn48177,76577306,79193512,2616206,NBS
chr12,Bn48178,89329210,91244012,1914802,RLP
chr12,Bn48179,47273528,90203489,42929961,CN
chr12,Bn48180,51854039,75034175,23180136,CN
chr12,Bn48181,65869957,68488497,2618540,NBS
chr12,Bn48182,82398100,85865359,3467259,RLK
chr12,Bn48183,56572447,76386816,19814369,TN
chr12,Bn48184,45594237,49458005,3863768,NBS
chr12,Bn48185,9486179,84428979,74942800,CN
chr12,Bn48186,78074431,79072083,997652,TNL
chr12,Bn48187,9926762,80118875,70192113,RLP
chr12,Bn48188,75572701,84984570,9411869,RLK
chr12,Bn48189,59593970,62155858,2561888,TNL
chr12,Bn48190,95256211,98081497,2825286,CNL
chr12,Bn48191,42944003,93589003,50645000,CNL
chr12,Bn48192,85482319,94398925,8916606,TNL
chr12,Bn48193,42125438,42382852,257414,RLK
chr12,Bn48194,4725988,8583041,3857053,NBS
chr12,Bn48195,6446794,38094754,31647960,CNL
chr12,Bn48196,95297432,99378794,4081362,NBS
chr12,Bn48197,47869491,69110116,21240625,TN
chr12,Bn48198,37491103,46536133,9045030,TNL
chr12,Bn48199,25488856,57682500,32193644,RLP
chr12,Bn48200,61598731,73017364,11418633,RLP
chr12,Bn48201,1488251,85972129,84483878,TN
chr12,Bn48202,21409659,89662961,68253302,CNL
chr12,Bn48203,27127571,92131014,65003443,CN
chr12,Bn48204,28221023,61424305,33203282,RLK
chr12,Bn48205,33196184,90588572,57392388,RLK
chr12,Bn48206,65189707,89114833,23925126,CNL
chr12,Bn48207,62396856,81348609,18951753,RLK
chr12,Bn48208,49188895,97773093,48584198,NBS
chr12,Bn48209,31101133,83523115,52421982,CN
chr12,Bn48210,64605205,86200398,21595193,RLK
chr12,Bn48211,88594282,93697478,5103196,CN
chr12,Bn48212,2869033,8653144,5784111,TNL
chr12,Bn48213,28178670,29840474,1661804,TNL
chr12,Bn48214,97510586,98819706,1309120,CN
chr12,Bn48215,84138759,89293291,5154532,RLK
chr12,Bn48216,47881086,75546577,27665491,CNL
chr12,Bn48217,79040639,89133708,10093069,CN
chr12,Bn48218,49989166,85193556,35204390,RLK
chr12,Bn48219,33323614,43576599,10252985,RLP
chr12,Bn48220,37063681,56378168,19314487,RLK
chr12,Bn48221,3535020,82450712,78915692,RLK
chr12,Bn48222,96095222,96294031,198809,CN
chr12,Bn48223,81136532,93258208,12121676,CN
chr12,Bn48224,7471647,33504624,26032977,RLK
chr12,Bn48225,6993578,16494465,9500887,RLP
chr12,Bn48226,23875619,41746001,17870382,NBS
chr12,Bn48227,10804197,18607794,7803597,TN
chr12,Bn48228,34883969,37342630,2458661,RLK
chr12,Bn48229,20668630,58997742,38329112,RLP
chr12,Bn48230,71841570,99783302,27941732,CNL
chr12,Bn48231,97997403,98864553,867150,RLK
chr12,Bn48232,20070903,82004215,61933312,NBS
chr12,Bn48233,6525326,60698116,54172790,RLP
chr12,Bn48234,97088799,97345135,256336,CNL
chr12,Bn48235,16015953,98046842,82030889,TNL
chr12,Bn48236,4019349,83569700,79550351,RLP
chr12,Bn48237,98446401,99643350,1196949,RLK
chr12,Bn48238,57683428,61965960,4282532,RLK
chr12,Bn48239,95039454,95976989,937535,TNL
chr12,Bn48240,33624081,87793665,54169584,RLP
chr12,Bn48241,2333498,87699736,85366238,NBS
chr12,Bn48242,98208594,98232423,23829,NBS
chr12,Bn48243,71312535,80827013,9514478,TN
chr12,Bn48244,69229406,93730740,24501334,RLP
chr12,Bn48245,15483979,96395767,80911788,CN
chr12,Bn48246,77545895,81974447,4428552,TNL
chr12,Bn48247,65810544,79271804,13461260,RLK
chr12,Bn48248,25522348,67983598,42461250,RLP
chr12,Bn48249,92971431,95510626,2539195,RLP
chr12,Bn48250,37387755,91315946,53928191,TNL
chr12,Bn48251,64368807,73830890,9462083,CNL
chr12,Bn48252,58144501,79433409,21288908,RLP
chr12,Bn48253,77668271,81482155,3813884,RLP
chr12,Bn48254,84215708,96876964,12661256,RLK
chr12,Bn48255,99046079,99608083,562004,NBS
chr12,Bn48256,56512674,81503250,24990576,TNL
chr12,Bn48257,56008396,98456572,42448176,TN
chr12,Bn48258,91814124,95722705,3908581,TNL
chr12,Bn48259,6040564,57835578,51795014,CNL
chr12,Bn48260,91098429,96058785,4960356,CN
chr12,Bn48261,23723380,40713658,16990278,NBS
chr12,Bn48262,20257425,37706246,17448821,TNL
chr12,Bn48263,1845092,68140276,66295184,NBS
chr12,Bn48264,96864578,97990118,1125540,TN
chr12,Bn48265,39955264,59659656,19704392,NBS
chr12,Bn48266,80211406,81879480,1668074,NBS
chr12,Bn48267,85794824,98859079,13064255,TN
chr12,Bn48268,99078087,99300466,222379,TNL
chr12,Bn48269,22335316,87146086,64810770,RLK
chr12,Bn48270,21078245,73299687,52221442,TNL
chr12,Bn48271,18346564,30967817,12621253,RLK
chr12,Bn48272,83434722,94058240,10623518,NBS
chr12,Bn48273,17012160,56537217,39525057,RLK
chr12,Bn48274,38135386,61463545,23328159,NBS
chr12,Bn48275,11417848,83106296,71688448,CNL
chr12,Bn48276,76627157,80473651,3846494,NBS
chr12,Bn48277,91427783,92668360,1240577,TN
chr12,Bn48278,65124902,75074797,9949895,NBS
chr12,Bn48279,26031746,71714576,45682830,RLP
chr12,Bn48280,20851817,38430465,17578648,CNL
chr12,Bn48281,93962257,98259014,4296757,TNL
chr12,Bn48282,94711474,98344830,3633356,RLK
chr12,Bn48283,82547638,91400092,8852454,CNL
chr12,Bn48284,64918974,83277658,18358684,TN
chr12,Bn48285,20543553,92558093,72014540,TNL
chr12,Bn48286,37939178,57113377,19174199,NBS
chr12,Bn48287,43247710,66666289,23418579,RLK
chr12,Bn48288,27515560,71967527,44451967,CNL
chr12,Bn48289,60829042,72332418,11503376,NBS
chr12,Bn48290,15607819,81614127,66006308,CNL
chr12,Bn48291,90940324,91034969,94645,TN
chr12,Bn48292,17154732,64288184,47133452,RLP
chr12,Bn48293,39411330,50241719,10830389,CNL
chr12,Bn48294,5686227,9919048,4232821,CN
chr12,Bn48295,86114846,87708150,1593304,TNL
chr12,Bn48296,16422937,24061292,7638355,RLP
chr12,Bn48297,97005666,99827230,2821564,TNL
chr12,Bn48298,13634855,39117339,25482484,TN
chr12,Bn48299,41989030,77378767,35389737,TNL
chr12,Bn48300,30201128,31688593,1487465,TN
chr12,Bn48301,60431656,84946841,24515185,RLK
chr12,Bn48302,49311382,92117072,42805690,TNL
chr12,Bn48303,20458308,88434075,67975767,CNL
chr12,Bn48304,94983300,96272500,1289200,TNL
chr12,Bn48305,89678493,90752658,1074165,CNL
chr12,Bn48306,30302035,53860252,23558217,CNL
chr12,Bn48307,97882013,99866350,1984337,RLP
chr12,Bn48308,43028110,64215410,21187300,NBS
chr12,Bn48309,80185741,97258380,17072639,TNL
chr12,Bn48310,85551522,86908495,1356973,RLP
chr12,Bn48311,54481965,79500596,25018631,RLK
chr12,Bn48312,98680452,99021118,340666,CN
chr12,Bn48313,4005624,89838347,85832723,RLK
chr12,Bn48314,20783702,96781699,75997997,RLK
chr12,Bn48315,29559138,81753661,52194523,TNL
chr12,Bn48316,91770867,99209901,7439034,TNL
chr12,Bn48317,57717439,57779797,62358,TNL
chr12,Bn48318,34859076,49478542,14619466,CN
chr12,Bn48319,40728865,62785016,22056151,TN
chr12,Bn48320,88577060,89498453,921393,RLK
chr12,Bn48321,94642621,96459939,1817318,TNL
chr12,Bn48322,53980539,86441986,32461447,CNL
chr12,Bn48323,70405549,92758880,22353331,TNL
chr12,Bn48324,9909656,34045969,24136313,RLK
chr12,Bn48325,83665439,91805207,8139768,TNL
chr12,Bn48326,71147392,86582746,15435354,TNL
chr12,Bn48327,34608790,89369483,54760693,TNL
chr12,Bn48328,6331466,87396842,81065376,TNL
chr12,Bn48329,72770934,89166117,16395183,CNL
chr12,Bn48330,12564567,56524766,43960199,NBS
chr12,Bn48331,14509917,29492543,14982626,CNL
chr12,Bn48332,26749787,88272871,61523084,RLK
chr12,Bn48333,17661234,31975312,14314078,CNL
chr12,Bn48334,68779758,88916881,20137123,TNL
chr12,Bn48335,23916388,55096666,31180278,TNL
chr12,Bn48336,32344822,95505530,63160708,RLP
chr12,Bn48337,99412846,99843091,430245,RLP
chr12,Bn48338,6187033,59082669,52895636,TNL
chr12,Bn48339,4135330,47584105,43448775,CNL
chr12,Bn48340,27726510,81920975,54194465,RLK
chr12,Bn48341,23440074,49283002,25842928,CNL
chr12,Bn48342,46362075,75064327,28702252,TNL
chr12,Bn48343,52605709,65637380,13031671,TNL
chr12,Bn48344,58680197,94083653,35403456,TN
chr12,Bn48345,25853967,95379498,69525531,RLK
chr12,Bn48346,11152294,35472446,24320152,RLP
chr12,Bn48347,5909177,80407597,74498420,TN
chr12,Bn48348,3044100,22852975,19808875,CNL
chr12,Bn48349,33818733,86878083,53059350,TN
chr12,Bn48350,90081962,99819415,9737453,RLK
chr12,Bn48351,50313914,80180219,29866305,TNL
chr12,Bn48352,71410817,91950338,20539521,NBS
chr12,Bn48353,28860357,35431625,6571268,TN
chr12,Bn48354,46340152,75608144,29267992,CNL
chr12,Bn48355,44095747,44465043,369296,CN
chr12,Bn48356,44232714,66372990,22140276,TN
chr12,Bn48357,32281550,93916707,61635157,RLK
chr12,Bn48358,12667774,76536554,63868780,NBS
chr12,Bn48359,8468053,17600658,9132605,CNL
chr12,Bn48360,87787016,93758602,5971586,RLK
chr12,Bn48361,84172580,88194154,4021574,CNL
chr12,Bn48362,51226531,70287204,19060673,CNL
chr12,Bn48363,30014147,56342607,26328460,NBS
chr12,Bn48364,87678375,93013413,5335038,TN
chr12,Bn48365,63429764,90563408,27133644,RLK
chr12,Bn48366,51702934,60332630,8629696,RLP
chr12,Bn48367,36798854,91998573,55199719,RLK
chr12,Bn48368,68332065,73461605,5129540,RLK
chr12,Bn48369,71740566,88273597,16533031,RLP
chr12,Bn48370,3025241,33620824,30595583,TN
chr12,Bn48371,69134319,80153796,11019477,NBS
chr12,Bn48372,21974067,80464583,58490516,TNL
chr12,Bn48373,21137969,71424799,50286830,RLP
chr12,Bn48374,18499823,50051851,31552028,RLK
chr12,Bn48375,95134331,97627400,2493069,CN
chr12,Bn48376,34960159,52520338,17560179,NBS
chr12,Bn48377,58373994,64586942,6212948,NBS
chr12,Bn48378,44082931,93892847,49809916,TNL
chr12,Bn48379,97271040,97354882,83842,NBS
chr12,Bn48380,3649940,42726665,39076725,RLP
chr12,Bn48381,41747492,54417524,12670032,NBS
chr12,Bn48382,77570920,79831083,2260163,TN
chr12,Bn48383,33862816,88734784,54871968,NBS
chr12,Bn48384,29510852,46678231,17167379,RLK
chr12,Bn48385,5997921,45514767,39516846,TNL
chr12,Bn48386,96983040,98453130,1470090,NBS
chr12,Bn48387,9867340,69863210,59995870,TN
chr12,Bn48388,5810215,21972837,16162622,CN
chr12,Bn48389,22313652,50760829,28447177,RLP
chr12,Bn48390,73572009,83788397,10216388,NBS
chr12,Bn48391,73813051,90875933,17062882,CN
chr12,Bn48392,75059416,98773094,23713678,RLK
chr12,Bn48393,4705423,41352647,36647224,TNL
chr12,Bn48394,81808219,90613327,8805108,CN
chr12,Bn48395,38182427,48744095,10561668,CNL
chr12,Bn48396,17186061,34999768,17813707,NBS
chr12,Bn48397,59104162,69109825,10005663,NBS
chr12,Bn48398,59273491,63233330,3959839,TNL
chr12,Bn48399,50557941,91343686,40785745,CNL
chr12,Bn48400,28535013,67955752,39420739,RLK
chr12,Bn48401,99928181,99994069,65888,CN
chr12,Bn48402,76235668,92327071,16091403,TN
chr12,Bn48403,57124384,85053453,27929069,NBS
chr12,Bn48404,73903365,98940194,25036829,RLK
chr12,Bn48405,65729911,81891054,16161143,RLP
chr12,Bn48406,76231243,94077624,17846381,TNL
chr12,Bn48407,55730923,62105498,6374575,CNL
chr12,Bn48408,3982729,46630943,42648214,RLK
chr12,Bn48409,46839262,88327279,41488017,RLP
chr12,Bn48410,41172383,66486688,25314305,RLP
chr12,Bn48411,3512647,59531453,56018806,RLK
chr12,Bn48412,58520904,81582806,23061902,TNL
chr12,Bn48413,77428107,80299069,2870962,NBS
chr12,Bn48414,12901745,53421343,40519598,RLP
chr12,Bn48415,93652839,94754528,1101689,CNL
chr12,Bn48416,21041645,69595318,48553673,RLK
chr12,Bn48417,75766845,84341296,8574451,CNL
chr12,Bn48418,12897432,98355998,85458566,NBS
chr12,Bn48419,17726093,93438336,75712243,RLK
chr12,Bn48420,88667321,97460415,8793094,NBS
chr12,Bn48421,42594514,66576990,23982476,RLP
chr12,Bn48422,18159134,70698226,52539092,CN
chr12,Bn48423,86360388,91485768,5125380,NBS
chr12,Bn48424,43754204,52590983,8836779,TNL
chr12,Bn48425,10633098,20933202,10300104,CN
chr12,Bn48426,22034517,98616533,76582016,RLP
chr12,Bn48427,8221642,25402810,17181168,CNL
chr12,Bn48428,13256850,98047678,84790828,NBS
chr12,Bn48429,62903620,90436050,27532430,CN
chr12,Bn48430,70306942,78537659,8230717,RLK
chr12,Bn48431,89539797,91670604,2130807,TNL
chr12,Bn48432,76617621,90564883,13947262,RLK
chr12,Bn48433,81801615,88101369,6299754,CN
chr12,Bn48434,44072338,58435848,14363510,RLK
chr12,Bn48435,38113543,82852600,44739057,RLP
chr12,Bn48436,51689750,57993916,6304166,CNL
chr12,Bn48437,30645569,57560400,26914831,RLP
chr12,Bn48438,28249419,80746637,52497218,TN
chr12,Bn48439,36946968,49561937,12614969,RLK
chr12,Bn48440,47083599,90048577,42964978,RLP
chr12,Bn48441,38150174,45328173,7177999,RLP
chr12,Bn48442,32589788,51480043,18890255,RLP
chr12,Bn48443,22748565,28431900,5683335,NBS
chr12,Bn48444,42632956,54469156,11836200,RLK
chr12,Bn48445,20169907,46556127,26386220,RLP
chr12,Bn48446,64547600,90660973,26113373,CNL
chr12,Bn48447,34454845,36906827,2451982,CN
chr12,Bn48448,42740738,81296453,38555715,TN
chr12,Bn48449,4517642,66848789,62331147,CN
chr12,Bn48450,34042073,59352555,25310482,RLK
chr12,Bn48451,92883998,99416795,6532797,TNL
chr12,Bn48452,78581422,82867372,4285950,RLP
chr12,Bn48453,48226994,88454497,40227503,RLK
chr12,Bn48454,1491695,36385163,34893468,CN
chr12,Bn48455,73384149,84297272,10913123,NBS
chr12,Bn48456,78582324,87347131,8764807,RLK
chr12,Bn48457,55440834,76558649,21117815,NBS
chr12,Bn48458,62172657,68994398,6821741,CNL
chr12,Bn48459,63664708,81500559,17835851,CNL
chr12,Bn48460,3341018,7988648,4647630,NBS
chr12,Bn48461,6580942,56793729,50212787,RLP
chr12,Bn48462,3290298,35311633,32021335,TNL
chr12,Bn48463,9056709,33586029,24529320,RLK
chr12,Bn48464,96915314,97049952,134638,CN
chr12,Bn48465,77503406,86387817,8884411,RLK
chr12,Bn48466,43481946,92604206,49122260,CNL
chr12,Bn48467,17834024,19946051,2112027,RLP
chr12,Bn48468,85720843,98044490,12323647,TNL
chr12,Bn48469,99029741,99830458,800717,TN
chr12,Bn48470,15944459,29373646,13429187,CNL
chr12,Bn48471,21261236,42029033,20767797,CN
chr12,Bn48472,60133429,97247220,37113791,CN
chr12,Bn48473,11478296,50745564,39267268,CNL
chr12,Bn48474,64400836,79431474,15030638,RLK
chr12,Bn48475,46858385,51805754,4947369,RLK
chr12,Bn48476,59409767,73720333,14310566,CN
chr12,Bn48477,76256887,96247803,19990916,RLK
chr12,Bn48478,36324293,36429370,105077,CN
chr12,Bn48479,75351717,88809413,13457696,RLK
chr12,Bn48480,42336372,96251254,53914882,TN
chr12,Bn48481,30651730,57032380,26380650,TN
chr12,Bn48482,92350214,94168777,1818563,TNL
chr12,Bn48483,9201092,26963703,17762611,CNL
chr12,Bn48484,93762891,97794685,4031794,RLK
chr12,Bn48485,6338099,47475452,41137353,RLK
chr12,Bn48486,22037023,85730730,63693707,TN
chr12,Bn48487,52204492,86717340,34512848,NBS
chr12,Bn48488,44314254,84718514,40404260,TNL
chr12,Bn48489,10014980,95288702,85273722,NBS
chr12,Bn48490,58677063,77432659,18755596,NBS
chr12,Bn48491,70358570,97574617,27216047,NBS
chr12,Bn48492,24581547,37670536,13088989,CNL
chr12,Bn48493,69907048,77949791,8042743,NBS
chr12,Bn48494,68609393,80830706,12221313,RLK
chr12,Bn48495,56144602,86660312,30515710,NBS
chr12,Bn48496,35979114,37142251,1163137,CN
chr12,Bn48497,20900762,78845777,57945015,TNL
chr12,Bn48498,77188044,85895588,8707544,TN
chr12,Bn48499,73385547,82067090,8681543,CNL
chr12,Bn48500,91667513,96828929,5161416,NBS
chr12,Bn48501,47890100,66443418,18553318,RLK
chr12,Bn48502,43617727,75972493,32354766,CN
chr12,Bn48503,71108465,73148951,2040486,TNL
chr12,Bn48504,41282579,70140526,28857947,TN
chr12,Bn48505,33799423,98624846,64825423,RLK
chr12,Bn48506,69612086,94487964,24875878,RLP
chr12,Bn48507,10848774,92369440,81520666,RLK
chr12,Bn48508,21616710,33904132,12287422,CNL
chr12,Bn48509,49780971,63898044,14117073,RLK
chr12,Bn48510,21896059,76037063,54141004,RLP
chr12,Bn48511,24023322,36072282,12048960,RLK
chr12,Bn48512,11490904,45624291,34133387,NBS
chr12,Bn48513,64349457,76908054,12558597,CNL
chr12,Bn48514,46178925,70403877,24224952,RLP
chr12,Bn48515,14162109,18987230,4825121,CN
chr12,Bn48516,75537430,76255333,717903,TN
chr12,Bn48517,75553441,79302469,3749028,CN
chr12,Bn48518,32148647,87408402,55259755,NBS
chr12,Bn48519,72349677,98194075,25844398,NBS
chr12,Bn48520,51007682,59838438,8830756,TNL
chr12,Bn48521,92439266,94010101,1570835,TNL
chr12,Bn48522,70619683,93637693,23018010,RLP
chr12,Bn48523,65401305,78391102,12989797,TNL
chr12,Bn48524,60422657,67563035,7140378,CNL
chr12,Bn48525,96092652,98661717,2569065,RLP
chr12,Bn48526,2494921,69591171,67096250,RLK
chr12,Bn48527,4559106,51043252,46484146,RLP
chr12,Bn48528,41888221,73724444,31836223,CN
chr12,Bn48529,7578622,76030605,68451983,RLP
chr12,Bn48530,7873048,53334165,45461117,CNL
chr12,Bn48531,88498641,92938829,4440188,NBS
chr12,Bn48532,26042780,32303602,6260822,TNL
chr12,Bn48533,77859000,86311885,8452885,NBS
chr12,Bn48534,1629705,21138110,19508405,TN
chr12,Bn48535,9099374,71909338,62809964,TN
chr12,Bn48536,89332217,95567109,6234892,TNL
chr12,Bn48537,39630987,75224736,35593749,TN
chr12,Bn48538,7770914,35051614,27280700,RLP
chr12,Bn48539,56808991,68026212,11217221,TN
chr12,Bn48540,97267451,99116613,1849162,NBS
chr12,Bn48541,28061582,37763474,9701892,TN
chr12,Bn48542,46978223,51899312,4921089,TN
chr12,Bn48543,35467346,86539588,51072242,TNL
chr12,Bn48544,87605183,91069851,3464668,CNL
chr12,Bn48545,40483627,96043905,55560278,CN
chr12,Bn48546,16154358,97701568,81547210,RLK
chr12,Bn48547,83150982,90483613,7332631,RLK
chr12,Bn48548,61605327,79239420,17634093,NBS
chr12,Bn48549,10697840,74245212,63547372,CN
chr12,Bn48550,28414245,53603546,25189301,TN
chr12,Bn48551,76081206,91797135,15715929,RLP
chr12,Bn48552,67245685,96791360,29545675,CN
chr12,Bn48553,78478971,99617750,21138779,TNL
chr12,Bn48554,8698843,34057834,25358991,RLP
chr12,Bn48555,72605353,79848291,7242938,RLK
chr12,Bn48556,79124497,79500757,376260,TN
chr12,Bn48557,23620794,66647907,43027113,NBS
chr12,Bn48558,78581412,99878891,21297479,CNL
chr12,Bn48559,82109488,93393399,11283911,RLK
chr12,Bn48560,64220488,74593622,10373134,CNL
chr12,Bn48561,43690098,98459676,54769578,TN
chr12,Bn48562,29067028,29239525,172497,NBS
chr12,Bn48563,12172283,28191603,16019320,TN
chr12,Bn48564,97187330,99170078,1982748,TN
chr12,Bn48565,32343741,83568487,51224746,CN
chr12,Bn48566,4831874,16908686,12076812,TN
chr12,Bn48567,51319100,87870489,36551389,TN
chr12,Bn48568,3906015,93003063,89097048,RLP
chr12,Bn48569,21483784,80478822,58995038,CNL
chr12,Bn48570,25229794,47845247,22615453,TN
chr12,Bn48571,15805935,78471471,62665536,NBS
chr12,Bn48572,71590859,94702306,23111447,CNL
chr12,Bn48573,55981423,89500026,33518603,TNL
chr12,Bn48574,97959945,98062055,102110,RLK
chr12,Bn48575,71299391,96150830,24851439,RLK
chr12,Bn48576,80759649,93248496,12488847,RLK
chr12,Bn48577,49261562,70069944,20808382,CNL
chr12,Bn48578,85624566,90682327,5057761,TNL
chr12,Bn48579,51248329,75168473,23920144,TN
chr12,Bn48580,67798573,77713248,9914675,RLK
chr12,Bn48581,15061000,48906678,33845678,CN
chr12,Bn48582,92886086,94742545,1856459,NBS
chr12,Bn48583,36453969,79897870,43443901,TNL
chr12,Bn48584,11568572,62035392,50466820,RLK
chr12,Bn48585,67216184,69737105,2520921,TN
chr12,Bn48586,59546459,61020405,1473946,NBS
chr12,Bn48587,78615352,95424875,16809523,TN
chr12,Bn48588,86523779,98174715,11650936,NBS
chr12,Bn48589,20910894,86033785,65122891,TN
chr12,Bn48590,80539136,84001591,3462455,NBS
chr12,Bn48591,93902323,97155043,3252720,NBS
chr12,Bn48592,39534340,67223739,27689399,CN
chr12,Bn48593,39656660,96756924,57100264,RLP
chr12,Bn48594,80450336,82848349,2398013,TNL
chr12,Bn48595,66020700,69152267,3131567,TN
chr12,Bn48596,4395190,15778160,11382970,CN
chr12,Bn48597,2503222,63622170,61118948,CN
chr12,Bn48598,99892515,99951019,58504,RLP
chr12,Bn48599,39264934,55743099,16478165,CNL
chr12,Bn48600,61819809,71025996,9206187,CN
chr12,Bn48601,70301977,83313283,13011306,TN
chr12,Bn48602,26883745,42319846,15436101,RLK
chr12,Bn48603,72055049,96517279,24462230,CN
chr12,Bn48604,47918532,92717111,44798579,TN
chr12,Bn48605,27085359,64221816,37136457,TNL
chr12,Bn48606,93464248,95521789,2057541,CN
chr12,Bn48607,96088501,96479233,390732,TNL
chr12,Bn48608,82931501,88890274,5958773,TN
chr12,Bn48609,13839759,18022977,4183218,NBS
chr12,Bn48610,52181270,85475553,33294283,CN
chr12,Bn48611,67955324,75055941,7100617,CN
chr12,Bn48612,93687875,95979143,2291268,CN
chr12,Bn48613,52901028,79149126,26248098,RLP
chr12,Bn48614,47576748,73156613,25579865,TNL
chr12,Bn48615,74728478,85218080,10489602,TN
chr12,Bn48616,51914673,84753986,32839313,CN
chr12,Bn48617,60936070,69337613,8401543,RLP
chr12,Bn48618,47670462,94997304,47326842,CN
chr12,Bn48619,3081640,24896346,21814706,TN
chr12,Bn48620,97699608,98514119,814511,RLK
chr12,Bn48621,37316698,40806004,3489306,CNL
chr12,Bn48622,11778736,31092905,19314169,CN
chr12,Bn48623,81432421,81968495,536074,CN
chr12,Bn48624,43291848,89075303,45783455,NBS
chr12,Bn48625,89533740,98555180,9021440,CN
chr12,Bn48626,83588398,88251253,4662855,CN
chr12,Bn48627,60447051,73604808,13157757,CNL
chr12,Bn48628,97377056,99591235,2214179,RLK
chr12,Bn48629,82326918,95011476,12684558,NBS
chr12,Bn48630,42523006,99106046,56583040,TN
chr12,Bn48631,19261553,61900757,42639204,NBS
chr12,Bn48632,60026579,62435696,2409117,TNL
chr12,Bn48633,1127130,62235888,61108758,RLK
chr12,Bn48634,11583698,29686713,18103015,CNL
chr12,Bn48635,2788969,63556116,60767147,NBS
chr12,Bn48636,30346050,43513119,13167069,NBS
chr12,Bn48637,35272904,97354184,62081280,TN
chr12,Bn48638,89974208,93996419,4022211,RLP
chr12,Bn48639,12009999,17261288,5251289,RLP
chr12,Bn48640,75091392,89731767,14640375,TNL
chr12,Bn48641,43594319,67607120,24012801,CN
chr12,Bn48642,15504531,60443585,44939054,RLP
chr12,Bn48643,68517464,77764157,9246693,RLP
chr12,Bn48644,82945835,97892742,14946907,TNL
chr12,Bn48645,34808197,72696461,37888264,RLK
chr12,Bn48646,78801502,98727294,19925792,TNL
chr12,Bn48647,5234770,22258260,17023490,TN
chr12,Bn48648,34821670,37386965,2565295,CNL
chr12,Bn48649,53530753,64885429,11354676,RLP
chr12,Bn48650,42873569,90719961,47846392,CNL
chr12,Bn48651,20843380,49106671,28263291,NBS
chr12,Bn48652,94264207,98875248,4611041,RLK
chr12,Bn48653,15767641,85427386,69659745,CNL
chr12,Bn48654,83317447,89830166,6512719,TN
chr12,Bn48655,83828773,91713283,7884510,NBS
chr12,Bn48656,11764244,57714953,45950709,NBS
chr12,Bn48657,79728801,93236103,13507302,TN
chr12,Bn48658,62998496,64747849,1749353,RLP
chr12,Bn48659,86162105,92248164,6086059,TN
chr12,Bn48660,61747918,72195663,10447745,RLK
chr12,Bn48661,19506049,33666123,14160074,CNL
chr12,Bn48662,27481056,64392121,36911065,CNL
chr12,Bn48663,43288786,55923702,12634916,NBS
chr12,Bn48664,11058725,71919217,60860492,NBS
chr12,Bn48665,31494447,92994553,61500106,RLP
chr12,Bn48666,72682559,73819491,1136932,RLP
chr12,Bn48667,93990168,95721289,1731121,RLP
chr12,Bn48668,70418577,97058598,26640021,RLP
chr12,Bn48669,68074672,91416327,23341655,TN
chr12,Bn48670,26836497,28034603,1198106,TNL
chr12,Bn48671,4211579,29429045,25217466,CN
chr12,Bn48672,61758165,64512426,2754261,RLP
chr12,Bn48673,29819646,89501481,59681835,CN
chr12,Bn48674,67392017,98884505,31492488,NBS
chr12,Bn48675,75308087,87423771,12115684,NBS
chr12,Bn48676,94221467,98023110,3801643,NBS
chr12,Bn48677,5293891,33528660,28234769,CN
chr12,Bn48678,87577166,87644104,66938,CN
chr12,Bn48679,28499650,61167270,32667620,NBS
chr12,Bn48680,10596243,44551845,33955602,CNL
chr12,Bn48681,49534579,69332776,19798197,CNL
chr12,Bn48682,45019429,48606735,3587306,NBS
chr12,Bn48683,72278772,75653239,3374467,RLK
chr12,Bn48684,40737881,83703374,42965493,CNL
chr12,Bn48685,14366916,17112016,2745100,TNL
chr12,Bn48686,2666657,79646873,76980216,NBS
chr12,Bn48687,85145322,95851414,10706092,NBS
chr12,Bn48688,85794512,97556470,11761958,CN
chr12,Bn48689,47898170,91944053,44045883,TNL
chr12,Bn48690,80647629,99700133,19052504,CNL
chr12,Bn48691,64680802,70674299,5993497,RLP
chr12,Bn48692,49344399,78339145,28994746,RLK
chr12,Bn48693,85290863,99556958,14266095,RLK
chr12,Bn48694,68386894,73706130,5319236,TN
chr12,Bn48695,90383879,94336401,3952522,TNL
chr12,Bn48696,11028232,34616792,23588560,CN
chr12,Bn48697,71341703,87510891,16169188,NBS
chr12,Bn48698,24817832,37096590,12278758,TN
chr12,Bn48699,38804209,57303974,18499765,TNL
chr12,Bn48700,27654116,63713610,36059494,TNL
chr12,Bn48701,31711242,82463000,50751758,NBS
chr12,Bn48702,96739985,98136261,1396276,CN
chr12,Bn48703,59045870,92691438,33645568,RLK
chr12,Bn48704,57203474,62797943,5594469,RLK
chr12,Bn48705,61310731,86007046,24696315,TN
chr12,Bn48706,21594973,81511139,59916166,RLK
chr12,Bn48707,61710304,91768681,30058377,CN
chr12,Bn48708,14789614,82343469,67553855,TN
chr12,Bn48709,69583178,96262086,26678908,TNL
chr12,Bn48710,93285008,94576220,1291212,RLK
chr12,Bn48711,44872866,73852516,28979650,RLK
chr12,Bn48712,45284793,69293921,24009128,CNL
chr12,Bn48713,42090211,44841829,2751618,CNL
chr12,Bn48714,65924767,80864581,14939814,TNL
chr12,Bn48715,40076867,63184442,23107575,CNL
chr12,Bn48716,13153424,46363392,33209968,RLK
chr12,Bn48717,73750435,83900851,10150416,CN
chr12,Bn48718,94722357,98623788,3901431,RLP
chr12,Bn48719,25324985,34887099,9562114,TNL
chr12,Bn48720,86922787,99154579,12231792,TN
chr12,Bn48721,52756606,83860961,31104355,CNL
chr12,Bn48722,36252440,55360642,19108202,TNL
chr12,Bn48723,75321548,94876044,19554496,RLP
chr12,Bn48724,13126415,30948113,17821698,CNL
chr12,Bn48725,80577490,91249056,10671566,TN
chr12,Bn48726,43107283,57294928,14187645,NBS
chr12,Bn48727,20456200,69958157,49501957,RLK
chr12,Bn48728,89382656,94952983,5570327,CN
chr12,Bn48729,62245343,86087479,23842136,RLP
chr12,Bn48730,52741803,72307727,19565924,CNL
chr12,Bn48731,3668513,91265939,87597426,TNL
chr12,Bn48732,7548405,64354892,56806487,NBS
chr12,Bn48733,82673725,96769393,14095668,RLP
chr12,Bn48734,68676396,96820299,28143903,RLK
chr12,Bn48735,32221719,95662823,63441104,TNL
chr12,Bn48736,2566147,40008779,37442632,CN
chr12,Bn48737,36720134,55689820,18969686,NBS
chr12,Bn48738,36163181,86242909,50079728,RLK
chr12,Bn48739,46036344,90907564,44871220,TN
chr12,Bn48740,35288695,87126690,51837995,RLK
chr12,Bn48741,98077662,99490277,1412615,TNL
chr12,Bn48742,13348208,29866436,16518228,CN
chr12,Bn48743,74127134,97544934,23417800,CNL
chr12,Bn48744,14467169,57557956,43090787,NBS
chr12,Bn48745,43495742,59283765,15788023,NBS
chr12,Bn48746,72971567,79651320,6679753,TN
chr12,Bn48747,15005876,73826578,58820702,CN
chr12,Bn48748,69684272,85027140,15342868,TNL
chr12,Bn48749,5348497,31737796,26389299,TN
chr12,Bn48750,43032926,87592274,44559348,CNL
chr12,Bn48751,93019144,95702697,2683553,NBS
chr12,Bn48752,28623843,41936858,13313015,RLK
chr12,Bn48753,59052127,70033015,10980888,CNL
chr12,Bn48754,4635681,40594470,35958789,NBS
chr12,Bn48755,19380989,77942431,58561442,RLK
chr12,Bn48756,56661339,61031299,4369960,RLK
chr12,Bn48757,44441858,91328633,46886775,NBS
chr12,Bn48758,11396763,65938194,54541431,NBS
chr12,Bn48759,80497461,85904612,5407151,CNL
chr12,Bn48760,15642400,70548802,54906402,CNL
chr12,Bn48761,21181274,60723952,39542678,CN
chr12,Bn48762,53932990,85180039,31247049,TNL
chr12,Bn48763,80629286,88460427,7831141,TN
chr12,Bn48764,61958129,82169044,20210915,CN
chr12,Bn48765,47968593,50496037,2527444,CN
chr12,Bn48766,97635178,98674713,1039535,RLK
chr12,Bn48767,85469161,99931661,14462500,TNL
chr12,Bn48768,34874064,95454083,60580019,TN
chr12,Bn48769,68465507,94854721,26389214,CN
chr12,Bn48770,82105199,95405924,13300725,CN
chr12,Bn48771,4164782,77288036,73123254,CN
chr12,Bn48772,29690482,49437682,19747200,CNL
chr12,Bn48773,19866209,93782243,73916034,NBS
chr12,Bn48774,69642190,83001243,13359053,TN
chr12,Bn48775,10537996,70859478,60321482,RLP
chr12,Bn48776,53966477,55368022,1401545,RLK
chr12,Bn48777,72006209,91880932,19874723,TN
chr12,Bn48778,57159067,72447768,15288701,RLP
chr12,Bn48779,2907177,74347538,71440361,TN
chr12,Bn48780,9802095,88001215,78199120,TN
chr12,Bn48781,59351529,75989137,16637608,CN
chr12,Bn48782,51219030,73784920,22565890,RLP
chr12,Bn48783,85349185,90239383,4890198,CNL
chr12,Bn48784,29486650,40093168,10606518,TNL
chr12,Bn48785,33014710,58289462,25274752,TNL
chr12,Bn48786,86700108,99515149,12815041,TN
chr12,Bn48787,93129363,98188992,5059629,TN
chr12,Bn48788,12517634,46311711,33794077,TN
chr12,Bn48789,2557394,3373443,816049,TNL
chr12,Bn48790,69667505,70723073,1055568,RLK
chr12,Bn48791,13937507,14046211,108704,TNL
chr12,Bn48792,12031462,16687122,4655660,TN
chr12,Bn48793,13801491,84953785,71152294,RLK
chr12,Bn48794,7791533,68442334,60650801,NBS
chr12,Bn48795,87416826,90793660,3376834,NBS
chr12,Bn48796,55564813,91396077,35831264,NBS
chr12,Bn48797,69464477,96426958,26962481,TNL
chr12,Bn48798,10219654,85512316,75292662,NBS
chr12,Bn48799,15414392,25179587,9765195,CNL
chr12,Bn48800,46434852,78713683,32278831,CN
chr12,Bn48801,88344547,91860362,3515815,RLK
chr12,Bn48802,47321947,52770585,5448638,NBS
chr12,Bn48803,46778586,92535921,45757335,CNL
chr12,Bn48804,67574755,80202799,12628044,CN
chr12,Bn48805,9845460,19372017,9526557,TNL
chr12,Bn48806,26023314,89314448,63291134,CN
chr12,Bn48807,63019480,67493827,4474347,CNL
chr12,Bn48808,91415632,96048316,4632684,TN
chr12,Bn48809,27247177,90488711,63241534,TN
chr12,Bn48810,33478474,52459699,18981225,NBS
chr12,Bn48811,90987960,96422989,5435029,TNL
chr12,Bn48812,46620322,98600316,51979994,CN
chr12,Bn48813,8166916,92525864,84358948,TN
chr12,Bn48814,52043537,94469515,42425978,CNL
chr12,Bn48815,14954819,27957921,13003102,TNL
chr12,Bn48816,28168366,41928297,13759931,RLK
chr12,Bn48817,58426354,61524253,3097899,TNL
chr12,Bn48818,32051844,88764795,56712951,NBS
chr12,Bn48819,82621413,86438608,3817195,NBS
chr12,Bn48820,81103162,94348071,13244909,NBS
chr12,Bn48821,92443524,97769892,5326368,RLP
chr12,Bn48822,59038966,70187644,11148678,NBS
chr12,Bn48823,35702198,62913303,27211105,RLK
chr12,Bn48824,21606801,86633908,65027107,CNL
chr12,Bn48825,70202553,83985441,13782888,CNL
chr12,Bn48826,64884616,94368690,29484074,RLK
chr12,Bn48827,11853526,97665806,85812280,NBS
chr12,Bn48828,50796281,79572243,28775962,RLK
chr12,Bn48829,59249206,76385278,17136072,TNL
chr12,Bn48830,53404703,80779889,27375186,RLK
chr12,Bn48831,77798682,89217355,11418673,NBS
chr12,Bn48832,93602321,99051135,5448814,RLP
chr12,Bn48833,87648206,94584548,6936342,TNL
chr12,Bn48834,99768665,99799805,31140,TNL
chr12,Bn48835,95287919,97038305,1750386,CNL
chr12,Bn48836,55787268,91089518,35302250,NBS
chr12,Bn48837,27764711,76380119,48615408,RLK
chr12,Bn48838,13180938,24655204,11474266,CNL
chr12,Bn48839,52036571,93605348,41568777,TN
chr12,Bn48840,30596929,92518975,61922046,CN
chr12,Bn48841,69106658,96478296,27371638,NBS
chr12,Bn48842,90000523,97310402,7309879,TNL
chr12,Bn48843,97695814,99081451,1385637,NBS
chr12,Bn48844,69872624,82276162,12403538,RLK
chr12,Bn48845,21604412,47973794,26369382,TN
chr12,Bn48846,83578747,84451025,872278,TN
chr12,Bn48847,62759170,73805002,11045832,RLK
chr12,Bn48848,31264531,33457366,2192835,CN
chr12,Bn48849,60138866,78661435,18522569,CNL
chr12,Bn48850,87338139,97524042,10185903,RLK
chr12,Bn48851,51286445,75966622,24680177,TNL
chr12,Bn48852,5306073,73919238,68613165,TNL
chr12,Bn48853,96992140,98331001,1338861,NBS
chr12,Bn48854,93116657,97967844,4851187,CN
chr12,Bn48855,41879733,89754649,47874916,NBS
chr12,Bn48856,46288768,52890330,6601562,NBS
chr12,Bn48857,94192096,94464728,272632,TNL
chr12,Bn48858,13791272,98927363,85136091,CNL
chr12,Bn48859,52512691,72523606,20010915,CNL
chr12,Bn48860,71398253,85560111,14161858,TN
chr12,Bn48861,98400868,98824249,423381,NBS
chr12,Bn48862,70120828,72865823,2744995,RLP
chr12,Bn48863,98954287,99557128,602841,RLP
chr12,Bn48864,83067928,88281418,5213490,CNL
chr12,Bn48865,98409132,98770045,360913,NBS
chr12,Bn48866,81987421,97131958,15144537,TN
chr12,Bn48867,85115503,91898845,6783342,CNL
chr12,Bn48868,37544735,45352398,7807663,CN
chr12,Bn48869,52489418,84294300,31804882,RLP
chr12,Bn48870,16274407,35950739,19676332,CN
chr12,Bn48871,73340650,93760400,20419750,CNL
chr12,Bn48872,81924235,82557133,632898,TN
chr12,Bn48873,99542989,99686544,143555,RLK
chr12,Bn48874,93400125,93616395,216270,RLP
chr12,Bn48875,1717483,47525657,45808174,TN
chr12,Bn48876,66806842,87799304,20992462,TN
chr12,Bn48877,92436343,94637791,2201448,CNL
chr12,Bn48878,29175820,90215481,61039661,NBS
chr12,Bn48879,99154740,99953674,798934,RLP
chr12,Bn48880,34074669,78424190,44349521,CNL
chr12,Bn48881,93205708,97020856,3815148,CN
chr12,Bn48882,80541049,80784894,243845,TNL
chr12,Bn48883,35976792,80879405,44902613,CNL
chr12,Bn48884,29463207,32200315,2737108,RLK
chr12,Bn48885,73066910,99122008,26055098,RLP
chr12,Bn48886,64504433,83327154,18822721,CNL
chr12,Bn48887,84503466,87323057,2819591,NBS
chr12,Bn48888,1677711,91960542,90282831,TN
chr12,Bn48889,14542367,60760267,46217900,TN
chr12,Bn48890,83788343,91073250,7284907,NBS
chr12,Bn48891,99066841,99160791,93950,TN
chr12,Bn48892,84868030,91335092,6467062,RLK
chr12,Bn48893,30858485,42295856,11437371,TNL
chr12,Bn48894,26895496,60061452,33165956,CNL
chr12,Bn48895,77062068,95650628,18588560,TNL
chr12,Bn48896,50830940,91179894,40348954,CNL
chr12,Bn48897,63279427,74909095,11629668,RLK
chr12,Bn48898,73116194,74854841,1738647,CNL
chr12,Bn48899,83058355,94485360,11427005,RLP
chr12,Bn48900,17453394,19455084,2001690,RLK
chr12,Bn48901,10568984,85548663,74979679,CNL
chr12,Bn48902,39613139,73988280,34375141,NBS
chr12,Bn48903,18030761,92686851,74656090,NBS
chr12,Bn48904,67308997,86386295,19077298,RLK
chr12,Bn48905,84743973,96639764,11895791,RLP
chr12,Bn48906,56363808,77553484,21189676,RLP
chr12,Bn48907,22843407,41617846,18774439,RLP
chr12,Bn48908,74047704,98753501,24705797,RLP
chr12,Bn48909,87955349,92328026,4372677,NBS
chr12,Bn48910,90287559,93012537,2724978,RLP
chr12,Bn48911,20828049,33236622,12408573,NBS
chr12,Bn48912,67741949,80462926,12720977,RLP
chr12,Bn48913,85951676,89654359,3702683,CN
chr12,Bn48914,56491195,99073021,42581826,RLK
chr12,Bn48915,83432989,90683789,7250800,TNL
chr12,Bn48916,39098419,86516108,47417689,CN
chr12,Bn48917,38697142,56287357,17590215,RLK
chr12,Bn48918,29784624,81638419,51853795,TNL
chr12,Bn48919,22495243,74444732,51949489,CN
chr12,Bn48920,15355435,48207997,32852562,NBS
chr12,Bn48921,96915312,98614581,1699269,NBS
chr12,Bn48922,78344451,92526153,14181702,RLK
chr12,Bn48923,74487236,74628319,141083,RLP
chr12,Bn48924,30509779,98367746,67857967,NBS
chr12,Bn48925,62965935,94579106,31613171,NBS
chr12,Bn48926,77766691,91430481,13663790,CNL
chr12,Bn48927,54946610,73819346,18872736,NBS
chr12,Bn48928,35147069,95499247,60352178,NBS
chr12,Bn48929,89714852,93223198,3508346,CNL
chr12,Bn48930,46398774,50341744,3942970,RLK
chr12,Bn48931,11441481,24752348,13310867,CN
chr12,Bn48932,43373675,63538630,20164955,CN
chr12,Bn48933,9071246,71147828,62076582,CN
chr12,Bn48934,53343402,65226632,11883230,TN
chr12,Bn48935,19665705,40465788,20800083,TNL
chr12,Bn48936,30041672,49658018,19616346,TNL
chr12,Bn48937,55508390,73677878,18169488,TN
chr12,Bn48938,10678435,36801605,26123170,TN
chr12,Bn48939,20926416,53822336,32895920,NBS
chr12,Bn48940,76375804,87774233,11398429,CN
chr12,Bn48941,98991085,99154467,163382,RLP
chr12,Bn48942,28306507,93179983,64873476,RLK
chr12,Bn48943,25348039,35733584,10385545,RLP
chr12,Bn48944,19246356,27886816,8640460,TNL
chr12,Bn48945,1912127,86227820,84315693,TNL
chr12,Bn48946,87193729,99648441,12454712,CNL
chr12,Bn48947,97663859,98916985,1253126,RLK
chr12,Bn48948,72957010,74221716,1264706,CN
chr12,Bn48949,27832780,51140164,23307384,TN
chr12,Bn48950,22217046,38568361,16351315,CNL
chr12,Bn48951,22156966,98150033,75993067,RLP
chr12,Bn48952,84571115,85419348,848233,TNL
chr12,Bn48953,32625617,77055402,44429785,CN
chr12,Bn48954,51387850,67917528,16529678,TN
chr12,Bn48955,94583631,97467382,2883751,NBS
chr12,Bn48956,67779043,80763823,12984780,RLP
chr12,Bn48957,44020205,58544039,14523834,RLK
chr12,Bn48958,29341800,60068499,30726699,CNL
chr12,Bn48959,54687474,78775716,24088242,CN
chr12,Bn48960,26180554,89939724,63759170,CN
chr12,Bn48961,99624744,99912352,287608,CNL
chr12,Bn48962,52342520,82104056,29761536,NBS
chr12,Bn48963,36298344,46498480,10200136,TNL
chr12,Bn48964,99029859,99031685,1826,TNL
chr12,Bn48965,71269799,94377100,23107301,TNL
chr12,Bn48966,75871503,84762845,8891342,CN
chr12,Bn48967,95407715,98828862,3421147,CN
chr12,Bn48968,76566971,95175950,18608979,TNL
chr12,Bn48969,76273446,84036867,7763421,RLP
chr12,Bn48970,33040152,57012395,23972243,RLP
chr12,Bn48971,54718527,80941093,26222566,RLP
chr12,Bn48972,89657104,89715608,58504,NBS
chr12,Bn48973,22254666,70020147,47765481,CN
chr12,Bn48974,84061135,94199548,10138413,RLK
chr12,Bn48975,84884633,88612506,3727873,RLP
chr12,Bn48976,84806767,97183645,12376878,TNL
chr12,Bn48977,37646200,78517547,40871347,RLP
chr12,Bn48978,43625422,55429428,11804006,TNL
chr12,Bn48979,37589493,70697274,33107781,NBS
chr12,Bn48980,48302358,82580299,34277941,RLK
chr12,Bn48981,54013446,67176070,13162624,RLK
chr12,Bn48982,24235923,90271783,66035860,CNL
chr12,Bn48983,58619998,77681563,19061565,TN
chr12,Bn48984,60244461,63632417,3387956,CN
chr12,Bn48985,20193454,51698807,31505353,RLP
chr12,Bn48986,51863779,64181907,12318128,NBS
chr12,Bn48987,2314358,19457711,17143353,TN
chr12,Bn48988,62282209,89394876,27112667,CN
chr12,Bn48989,17939876,38407120,20467244,NBS
chr12,Bn48990,49841389,73277698,23436309,TN
chr12,Bn48991,34487979,59736102,25248123,CN
chr12,Bn48992,20143237,74119428,53976191,TNL
chr12,Bn48993,97332413,97489219,156806,CN
chr12,Bn48994,3180046,92835954,89655908,CNL
chr12,Bn48995,92467132,98095818,5628686,CNL
chr12,Bn48996,82467253,84278920,1811667,TNL
chr12,Bn48997,87049706,93118276,6068570,TNL
chr12,Bn48998,62301524,65114640,2813116,RLK
chr12,Bn48999,97232653,98360423,1127770,TN
chr12,Bn49000,92826394,93017586,191192,TNL
chr12,Bn49001,64908462,69074583,4166121,RLP
chr12,Bn49002,66768172,94191673,27423501,TNL
chr12,Bn49003,93318093,95994434,2676341,TN
chr12,Bn49004,54183338,97918958,43735620,RLP
chr12,Bn49005,74007525,91421366,17413841,NBS
chr12,Bn49006,45867186,90068250,44201064,RLP
chr12,Bn49007,31578297,64621012,33042715,RLP
chr12,Bn49008,32575766,68557764,35981998,NBS
chr12,Bn49009,4743469,8596973,3853504,TN
chr12,Bn49010,90573276,92281858,1708582,TNL
chr12,Bn49011,51450638,60873936,9423298,CN
chr12,Bn49012,59112842,73693315,14580473,TNL
chr12,Bn49013,28644402,65120181,36475779,CNL
chr12,Bn49014,52096399,81872467,29776068,CN
chr12,Bn49015,10814737,58575852,47761115,RLK
chr12,Bn49016,31978528,65048583,33070055,TNL
chr12,Bn49017,90547829,95440976,4893147,CN
chr12,Bn49018,1835041,85500305,83665264,TN
chr12,Bn49019,49235830,81100207,31864377,CNL
chr12,Bn49020,11780118,85210821,73430703,NBS
chr12,Bn49021,2032346,58141844,56109498,RLK
chr12,Bn49022,98688339,99035395,347056,CN
chr12,Bn49023,82281611,98362882,16081271,RLK
chr12,Bn49024,39745994,53427540,13681546,CN
chr12,Bn49025,8037933,55473642,47435709,CNL
chr12,Bn49026,24093757,81253619,57159862,NBS
chr12,Bn49027,13305826,20716905,7411079,TNL
chr12,Bn49028,57640072,98718219,41078147,TNL
chr12,Bn49029,34887728,91641812,56754084,CN
chr12,Bn49030,91114672,97984101,6869429,NBS
chr12,Bn49031,29445250,93690482,64245232,CN
chr12,Bn49032,40542788,76864248,36321460,NBS
chr12,Bn49033,43471491,52963821,9492330,RLP
chr12,Bn49034,12041444,91468358,79426914,CN
chr12,Bn49035,59885653,98442919,38557266,TN
chr12,Bn49036,41341586,70011031,28669445,CN
chr12,Bn49037,75598608,77444429,1845821,RLP
chr12,Bn49038,36484372,75757175,39272803,CNL
chr12,Bn49039,57831497,80647381,22815884,TN
chr12,Bn49040,65358374,71754129,6395755,RLP
chr12,Bn49041,37091591,67174034,30082443,CN
chr12,Bn49042,96843098,99629013,2785915,CN
chr12,Bn49043,25841314,87413799,61572485,CN
chr12,Bn49044,67743446,94256314,26512868,RLK
chr12,Bn49045,3402355,16382867,12980512,CNL
chr12,Bn49046,86745222,89958719,3213497,TN
chr12,Bn49047,1391350,7770380,6379030,NBS
chr12,Bn49048,32556227,88036035,55479808,CNL
chr12,Bn49049,89998535,93418670,3420135,RLK
chr12,Bn49050,94931606,98409556,3477950,CNL
chr12,Bn49051,14503791,50305405,35801614,RLK
chr12,Bn49052,86737562,89621178,2883616,RLP
chr12,Bn49053,47636757,76437369,28800612,TN
chr12,Bn49054,54165605,87176801,33011196,RLP
chr12,Bn49055,87091425,97095198,10003773,NBS
chr12,Bn49056,14156513,59341224,45184711,RLP
chr12,Bn49057,28389449,89645231,61255782,CN
chr12,Bn49058,81241926,88178188,6936262,RLK
chr12,Bn49059,23923019,49367375,25444356,NBS
chr12,Bn49060,83252847,89806048,6553201,TN
chr12,Bn49061,39541507,76179132,36637625,CNL
chr12,Bn49062,45646569,88270191,42623622,CN
chr12,Bn49063,40731148,42961066,2229918,RLK
chr12,Bn49064,35297644,80588687,45291043,TN
chr12,Bn49065,32091430,62480713,30389283,RLP
chr12,Bn49066,64975294,78303325,13328031,TN
chr12,Bn49067,44087550,70912115,26824565,TNL
chr12,Bn49068,9493061,77115815,67622754,TNL
chr12,Bn49069,27166357,57562146,30395789,NBS
chr12,Bn49070,99421918,99990183,568265,RLP
chr12,Bn49071,16518949,84472293,67953344,CN
chr12,Bn49072,9617693,31439551,21821858,CNL
chr12,Bn49073,45016455,73190363,28173908,TN
chr12,Bn49074,68164222,94983637,26819415,NBS
chr12,Bn49075,88132319,95808070,7675751,TN
chr12,Bn49076,23131845,35055685,11923840,CN
chr12,Bn49077,26273278,64533416,38260138,RLP
chr12,Bn49078,74860610,92716009,17855399,NBS
chr12,Bn49079,17305552,75095671,57790119,RLP
chr12,Bn49080,54066923,91236437,37169514,TN
chr12,Bn49081,38544341,64155826,25611485,RLP
chr12,Bn49082,42829679,66073399,23243720,TNL
chr12,Bn49083,22012473,87369911,65357438,CN
chr12,Bn49084,87616287,94802375,7186088,CNL
chr12,Bn49085,70963504,83122740,12159236,TNL
chr12,Bn49086,63628427,67230084,3601657,RLK
chr12,Bn49087,60527497,69659992,9132495,TN
chr12,Bn49088,88428480,94409495,5981015,RLK
chr12,Bn49089,49011025,96466865,47455840,NBS
chr12,Bn49090,32165235,97146016,64980781,TNL
chr12,Bn49091,59073069,99373566,40300497,TN
chr12,Bn49092,16765027,17547727,782700,TN
chr12,Bn49093,53060267,67091143,14030876,TNL
chr12,Bn49094,91024357,97855329,6830972,CN
chr12,Bn49095,94524854,97903394,3378540,TNL
chr12,Bn49096,39309499,85769399,46459900,TNL
chr12,Bn49097,48357004,65703122,17346118,NBS
chr12,Bn49098,6723812,25291465,18567653,RLK
chr12,Bn49099,93630040,98621789,4991749,NBS
chr12,Bn49100,83350789,90309158,6958369,TNL
chr12,Bn49101,1228484,3630264,2401780,TN
chr12,Bn49102,56105409,96075266,39969857,TNL
chr12,Bn49103,48830335,98656636,49826301,TNL
chr12,Bn49104,93417032,97421770,4004738,NBS
chr12,Bn49105,55130621,88866433,33735812,CNL
chr12,Bn49106,41987879,63707129,21719250,CNL
chr12,Bn49107,55592855,59095790,3502935,RLK
chr12,Bn49108,60661556,88303765,27642209,RLK
chr12,Bn49109,63468769,68030236,4561467,RLP
chr12,Bn49110,54248439,87288284,33039845,TNL
chr12,Bn49111,6647448,22046393,15398945,CNL
chr12,Bn49112,39405662,99104733,59699071,NBS
chr12,Bn49113,88396491,90453393,2056902,NBS
chr12,Bn49114,65083994,76538949,11454955,RLK
chr12,Bn49115,9906224,68367408,58461184,TNL
chr12,Bn49116,72039642,83837140,11797498,TNL
chr12,Bn49117,72781681,85617231,12835550,TN
chr12,Bn49118,43654078,71667971,28013893,RLP
chr12,Bn49119,65480190,84057749,18577559,RLK
chr12,Bn49120,25142059,90940119,65798060,RLK
chr12,Bn49121,9700560,40690331,30989771,CNL
chr12,Bn49122,27492278,81083538,53591260,TN
chr12,Bn49123,26306972,46632193,20325221,RLK
chr12,Bn49124,30034152,64999701,34965549,CN
chr12,Bn49125,85610688,90580861,4970173,TNL
chr12,Bn49126,84384638,87332550,2947912,RLK
chr12,Bn49127,66540034,78246039,11706005,CN
chr12,Bn49128,77634121,85892083,8257962,CN
chr12,Bn49129,56812536,98148237,41335701,TN
chr12,Bn49130,73271111,98741947,25470836,RLK
chr12,Bn49131,62223386,66213176,3989790,RLP
chr12,Bn49132,72745623,78311393,5565770,NBS
chr12,Bn49133,12611840,30387484,17775644,NBS
chr12,Bn49134,12674301,47015695,34341394,CN
chr12,Bn49135,8727151,26635683,17908532,TN
chr12,Bn49136,94343791,95037584,693793,RLP
chr12,Bn49137,6283636,15216410,8932774,CNL
chr12,Bn49138,59162801,59982603,819802,RLP
chr12,Bn49139,37751642,88762947,51011305,NBS
chr12,Bn49140,68035592,74322856,6287264,CNL
chr12,Bn49141,73922308,79890021,5967713,RLP
chr12,Bn49142,51216919,69364386,18147467,RLK
chr12,Bn49143,17528891,72953536,55424645,RLP
chr12,Bn49144,3858165,67223660,63365495,NBS
chr12,Bn49145,49626881,51590853,1963972,TNL
chr12,Bn49146,35245651,48308302,13062651,RLP
chr12,Bn49147,51527692,57324503,5796811,RLP
chr12,Bn49148,28123805,31852328,3728523,RLK
chr12,Bn49149,25424439,51643186,26218747,RLP
chr12,Bn49150,99198530,99417556,219026,RLK
chr12,Bn49151,56332938,66568859,10235921,TNL
chr12,Bn49152,20664817,74896837,54232020,RLP
chr12,Bn49153,15612996,31324083,15711087,TNL
chr12,Bn49154,49910816,70739388,20828572,TN
chr12,Bn49155,59204391,78794538,19590147,CNL
chr12,Bn49156,3285184,71951084,68665900,TNL
chr12,Bn49157,17576702,92106159,74529457,TN
chr12,Bn49158,73899278,95865647,21966369,NBS
chr12,Bn49159,38437208,43089026,4651818,TN
chr12,Bn49160,2941601,20642739,17701138,RLP
chr12,Bn49161,55443285,80703738,25260453,TN
chr12,Bn49162,91934076,92109248,175172,CNL
chr12,Bn49163,44544382,60565273,16020891,TN
chr12,Bn49164,33307200,71613216,38306016,CNL
chr12,Bn49165,98452364,99311685,859321,NBS
chr12,Bn49166,79748686,96057325,16308639,CN
chr12,Bn49167,75748224,92919675,17171451,TN
chr12,Bn49168,58427869,58485950,58081,TNL
chr12,Bn49169,20874966,22924337,2049371,CN
chr12,Bn49170,51543554,94817614,43274060,TN
chr12,Bn49171,17601786,97597517,79995731,CN
chr12,Bn49172,23272981,78141748,54868767,RLP
chr12,Bn49173,1194411,84860853,83666442,NBS
chr12,Bn49174,45088169,99916081,54827912,CNL
chr12,Bn49175,13489059,36492576,23003517,NBS
chr12,Bn49176,61341676,86755692,25414016,NBS
chr12,Bn49177,16035971,75286134,59250163,RLP
chr12,Bn49178,64773240,95892755,31119515,CNL
chr12,Bn49179,25287741,55235961,29948220,TNL
chr12,Bn49180,89620380,95398585,5778205,NBS
chr12,Bn49181,28821617,52412128,23590511,RLP
chr12,Bn49182,51420789,78822528,27401739,CNL
chr12,Bn49183,17403438,85907948,68504510,NBS
chr12,Bn49184,87520564,95877749,8357185,TNL
chr12,Bn49185,4463538,20249268,15785730,TN
chr12,Bn49186,42299315,47210450,4911135,TNL
chr12,Bn49187,4810285,6875329,2065044,CNL
chr12,Bn49188,96845956,99944813,3098857,NBS
chr12,Bn49189,19755611,21361465,1605854,TN
chr12,Bn49190,70762320,81439998,10677678,TNL
chr12,Bn49191,34552591,70010991,35458400,TN
chr12,Bn49192,19200251,68561481,49361230,RLP
chr12,Bn49193,9315457,41833738,32518281,TNL
chr12,Bn49194,7609285,60785037,53175752,TNL
chr12,Bn49195,82038952,82333520,294568,TNL
chr12,Bn49196,84002433,84774973,772540,RLK
chr12,Bn49197,58582646,66516180,7933534,RLK
chr12,Bn49198,60878506,99355721,38477215,CN
chr12,Bn49199,26567640,70177123,43609483,TN
chr12,Bn49200,5409273,16706047,11296774,CNL
chr12,Bn49201,33936690,77340596,43403906,RLP
chr12,Bn49202,12435992,60477745,48041753,TNL
chr12,Bn49203,55068236,87085692,32017456,RLP
chr12,Bn49204,75259779,96644472,21384693,TN
chr12,Bn49205,56823137,87635197,30812060,TN
chr12,Bn49206,88004917,96760024,8755107,RLP
chr12,Bn49207,43483932,46169520,2685588,TN
chr12,Bn49208,75648586,78653086,3004500,CNL
chr12,Bn49209,49214576,75687409,26472833,TN
chr12,Bn49210,50211235,55044191,4832956,RLP
chr12,Bn49211,77421913,90520825,13098912,RLP
chr12,Bn49212,80014719,86974099,6959380,CNL
chr12,Bn49213,54292803,64518071,10225268,RLP
chr12,Bn49214,35681542,82753061,47071519,RLP
chr12,Bn49215,20059175,49348515,29289340,RLK
chr12,Bn49216,49435931,56521735,7085804,TNL
chr12,Bn49217,14148827,32298972,18150145,TN
chr12,Bn49218,61422929,69153313,7730384,TN
chr12,Bn49219,77739036,90448857,12709821,NBS
chr12,Bn49220,47116217,61031986,13915769,CNL
chr12,Bn49221,24744789,95441589,70696800,RLP
chr12,Bn49222,37614263,60848026,23233763,RLP
chr12,Bn49223,52376930,98580782,46203852,RLP
chr12,Bn49224,24974477,85396685,60422208,CNL
chr12,Bn49225,57916123,87822395,29906272,NBS
chr12,Bn49226,7997965,89112258,81114293,RLP
chr12,Bn49227,57794741,58670153,875412,RLK
chr12,Bn49228,17120532,75802975,58682443,NBS
chr12,Bn49229,60711834,61583583,871749,CN
chr12,Bn49230,32058973,72555686,40496713,RLP
chr12,Bn49231,39585401,50084496,10499095,TN
chr12,Bn49232,46707431,93364557,46657126,TN
chr12,Bn49233,93852346,98972882,5120536,NBS
chr12,Bn49234,4597898,63793454,59195556,NBS
chr12,Bn49235,38547938,39999825,1451887,NBS
chr12,Bn49236,45446915,87371992,41925077,RLK
chr12,Bn49237,40480823,89201382,48720559,TN
chr12,Bn49238,45425445,72558404,27132959,CN
chr12,Bn49239,15631489,58498930,42867441,CNL
chr12,Bn49240,46307205,65309112,19001907,CN
chr12,Bn49241,38343743,66325674,27981931,CNL
chr12,Bn49242,57870912,93267473,35396561,NBS
chr12,Bn49243,88166448,96325202,8158754,CN
chr12,Bn49244,34789866,79830004,45040138,CNL
chr12,Bn49245,33418889,83469352,50050463,NBS
chr12,Bn49246,32814075,65045443,32231368,CN
chr12,Bn49247,25842207,76393424,50551217,NBS
chr12,Bn49248,3678899,56152390,52473491,RLP
chr12,Bn49249,86847978,93025949,6177971,NBS
chr12,Bn49250,84323978,88244715,3920737,NBS
chr12,Bn49251,57110208,61272685,4162477,RLP
chr12,Bn49252,69668840,84296289,14627449,CNL
chr12,Bn49253,81854262,89039376,7185114,CNL
chr12,Bn49254,91454945,99988670,8533725,CNL
chr12,Bn49255,53274722,92693939,39419217,NBS
chr12,Bn49256,7588288,97190490,89602202,CN
chr12,Bn49257,42862728,76154548,33291820,RLP
chr12,Bn49258,56690868,95171164,38480296,CNL
chr12,Bn49259,46222286,76604694,30382408,TN
chr12,Bn49260,9821327,43073594,33252267,TN
chr12,Bn49261,84036105,96864340,12828235,CN
chr12,Bn49262,72220460,76443792,4223332,RLK
chr12,Bn49263,71153160,86257216,15104056,RLK
chr12,Bn49264,97409363,99120384,1711021,NBS
chr12,Bn49265,36349457,41133200,4783743,NBS
chr12,Bn49266,81800281,98823002,17022721,CNL
chr12,Bn49267,61982086,68142145,6160059,TN
chr12,Bn49268,50419125,79303739,28884614,RLK
chr12,Bn49269,66109616,82749936,16640320,NBS
chr12,Bn49270,47121790,93821530,46699740,CNL
chr12,Bn49271,86712462,93137212,6424750,TN
chr12,Bn49272,21721009,38590689,16869680,TNL
chr12,Bn49273,40117065,44069513,3952448,NBS
chr12,Bn49274,62397896,94050773,31652877,CNL
chr12,Bn49275,69098779,81945743,12846964,RLK
chr12,Bn49276,45970174,56340498,10370324,TN
chr12,Bn49277,3971897,31774941,27803044,TN
chr12,Bn49278,70017027,82451625,12434598,CN
chr12,Bn49279,94092212,99896009,5803797,RLK
chr12,Bn49280,5884390,90842937,84958547,RLP
chr12,Bn49281,20491630,58065033,37573403,CNL
chr12,Bn49282,36691568,42837942,6146374,TNL
chr12,Bn49283,78163144,92128878,13965734,NBS
chr12,Bn49284,18619812,54097910,35478098,NBS
chr12,Bn49285,69731645,72576842,2845197,RLK
chr12,Bn49286,87263987,96588709,9324722,RLK
chr12,Bn49287,45268898,72466350,27197452,TN
chr12,Bn49288,94776785,98819615,4042830,TN
chr12,Bn49289,5224078,38088373,32864295,NBS
chr12,Bn49290,50980851,53735128,2754277,RLK
chr12,Bn49291,49136894,59586935,10450041,RLP
chr12,Bn49292,75693392,95914696,20221304,RLK
chr12,Bn49293,65870950,87187318,21316368,CN
chr12,Bn49294,38598220,56578297,17980077,TNL
chr12,Bn49295,90338003,90759473,421470,TN
chr12,Bn49296,88122160,92589924,4467764,NBS
chr12,Bn49297,59785185,90868569,31083384,CN
chr12,Bn49298,73371944,98276114,24904170,CNL
chr12,Bn49299,54903681,62225628,7321947,CN
chr12,Bn49300,59681413,77698596,18017183,NBS
chr12,Bn49301,8252655,96547951,88295296,RLP
chr12,Bn49302,9560023,22526018,12965995,TN
chr12,Bn49303,72955646,95435252,22479606,TNL
chr12,Bn49304,31141867,32567419,1425552,NBS
chr12,Bn49305,40494873,78442946,37948073,RLP
chr12,Bn49306,41571840,99255384,57683544,CNL
chr12,Bn49307,2679676,69935614,67255938,CN
chr12,Bn49308,65268957,90498030,25229073,RLP
chr12,Bn49309,40009981,92900474,52890493,TN
chr12,Bn49310,68527407,93021060,24493653,RLK
chr12,Bn49311,83261347,91364715,8103368,NBS
chr12,Bn49312,1509647,99884324,98374677,RLK
chr12,Bn49313,31730700,99212553,67481853,CN
chr12,Bn49314,75023274,97346689,22323415,TNL
chr12,Bn49315,14151711,87766935,73615224,RLK
chr12,Bn49316,80198926,96451711,16252785,TN
chr12,Bn49317,70876294,76352063,5475769,NBS
chr12,Bn49318,90421741,94179011,3757270,NBS
chr12,Bn49319,47033370,70040232,23006862,TNL
chr12,Bn49320,73340195,99281746,25941551,TN
chr12,Bn49321,89003088,91446411,2443323,CN
chr12,Bn49322,15963160,35309085,19345925,RLP
chr12,Bn49323,59405515,75254003,15848488,CNL
chr12,Bn49324,61671611,68869390,7197779,NBS
chr12,Bn49325,59336274,89195409,29859135,RLP
chr12,Bn49326,23879534,85476253,61596719,RLK
chr12,Bn49327,15358589,28220676,12862087,RLP
chr12,Bn49328,45379213,89097800,43718587,TN
chr12,Bn49329,31830419,46654810,14824391,CNL
chr12,Bn49330,55058800,93082323,38023523,RLK
chr12,Bn49331,67642862,83867206,16224344,NBS
chr12,Bn49332,89819159,90878399,1059240,RLP
chr12,Bn49333,57836851,87617019,29780168,RLP
chr12,Bn49334,95589988,99101144,3511156,CN
chr12,Bn49335,22820465,96323178,73502713,CN
chr12,Bn49336,61329153,71815405,10486252,CNL
chr12,Bn49337,57057421,75454412,18396991,RLK
chr12,Bn49338,65352863,72493841,7140978,TN
chr12,Bn49339,53446419,60449089,7002670,RLK
chr12,Bn49340,39159786,45097749,5937963,RLP
chr12,Bn49341,60642469,80470874,19828405,RLP
chr12,Bn49342,54637788,94428337,39790549,CN
chr12,Bn49343,46902024,90918686,44016662,RLP
chr12,Bn49344,37910525,81928554,44018029,NBS
chr12,Bn49345,21526189,89348660,67822471,RLK
chr12,Bn49346,66128386,82783667,16655281,NBS
chr12,Bn49347,82792366,93060037,10267671,RLK
chr12,Bn49348,50672751,82794362,32121611,NBS
chr12,Bn49349,72086172,84202634,12116462,RLP
chr12,Bn49350,95140795,98601998,3461203,TN
chr12,Bn49351,15335969,60479869,45143900,TNL
chr12,Bn49352,42096716,99879133,57782417,RLK
chr12,Bn49353,44232542,94930836,50698294,RLP
chr12,Bn49354,53589456,80488867,26899411,TNL
chr12,Bn49355,15795408,50380374,34584966,TNL
chr12,Bn49356,46910309,88594999,41684690,RLK
chr12,Bn49357,76596880,81168719,4571839,CNL
chr12,Bn49358,12845785,81824650,68978865,TN
chr12,Bn49359,44714017,79672073,34958056,RLP
chr12,Bn49360,92654073,93865165,1211092,TN
chr12,Bn49361,70317987,90192041,19874054,TNL
chr12,Bn49362,38550554,61032984,22482430,NBS
chr12,Bn49363,68146475,80073420,11926945,CNL
chr12,Bn49364,23960349,66954396,42994047,TN
chr12,Bn49365,80950919,88350778,7399859,TNL
chr12,Bn49366,90926159,97126285,6200126,CNL
chr12,Bn49367,3879796,12586014,8706218,TN
chr12,Bn49368,69890022,82120739,12230717,RLP
chr12,Bn49369,19488263,98502519,79014256,CNL
chr12,Bn49370,73172488,76213686,3041198,RLP
chr12,Bn49371,24645631,95061874,70416243,NBS
chr12,Bn49372,40817456,53723985,12906529,RLP
chr12,Bn49373,39984725,80803569,40818844,NBS
chr12,Bn49374,66677133,82931699,16254566,RLK
chr12,Bn49375,6221821,20880233,14658412,TNL
chr12,Bn49376,1465000,43743922,42278922,CN
chr12,Bn49377,41826505,73352695,31526190,TNL
chr12,Bn49378,12981795,67970434,54988639,NBS
chr12,Bn49379,94598329,98852078,4253749,CNL
chr12,Bn49380,5346183,68697346,63351163,TN
chr12,Bn49381,27524670,67629672,40105002,RLP
chr12,Bn49382,9986755,62481589,52494834,TN
chr12,Bn49383,39852857,90922068,51069211,RLK
chr12,Bn49384,16710553,59299856,42589303,CNL
chr12,Bn49385,42878353,93247367,50369014,TN
chr12,Bn49386,71934375,77816728,5882353,RLP
chr12,Bn49387,84470440,93608524,9138084,RLK
chr12,Bn49388,32387748,94014830,61627082,RLK
chr12,Bn49389,63443558,77775516,14331958,TN
chr12,Bn49390,24010170,55759771,31749601,RLK
chr12,Bn49391,93989246,94795351,806105,CNL
chr12,Bn49392,16162640,95438427,79275787,RLK
chr12,Bn49393,79726112,86541581,6815469,RLK
chr12,Bn49394,11260239,67983383,56723144,CNL
chr12,Bn49395,42258108,96363372,54105264,TN
chr12,Bn49396,25135002,72862045,47727043,CN
chr12,Bn49397,90203648,99874576,9670928,CN
chr12,Bn49398,74283442,91645355,17361913,CNL
chr12,Bn49399,19697322,30249246,10551924,TNL
chr12,Bn49400,34611895,78258974,43647079,RLK
chr12,Bn49401,68595663,83456147,14860484,CNL
chr12,Bn49402,2814960,89482512,86667552,NBS
chr12,Bn49403,2847016,33438965,30591949,TN
chr12,Bn49404,71625586,79574695,7949109,CN
chr12,Bn49405,92854412,96949287,4094875,TNL
chr12,Bn49406,67733591,96183373,28449782,CN
chr12,Bn49407,6601657,76587807,69986150,TN
chr12,Bn49408,68933429,75798888,6865459,CN
chr12,Bn49409,86567016,88900983,2333967,NBS
chr12,Bn49410,51857820,67845232,15987412,CN
chr12,Bn49411,28768835,90788475,62019640,TNL
chr12,Bn49412,85263403,98515943,13252540,RLP
chr12,Bn49413,12962719,83663230,70700511,TNL
chr12,Bn49414,45144932,86389388,41244456,CN
chr12,Bn49415,33403172,96306834,62903662,TNL
chr12,Bn49416,61545077,71284874,9739797,RLK
chr12,Bn49417,52355986,78477056,26121070,CNL
chr12,Bn49418,46873692,51746887,4873195,NBS
chr12,Bn49419,53070794,77903264,24832470,RLK
chr12,Bn49420,20323062,61910299,41587237,RLK
chr12,Bn49421,31627215,65749529,34122314,NBS
chr12,Bn49422,69949095,93833301,23884206,CNL
chr12,Bn49423,83525831,83536503,10672,NBS
chr12,Bn49424,95799926,99868664,4068738,RLP
chr12,Bn49425,48963987,85420281,36456294,CN
chr12,Bn49426,76317367,96505249,20187882,TNL
chr12,Bn49427,34208431,62818183,28609752,RLK
chr12,Bn49428,61106148,91169968,30063820,TNL
chr12,Bn49429,24013419,75778864,51765445,RLK
chr12,Bn49430,47153648,65886805,18733157,NBS
chr12,Bn49431,91628807,92710001,1081194,CNL
chr12,Bn49432,95900170,98180152,2279982,NBS
chr12,Bn49433,71251159,76876911,5625752,NBS
chr12,Bn49434,1854899,23051476,21196577,RLP
chr12,Bn49435,48834767,81767685,32932918,TNL
chr12,Bn49436,83476479,89686732,6210253,NBS
chr12,Bn49437,93550943,96791752,3240809,RLP
chr12,Bn49438,87413608,91027609,3614001,RLP
chr12,Bn49439,78520301,91230929,12710628,NBS
chr12,Bn49440,49757581,62838362,13080781,TNL
chr12,Bn49441,41668288,52763711,11095423,NBS
chr12,Bn49442,15657106,43348026,27690920,TN
chr12,Bn49443,69112467,89314453,20201986,RLK
chr12,Bn49444,82903907,94967742,12063835,TN
chr12,Bn49445,61258295,82645108,21386813,RLP
chr12,Bn49446,13881747,80714881,66833134,TN
chr12,Bn49447,56632263,58431558,1799295,TNL
chr12,Bn49448,6962647,92404805,85442158,RLK
chr12,Bn49449,29027403,29399447,372044,TNL
chr12,Bn49450,60116260,64868786,4752526,TNL
chr12,Bn49451,74121689,89501215,15379526,CNL
chr12,Bn49452,3025442,72746302,69720860,RLK
chr12,Bn49453,86777541,96090050,9312509,CN
chr12,Bn49454,34071119,45639717,11568598,CNL
chr12,Bn49455,85715795,95878615,10162820,RLK
chr12,Bn49456,31803043,95773102,63970059,TNL
chr12,Bn49457,14908549,72649518,57740969,RLP
chr12,Bn49458,25636673,66907831,41271158,TN
chr12,Bn49459,8817186,9760398,943212,RLP
chr12,Bn49460,62868658,73154395,10285737,TN
chr12,Bn49461,63597973,93631331,30033358,NBS
chr12,Bn49462,46142794,80277247,34134453,TNL
chr12,Bn49463,52375372,64560165,12184793,CN
chr12,Bn49464,83265156,85773067,2507911,TN
chr12,Bn49465,98902518,99019498,116980,TNL
chr12,Bn49466,70959252,89739938,18780686,CNL
chr12,Bn49467,39481261,62519124,23037863,CNL
chr12,Bn49468,32358913,62714174,30355261,NBS
chr12,Bn49469,28370635,87801520,59430885,RLP
chr12,Bn49470,41507123,95169669,53662546,RLP
chr12,Bn49471,10322790,99107426,88784636,TN
chr12,Bn49472,84542712,92558783,8016071,TNL
chr12,Bn49473,76304986,97762719,21457733,NBS
chr12,Bn49474,88133069,88624821,491752,TN
chr12,Bn49475,36854655,80413800,43559145,NBS
chr12,Bn49476,37790098,80866973,43076875,NBS
chr12,Bn49477,26844942,39106786,12261844,TNL
chr12,Bn49478,98147632,99718498,1570866,RLK
chr12,Bn49479,99889124,99901018,11894,CN
chr12,Bn49480,85509762,95956118,10446356,TN
chr12,Bn49481,84454824,93946349,9491525,CN
chr12,Bn49482,70094198,95468804,25374606,RLK
chr12,Bn49483,70371363,85754763,15383400,NBS
chr12,Bn49484,66196773,69405640,3208867,NBS
chr12,Bn49485,42058859,51232375,9173516,RLP
chr12,Bn49486,32510673,75011078,42500405,TNL
chr12,Bn49487,14079644,95579182,81499538,CN
chr12,Bn49488,32598219,40878363,8280144,NBS
chr12,Bn49489,62810800,76648541,13837741,RLK
chr12,Bn49490,26597510,96215552,69618042,TNL
chr12,Bn49491,94331264,97255668,2924404,RLP
chr12,Bn49492,93299274,94350771,1051497,TNL
chr12,Bn49493,96814353,97247197,432844,TN
chr12,Bn49494,38859286,94430331,55571045,TNL
chr12,Bn49495,40981367,86155722,45174355,RLK
chr12,Bn49496,89223762,94047284,4823522,CN
chr12,Bn49497,93843082,97276966,3433884,CN
chr12,Bn49498,84243042,96537769,12294727,NBS
chr12,Bn49499,8475777,66092156,57616379,RLP
chr12,Bn49500,33141634,99163715,66022081,CN
chr12,Bn49501,54572444,56964240,2391796,TN
chr12,Bn49502,77397178,88061513,10664335,TN
chr12,Bn49503,32644539,64912694,32268155,CNL
chr12,Bn49504,1682474,4548003,2865529,TN
chr12,Bn49505,50961178,81546379,30585201,CN
chr12,Bn49506,66698131,77814756,11116625,CN
chr12,Bn49507,64930514,72820702,7890188,RLK
chr12,Bn49508,71470962,98581160,27110198,RLP
chr12,Bn49509,88600143,99935258,11335115,CN
chr12,Bn49510,18858662,20104372,1245710,RLP
chr12,Bn49511,81604738,86558129,4953391,CN
chr12,Bn49512,30744066,40899383,10155317,CNL
chr12,Bn49513,19713293,34878346,15165053,CN
chr12,Bn49514,62463575,93155421,30691846,CNL
chr12,Bn49515,86122278,96923588,10801310,RLK
chr12,Bn49516,14420669,89464015,75043346,CNL
chr12,Bn49517,97500822,98252400,751578,NBS
chr12,Bn49518,59814956,64987920,5172964,TNL
chr12,Bn49519,13204398,91948153,78743755,RLK
chr12,Bn49520,16050293,34204753,18154460,TNL
chr12,Bn49521,60242519,62097051,1854532,CN
chr12,Bn49522,15472275,95335575,79863300,CN
chr12,Bn49523,57083050,92851820,35768770,NBS
chr12,Bn49524,71512835,89945964,18433129,TN
chr12,Bn49525,76003625,82189595,6185970,TN
chr12,Bn49526,93993669,95702301,1708632,CN
chr12,Bn49527,24211310,45540775,21329465,TN
chr12,Bn49528,26028611,43666748,17638137,RLP
chr12,Bn49529,46317342,92083837,45766495,CN
chr12,Bn49530,61906219,82465016,20558797,TN
chr12,Bn49531,46809233,67770253,20961020,TNL
chr12,Bn49532,93351048,97557934,4206886,TN
chr12,Bn49533,16551021,71069261,54518240,RLK
chr12,Bn49534,75362803,91246452,15883649,NBS
chr12,Bn49535,45527021,64809630,19282609,RLK
chr12,Bn49536,32157004,79181508,47024504,RLK
chr12,Bn49537,47245651,61446144,14200493,TN
chr12,Bn49538,53214084,66278320,13064236,TNL
chr12,Bn49539,22797883,60435757,37637874,NBS
chr12,Bn49540,56296940,60728267,4431327,RLK
chr12,Bn49541,52341367,77621724,25280357,CNL
chr12,Bn49542,88738136,95728783,6990647,TN
chr12,Bn49543,67753767,83354665,15600898,NBS
chr12,Bn49544,63046890,72028201,8981311,CN
chr12,Bn49545,54009088,83008843,28999755,NBS
chr12,Bn49546,32970915,45700862,12729947,RLP
chr12,Bn49547,9155956,98182895,89026939,RLP
chr12,Bn49548,16073877,59312495,43238618,TNL
chr12,Bn49549,15014456,30493467,15479011,RLP
chr12,Bn49550,60338782,98082304,37743522,NBS
chr12,Bn49551,84786860,90824186,6037326,CNL
chr12,Bn49552,26380092,97889080,71508988,CNL
chr12,Bn49553,93954917,95360420,1405503,RLK
chr12,Bn49554,23647804,25760667,2112863,TNL
chr12,Bn49555,66862251,93027017,26164766,TNL
chr12,Bn49556,12130349,79656044,67525695,TNL
chr12,Bn49557,20259184,61112893,40853709,NBS
chr12,Bn49558,71505331,72415639,910308,CNL
chr12,Bn49559,20795908,54056477,33260569,CN
chr12,Bn49560,15866975,93001910,77134935,CNL
chr12,Bn49561,35263444,72831580,37568136,NBS
chr12,Bn49562,73727847,96025590,22297743,CN
chr12,Bn49563,77051445,92136977,15085532,TN
chr12,Bn49564,85649943,93585228,7935285,CN
chr12,Bn49565,84817458,87667161,2849703,CN
chr12,Bn49566,61240658,68152358,6911700,CNL
chr12,Bn49567,98104371,99813751,1709380,CNL
chr12,Bn49568,16172302,94465293,78292991,NBS
chr12,Bn49569,49524602,60129556,10604954,CN
chr12,Bn49570,79822052,91437715,11615663,RLP
chr12,Bn49571,70716409,87098976,16382567,RLP
chr12,Bn49572,9700886,48241938,38541052,RLP
chr12,Bn49573,71085263,72548948,1463685,TNL
chr12,Bn49574,53272120,80267603,26995483,NBS
chr12,Bn49575,4196067,17763224,13567157,TNL
chr12,Bn49576,86494329,98017414,11523085,NBS
chr12,Bn49577,57794844,70800599,13005755,RLK
chr12,Bn49578,29897789,68850241,38952452,TN
chr12,Bn49579,77138230,84299751,7161521,TN
chr12,Bn49580,93697662,99280853,5583191,CNL
chr12,Bn49581,93810555,95648738,1838183,TNL
chr12,Bn49582,53302278,60943029,7640751,CN
chr12,Bn49583,41263621,69329667,28066046,TNL
chr12,Bn49584,8663404,44093726,35430322,RLP
chr12,Bn49585,33663832,47022333,13358501,RLK
chr12,Bn49586,63948086,67429281,3481195,RLK
chr12,Bn49587,48832852,81267681,32434829,TNL
chr12,Bn49588,30674974,56434192,25759218,CNL
chr12,Bn49589,45829599,72817280,26987681,NBS
chr12,Bn49590,68702522,83874962,15172440,RLK
chr12,Bn49591,80040963,93603194,13562231,TNL
chr12,Bn49592,58728584,87560958,28832374,TNL
chr12,Bn49593,61426072,86030067,24603995,TNL
chr12,Bn49594,85644432,98247267,12602835,CNL
chr12,Bn49595,31298207,50571943,19273736,CNL
chr12,Bn49596,17567345,83910049,66342704,NBS
chr12,Bn49597,6833305,83366478,76533173,TNL
chr12,Bn49598,38199461,82287037,44087576,RLK
chr12,Bn49599,7953171,53096102,45142931,CN
chr12,Bn49600,97044399,98813095,1768696,RLP
chr12,Bn49601,86687119,97194991,10507872,TNL
chr12,Bn49602,90948464,98246684,7298220,RLK
chr12,Bn49603,83368147,95735468,12367321,RLK
chr12,Bn49604,18522929,38431806,19908877,RLK
chr12,Bn49605,44190211,94254012,50063801,TN
chr12,Bn49606,57162726,57692945,530219,CN
chr12,Bn49607,82907154,89099042,6191888,TNL
chr12,Bn49608,32385298,91075220,58689922,TNL
chr12,Bn49609,11861376,77855909,65994533,RLK
chr12,Bn49610,71929388,77988728,6059340,TN
chr12,Bn49611,96094063,99759621,3665558,TNL
chr12,Bn49612,61745274,66176966,4431692,RLK
chr12,Bn49613,26329993,89119031,62789038,CN
chr12,Bn49614,53409758,90012647,36602889,TN
chr12,Bn49615,56249600,56310545,60945,TN
chr12,Bn49616,57567335,65979146,8411811,CN
chr12,Bn49617,66684689,87062164,20377475,CN
chr12,Bn49618,53291577,90711460,37419883,NBS
chr12,Bn49619,83285896,93073733,9787837,RLK
chr12,Bn49620,24867144,75006468,50139324,TNL
chr12,Bn49621,8788242,11130340,2342098,RLK
chr12,Bn49622,38718215,99934204,61215989,TNL
chr12,Bn49623,81289655,94981590,13691935,NBS
chr12,Bn49624,73783876,82384395,8600519,TN
chr12,Bn49625,21860820,96743764,74882944,NBS
chr12,Bn49626,57414641,75210905,17796264,NBS
chr12,Bn49627,8245338,82744297,74498959,RLP
chr12,Bn49628,67201746,96918307,29716561,RLP
chr12,Bn49629,16284930,82057713,65772783,CN
chr12,Bn49630,61486644,72837649,11351005,CN
chr12,Bn49631,10690270,17989301,7299031,TN
chr12,Bn49632,62239184,89771448,27532264,NBS
chr12,Bn49633,8860469,64890290,56029821,TN
chr12,Bn49634,75648194,83931018,8282824,RLK
chr12,Bn49635,57009133,62328907,5319774,RLP
chr12,Bn49636,43809076,94278855,50469779,NBS
chr12,Bn49637,4982981,63389671,58406690,NBS
chr12,Bn49638,87855159,89497468,1642309,RLP
chr12,Bn49639,75825961,93196332,17370371,TNL
chr12,Bn49640,97683161,99231850,1548689,TN
chr12,Bn49641,25420526,50553179,25132653,TNL
chr12,Bn49642,43777459,96249710,52472251,RLP
chr12,Bn49643,51098787,51599958,501171,CNL
chr12,Bn49644,38254777,65407769,27152992,CNL
chr12,Bn49645,37494268,88888420,51394152,CN
chr12,Bn49646,39163979,41851716,2687737,TN
chr12,Bn49647,30922796,92835941,61913145,CNL
chr12,Bn49648,77640402,83856418,6216016,NBS
chr12,Bn49649,12697037,43500215,30803178,NBS
chr12,Bn49650,49726482,54302271,4575789,NBS
chr12,Bn49651,52738811,69769553,17030742,TNL
chr12,Bn49652,33996910,61991999,27995089,CNL
chr12,Bn49653,5918931,8192639,2273708,TN
chr12,Bn49654,23042903,62910291,39867388,TN
chr12,Bn49655,28796088,80626307,51830219,CN
chr12,Bn49656,38284852,77376397,39091545,TN
chr12,Bn49657,3226845,72459703,69232858,NBS
chr12,Bn49658,19416503,80600100,61183597,CN
chr12,Bn49659,46258864,66456863,20197999,NBS
chr12,Bn49660,73536454,87545365,14008911,NBS
chr12,Bn49661,64732510,90050318,25317808,RLP
chr12,Bn49662,94478012,95712756,1234744,RLP
chr12,Bn49663,78214637,81251835,3037198,RLK
chr12,Bn49664,71712189,86319811,14607622,CN
chr12,Bn49665,28955421,97873719,68918298,RLP
chr12,Bn49666,51679143,95205111,43525968,TN
chr12,Bn49667,94224088,99447706,5223618,CN
chr12,Bn49668,53985460,89658378,35672918,CN
chr12,Bn49669,30184439,74490921,44306482,TN
chr12,Bn49670,45295607,72377690,27082083,NBS
chr12,Bn49671,81614308,83498942,1884634,NBS
chr12,Bn49672,4936693,78506983,73570290,TN
chr12,Bn49673,46692199,91113078,44420879,NBS
chr12,Bn49674,46564621,69451273,22886652,CNL
chr12,Bn49675,38720029,41714496,2994467,TNL
chr12,Bn49676,48712441,59056770,10344329,CNL
chr12,Bn49677,81445957,94826030,13380073,CN
chr12,Bn49678,99489384,99503128,13744,TNL
chr12,Bn49679,88228250,98733508,10505258,RLP
chr12,Bn49680,8044169,10443222,2399053,TNL
chr12,Bn49681,30296753,39214510,8917757,RLP
chr12,Bn49682,72608259,75744019,3135760,RLP
chr12,Bn49683,38677522,74518314,35840792,RLK
chr12,Bn49684,21929183,62248878,40319695,RLP
chr12,Bn49685,55473687,85660850,30187163,CNL
chr12,Bn49686,76298085,97774789,21476704,RLP
chr12,Bn49687,83654402,96891577,13237175,RLK
chr12,Bn49688,96980008,99974746,2994738,CN
chr12,Bn49689,62925321,78338541,15413220,TNL
chr12,Bn49690,53330010,94155120,40825110,TNL
chr12,Bn49691,89694225,96696826,7002601,RLK
chr12,Bn49692,45755501,62058288,16302787,CNL
chr12,Bn49693,65690506,86460795,20770289,CN
chr12,Bn49694,73790972,92795813,19004841,TNL
chr12,Bn49695,79155295,83817708,4662413,CNL
chr12,Bn49696,50891870,80971950,30080080,CNL
chr12,Bn49697,47764532,72076988,24312456,NBS
chr12,Bn49698,54582083,83714754,29132671,TN
chr12,Bn49699,9611171,79700046,70088875,RLK
chr12,Bn49700,59508498,74854881,15346383,RLP
chr12,Bn49701,55667148,68249638,12582490,RLK
chr12,Bn49702,9792355,80408529,70616174,TN
chr12,Bn49703,78386985,91944237,13557252,CN
chr12,Bn49704,55963901,66514999,10551098,CNL
chr12,Bn49705,38932305,50093832,11161527,RLK
chr12,Bn49706,80923373,91285209,10361836,CN
chr12,Bn49707,85112154,95544175,10432021,CNL
chr12,Bn49708,52563380,95315583,42752203,TN
chr12,Bn49709,61017930,99649019,38631089,NBS
chr12,Bn49710,42223605,83512136,41288531,RLK
chr12,Bn49711,7489791,11845619,4355828,RLP
chr12,Bn49712,88436372,96426702,7990330,TN
chr12,Bn49713,69300203,77206157,7905954,CN
chr12,Bn49714,22304044,27404633,5100589,CNL
chr12,Bn49715,11917706,20649346,8731640,RLK
chr12,Bn49716,14060632,23659996,9599364,CN
chr12,Bn49717,16020027,22578688,6558661,TNL
chr12,Bn49718,42539873,91797897,49258024,CNL
chr12,Bn49719,8684731,30799918,22115187,CNL
chr12,Bn49720,80659340,88386293,7726953,RLP
chr12,Bn49721,46065420,70045193,23979773,TNL
chr12,Bn49722,83524874,87298718,3773844,CNL
chr12,Bn49723,53795004,86597812,32802808,NBS
chr12,Bn49724,23473816,69056549,45582733,CNL
chr12,Bn49725,79081247,80254007,1172760,NBS
chr12,Bn49726,69766030,92151612,22385582,CNL
chr12,Bn49727,42006173,68270621,26264448,TN
chr12,Bn49728,64149088,96421037,32271949,TNL
chr12,Bn49729,71228156,82958500,11730344,CNL
chr12,Bn49730,40863301,82755698,41892397,RLP
chr12,Bn49731,66327735,91953780,25626045,NBS
chr12,Bn49732,14881688,99120822,84239134,TNL
chr12,Bn49733,4457648,27033024,22575376,CNL
chr12,Bn49734,77238817,79549509,2310692,CNL
chr12,Bn49735,77245936,85702611,8456675,CNL
chr12,Bn49736,91750178,93573667,1823489,RLK
chr12,Bn49737,14729112,92900421,78171309,NBS
chr12,Bn49738,30152895,53793145,23640250,CNL
chr12,Bn49739,91012266,96472069,5459803,CNL
chr12,Bn49740,38761708,87647006,48885298,TN
chr12,Bn49741,95693374,99635205,3941831,TNL
chr12,Bn49742,54360091,86583502,32223411,RLP
chr12,Bn49743,32781298,40641062,7859764,NBS
chr12,Bn49744,36788346,54095146,17306800,CNL
chr12,Bn49745,55100546,75896615,20796069,TN
chr12,Bn49746,39524860,51833703,12308843,CNL
chr12,Bn49747,55503719,55794713,290994,TN
chr12,Bn49748,21862316,63387322,41525006,CN
chr12,Bn49749,97700297,98296749,596452,CN
chr12,Bn49750,18670094,37709621,19039527,RLP
chr12,Bn49751,75085475,75844425,758950,TN
chr12,Bn49752,31874755,64671040,32796285,TN
chr12,Bn49753,39131491,68899362,29767871,NBS
chr12,Bn49754,49252825,96291297,47038472,NBS
chr12,Bn49755,79387349,97659989,18272640,TNL
chr12,Bn49756,16605955,59937476,43331521,RLP
chr12,Bn49757,93511165,94332346,821181,NBS
chr12,Bn49758,93231800,97347606,4115806,TNL
chr12,Bn49759,24477895,25911473,1433578,RLK
chr12,Bn49760,48470325,53408657,4938332,TN
chr12,Bn49761,54170057,64176052,10005995,CNL
chr12,Bn49762,93881446,95787122,1905676,TNL
chr12,Bn49763,93509685,93686536,176851,RLP
chr12,Bn49764,10777652,29298339,18520687,CN
chr12,Bn49765,66476375,85726566,19250191,RLP
chr12,Bn49766,75804744,77973244,2168500,CNL
chr12,Bn49767,35572238,91033975,55461737,CN
chr12,Bn49768,77032333,90503670,13471337,CN
chr12,Bn49769,87058656,87194003,135347,RLP
chr12,Bn49770,1865889,68902183,67036294,CN
chr12,Bn49771,17594858,59326063,41731205,CNL
chr12,Bn49772,56634629,98522483,41887854,NBS
chr12,Bn49773,24805851,64242424,39436573,RLK
chr12,Bn49774,37621625,95326100,57704475,RLP
chr12,Bn49775,53695727,94153078,40457351,RLP
chr12,Bn49776,88752449,88790349,37900,RLK
chr12,Bn49777,54771418,97045383,42273965,RLP
chr12,Bn49778,45590795,53363456,7772661,CNL
chr12,Bn49779,26425440,90402015,63976575,CN
chr12,Bn49780,2466532,36592382,34125850,RLP
chr12,Bn49781,48226892,78102916,29876024,RLK
chr12,Bn49782,36352765,46729200,10376435,RLP
chr12,Bn49783,25832533,66669777,40837244,TNL
chr12,Bn49784,7650518,13445063,5794545,TNL
chr12,Bn49785,54065056,99597804,45532748,TN
chr12,Bn49786,19430238,23116765,3686527,TNL
chr12,Bn49787,32512430,66367080,33854650,TNL
chr12,Bn49788,83249349,94744433,11495084,CN
chr12,Bn49789,97198907,98420119,1221212,NBS
chr12,Bn49790,58245806,59757423,1511617,RLP
chr12,Bn49791,15493133,79414315,63921182,CNL
chr12,Bn49792,44607896,66373622,21765726,TN
chr12,Bn49793,95629228,98731626,3102398,TNL
chr12,Bn49794,55359313,91145862,35786549,TN
chr12,Bn49795,33354316,66850865,33496549,TN
chr12,Bn49796,69633105,86985485,17352380,TNL
chr12,Bn49797,21986236,96308094,74321858,CN
chr12,Bn49798,24859240,68807184,43947944,RLK
chr12,Bn49799,31902635,41000753,9098118,RLK
chr12,Bn49800,41781649,90305507,48523858,TN
chr12,Bn49801,29931742,36045987,6114245,RLK
chr12,Bn49802,8942312,87493960,78551648,TNL
chr12,Bn49803,73984592,96329271,22344679,RLP
chr12,Bn49804,67685548,86648522,18962974,RLK
chr12,Bn49805,93052483,94600852,1548369,CNL
chr12,Bn49806,75539744,96491026,20951282,CN
chr12,Bn49807,3998967,52732368,48733401,CNL
chr12,Bn49808,53883019,60130407,6247388,CN
chr12,Bn49809,80525448,97396342,16870894,RLP
chr12,Bn49810,11352267,65081915,53729648,RLP
chr12,Bn49811,13513898,90251804,76737906,CN
chr12,Bn49812,39418159,56507084,17088925,RLP
chr12,Bn49813,25035915,79963960,54928045,NBS
chr12,Bn49814,76943757,77244280,300523,TN
chr12,Bn49815,26763745,42170276,15406531,TN
chr12,Bn49816,76459694,97194539,20734845,CNL
chr12,Bn49817,50835972,96899850,46063878,RLK
chr12,Bn49818,31349020,83340214,51991194,RLK
chr12,Bn49819,36176365,51448432,15272067,CN
chr12,Bn49820,40004641,42266865,2262224,TNL
chr12,Bn49821,80766303,91066926,10300623,CN
chr12,Bn49822,47257024,62402853,15145829,RLP
chr12,Bn49823,93652133,96857388,3205255,RLP
chr12,Bn49824,92856933,97520424,4663491,TN
chr12,Bn49825,55435624,76996962,21561338,CN
chr12,Bn49826,65326497,96408425,31081928,RLP
chr12,Bn49827,67407219,93637358,26230139,NBS
chr12,Bn49828,14151014,85327696,71176682,RLK
chr12,Bn49829,22432435,61147113,38714678,RLK
chr12,Bn49830,35207128,57458253,22251125,RLK
chr12,Bn49831,11087625,38434253,27346628,RLP
chr12,Bn49832,33994749,95351399,61356650,TN
chr12,Bn49833,78532190,86565947,8033757,CN
chr12,Bn49834,52052266,67194286,15142020,CN
chr12,Bn49835,64336431,83674403,19337972,TNL
chr12,Bn49836,10389540,47494016,37104476,TN
chr12,Bn49837,95085237,96417533,1332296,TNL
chr12,Bn49838,28030846,52909725,24878879,NBS
chr12,Bn49839,74092313,77716927,3624614,NBS
chr12,Bn49840,49662265,84574903,34912638,RLP
chr12,Bn49841,23930385,93912638,69982253,CNL
chr12,Bn49842,31788369,79857559,48069190,TNL
chr12,Bn49843,83628909,86553771,2924862,RLP
chr12,Bn49844,92770185,94955120,2184935,TN
chr12,Bn49845,2761655,97379889,94618234,NBS
chr12,Bn49846,30971333,62886803,31915470,CN
chr12,Bn49847,39434361,64476274,25041913,CN
chr12,Bn49848,33894764,93330685,59435921,NBS
chr12,Bn49849,39970781,46986041,7015260,TNL
chr12,Bn49850,80107509,86247568,6140059,TNL
chr12,Bn49851,28708123,78820713,50112590,CNL
chr12,Bn49852,1088429,59530259,58441830,TN
chr12,Bn49853,55083474,72119729,17036255,TN
chr12,Bn49854,47737998,78449274,30711276,CN
chr12,Bn49855,30195343,91464563,61269220,RLP
chr12,Bn49856,74885666,76847794,1962128,RLK
chr12,Bn49857,42138639,92893725,50755086,TNL
chr12,Bn49858,5563272,78727604,73164332,CN
chr12,Bn49859,63355305,99207036,35851731,CNL
chr12,Bn49860,43980783,70254396,26273613,CN
chr12,Bn49861,38772788,47187681,8414893,RLP
chr12,Bn49862,48903773,94078988,45175215,RLK
chr12,Bn49863,51830912,79251105,27420193,TNL
chr12,Bn49864,68792335,70355267,1562932,TNL
chr12,Bn49865,40142809,64521379,24378570,TNL
chr12,Bn49866,64737966,91475427,26737461,CNL
chr12,Bn49867,35824719,81742861,45918142,CN
chr12,Bn49868,93719429,94211819,492390,TNL
chr12,Bn49869,72155521,78239837,6084316,RLP
chr12,Bn49870,58144012,64537908,6393896,RLK
chr12,Bn49871,81698995,86181016,4482021,CN
chr12,Bn49872,61183626,71443525,10259899,TN
chr12,Bn49873,48505149,70264111,21758962,TN
chr12,Bn49874,42749509,92614673,49865164,NBS
chr12,Bn49875,15106860,89334309,74227449,RLK
chr12,Bn49876,12589745,68272935,55683190,RLP
chr12,Bn49877,18687248,62556212,43868964,RLP
chr12,Bn49878,95124219,96818638,1694419,CNL
chr12,Bn49879,64501364,79214891,14713527,RLK
chr12,Bn49880,52177064,80496261,28319197,NBS
chr12,Bn49881,48986648,97477999,48491351,CNL
chr12,Bn49882,53450308,63909432,10459124,RLK
chr12,Bn49883,7786575,87904970,80118395,RLP
chr12,Bn49884,55129788,59884274,4754486,RLP
chr12,Bn49885,42204368,99144401,56940033,TN
chr12,Bn49886,76912646,85932410,9019764,NBS
chr12,Bn49887,78164419,94073399,15908980,TN
chr12,Bn49888,63530387,94774908,31244521,NBS
chr12,Bn49889,90939929,95121677,4181748,NBS
chr12,Bn49890,48276666,91194659,42917993,TN
chr12,Bn49891,40013802,65543896,25530094,CN
chr12,Bn49892,16296781,94782743,78485962,CNL
chr12,Bn49893,48637506,72806786,24169280,RLP
chr12,Bn49894,39967876,43420131,3452255,NBS
chr12,Bn49895,90316369,96563144,6246775,RLP
chr12,Bn49896,69545210,95667616,26122406,RLP
chr12,Bn49897,76761623,90978621,14216998,CNL
chr12,Bn49898,4406792,23009262,18602470,TNL
chr12,Bn49899,93415880,98344556,4928676,CNL
chr12,Bn49900,69635946,71962928,2326982,RLK
chr12,Bn49901,59640807,69655611,10014804,NBS
chr12,Bn49902,79206406,89597411,10391005,TN
chr12,Bn49903,53652444,90359876,36707432,RLP
chr12,Bn49904,31136219,55621946,24485727,CN
chr12,Bn49905,33147952,65373833,32225881,TNL
chr12,Bn49906,54682663,83267790,28585127,CN
chr12,Bn49907,16131640,58343359,42211719,TN
chr12,Bn49908,43470955,45632111,2161156,TN
chr12,Bn49909,60236222,90547989,30311767,RLP
chr12,Bn49910,28325784,57145202,28819418,RLP
chr12,Bn49911,47208433,68373851,21165418,RLK
chr12,Bn49912,91982690,93643333,1660643,CNL
chr12,Bn49913,50308270,51931519,1623249,NBS
chr12,Bn49914,30901493,45107689,14206196,RLK
chr12,Bn49915,61303166,98417759,37114593,RLK
chr12,Bn49916,97755547,99401904,1646357,CNL
chr12,Bn49917,73315875,94885633,21569758,TN
chr12,Bn49918,78569766,94294830,15725064,RLP
chr12,Bn49919,88772190,91937412,3165222,NBS
chr12,Bn49920,24937013,62992922,38055909,TN
chr12,Bn49921,72474487,90991306,18516819,TNL
chr12,Bn49922,43081264,60992930,17911666,NBS
chr12,Bn49923,59496427,87299419,27802992,RLK
chr12,Bn49924,32947331,66421705,33474374,RLK
chr12,Bn49925,40026689,64165966,24139277,NBS
chr12,Bn49926,65157118,79109473,13952355,RLP
chr12,Bn49927,13923260,55934851,42011591,CNL
chr12,Bn49928,80832914,92558563,11725649,RLK
chr12,Bn49929,43479488,79489190,36009702,TNL
chr12,Bn49930,89125684,94619700,5494016,TN
chr12,Bn49931,78291279,82873711,4582432,NBS
chr12,Bn49932,17374742,67132214,49757472,NBS
chr12,Bn49933,2642446,51832471,49190025,CN
chr12,Bn49934,5951006,55553204,49602198,NBS
chr12,Bn49935,51437108,62752539,11315431,RLP
chr12,Bn49936,19298789,48393663,29094874,CNL
chr12,Bn49937,11019799,28632635,17612836,TN
chr12,Bn49938,6771016,86189484,79418468,TN
chr12,Bn49939,36285417,41384971,5099554,RLK
chr12,Bn49940,45494996,87338543,41843547,TN
chr12,Bn49941,12332429,57044102,44711673,NBS
chr12,Bn49942,62790156,75345407,12555251,TNL
chr12,Bn49943,71415214,95802158,24386944,TN
chr12,Bn49944,69152580,77656038,8503458,CN
chr12,Bn49945,36207159,94059232,57852073,TNL
chr12,Bn49946,8763308,87049905,78286597,RLP
chr12,Bn49947,36142108,88856943,52714835,RLP
chr12,Bn49948,89266926,95040102,5773176,CN
chr12,Bn49949,61511221,87366532,25855311,RLP
chr12,Bn49950,17372802,67258544,49885742,CNL
chr12,Bn49951,80163421,91318388,11154967,TNL
chr12,Bn49952,74760256,96573762,21813506,RLK
chr12,Bn49953,12825245,93908669,81083424,TNL
chr12,Bn49954,9482767,88862613,79379846,TN
chr12,Bn49955,26149503,33313599,7164096,NBS
chr12,Bn49956,4954417,94024462,89070045,RLK
chr12,Bn49957,31765810,56361410,24595600,TN
chr12,Bn49958,67186963,96575892,29388929,NBS
chr12,Bn49959,74047633,88522495,14474862,RLK
chr12,Bn49960,90359700,98857585,8497885,TNL
chr12,Bn49961,39017462,46467943,7450481,CN
chr12,Bn49962,90503477,97009649,6506172,CNL
chr12,Bn49963,2060715,60561608,58500893,CN
chr12,Bn49964,93534548,99401440,5866892,TNL
chr12,Bn49965,64850943,68139808,3288865,CN
chr12,Bn49966,15273190,74080332,58807142,TN
chr12,Bn49967,85644904,99817991,14173087,TNL
chr12,Bn49968,11530591,67807243,56276652,CN
chr12,Bn49969,38155445,92259854,54104409,TNL
chr12,Bn49970,11394062,27541403,16147341,TNL
chr12,Bn49971,82617912,96990687,14372775,NBS
chr12,Bn49972,7318876,93933298,86614422,TNL
chr12,Bn49973,39172604,76826415,37653811,RLK
chr12,Bn49974,55952388,74498037,18545649,RLK
chr12,Bn49975,37158884,52569274,15410390,NBS
chr12,Bn49976,75849533,93943188,18093655,TN
chr12,Bn49977,79451446,82347298,2895852,NBS
chr12,Bn49978,54408096,66872012,12463916,RLK
chr12,Bn49979,22510303,58175583,35665280,CNL
chr12,Bn49980,96293287,96834038,540751,CNL
chr12,Bn49981,59957857,77726024,17768167,CN
chr12,Bn49982,82984279,92361151,9376872,TNL
chr12,Bn49983,11068402,44337660,33269258,TNL
chr12,Bn49984,62521951,88819401,26297450,CN
chr12,Bn49985,24074509,80857920,56783411,TNL
chr12,Bn49986,88812613,91108584,2295971,RLK
chr12,Bn49987,58895401,74004348,15108947,TNL
chr12,Bn49988,32486200,56193478,23707278,RLK
chr12,Bn49989,86774156,93194740,6420584,CN
chr12,Bn49990,39166229,66526694,27360465,RLP
chr12,Bn49991,45023230,80943447,35920217,NBS
chr12,Bn49992,29867240,51669702,21802462,CN
chr12,Bn49993,97675133,99967394,2292261,TNL
chr12,Bn49994,90914462,95123142,4208680,TNL
chr12,Bn49995,33093411,58742970,25649559,CNL
chr12,Bn49996,38273729,60114079,21840350,CNL
chr12,Bn49997,69005076,99248685,30243609,TN
chr12,Bn49998,42403690,92414418,50010728,RLK
chr12,Bn49999,18580241,54479318,35899077,NBS
chr12,Bn50000,54625800,92902444,38276644,NBS
chr12,Bn50001,16615053,94481867,77866814,CN
chr12,Bn50002,12544107,25801734,13257627,NBS
chr12,Bn50003,19899613,26627230,6727617,TN
chr12,Bn50004,59658436,95087643,35429207,CNL
chr12,Bn50005,20177306,58330150,38152844,TNL
chr12,Bn50006,14179491,58242378,44062887,CNL
chr12,Bn50007,45239528,75232420,29992892,TNL
chr12,Bn50008,80265586,88614390,8348804,NBS
chr12,Bn50009,49304347,53183125,3878778,CN
chr12,Bn50010,50755621,87540715,36785094,NBS
chr12,Bn50011,37689348,41446386,3757038,CNL
chr12,Bn50012,23149866,72742904,49593038,TN
chr12,Bn50013,25181896,35445954,10264058,CN
chr12,Bn50014,69188434,85535085,16346651,NBS
chr12,Bn50015,17988687,74480255,56491568,CNL
chr12,Bn50016,23552757,77398734,53845977,NBS
chr12,Bn50017,71532616,85220136,13687520,RLK
chr12,Bn50018,16607825,84621167,68013342,NBS
chr12,Bn50019,94324641,94924585,599944,CN
chr12,Bn50020,80722757,98641106,17918349,TNL
chr12,Bn50021,42187041,55553853,13366812,TNL
chr12,Bn50022,64256804,66307022,2050218,NBS
chr12,Bn50023,36494722,41376838,4882116,CNL
chr12,Bn50024,56509020,67340065,10831045,RLK
chr12,Bn50025,50374770,76373627,25998857,TN
chr12,Bn50026,13884613,38575081,24690468,RLP
chr12,Bn50027,87062556,99999396,12936840,CN
chr12,Bn50028,27861631,81878312,54016681,RLP
chr12,Bn50029,83776433,85687276,1910843,CN
chr12,Bn50030,46457657,93714424,47256767,NBS
chr12,Bn50031,23186799,25633939,2447140,NBS
chr12,Bn50032,33964095,60485860,26521765,CNL
chr12,Bn50033,71575001,92199785,20624784,RLK
chr12,Bn50034,52376852,64473092,12096240,RLP
chr12,Bn50035,45584300,82659922,37075622,CN
chr12,Bn50036,54761510,86130391,31368881,CN
chr12,Bn50037,38822069,54811023,15988954,RLK
chr12,Bn50038,91287785,92808529,1520744,CN
chr12,Bn50039,62423093,85403028,22979935,CNL
chr12,Bn50040,7705090,34280487,26575397,RLP
chr12,Bn50041,20593120,22597866,2004746,RLK
chr12,Bn50042,67928505,90422627,22494122,RLK
chr12,Bn50043,89168654,93866479,4697825,RLK
chr12,Bn50044,86630682,91286785,4656103,CNL
chr12,Bn50045,77908444,85369554,7461110,CNL
chr12,Bn50046,82069812,87425976,5356164,CNL
chr12,Bn50047,70935014,93755392,22820378,CNL
chr12,Bn50048,49928262,91460759,41532497,CN
chr12,Bn50049,18120105,28114785,9994680,CN
chr12,Bn50050,54907230,69581523,14674293,NBS
chr12,Bn50051,23382788,35781425,12398637,TN
chr12,Bn50052,53599647,99849465,46249818,NBS
chr12,Bn50053,66434464,84967790,18533326,RLP
chr12,Bn50054,77040740,90053649,13012909,CNL
chr12,Bn50055,69235494,90075422,20839928,CN
chr12,Bn50056,15510363,62730574,47220211,RLK
chr12,Bn50057,8200607,98103944,89903337,RLK
chr12,Bn50058,84906470,91915705,7009235,CNL
chr12,Bn50059,62859049,71354956,8495907,RLK
chr12,Bn50060,39569252,50039935,10470683,TN
chr12,Bn50061,91621461,94951764,3330303,RLP
chr12,Bn50062,80385113,90255723,9870610,NBS
chr12,Bn50063,18479952,85489184,67009232,RLP
chr12,Bn50064,46010948,46193984,183036,RLP
chr12,Bn50065,41491887,62825391,21333504,RLK
chr12,Bn50066,42176776,87569009,45392233,CN
chr12,Bn50067,74165564,83767463,9601899,CN
chr12,Bn50068,51288618,57279678,5991060,CN
chr12,Bn50069,28740025,96601798,67861773,TNL
chr12,Bn50070,53745443,61207375,7461932,CN
chr12,Bn50071,61944316,69611665,7667349,CNL
chr12,Bn50072,16617081,29545591,12928510,TNL
chr12,Bn50073,83424978,96008887,12583909,TN
chr12,Bn50074,30883016,55044429,24161413,CNL
chr12,Bn50075,5725476,98189937,92464461,CNL
chr12,Bn50076,41250597,83476602,42226005,RLP
chr12,Bn50077,84405023,98208845,13803822,NBS
chr12,Bn50078,42411044,81058470,38647426,TNL
chr12,Bn50079,72675777,92141648,19465871,CNL
chr12,Bn50080,84329932,94056138,9726206,NBS
chr12,Bn50081,5558065,26702402,21144337,RLP
chr12,Bn50082,76212902,98348949,22136047,CNL
chr12,Bn50083,45782015,68199108,22417093,RLP
chr12,Bn50084,11046213,99451046,88404833,CN
chr12,Bn50085,82005492,97959474,15953982,CN
chr12,Bn50086,9552087,18956722,9404635,RLK
chr12,Bn50087,76069497,88708002,12638505,TNL
chr12,Bn50088,1587045,10070730,8483685,CN
chr12,Bn50089,33823508,75272654,41449146,CN
chr12,Bn50090,38779995,87415374,48635379,RLK
chr12,Bn50091,5708763,44921811,39213048,CN
chr12,Bn50092,89672587,99335560,9662973,CNL
chr12,Bn50093,18381628,72886920,54505292,TNL
chr12,Bn50094,69831195,80106128,10274933,NBS
chr12,Bn50095,95310197,99352028,4041831,NBS
chr12,Bn50096,10057893,68298363,58240470,TN
chr12,Bn50097,75638047,83582778,7944731,TNL
chr12,Bn50098,76988301,95502527,18514226,CNL
chr12,Bn50099,47887809,72838315,24950506,TNL
chr12,Bn50100,43858326,96760858,52902532,TN
chr12,Bn50101,92010420,97012546,5002126,CNL
chr12,Bn50102,46339043,76051605,29712562,TN
chr12,Bn50103,67519324,78019834,10500510,TN
chr12,Bn50104,44082133,79168724,35086591,CN
chr12,Bn50105,66197582,93419560,27221978,NBS
chr12,Bn50106,19558180,38957323,19399143,NBS
chr12,Bn50107,38719237,91823442,53104205,CN
chr12,Bn50108,38550982,69021896,30470914,RLK
chr12,Bn50109,66014603,90624269,24609666,CN
chr12,Bn50110,88568885,96663510,8094625,RLK
chr12,Bn50111,55387371,83744825,28357454,TN
chr12,Bn50112,73070299,84536703,11466404,TNL
chr12,Bn50113,71848347,93532299,21683952,TNL
chr12,Bn50114,88546937,98007731,9460794,CN
chr12,Bn50115,79287733,85201512,5913779,RLK
chr12,Bn50116,69768662,75625745,5857083,NBS
chr12,Bn50117,70834487,76846306,6011819,RLP
chr12,Bn50118,34575064,42705814,8130750,TNL
chr12,Bn50119,76879423,93979259,17099836,TN
chr12,Bn50120,93170826,96409198,3238372,NBS
chr12,Bn50121,63509117,70163530,6654413,TN
chr12,Bn50122,89170583,91792701,2622118,TN
chr12,Bn50123,50620454,61388690,10768236,CN
chr12,Bn50124,55872184,70592176,14719992,NBS
chr12,Bn50125,97064482,97339831,275349,CN
chr12,Bn50126,93995821,99208689,5212868,CNL
chr12,Bn50127,3820748,48884001,45063253,CNL
chr12,Bn50128,37160917,60007333,22846416,CN
chr12,Bn50129,49902627,91848654,41946027,RLP
chr12,Bn50130,56462828,94390469,37927641,TN
chr12,Bn50131,22007297,79731174,57723877,CNL
chr12,Bn50132,15007232,33228184,18220952,RLP
chr12,Bn50133,5799017,44725771,38926754,TNL
chr12,Bn50134,6749757,99983982,93234225,CN
chr12,Bn50135,44725864,49263940,4538076,TN
chr12,Bn50136,30621477,53831462,23209985,TNL
chr12,Bn50137,63974408,87705776,23731368,RLK
chr12,Bn50138,43578118,46082263,2504145,TNL
chr12,Bn50139,4806025,82612556,77806531,NBS
chr12,Bn50140,84661128,92517869,7856741,CN
chr12,Bn50141,35591494,54135575,18544081,RLP
chr12,Bn50142,88706387,95757338,7050951,TNL
chr12,Bn50143,17691056,20255513,2564457,TN
chr12,Bn50144,50990571,57876039,6885468,NBS
chr12,Bn50145,46628038,82416949,35788911,CN
chr12,Bn50146,45400099,68861537,23461438,NBS
chr12,Bn50147,1419594,74015561,72595967,TN
chr12,Bn50148,96688339,98014196,1325857,CN
chr12,Bn50149,65627189,92431685,26804496,CN
chr12,Bn50150,61235357,76940035,15704678,CN
chr12,Bn50151,26276798,76026731,49749933,RLP
chr12,Bn50152,59737446,92444860,32707414,CN
chr12,Bn50153,78562949,92438195,13875246,CNL
chr12,Bn50154,72832809,97037252,24204443,TN
chr12,Bn50155,37537911,38422403,884492,NBS
chr12,Bn50156,4700331,91811399,87111068,RLK
chr12,Bn50157,92961539,98634170,5672631,CN
chr12,Bn50158,1768584,96045350,94276766,TN
chr12,Bn50159,29492129,43754898,14262769,RLK
chr12,Bn50160,62051444,69995940,7944496,CN
chr12,Bn50161,55700038,82280873,26580835,CN
chr12,Bn50162,63045218,92961419,29916201,CNL
chr12,Bn50163,96784663,98517913,1733250,CNL
chr12,Bn50164,16353642,23704317,7350675,RLP
chr12,Bn50165,75859688,85725171,9865483,RLK
chr12,Bn50166,23677377,90267336,66589959,CNL
chr12,Bn50167,53394710,81425314,28030604,CNL
chr12,Bn50168,70487991,76416930,5928939,RLK
chr12,Bn50169,42684444,51436676,8752232,CN
chr12,Bn50170,78058197,85985119,7926922,TN
chr12,Bn50171,45491298,55678235,10186937,RLK
chr12,Bn50172,38566701,96151303,57584602,RLK
chr12,Bn50173,99973575,99987061,13486,TNL
chr12,Bn50174,26636544,40934730,14298186,CNL
chr12,Bn50175,78577442,82877839,4300397,RLP
chr12,Bn50176,17287692,32019077,14731385,CN
chr12,Bn50177,84198104,92164974,7966870,NBS
chr12,Bn50178,12794731,81266951,68472220,CNL
chr12,Bn50179,96948437,98343295,1394858,RLK
chr12,Bn50180,29409820,47136627,17726807,TNL
chr12,Bn50181,58548373,69930866,11382493,NBS
chr12,Bn50182,51943584,64658359,12714775,CNL
chr12,Bn50183,36852934,89129866,52276932,CN
chr12,Bn50184,95036993,95068382,31389,TNL
chr12,Bn50185,6475611,98778726,92303115,NBS
chr12,Bn50186,92531042,99627774,7096732,RLK
chr12,Bn50187,5571833,26102940,20531107,CNL
chr12,Bn50188,62574498,98780864,36206366,TN
chr12,Bn50189,35005881,57766016,22760135,CNL
chr12,Bn50190,68277054,97307599,29030545,CN
chr12,Bn50191,16606236,75070577,58464341,CN
chr12,Bn50192,54683217,78934747,24251530,NBS
chr12,Bn50193,20326862,57773355,37446493,TN
chr12,Bn50194,17606066,42126513,24520447,RLP
chr12,Bn50195,99591468,99906092,314624,CN
chr12,Bn50196,13160124,17600689,4440565,CNL
chr12,Bn50197,8712640,16396095,7683455,RLP
chr12,Bn50198,52074571,79917514,27842943,CNL
chr12,Bn50199,42705478,44567447,1861969,TN
chr12,Bn50200,51650036,66413701,14763665,TNL
chr12,Bn50201,56027056,74215507,18188451,RLP
chr12,Bn50202,41217806,94214697,52996891,RLP
chr12,Bn50203,34966325,98003552,63037227,CN
chr12,Bn50204,24661224,27083594,2422370,TN
chr12,Bn50205,24560007,46501442,21941435,TN
chr12,Bn50206,21035184,45878932,24843748,CNL
chr12,Bn50207,23485385,85067296,61581911,RLP
chr12,Bn50208,43351163,81554092,38202929,RLK
chr12,Bn50209,56188579,87561785,31373206,TNL
chr12,Bn50210,80915730,93120981,12205251,TNL
chr12,Bn50211,30662975,58117377,27454402,TNL
chr12,Bn50212,23583606,91167181,67583575,RLP
chr12,Bn50213,13983395,80063662,66080267,TN
chr12,Bn50214,44419462,86049985,41630523,TNL
chr12,Bn50215,66430917,83847712,17416795,RLP
chr12,Bn50216,10581104,69473837,58892733,CNL
chr12,Bn50217,55115137,69247507,14132370,RLK
chr12,Bn50218,1100148,25721788,24621640,NBS
chr12,Bn50219,65700453,95620238,29919785,TNL
chr12,Bn50220,60010447,68274952,8264505,TNL
chr12,Bn50221,64976252,98983656,34007404,CN
chr12,Bn50222,26115302,32004343,5889041,TN
chr12,Bn50223,35391859,75726118,40334259,TN
chr12,Bn50224,48726421,69666320,20939899,RLK
chr12,Bn50225,65093190,71831436,6738246,CNL
chr12,Bn50226,71584032,85907585,14323553,TNL
chr12,Bn50227,13143712,64200521,51056809,RLP
chr12,Bn50228,72133552,85586848,13453296,RLK
chr12,Bn50229,46972175,92448452,45476277,NBS
chr12,Bn50230,36606249,54741981,18135732,CNL
chr12,Bn50231,68203615,97563782,29360167,CN
chr12,Bn50232,98219639,98653600,433961,CN
chr12,Bn50233,52291551,56874716,4583165,TN
chr12,Bn50234,28360179,48221049,19860870,TNL
chr12,Bn50235,41541465,51247006,9705541,CN
chr12,Bn50236,1173069,46029632,44856563,CN
chr12,Bn50237,50793946,58590283,7796337,TNL
chr12,Bn50238,94501512,95066914,565402,RLK
chr12,Bn50239,44742920,78559201,33816281,TNL
chr12,Bn50240,9809890,56887190,47077300,CN
chr12,Bn50241,7625164,72145026,64519862,RLP
chr12,Bn50242,89203961,93504273,4300312,TN
chr12,Bn50243,72576641,82687424,10110783,RLP
chr12,Bn50244,54066477,65317673,11251196,RLK
chr12,Bn50245,99448334,99957973,509639,RLP
chr12,Bn50246,91776595,92556420,779825,TNL
chr12,Bn50247,81660591,83563293,1902702,TN
chr12,Bn50248,15832991,47049546,31216555,RLP
chr12,Bn50249,19356774,35390228,16033454,RLP
chr12,Bn50250,95358989,98948189,3589200,TN
chr12,Bn50251,84739972,91972737,7232765,RLP
chr12,Bn50252,41360428,94069441,52709013,CN
chr12,Bn50253,73524586,87538981,14014395,CNL
chr12,Bn50254,22343891,69581817,47237926,TN
chr12,Bn50255,69179680,78040622,8860942,CNL
chr12,Bn50256,46704691,99153193,52448502,TN
chr12,Bn50257,98387883,98861728,473845,RLK
chr12,Bn50258,49613403,82938497,33325094,RLK
chr12,Bn50259,95839535,99399508,3559973,RLK
chr12,Bn50260,61873616,98090109,36216493,CN
chr12,Bn50261,34932340,91831774,56899434,CN
chr12,Bn50262,72661592,84991610,12330018,NBS
chr12,Bn50263,70040652,73780062,3739410,RLP
chr12,Bn50264,57996711,92665863,34669152,TN
chr12,Bn50265,27219484,63806446,36586962,NBS
chr12,Bn50266,82648790,88987126,6338336,RLP
chr12,Bn50267,7473411,47030225,39556814,CNL
chr12,Bn50268,79539196,82798476,3259280,RLP
chr12,Bn50269,4914848,99279330,94364482,NBS
chr12,Bn50270,78195065,93509690,15314625,TN
chr12,Bn50271,25983510,68154609,42171099,TNL
chr12,Bn50272,27418453,73675688,46257235,TN
chr12,Bn50273,26304133,49772031,23467898,TN
chr12,Bn50274,21045655,54480430,33434775,NBS
chr12,Bn50275,4038263,5102538,1064275,RLK
chr12,Bn50276,3072834,68660957,65588123,RLP
chr12,Bn50277,21812393,31215662,9403269,TNL
chr12,Bn50278,98495446,98535484,40038,CNL
chr12,Bn50279,68448535,89205580,20757045,TNL
chr12,Bn50280,13821650,72844130,59022480,CNL
chr12,Bn50281,53268434,53742638,474204,TNL
chr12,Bn50282,37647411,44010328,6362917,RLK
chr12,Bn50283,36347673,60988661,24640988,CNL
chr12,Bn50284,48726942,78885105,30158163,NBS
chr12,Bn50285,29673315,68247933,38574618,TNL
chr12,Bn50286,77243627,97118357,19874730,TNL
chr12,Bn50287,86969278,93527760,6558482,RLP
chr12,Bn50288,53229590,88544260,35314670,TNL
chr12,Bn50289,60640667,76643789,16003122,TNL
chr12,Bn50290,64319779,70061929,5742150,CN
chr12,Bn50291,48647446,82079759,33432313,TN
chr12,Bn50292,43948552,90711551,46762999,CNL
chr12,Bn50293,16294529,74759378,58464849,RLP
chr12,Bn50294,28686548,38589253,9902705,RLP
chr12,Bn50295,15394118,19949412,4555294,TNL
chr12,Bn50296,19872536,72953226,53080690,NBS
chr12,Bn50297,27887760,98579820,70692060,CN
chr12,Bn50298,44203850,56300861,12097011,CNL
chr12,Bn50299,44871169,93241523,48370354,RLK
chr12,Bn50300,63748025,91090385,27342360,CN
chr12,Bn50301,12457828,16652104,4194276,CNL
chr12,Bn50302,42956841,75407905,32451064,TN
chr12,Bn50303,94503231,96734584,2231353,RLK
chr12,Bn50304,98001933,98424822,422889,RLK
chr12,Bn50305,33437652,45014093,11576441,NBS
chr12,Bn50306,70507768,92507155,21999387,TN
chr12,Bn50307,16202049,54369758,38167709,NBS
chr12,Bn50308,99211308,99412245,200937,TN
chr12,Bn50309,58909470,90768251,31858781,TN
chr12,Bn50310,25270661,88556395,63285734,CNL
chr12,Bn50311,89026135,94262856,5236721,CN
chr12,Bn50312,44197626,66542237,22344611,TN
chr12,Bn50313,20325211,84386503,64061292,TNL
chr12,Bn50314,96382281,98425561,2043280,RLK
chr12,Bn50315,8410562,84638984,76228422,TN
chr12,Bn50316,42810891,62497890,19686999,TNL
chr12,Bn50317,10106940,93629969,83523029,NBS
chr12,Bn50318,50295484,91125881,40830397,RLK
chr12,Bn50319,70183810,92663039,22479229,RLP
chr12,Bn50320,45818111,87898038,42079927,TNL
chr12,Bn50321,81258683,85213072,3954389,TN
chr12,Bn50322,28790094,45725880,16935786,CNL
chr12,Bn50323,11550265,78786776,67236511,CNL
chr12,Bn50324,33853200,60379298,26526098,RLP
chr12,Bn50325,4077148,80913503,76836355,RLK
chr12,Bn50326,67416448,69142805,1726357,NBS
chr12,Bn50327,72108332,84544085,12435753,TN
chr12,Bn50328,32020903,97916077,65895174,NBS
chr12,Bn50329,11257537,84628147,73370610,CNL
chr12,Bn50330,35289819,54312185,19022366,TN
chr12,Bn50331,44962836,54784394,9821558,RLK
chr12,Bn50332,84742577,85483094,740517,TNL
chr12,Bn50333,2163339,28545301,26381962,RLP
chr12,Bn50334,17760326,60548277,42787951,CNL
chr12,Bn50335,30271224,95973219,65701995,RLK
chr12,Bn50336,37251057,69049812,31798755,NBS
chr12,Bn50337,53996004,64945801,10949797,CNL
chr12,Bn50338,62090498,95707826,33617328,NBS
chr12,Bn50339,74382914,76137260,1754346,RLP
chr12,Bn50340,22680237,29492547,6812310,RLK
chr12,Bn50341,40328851,99448665,59119814,RLP
chr12,Bn50342,57741725,59526507,1784782,RLK
chr12,Bn50343,60079550,65311678,5232128,CNL
chr12,Bn50344,28228271,56929280,28701009,NBS
chr12,Bn50345,62729236,68735574,6006338,TN
chr12,Bn50346,18496970,77565976,59069006,CNL
chr12,Bn50347,98363911,99540894,1176983,TNL
chr12,Bn50348,79926843,92925805,12998962,RLK
chr12,Bn50349,87936942,92584563,4647621,RLP
chr12,Bn50350,46620600,95824881,49204281,TN
chr12,Bn50351,43188537,48575957,5387420,NBS
chr12,Bn50352,44819961,62966157,18146196,RLP
chr12,Bn50353,84674588,93124698,8450110,NBS
chr12,Bn50354,23046919,93490199,70443280,RLK
chr12,Bn50355,87576409,89844381,2267972,CN
chr12,Bn50356,25682397,97748495,72066098,NBS
chr12,Bn50357,84913382,92313075,7399693,TNL
chr12,Bn50358,37861400,53339357,15477957,RLP
chr12,Bn50359,69112944,72659634,3546690,RLK
chr12,Bn50360,58728601,81532608,22804007,TN
chr12,Bn50361,68805276,95731113,26925837,CNL
chr12,Bn50362,1894551,60252574,58358023,CNL
chr12,Bn50363,89031755,92528259,3496504,TNL
chr12,Bn50364,75582318,75814346,232028,RLP
chr12,Bn50365,39286090,97266453,57980363,CN
chr12,Bn50366,17006211,28798229,11792018,CNL
chr12,Bn50367,5551426,60866194,55314768,RLP
chr12,Bn50368,70609868,93545012,22935144,TN
chr12,Bn50369,99836728,99838260,1532,CN
chr12,Bn50370,2405943,92079187,89673244,RLK
chr12,Bn50371,13920254,18152105,4231851,NBS
chr12,Bn50372,61253915,71969721,10715806,RLK
chr12,Bn50373,17943581,97947654,80004073,RLK
chr12,Bn50374,8233946,48803600,40569654,TN
chr12,Bn50375,80707635,95960022,15252387,CNL
chr12,Bn50376,97043327,99810460,2767133,TNL
chr12,Bn50377,57007634,94691956,37684322,CNL
chr12,Bn50378,71832219,87501218,15668999,CNL
chr12,Bn50379,98677783,99374642,696859,CNL
chr12,Bn50380,59435715,98083192,38647477,NBS
chr12,Bn50381,60804330,94188295,33383965,RLK
chr12,Bn50382,5561499,44153946,38592447,RLP
chr12,Bn50383,50879866,73809897,22930031,TN
chr12,Bn50384,68591176,93052160,24460984,CNL
chr12,Bn50385,12547735,70116120,57568385,TN
chr12,Bn50386,51161575,78546131,27384556,RLP
chr12,Bn50387,54533009,87152082,32619073,CNL
chr12,Bn50388,61753188,64889671,3136483,RLP
chr12,Bn50389,40128195,46548122,6419927,RLP
chr12,Bn50390,82592285,85659846,3067561,RLK
chr12,Bn50391,23569225,52645181,29075956,CN
chr12,Bn50392,72309613,81245688,8936075,CNL
chr12,Bn50393,37033049,60614220,23581171,CN
chr12,Bn50394,98603956,99063331,459375,NBS
chr12,Bn50395,63785960,87151912,23365952,RLP
chr12,Bn50396,58759808,63350080,4590272,TNL
chr12,Bn50397,14061078,84277518,70216440,CN
chr12,Bn50398,97819788,99432963,1613175,RLK
chr12,Bn50399,90077575,91644252,1566677,RLK
chr12,Bn50400,37812163,96084925,58272762,NBS
chr12,Bn50401,43509222,72801624,29292402,NBS
chr12,Bn50402,80714446,87712469,6998023,RLK
chr12,Bn50403,45992276,78755251,32762975,TNL
chr12,Bn50404,96771265,97133854,362589,RLK
chr12,Bn50405,92573155,98425663,5852508,TNL
chr12,Bn50406,76155743,84600086,8444343,TNL
chr12,Bn50407,54230403,94071259,39840856,RLK
chr12,Bn50408,24921496,64493190,39571694,CNL
chr12,Bn50409,35381339,75480703,40099364,NBS
chr12,Bn50410,79434696,95559522,16124826,RLP
chr12,Bn50411,55950297,63788971,7838674,CNL
chr12,Bn50412,89519585,93014776,3495191,RLK
chr12,Bn50413,36911512,87980819,51069307,CNL
chr12,Bn50414,79314716,81405655,2090939,CNL
chr12,Bn50415,75593685,97584986,21991301,NBS
chr12,Bn50416,94859354,96097239,1237885,RLK
chr12,Bn50417,5943117,14855754,8912637,NBS
chr12,Bn50418,43694484,70468249,26773765,RLP
chr12,Bn50419,2624363,75001111,72376748,RLK
chr12,Bn50420,72218647,84613767,12395120,NBS
chr12,Bn50421,62832581,89006740,26174159,TNL
chr12,Bn50422,26681553,89598953,62917400,CNL
chr12,Bn50423,81408350,87619083,6210733,TN
chr12,Bn50424,22320673,84341759,62021086,CNL
chr12,Bn50425,99698400,99763201,64801,NBS
chr12,Bn50426,58745303,95674545,36929242,NBS
chr12,Bn50427,24205537,99961585,75756048,CN
chr12,Bn50428,33734226,43480003,9745777,TNL
chr12,Bn50429,59585385,98069927,38484542,CN
chr12,Bn50430,81888273,83849194,1960921,RLK
chr12,Bn50431,12730298,51773922,39043624,TN
chr12,Bn50432,13463623,51886101,38422478,CN
chr12,Bn50433,10491012,27736988,17245976,CN
chr12,Bn50434,88205850,99375492,11169642,TNL
chr12,Bn50435,56188893,70880821,14691928,CN
chr12,Bn50436,64788677,68765058,3976381,NBS
chr12,Bn50437,39013613,50725408,11711795,TN
chr12,Bn50438,51475364,65559793,14084429,TN
chr12,Bn50439,52210709,69319440,17108731,TNL
chr12,Bn50440,86156384,86789453,633069,CN
chr12,Bn50441,29671005,32179765,2508760,CN
chr12,Bn50442,5532884,84543008,79010124,CNL
chr12,Bn50443,85027070,96319686,11292616,RLP
chr12,Bn50444,85312242,97758628,12446386,NBS
chr12,Bn50445,61329415,72641479,11312064,RLP
chr12,Bn50446,7025258,32438647,25413389,CNL
chr12,Bn50447,29262404,32606749,3344345,RLP
chr12,Bn50448,93729265,93986960,257695,RLP
chr12,Bn50449,15543350,84585887,69042537,TNL
chr12,Bn50450,30402206,43456562,13054356,TNL
chr12,Bn50451,67243937,91303944,24060007,RLK
chr12,Bn50452,86718641,96972027,10253386,RLP
chr12,Bn50453,39144609,58502523,19357914,RLP
chr12,Bn50454,33319408,53798317,20478909,RLP
chr12,Bn50455,22909638,34323043,11413405,CNL
chr12,Bn50456,21437639,81047093,59609454,CNL
chr12,Bn50457,54755408,67267538,12512130,CNL
chr12,Bn50458,66214510,88225637,22011127,CN
chr12,Bn50459,21603346,38010988,16407642,CNL
chr12,Bn50460,69938918,93953262,24014344,NBS
chr12,Bn50461,15342527,67317705,51975178,NBS
chr12,Bn50462,85290371,95200237,9909866,TNL
chr12,Bn50463,5483248,40110359,34627111,TN
chr12,Bn50464,5255605,13641594,8385989,RLK
chr12,Bn50465,26794258,78306785,51512527,TN
chr12,Bn50466,15082070,92397346,77315276,CNL
chr12,Bn50467,83331358,84002649,671291,RLP
chr12,Bn50468,20282905,86373605,66090700,RLK
chr12,Bn50469,7788196,64521859,56733663,TNL
chr12,Bn50470,59130851,72335397,13204546,TNL
chr12,Bn50471,52119691,73490943,21371252,TN
chr12,Bn50472,20907401,40774873,19867472,CN
chr12,Bn50473,63363817,74014410,10650593,TN
chr12,Bn50474,42991929,55846289,12854360,TN
chr12,Bn50475,40902856,74545785,33642929,CN
chr12,Bn50476,29904674,76863567,46958893,CN
chr12,Bn50477,34998047,59295968,24297921,TN
chr12,Bn50478,65054704,67168147,2113443,NBS
chr12,Bn50479,88539357,96171144,7631787,CN
chr12,Bn50480,9392207,20889585,11497378,NBS
chr12,Bn50481,39251087,43711180,4460093,RLP
chr12,Bn50482,50782302,80877365,30095063,NBS
chr12,Bn50483,72127277,73909099,1781822,TN
chr12,Bn50484,26280810,70825109,44544299,NBS
chr12,Bn50485,59391320,75825429,16434109,RLP
chr12,Bn50486,17209106,77514421,60305315,CN
chr12,Bn50487,88604333,91753059,3148726,CNL
chr12,Bn50488,96246590,98071029,1824439,RLK
chr12,Bn50489,98443101,99104892,661791,NBS
chr12,Bn50490,12467326,61128883,48661557,TN
chr12,Bn50491,5617047,79828671,74211624,CNL
chr12,Bn50492,27426416,81759920,54333504,TNL
chr12,Bn50493,36922321,97267891,60345570,TNL
chr12,Bn50494,55433398,60511025,5077627,CNL
chr12,Bn50495,54988410,71284231,16295821,RLP
chr12,Bn50496,10796043,89399006,78602963,RLK
chr12,Bn50497,72558178,99701422,27143244,RLK
chr12,Bn50498,31826198,56081102,24254904,RLK
chr12,Bn50499,26518229,41657799,15139570,CN
chr12,Bn50500,19704156,19783807,79651,RLP
chr12,Bn50501,59197467,87573167,28375700,CNL
chr12,Bn50502,21442641,95433032,73990391,RLP
chr12,Bn50503,5529117,77658673,72129556,RLK
chr12,Bn50504,26237720,71566131,45328411,NBS
chr12,Bn50505,7011294,18052748,11041454,TN
chr12,Bn50506,22113012,74679050,52566038,RLP
chr12,Bn50507,26298671,47974568,21675897,NBS
chr12,Bn50508,27006338,89437789,62431451,NBS
chr12,Bn50509,71857413,83618451,11761038,TN
chr12,Bn50510,40860863,69511026,28650163,CNL
chr12,Bn50511,58974234,89111366,30137132,TNL
chr12,Bn50512,20628254,90630078,70001824,NBS
chr12,Bn50513,18896597,79491815,60595218,CNL
chr12,Bn50514,55844468,91655196,35810728,CNL
chr12,Bn50515,67242209,69760418,2518209,TNL
chr12,Bn50516,75483965,82714203,7230238,RLP
chr12,Bn50517,56157339,68216671,12059332,CNL
chr12,Bn50518,34256101,64093761,29837660,NBS
chr12,Bn50519,68141154,98204101,30062947,RLK
chr12,Bn50520,23376032,99736516,76360484,CN
chr12,Bn50521,70941143,87282057,16340914,TNL
chr12,Bn50522,64249239,67346088,3096849,NBS
chr12,Bn50523,25240790,80602822,55362032,TNL
chr12,Bn50524,51754673,88762591,37007918,TN
chr12,Bn50525,68938737,74586500,5647763,CN
chr12,Bn50526,90262247,99027617,8765370,RLK
chr12,Bn50527,31572760,67583660,36010900,TNL
chr12,Bn50528,71190310,84922190,13731880,TN
chr12,Bn50529,10918208,38295326,27377118,NBS
chr12,Bn50530,14055560,81736850,67681290,TNL
chr12,Bn50531,49847700,73251772,23404072,TN
chr12,Bn50532,91682040,92776738,1094698,RLP
chr12,Bn50533,61446673,62628787,1182114,TN
chr12,Bn50534,46610149,52691248,6081099,RLK
chr12,Bn50535,78038777,97247621,19208844,RLP
chr12,Bn50536,87760534,98799243,11038709,TNL
chr12,Bn50537,91930470,97052839,5122369,TNL
chr12,Bn50538,71196780,82508155,11311375,CNL
chr12,Bn50539,15155518,96425454,81269936,CNL
chr12,Bn50540,39719215,82911916,43192701,RLK
chr12,Bn50541,54165127,95527892,41362765,CN
chr12,Bn50542,30874127,56752675,25878548,TNL
chr12,Bn50543,53108941,99145472,46036531,CN
chr12,Bn50544,78908914,97675785,18766871,CN
chr12,Bn50545,39756653,71874420,32117767,TN
chr12,Bn50546,96433763,97248942,815179,RLK
chr12,Bn50547,23187852,83108815,59920963,TNL
chr12,Bn50548,74057233,81122678,7065445,CN
chr12,Bn50549,41093685,82106934,41013249,CN
chr12,Bn50550,85151524,97512156,12360632,CN
chr12,Bn50551,91088919,98988079,7899160,TNL
chr12,Bn50552,98302497,99347041,1044544,RLK
chr12,Bn50553,91518021,98500651,6982630,RLP
chr12,Bn50554,40285752,74528594,34242842,CNL
chr12,Bn50555,19683104,50025453,30342349,RLP
chr12,Bn50556,61454522,97588480,36133958,NBS
chr12,Bn50557,48403304,79333836,30930532,TNL
chr12,Bn50558,78837514,99536212,20698698,CNL
chr12,Bn50559,10238346,83201842,72963496,TNL
chr12,Bn50560,23575470,60838796,37263326,RLK
chr12,Bn50561,29034702,37873909,8839207,RLK
chr12,Bn50562,73707635,91889514,18181879,CN
chr12,Bn50563,11531725,99527850,87996125,RLP
chr12,Bn50564,61832260,95718864,33886604,TNL
chr12,Bn50565,22760619,47236206,24475587,RLP
chr12,Bn50566,44521737,66497699,21975962,TNL
chr12,Bn50567,95502848,95849848,347000,RLP
chr12,Bn50568,81775589,99518791,17743202,CN
chr12,Bn50569,23298266,24242802,944536,TNL
chr12,Bn50570,73349989,94646185,21296196,RLK
chr12,Bn50571,54346386,93375460,39029074,RLK
chr12,Bn50572,92125027,98802081,6677054,TNL
chr12,Bn50573,86670271,87304254,633983,TN
chr12,Bn50574,87057612,91646175,4588563,NBS
chr12,Bn50575,51783469,94934985,43151516,CNL
chr12,Bn50576,14965979,17871764,2905785,NBS
chr12,Bn50577,18816008,87499080,68683072,RLP
chr12,Bn50578,21832782,73646573,51813791,NBS
chr12,Bn50579,35852455,99897861,64045406,TNL
chr12,Bn50580,82007144,96397857,14390713,CNL
chr12,Bn50581,23479388,51107120,27627732,TN
chr12,Bn50582,36116710,95055154,58938444,TN
chr12,Bn50583,4535013,33314237,28779224,TN
chr12,Bn50584,81581800,83555125,1973325,RLK
chr12,Bn50585,47568077,83498098,35930021,CN
chr12,Bn50586,64725211,94973840,30248629,NBS
chr12,Bn50587,39935582,46256827,6321245,CNL
chr12,Bn50588,73092256,82512798,9420542,TN
chr12,Bn50589,94781989,94830748,48759,TN
chr12,Bn50590,21512517,96382902,74870385,CN
chr12,Bn50591,51762128,80800011,29037883,CNL
chr12,Bn50592,66520487,71409246,4888759,CN
chr12,Bn50593,98423087,99544917,1121830,TNL
chr12,Bn50594,7910960,62414767,54503807,RLP
chr12,Bn50595,79047164,82418098,3370934,NBS
chr12,Bn50596,65056252,89485297,24429045,RLP
chr12,Bn50597,85832157,93690279,7858122,CN
chr12,Bn50598,21501495,45044506,23543011,TN
chr12,Bn50599,28424966,37805737,9380771,RLK
chr12,Bn50600,28896992,81895196,52998204,TN
chr12,Bn50601,33006167,41433647,8427480,CNL
chr12,Bn50602,60283115,96694009,36410894,RLK
chr12,Bn50603,16003962,26925110,10921148,TNL
chr12,Bn50604,51907877,83084726,31176849,CNL
chr12,Bn50605,24303706,98176125,73872419,CN
chr12,Bn50606,27804630,63537672,35733042,CNL
chr12,Bn50607,48206523,71873174,23666651,RLK
chr12,Bn50608,60746115,79349686,18603571,TN
chr12,Bn50609,56882421,95771052,38888631,TNL
chr12,Bn50610,44935646,80905287,35969641,RLP
chr12,Bn50611,2677420,85338880,82661460,NBS
chr12,Bn50612,91701330,97614061,5912731,TN
chr12,Bn50613,83279020,86736930,3457910,RLP
chr12,Bn50614,14427733,86706156,72278423,CN
chr12,Bn50615,58820890,77006400,18185510,CNL
chr12,Bn50616,26301674,91894476,65592802,RLP
chr12,Bn50617,16021956,69009190,52987234,RLP
chr12,Bn50618,23528842,26133163,2604321,CNL
chr12,Bn50619,67120138,88731973,21611835,CN
chr12,Bn50620,85932912,98964696,13031784,RLP
chr12,Bn50621,27773797,92208831,64435034,TN
chr12,Bn50622,98020629,98986241,965612,RLK
chr12,Bn50623,57765197,90003784,32238587,RLP
chr12,Bn50624,92066837,92708814,641977,NBS
chr12,Bn50625,29686973,41800436,12113463,CN
chr12,Bn50626,46964941,84707037,37742096,TN
chr12,Bn50627,71748018,74112568,2364550,CNL
chr12,Bn50628,78567676,83216605,4648929,NBS
chr12,Bn50629,89597251,95002027,5404776,TN
chr12,Bn50630,80869286,91577406,10708120,NBS
chr12,Bn50631,44047523,47866770,3819247,CN
chr12,Bn50632,44344110,55733979,11389869,CNL
chr12,Bn50633,62621134,62836718,215584,RLK
chr12,Bn50634,72579043,90665467,18086424,RLK
chr12,Bn50635,84451950,95775246,11323296,RLK
chr12,Bn50636,69228462,98612419,29383957,NBS
chr12,Bn50637,73651449,75549844,1898395,TN
chr12,Bn50638,72818120,80232562,7414442,RLP
chr12,Bn50639,58908509,74529314,15620805,TNL
chr12,Bn50640,28207143,75868449,47661306,CNL
chr12,Bn50641,25011179,60664665,35653486,CN
chr12,Bn50642,92072579,93437474,1364895,RLK
chr12,Bn50643,71927671,79315218,7387547,TNL
chr12,Bn50644,46482089,92052364,45570275,TNL
chr12,Bn50645,88901296,96509350,7608054,TN
chr12,Bn50646,13551347,53604752,40053405,NBS
chr12,Bn50647,7884505,94742423,86857918,NBS
chr12,Bn50648,36392384,75817107,39424723,TNL
chr12,Bn50649,62293170,85195646,22902476,CNL
chr12,Bn50650,34293566,74462145,40168579,CNL
chr12,Bn50651,15553626,22432139,6878513,RLP
chr12,Bn50652,86576713,89238228,2661515,TN
chr12,Bn50653,13294169,88916923,75622754,CNL
chr12,Bn50654,8253647,25708642,17454995,CN
chr12,Bn50655,54691456,93616002,38924546,CN
chr12,Bn50656,31796376,32992044,1195668,CN
chr12,Bn50657,26985194,85887402,58902208,TNL
chr12,Bn50658,72620657,99069294,26448637,CN
chr12,Bn50659,23019055,28022495,5003440,CNL
chr12,Bn50660,37618281,52768995,15150714,RLK
chr12,Bn50661,33149694,83355349,50205655,CNL
chr12,Bn50662,24884232,57005776,32121544,RLP
chr12,Bn50663,78773585,94005250,15231665,TNL
chr12,Bn50664,53563481,78236990,24673509,RLP
chr12,Bn50665,80501678,95095580,14593902,NBS
chr12,Bn50666,2574123,95740278,93166155,RLP
chr12,Bn50667,43239234,81280557,38041323,TNL
chr12,Bn50668,7175049,38119804,30944755,CN
chr12,Bn50669,34015046,50771414,16756368,TN
chr12,Bn50670,51798612,55957452,4158840,RLK
chr12,Bn50671,42169647,75695774,33526127,NBS
chr12,Bn50672,96248867,96561398,312531,TNL
chr12,Bn50673,53785840,75870275,22084435,TN
chr12,Bn50674,5647088,56374042,50726954,CN
chr12,Bn50675,58035936,81879568,23843632,CN
chr12,Bn50676,76476135,97075438,20599303,TNL
chr12,Bn50677,51400873,65906916,14506043,NBS
chr12,Bn50678,47054233,52035513,4981280,RLK
chr12,Bn50679,48522301,94615167,46092866,RLP
chr12,Bn50680,86019938,96364675,10344737,TN
chr12,Bn50681,20927303,56591700,35664397,CNL
chr12,Bn50682,53552370,95685638,42133268,CN
chr12,Bn50683,39371442,57360420,17988978,CN
chr12,Bn50684,97210254,99328621,2118367,NBS
chr12,Bn50685,55690546,60358244,4667698,TNL
chr12,Bn50686,21083978,98565546,77481568,CN
chr12,Bn50687,3277694,51964145,48686451,CNL
chr12,Bn50688,14032969,99136200,85103231,TN
chr12,Bn50689,49310567,74128928,24818361,TNL
chr12,Bn50690,71695980,90542978,18846998,NBS
chr12,Bn50691,82588542,88557591,5969049,RLK
chr12,Bn50692,2979538,66474723,63495185,TN
chr12,Bn50693,24798916,51352507,26553591,CNL
chr12,Bn50694,41003792,63324739,22320947,CNL
chr12,Bn50695,81107007,97691921,16584914,RLK
chr12,Bn50696,94360160,95466087,1105927,RLK
chr12,Bn50697,42434689,91267315,48832626,CN
chr12,Bn50698,90269904,96569849,6299945,TN
chr12,Bn50699,80935129,92876377,11941248,TNL
chr12,Bn50700,92708327,93008448,300121,CNL
chr12,Bn50701,34575886,37349846,2773960,TNL
chr12,Bn50702,10719819,45489934,34770115,NBS
chr12,Bn50703,68190084,84718331,16528247,RLK
chr12,Bn50704,28879148,67430416,38551268,RLK
chr12,Bn50705,98197846,98453792,255946,TN
chr12,Bn50706,20578079,31170194,10592115,TNL
chr12,Bn50707,19470605,31208876,11738271,CNL
chr12,Bn50708,29556692,49166827,19610135,NBS
chr12,Bn50709,96983942,98767936,1783994,CNL
chr12,Bn50710,74184197,98600145,24415948,NBS
chr12,Bn50711,79248555,98164157,18915602,TN
chr12,Bn50712,22620327,71797323,49176996,NBS
chr12,Bn50713,38380267,99702321,61322054,RLK
chr12,Bn50714,45046821,68193849,23147028,CN
chr12,Bn50715,25750185,71692093,45941908,TNL
chr12,Bn50716,98843758,98906298,62540,NBS
chr12,Bn50717,38804902,75818781,37013879,RLK
chr12,Bn50718,53070068,76832102,23762034,RLK
chr12,Bn50719,55319900,63844864,8524964,CNL
chr12,Bn50720,40043205,60884658,20841453,CN
chr12,Bn50721,90336763,90754565,417802,TNL
chr12,Bn50722,16993148,34748183,17755035,TNL
chr12,Bn50723,24492062,81542044,57049982,CN
chr12,Bn50724,61240458,94349277,33108819,CN
chr12,Bn50725,82832481,85998827,3166346,CNL
chr12,Bn50726,42455135,72757823,30302688,CNL
chr12,Bn50727,20389243,36761078,16371835,NBS
chr12,Bn50728,79873646,93210780,13337134,TN
chr12,Bn50729,2301312,38262468,35961156,RLP
chr12,Bn50730,37117471,91097383,53979912,TN
chr12,Bn50731,21710645,97220505,75509860,CNL
chr12,Bn50732,94021976,99310163,5288187,RLK
chr12,Bn50733,68547039,99504600,30957561,TN
chr12,Bn50734,96899436,97022463,123027,RLP
chr12,Bn50735,50193818,96488171,46294353,TNL
chr12,Bn50736,77670950,86095464,8424514,TNL
chr12,Bn50737,91387625,97151922,5764297,TNL
chr12,Bn50738,9096172,44539030,35442858,RLK
chr12,Bn50739,73651407,79219988,5568581,CN
chr12,Bn50740,58020280,80501126,22480846,TNL
chr12,Bn50741,2512833,24575478,22062645,RLK
chr12,Bn50742,56756200,95280656,38524456,CN
chr12,Bn50743,18207876,79971253,61763377,NBS
chr12,Bn50744,16405531,35097850,18692319,CNL
chr12,Bn50745,83673812,91843084,8169272,TN
chr12,Bn50746,74567519,88600377,14032858,CNL
chr12,Bn50747,29616460,68750433,39133973,NBS
chr12,Bn50748,1621481,55150366,53528885,TN
chr12,Bn50749,90610329,96610638,6000309,CNL
chr12,Bn50750,99925581,99947467,21886,RLK
chr12,Bn50751,87346744,89043614,1696870,CNL
chr12,Bn50752,59165666,97719341,38553675,NBS
chr12,Bn50753,44951775,71743654,26791879,TNL
chr12,Bn50754,96950785,97594922,644137,CNL
chr12,Bn50755,58828216,66198634,7370418,RLP
chr12,Bn50756,24822765,77126909,52304144,RLP
chr12,Bn50757,76328659,81828618,5499959,CN
chr12,Bn50758,48899584,71507343,22607759,CN
chr12,Bn50759,81388675,82717488,1328813,TN
chr12,Bn50760,90230207,99959700,9729493,RLP
chr12,Bn50761,19841903,34127648,14285745,TN
chr12,Bn50762,10751084,47448183,36697099,TN
chr12,Bn50763,65369708,84610669,19240961,TNL
chr12,Bn50764,14778789,53775792,38997003,RLK
chr12,Bn50765,99936307,99940349,4042,TNL
chr12,Bn50766,54134529,63487092,9352563,TNL
chr12,Bn50767,46514480,48246139,1731659,NBS
chr12,Bn50768,65590148,68842957,3252809,TNL
chr12,Bn50769,55887441,88050891,32163450,CNL
chr12,Bn50770,35405410,81900266,46494856,TN
chr12,Bn50771,75643464,85852325,10208861,TNL
chr12,Bn50772,54357055,64663122,10306067,CNL
chr12,Bn50773,75197354,98918327,23720973,TN
chr12,Bn50774,12952350,56605265,43652915,CN
chr12,Bn50775,86576997,93244759,6667762,TN
chr12,Bn50776,34014381,49184570,15170189,NBS
chr12,Bn50777,10226214,13195065,2968851,TN
chr12,Bn50778,55741546,90982283,35240737,TNL
chr12,Bn50779,88970505,95527507,6557002,CNL
chr12,Bn50780,65802905,71358169,5555264,CN
chr12,Bn50781,3089042,51658171,48569129,RLP
chr12,Bn50782,93317039,99504645,6187606,RLP
chr12,Bn50783,79633515,95517478,15883963,NBS
chr12,Bn50784,22651998,96503467,73851469,TN
chr12,Bn50785,25561725,75870991,50309266,RLP
chr12,Bn50786,51305362,80967132,29661770,CN
chr12,Bn50787,84529059,86531501,2002442,CN
chr12,Bn50788,44768400,51024779,6256379,TN
chr12,Bn50789,63923224,65616685,1693461,TN
chr12,Bn50790,49569676,58710898,9141222,TN
chr12,Bn50791,62895237,90748780,27853543,CNL
chr12,Bn50792,41222471,72660847,31438376,CN
chr12,Bn50793,75881972,79717540,3835568,NBS
chr12,Bn50794,44390041,68869264,24479223,TNL
chr12,Bn50795,23330573,26603506,3272933,RLP
chr12,Bn50796,6179338,83934119,77754781,RLP
chr12,Bn50797,18847234,39291780,20444546,TN
chr12,Bn50798,13558918,30491902,16932984,CN
chr12,Bn50799,55583555,62202324,6618769,RLP
chr12,Bn50800,69499315,74978547,5479232,RLP
chr12,Bn50801,86959714,89504238,2544524,NBS
chr12,Bn50802,64189447,66906202,2716755,RLP
chr12,Bn50803,8027530,61823627,53796097,TN
chr12,Bn50804,39271872,80327671,41055799,CN
chr12,Bn50805,29021081,71671853,42650772,TN
chr12,Bn50806,13530183,69858490,56328307,TNL
chr12,Bn50807,26898649,96213527,69314878,RLK
chr12,Bn50808,46522016,67675442,21153426,CN
chr12,Bn50809,83015869,93616841,10600972,CN
chr12,Bn50810,62691350,67519103,4827753,RLK
chr12,Bn50811,35915316,98063724,62148408,CNL
chr12,Bn50812,88732180,93890875,5158695,TN
chr12,Bn50813,52978980,86421216,33442236,CNL
chr12,Bn50814,59439903,98384802,38944899,TNL
chr12,Bn50815,13439604,14924339,1484735,TNL
chr12,Bn50816,97627338,99584804,1957466,TN
chr12,Bn50817,83022015,84614806,1592791,TN
chr12,Bn50818,20847887,87226887,66379000,NBS
chr12,Bn50819,62327603,66345970,4018367,RLP
chr12,Bn50820,67858764,69219671,1360907,CN
chr12,Bn50821,74035498,84858129,10822631,RLP
chr12,Bn50822,95198308,95800449,602141,TN
chr12,Bn50823,79689156,93453569,13764413,CN
chr12,Bn50824,79357864,96559376,17201512,TNL
chr12,Bn50825,87688622,87814010,125388,TN
chr12,Bn50826,35695248,63156842,27461594,TNL
chr12,Bn50827,37000558,50211423,13210865,NBS
chr12,Bn50828,33764171,78423779,44659608,TNL
chr12,Bn50829,56482521,62003283,5520762,TNL
chr12,Bn50830,59486471,68369644,8883173,RLP
chr12,Bn50831,58749400,92793822,34044422,CN
chr12,Bn50832,25755495,74188732,48433237,TNL
chr12,Bn50833,60252932,85252032,24999100,NBS
chr12,Bn50834,48714823,50061765,1346942,TN
chr12,Bn50835,39449163,60744646,21295483,CN
chr12,Bn50836,3730905,72232032,68501127,RLK
chr12,Bn50837,98422888,98687406,264518,CNL
chr12,Bn50838,20087174,56546114,36458940,TN
chr12,Bn50839,20523868,52184652,31660784,RLP
chr12,Bn50840,21692563,44604302,22911739,CNL
chr12,Bn50841,21237738,84766048,63528310,RLP
chr12,Bn50842,67292653,84834711,17542058,NBS
chr12,Bn50843,30937365,78949099,48011734,CNL
chr12,Bn50844,66786170,81414422,14628252,TN
chr12,Bn50845,63775406,87093962,23318556,TN
chr12,Bn50846,93407845,95094942,1687097,NBS
chr12,Bn50847,42530822,58524420,15993598,RLP
chr12,Bn50848,27590866,87725140,60134274,TNL
chr12,Bn50849,67165605,70829103,3663498,RLP
chr12,Bn50850,99304994,99479285,174291,CNL
chr12,Bn50851,6460706,60654896,54194190,RLK
chr12,Bn50852,74898872,84461399,9562527,TN
chr12,Bn50853,40222453,42926278,2703825,CN
chr12,Bn50854,29095477,89563005,60467528,NBS
chr12,Bn50855,87194867,97937005,10742138,TN
chr12,Bn50856,12595854,23333901,10738047,RLP
chr12,Bn50857,54573658,69821973,15248315,RLP
chr12,Bn50858,81480178,83558413,2078235,TNL
chr12,Bn50859,10484524,14717057,4232533,RLK
chr12,Bn50860,85174660,88868512,3693852,CNL
chr12,Bn50861,1190755,52934407,51743652,CNL
chr12,Bn50862,51472415,59736181,8263766,RLP
chr12,Bn50863,57109631,72069205,14959574,CN
chr12,Bn50864,39802678,45872390,6069712,RLP
chr12,Bn50865,9848384,61126903,51278519,CN
chr12,Bn50866,28719670,77295037,48575367,TN
chr12,Bn50867,12600423,37993412,25392989,RLK
chr12,Bn50868,76163782,95461918,19298136,CNL
chr12,Bn50869,40135427,44701553,4566126,RLP
chr12,Bn50870,99098948,99352841,253893,RLP
chr12,Bn50871,91489619,99014456,7524837,NBS
chr12,Bn50872,38459319,66412073,27952754,TNL
chr12,Bn50873,12961356,40027806,27066450,RLK
chr12,Bn50874,47904020,67373240,19469220,CNL
chr12,Bn50875,35027280,67478520,32451240,TNL
chr12,Bn50876,90845866,99727039,8881173,NBS
chr12,Bn50877,97468491,99399287,1930796,NBS
chr12,Bn50878,77781715,88442796,10661081,TN
chr12,Bn50879,84348443,99398047,15049604,NBS
chr12,Bn50880,4532696,24553265,20020569,NBS
chr12,Bn50881,83854262,94053874,10199612,RLP
chr12,Bn50882,27030335,67993958,40963623,CN
chr12,Bn50883,73882842,77491345,3608503,RLK
chr12,Bn50884,39449520,85723433,46273913,RLP
chr12,Bn50885,59042423,74373973,15331550,CN
chr12,Bn50886,33338952,82146835,48807883,CNL
chr12,Bn50887,61532460,66203038,4670578,TNL
chr12,Bn50888,42671505,86951344,44279839,RLP
chr12,Bn50889,69543420,92059492,22516072,NBS
chr12,Bn50890,21883024,27718648,5835624,CNL
chr12,Bn50891,64554724,78523121,13968397,TN
chr12,Bn50892,66234636,97754409,31519773,RLK
chr12,Bn50893,32852280,46373724,13521444,TN
chr12,Bn50894,50256980,99483776,49226796,CN
chr12,Bn50895,6496067,26467209,19971142,RLP
chr12,Bn50896,42665989,76035770,33369781,RLK
chr12,Bn50897,33939239,63495676,29556437,CN
chr12,Bn50898,80566797,98321120,17754323,RLK
chr12,Bn50899,21492549,86819836,65327287,CN
chr12,Bn50900,85285454,99079441,13793987,CNL
chr12,Bn50901,45362629,76905019,31542390,TN
chr12,Bn50902,35967816,39624674,3656858,RLK
chr12,Bn50903,55958737,84234642,28275905,CNL
chr12,Bn50904,15537038,90183963,74646925,TNL
chr12,Bn50905,93787532,98874095,5086563,CN
chr12,Bn50906,9059297,23080292,14020995,TN
chr12,Bn50907,52105593,98626872,46521279,NBS
chr12,Bn50908,36508242,62545948,26037706,CNL
chr12,Bn50909,70560019,73775722,3215703,CNL
chr12,Bn50910,56351378,64690272,8338894,RLP
chr12,Bn50911,9482135,35249868,25767733,TNL
chr12,Bn50912,38273300,80031587,41758287,CNL
chr12,Bn50913,17232483,56010639,38778156,CN
chr12,Bn50914,33040865,54903309,21862444,CNL
chr12,Bn50915,69779062,87963416,18184354,RLK
chr12,Bn50916,30139138,65188974,35049836,TNL
chr12,Bn50917,90696943,94822271,4125328,RLK
chr12,Bn50918,7421188,92351011,84929823,TN
chr12,Bn50919,2644036,49004410,46360374,CN
chr12,Bn50920,45513791,66330515,20816724,TNL
chr12,Bn50921,37110529,64469932,27359403,RLP
chr12,Bn50922,31722711,99768375,68045664,NBS
chr12,Bn50923,73361210,92511750,19150540,CNL
chr12,Bn50924,3378606,45872989,42494383,TN
chr12,Bn50925,53240376,77067998,23827622,RLK
chr12,Bn50926,67826232,99149159,31322927,CN
chr12,Bn50927,80769034,87962581,7193547,RLP
chr12,Bn50928,50114288,70513413,20399125,RLP
chr12,Bn50929,33568092,69774252,36206160,TNL
chr12,Bn50930,87509220,94793468,7284248,CN
chr12,Bn50931,81541581,86508466,4966885,CNL
chr12,Bn50932,95899973,96459602,559629,NBS
chr12,Bn50933,44951632,91499095,46547463,TN
chr12,Bn50934,64014045,74689093,10675048,RLK
chr12,Bn50935,38708314,62374030,23665716,CN
chr12,Bn50936,39539911,82502631,42962720,CN
chr12,Bn50937,56223144,72697162,16474018,RLP
chr12,Bn50938,49169058,83515507,34346449,CN
chr12,Bn50939,48632771,80664841,32032070,CNL
chr12,Bn50940,67830501,71490493,3659992,TN
chr12,Bn50941,11680768,32892751,21211983,CN
chr12,Bn50942,51253583,52562661,1309078,RLP
chr12,Bn50943,66771167,98026303,31255136,NBS
chr12,Bn50944,6873098,72511211,65638113,NBS
chr12,Bn50945,25328632,83663677,58335045,NBS
chr12,Bn50946,52289194,60761067,8471873,CNL
chr12,Bn50947,23573682,43732813,20159131,RLK
chr12,Bn50948,69687856,74050718,4362862,RLK
chr12,Bn50949,18917362,69105819,50188457,RLP
chr12,Bn50950,63349377,74845101,11495724,NBS
chr12,Bn50951,44837241,81147805,36310564,RLK
chr12,Bn50952,83819554,86239683,2420129,RLP
chr12,Bn50953,42499357,63750292,21250935,RLP
chr12,Bn50954,33962296,56340582,22378286,CNL
chr12,Bn50955,26309546,84881479,58571933,RLK
chr12,Bn50956,10912590,98755079,87842489,RLP
chr12,Bn50957,35766673,62724533,26957860,CNL
chr12,Bn50958,8514771,31033576,22518805,TN
chr12,Bn50959,17752639,23510066,5757427,RLP
chr12,Bn50960,21975740,93479923,71504183,TN
chr12,Bn50961,98977927,99859465,881538,CN
chr12,Bn50962,22856736,88274039,65417303,RLK
chr12,Bn50963,71274243,93233854,21959611,RLP
chr12,Bn50964,47201909,63615625,16413716,NBS
chr12,Bn50965,2599327,21306316,18706989,RLK
chr12,Bn50966,27288596,99140757,71852161,TN
chr12,Bn50967,95284418,97257424,1973006,RLP
chr12,Bn50968,94628874,96040451,1411577,TNL
chr12,Bn50969,44206320,81605366,37399046,CN
chr12,Bn50970,91105488,97305849,6200361,RLP
chr12,Bn50971,72029056,82032766,10003710,CNL
chr12,Bn50972,4350670,93547899,89197229,TN
chr12,Bn50973,30237133,54730983,24493850,CN
chr12,Bn50974,76024698,99399848,23375150,TNL
chr12,Bn50975,46958481,64972582,18014101,TN
chr12,Bn50976,84535137,98897918,14362781,RLP
chr12,Bn50977,90776188,95578722,4802534,CN
chr12,Bn50978,74619534,90850363,16230829,CNL
chr12,Bn50979,23348959,31722274,8373315,TNL
chr12,Bn50980,62567946,73645454,11077508,RLP
chr12,Bn50981,42932746,45362890,2430144,RLK
chr12,Bn50982,17969667,78589524,60619857,CNL
chr12,Bn50983,59876521,89456444,29579923,TNL
chr12,Bn50984,82071732,99671430,17599698,CN
chr12,Bn50985,55645818,84340337,28694519,CN
chr12,Bn50986,14114792,36023177,21908385,RLP
chr12,Bn50987,26149368,86312547,60163179,CNL
chr12,Bn50988,70760918,74345014,3584096,TNL
chr12,Bn50989,48323344,58796198,10472854,TN
chr12,Bn50990,80209710,91628325,11418615,NBS
chr12,Bn50991,8895268,37255185,28359917,CN
chr12,Bn50992,22486193,98519284,76033091,CNL
chr12,Bn50993,1460070,4213117,2753047,TN
chr12,Bn50994,85970294,97942756,11972462,CN
chr12,Bn50995,14176099,20867706,6691607,RLP
chr12,Bn50996,77596405,94087732,16491327,TN
chr12,Bn50997,84589111,90879907,6290796,CN
chr12,Bn50998,21873098,54841040,32967942,TNL
chr12,Bn50999,28141798,28993970,852172,NBS
chr12,Bn51000,17436781,82517842,65081061,NBS
chr12,Bn51001,22830027,86054303,63224276,TNL
chr12,Bn51002,31393460,73674438,42280978,TN
chr12,Bn51003,61053884,84797665,23743781,NBS
chr12,Bn51004,78963487,92127729,13164242,TNL
chr12,Bn51005,19910743,94848623,74937880,CNL
chr12,Bn51006,73465885,87791667,14325782,RLK
chr12,Bn51007,39107189,65755622,26648433,CNL
chr12,Bn51008,4715716,99573349,94857633,NBS
chr12,Bn51009,59872461,97887865,38015404,RLP
chr12,Bn51010,28922681,46452443,17529762,RLK
chr12,Bn51011,61092237,95967379,34875142,RLK
chr12,Bn51012,12557358,37769516,25212158,RLP
chr12,Bn51013,71820449,77455419,5634970,CNL
chr12,Bn51014,79461863,94446860,14984997,NBS
chr12,Bn51015,55251738,69693830,14442092,CNL
chr12,Bn51016,91574762,95558953,3984191,RLP
chr12,Bn51017,38592481,92780979,54188498,TN
chr12,Bn51018,78302581,87578041,9275460,RLK
chr12,Bn51019,34275688,46449176,12173488,TNL
chr12,Bn51020,45543707,79681595,34137888,NBS
chr12,Bn51021,68182920,76530967,8348047,TNL
chr12,Bn51022,71374031,81440359,10066328,NBS
chr12,Bn51023,40431905,63318579,22886674,NBS
chr12,Bn51024,75820825,95204403,19383578,CN
chr12,Bn51025,48820024,61904078,13084054,RLP
chr12,Bn51026,74975649,92557597,17581948,CNL
chr12,Bn51027,55344913,80325344,24980431,CN
chr12,Bn51028,95263762,97756430,2492668,CNL
chr12,Bn51029,2619184,77079204,74460020,RLK
chr12,Bn51030,32200677,48724560,16523883,RLK
chr12,Bn51031,77489939,94345568,16855629,TNL
chr12,Bn51032,96709236,99094627,2385391,TNL
chr12,Bn51033,49789932,81942626,32152694,CNL
chr12,Bn51034,15838406,51185660,35347254,CNL
chr12,Bn51035,30925624,78823676,47898052,NBS
chr12,Bn51036,41766565,45989839,4223274,CN
chr12,Bn51037,83829344,97543559,13714215,RLP
chr12,Bn51038,85235815,93471257,8235442,TN
chr12,Bn51039,41063401,54540638,13477237,CN
chr12,Bn51040,23756422,40264504,16508082,RLP
chr12,Bn51041,16076822,94025305,77948483,CNL
chr12,Bn51042,61202945,68375300,7172355,CN
chr12,Bn51043,42933990,61743257,18809267,RLP
chr12,Bn51044,65611751,94057742,28445991,TNL
chr12,Bn51045,22031999,22763650,731651,NBS
chr12,Bn51046,59528332,84914808,25386476,NBS
chr12,Bn51047,6330743,26095677,19764934,RLK
chr12,Bn51048,23516421,78797273,55280852,NBS
chr12,Bn51049,55231586,80485635,25254049,CN
chr12,Bn51050,40447060,98334009,57886949,CN
chr12,Bn51051,26170661,86947694,60777033,TNL
chr12,Bn51052,29322981,91883036,62560055,CN
chr12,Bn51053,85442256,89958617,4516361,CNL
chr12,Bn51054,67627355,99363153,31735798,TNL
chr12,Bn51055,21070473,85931651,64861178,CNL
chr12,Bn51056,27030413,48447522,21417109,TNL
chr12,Bn51057,41592985,72475061,30882076,TNL
chr12,Bn51058,7314232,93563143,86248911,TNL
chr12,Bn51059,92129057,93624413,1495356,CNL
chr12,Bn51060,26697758,48344003,21646245,CN
chr12,Bn51061,81078657,95351605,14272948,CNL
chr12,Bn51062,31279835,74834932,43555097,RLK
chr12,Bn51063,92748449,96170462,3422013,NBS
chr12,Bn51064,48841077,83507338,34666261,CN
chr12,Bn51065,99597619,99769836,172217,RLP
chr12,Bn51066,1471663,10690646,9218983,RLP
chr12,Bn51067,52111104,64316491,12205387,RLK
chr12,Bn51068,18102527,38213464,20110937,TNL
chr12,Bn51069,9436620,9628745,192125,TN
chr12,Bn51070,65158932,78522253,13363321,CN
chr12,Bn51071,92917326,98720869,5803543,RLP
chr12,Bn51072,89054059,94062394,5008335,RLK
chr12,Bn51073,76462556,89058576,12596020,RLP
chr12,Bn51074,4274045,26236832,21962787,CN
chr12,Bn51075,49244220,91801828,42557608,NBS
chr12,Bn51076,42499194,92395729,49896535,CNL
chr12,Bn51077,91189042,96138003,4948961,CN
chr12,Bn51078,33727119,60144854,26417735,TNL
chr12,Bn51079,85907003,94341304,8434301,TN
chr12,Bn51080,47669676,84342070,36672394,CN
chr12,Bn51081,88775984,93682967,4906983,RLP
chr12,Bn51082,74487202,74844210,357008,TN
chr12,Bn51083,13484152,13793150,308998,CN
chr12,Bn51084,79091834,94154462,15062628,CNL
chr12,Bn51085,41483898,84473511,42989613,TN
chr12,Bn51086,43111783,71485048,28373265,CNL
chr12,Bn51087,35291148,55151371,19860223,RLK
chr12,Bn51088,55445482,95667684,40222202,CN
chr12,Bn51089,51909125,70545949,18636824,CN
chr12,Bn51090,56573762,92310155,35736393,TNL
chr12,Bn51091,49750939,73411682,23660743,CN
chr12,Bn51092,14233918,79331662,65097744,CNL
chr12,Bn51093,30881261,34734245,3852984,RLP
chr12,Bn51094,94435355,98071011,3635656,NBS
chr12,Bn51095,5059833,52242291,47182458,CNL
chr12,Bn51096,91277289,99958791,8681502,TN
chr12,Bn51097,1813060,3746235,1933175,RLK
chr12,Bn51098,78089480,80119722,2030242,NBS
chr12,Bn51099,91016783,93089694,2072911,TNL
chr12,Bn51100,44027901,73406950,29379049,TNL
chr12,Bn51101,67770088,75472883,7702795,TN
chr12,Bn51102,57803179,59814366,2011187,TNL
chr12,Bn51103,11501817,79657515,68155698,NBS
chr12,Bn51104,30943801,69993691,39049890,TN
chr12,Bn51105,17767174,29092423,11325249,NBS
chr12,Bn51106,94802644,96188859,1386215,CNL
chr12,Bn51107,82419657,85187498,2767841,TN
chr12,Bn51108,55449164,65115178,9666014,CN
chr12,Bn51109,48971719,49128321,156602,RLK
chr12,Bn51110,34363130,97787240,63424110,CNL
chr12,Bn51111,18149646,68098315,49948669,TNL
chr12,Bn51112,60136075,84642268,24506193,TN
chr12,Bn51113,26717058,82268061,55551003,CNL
chr12,Bn51114,65339634,96901662,31562028,RLK
chr12,Bn51115,99430752,99834013,403261,CNL
chr12,Bn51116,86421781,91090601,4668820,TN
chr12,Bn51117,85307718,92972097,7664379,RLP
chr12,Bn51118,78577121,89466082,10888961,TNL
chr12,Bn51119,93688513,97374199,3685686,CNL
chr12,Bn51120,4991838,36443218,31451380,NBS
chr12,Bn51121,91778590,98943667,7165077,NBS
chr12,Bn51122,68353298,76648879,8295581,TNL
chr12,Bn51123,4507893,42963230,38455337,CNL
chr12,Bn51124,52350064,88703378,36353314,NBS
chr12,Bn51125,70024892,79904533,9879641,RLP
chr12,Bn51126,71037552,71546623,509071,TNL
chr12,Bn51127,93615123,97141213,3526090,RLK
chr12,Bn51128,41055794,85386403,44330609,RLP
chr12,Bn51129,71912118,72885165,973047,TNL
chr12,Bn51130,83715953,96560637,12844684,NBS
chr12,Bn51131,52644708,71037059,18392351,CN
chr12,Bn51132,52908292,85828518,32920226,CN
chr12,Bn51133,78343099,98817748,20474649,RLK
chr12,Bn51134,74947940,79347102,4399162,TN
chr12,Bn51135,94091121,98071651,3980530,RLK
chr12,Bn51136,17573586,50880133,33306547,CNL
chr12,Bn51137,39199903,75925914,36726011,RLK
chr12,Bn51138,81525187,93342179,11816992,CNL
chr12,Bn51139,44395397,75139662,30744265,TN
chr12,Bn51140,38448806,85988849,47540043,NBS
chr12,Bn51141,43999813,65859681,21859868,TNL
chr12,Bn51142,39744105,56064709,16320604,RLK
chr12,Bn51143,64618747,90743242,26124495,NBS
chr12,Bn51144,78308683,80545802,2237119,TNL
chr12,Bn51145,92538699,96217919,3679220,NBS
chr12,Bn51146,68526672,97097824,28571152,CNL
chr12,Bn51147,16250595,25730134,9479539,TN
chr12,Bn51148,57085277,83354055,26268778,RLP
chr12,Bn51149,97297349,97492522,195173,RLK
chr12,Bn51150,53520013,60582412,7062399,RLK
chr12,Bn51151,50884496,86857806,35973310,CN
chr12,Bn51152,54407579,65139222,10731643,RLK
chr12,Bn51153,77176697,77915696,738999,TN
chr12,Bn51154,26009423,30198146,4188723,TNL
chr12,Bn51155,81330259,87703253,6372994,TNL
chr12,Bn51156,55383391,81366028,25982637,RLP
chr12,Bn51157,54309062,96402683,42093621,TNL
chr12,Bn51158,45193295,93434661,48241366,TNL
chr12,Bn51159,85240711,89402848,4162137,TN
chr12,Bn51160,62643058,86532597,23889539,TN
chr12,Bn51161,94597848,95839757,1241909,CNL
chr12,Bn51162,71413063,77452000,6038937,TN
chr12,Bn51163,89868796,97550236,7681440,CNL
chr12,Bn51164,16371675,75039887,58668212,TNL
chr12,Bn51165,48298143,65337667,17039524,RLK
chr12,Bn51166,45086368,53564281,8477913,CNL
chr12,Bn51167,67364765,86065109,18700344,RLK
chr12,Bn51168,53471173,73631599,20160426,CNL
chr12,Bn51169,59065794,90560531,31494737,NBS
chr12,Bn51170,54282196,89633526,35351330,TN
chr12,Bn51171,63271646,95701598,32429952,TN
chr12,Bn51172,29438493,61071160,31632667,NBS
chr12,Bn51173,14244570,22070568,7825998,NBS
chr12,Bn51174,11627699,68330298,56702599,TNL
chr12,Bn51175,42543168,88670345,46127177,TNL
chr12,Bn51176,89373313,90249720,876407,RLP
chr12,Bn51177,77146274,97934087,20787813,TN
chr12,Bn51178,92715456,95061951,2346495,TNL
chr12,Bn51179,25263198,33680214,8417016,RLK
chr12,Bn51180,50701800,89776542,39074742,RLK
chr12,Bn51181,59096677,97922235,38825558,CN
chr12,Bn51182,37578286,63069802,25491516,TN
chr12,Bn51183,32077835,96385850,64308015,NBS
chr12,Bn51184,89720256,92665392,2945136,RLP
chr12,Bn51185,82932497,91774880,8842383,NBS
chr12,Bn51186,11172670,62964939,51792269,TN
chr12,Bn51187,19495358,61195724,41700366,TNL
chr12,Bn51188,47207095,64305754,17098659,NBS
chr12,Bn51189,15239601,48962088,33722487,TNL
chr12,Bn51190,45010274,80527658,35517384,RLP
chr12,Bn51191,24152843,29468753,5315910,TN
chr12,Bn51192,92385352,98387380,6002028,NBS
chr12,Bn51193,9735269,96029337,86294068,RLP
chr12,Bn51194,31693547,59436333,27742786,TNL
chr12,Bn51195,38649386,77645093,38995707,RLK
chr12,Bn51196,57786176,94153056,36366880,CN
chr12,Bn51197,4886104,82441996,77555892,TN
chr12,Bn51198,98669595,99766920,1097325,NBS
chr12,Bn51199,8002198,14060707,6058509,NBS
chr12,Bn51200,22864918,53029212,30164294,NBS
chr12,Bn51201,88297813,93569731,5271918,CN
chr12,Bn51202,41193236,42077380,884144,RLK
chr12,Bn51203,85931902,87304288,1372386,CN
chr12,Bn51204,60746559,71621049,10874490,TNL
chr12,Bn51205,84820387,87462171,2641784,TN
chr12,Bn51206,82557557,85875455,3317898,TNL
chr12,Bn51207,28216921,67612777,39395856,NBS
chr12,Bn51208,24400658,96096157,71695499,TN
chr12,Bn51209,68258525,98196558,29938033,NBS
chr12,Bn51210,13873791,32083825,18210034,TN
chr12,Bn51211,89857226,97721134,7863908,CN
chr12,Bn51212,67127813,87487898,20360085,RLK
chr12,Bn51213,89155803,95447851,6292048,CNL
chr12,Bn51214,99752821,99909149,156328,RLK
chr12,Bn51215,33645377,69609771,35964394,TN
chr12,Bn51216,60068764,73675011,13606247,TN
chr12,Bn51217,8417246,24618773,16201527,RLP
chr12,Bn51218,77494979,83364989,5870010,CNL
chr12,Bn51219,82254872,98448386,16193514,RLP
chr12,Bn51220,5616692,80624563,75007871,CNL
chr12,Bn51221,25417746,65189908,39772162,TNL
chr12,Bn51222,95836737,95875168,38431,CN
chr12,Bn51223,58670408,76460123,17789715,CN
chr12,Bn51224,73005133,94548007,21542874,TN
chr12,Bn51225,19047070,94005690,74958620,CNL
chr12,Bn51226,51005091,66961490,15956399,RLK
chr12,Bn51227,28871287,60363727,31492440,TNL
chr12,Bn51228,28275301,74354487,46079186,RLK
chr12,Bn51229,43947665,88258348,44310683,NBS
chr12,Bn51230,8975297,61546257,52570960,CNL
chr12,Bn51231,11380330,58631854,47251524,TNL
chr12,Bn51232,96156620,98809854,2653234,RLK
chr12,Bn51233,84081129,90786846,6705717,RLP
chr12,Bn51234,90036860,99092383,9055523,RLP
chr12,Bn51235,91355241,96084330,4729089,RLK
chr12,Bn51236,30601738,49671707,19069969,CN
chr12,Bn51237,35006781,43370951,8364170,RLK
chr12,Bn51238,10684720,54355593,43670873,TNL
chr12,Bn51239,40702077,80697818,39995741,RLP
chr12,Bn51240,46330216,93046133,46715917,RLK
chr12,Bn51241,12620137,43109340,30489203,CN
chr12,Bn51242,45804170,70573235,24769065,NBS
chr12,Bn51243,39090353,45574117,6483764,TNL
chr12,Bn51244,2715728,97936613,95220885,CNL
chr12,Bn51245,19229432,25165905,5936473,NBS
chr12,Bn51246,49875734,76748541,26872807,RLK
chr12,Bn51247,13447672,85785741,72338069,TNL
chr12,Bn51248,71084015,97271116,26187101,RLK
chr12,Bn51249,73306575,87847550,14540975,NBS
chr12,Bn51250,1529041,94349443,92820402,CNL
chr12,Bn51251,54743826,99625298,44881472,TN
chr12,Bn51252,53763574,85514969,31751395,RLK
chr12,Bn51253,6655137,19097799,12442662,CNL
chr12,Bn51254,63098358,66853545,3755187,TNL
chr12,Bn51255,68289925,87936168,19646243,RLP
chr12,Bn51256,2130032,82258613,80128581,CNL
chr12,Bn51257,6657031,54491384,47834353,TNL
chr12,Bn51258,2996661,38424902,35428241,TNL
chr12,Bn51259,7235220,39144329,31909109,CN
chr12,Bn51260,10297347,44963741,34666394,CN
chr12,Bn51261,37871827,86149724,48277897,NBS
chr12,Bn51262,77008411,80777268,3768857,CNL
chr12,Bn51263,38416381,80576275,42159894,TN
chr12,Bn51264,42781128,45543809,2762681,NBS
chr12,Bn51265,1667304,69603770,67936466,CN
chr12,Bn51266,92735162,93039991,304829,CN
chr12,Bn51267,30627841,71492318,40864477,NBS
chr12,Bn51268,42911863,58127157,15215294,TNL
chr12,Bn51269,87238288,94993212,7754924,CNL
chr12,Bn51270,89564446,96797814,7233368,NBS
chr12,Bn51271,47747483,81072098,33324615,CN
chr12,Bn51272,54289200,54418833,129633,RLP
chr12,Bn51273,64316243,96963258,32647015,CN
chr12,Bn51274,48600962,82448313,33847351,TNL
chr12,Bn51275,5354082,72029316,66675234,TNL
chr12,Bn51276,72641792,76974868,4333076,RLP
chr12,Bn51277,72813539,73582412,768873,CNL
chr12,Bn51278,6180344,77943820,71763476,CNL
chr12,Bn51279,80118313,89365877,9247564,NBS
chr12,Bn51280,83882367,84035715,153348,RLP
chr12,Bn51281,26074542,37139133,11064591,TN
chr12,Bn51282,24475846,76387651,51911805,NBS
chr12,Bn51283,11327300,42733796,31406496,TN
chr12,Bn51284,86837722,92033660,5195938,TN
chr12,Bn51285,96368073,99585621,3217548,TNL
chr12,Bn51286,51436632,88321405,36884773,NBS
chr12,Bn51287,86246712,99261766,13015054,TN
chr12,Bn51288,42460469,72121076,29660607,CN
chr12,Bn51289,99973679,99994657,20978,TNL
chr12,Bn51290,11498463,50320925,38822462,CN
chr12,Bn51291,28999147,41327699,12328552,CNL
chr12,Bn51292,18627923,33181698,14553775,CNL
chr12,Bn51293,29748129,96248836,66500707,RLK
chr12,Bn51294,67294172,94910612,27616440,CN
chr12,Bn51295,31877893,59123967,27246074,RLP
chr12,Bn51296,82500584,91573076,9072492,RLK
chr12,Bn51297,15218061,82569996,67351935,NBS
chr12,Bn51298,58946002,89869400,30923398,NBS
chr12,Bn51299,54977130,87686698,32709568,CN
chr12,Bn51300,43259747,61759995,18500248,TN
chr12,Bn51301,69507060,72370141,2863081,TN
chr12,Bn51302,4014892,85300484,81285592,CN
chr12,Bn51303,85399045,92728487,7329442,RLK
chr12,Bn51304,12366218,22177224,9811006,NBS
chr12,Bn51305,37221013,76214888,38993875,RLP
chr12,Bn51306,63604571,72753868,9149297,CN
chr12,Bn51307,90553980,98413421,7859441,RLP
chr12,Bn51308,48008636,86179419,38170783,TN
chr12,Bn51309,25424312,74923874,49499562,NBS
chr12,Bn51310,71135545,99625676,28490131,CNL
chr12,Bn51311,51782832,87507583,35724751,CN
chr12,Bn51312,14491915,94857568,80365653,TNL
chr12,Bn51313,17973238,69621392,51648154,TNL
chr12,Bn51314,76127530,86685363,10557833,NBS
chr12,Bn51315,26754876,70977557,44222681,CNL
chr12,Bn51316,67216501,82224154,15007653,RLP
chr12,Bn51317,34635122,61529075,26893953,NBS
chr12,Bn51318,67235849,80968728,13732879,NBS
chr12,Bn51319,96415273,98357046,1941773,RLK
chr12,Bn51320,13296641,22865184,9568543,TN
chr12,Bn51321,51595261,82747434,31152173,CN
chr12,Bn51322,51190568,55095413,3904845,TN
chr12,Bn51323,39844400,92324585,52480185,TN
chr12,Bn51324,82782888,87254218,4471330,CNL
chr12,Bn51325,58804207,61549466,2745259,CN
chr12,Bn51326,35473028,56534436,21061408,RLK
chr12,Bn51327,85479172,96913160,11433988,CN
chr12,Bn51328,39317923,91430570,52112647,RLP
chr12,Bn51329,70682421,75779391,5096970,CN
chr12,Bn51330,26227165,57078538,30851373,TNL
chr12,Bn51331,18263739,18985172,721433,CNL
chr12,Bn51332,24398273,72548794,48150521,RLK
chr12,Bn51333,19818536,93091551,73273015,NBS
chr12,Bn51334,64527862,83118623,18590761,RLK
chr12,Bn51335,28504077,58317361,29813284,NBS
chr12,Bn51336,41661825,79960824,38298999,CN
chr12,Bn51337,3049429,96408830,93359401,RLK
chr12,Bn51338,92197359,96974110,4776751,CN
chr12,Bn51339,31159926,47759465,16599539,TNL
chr12,Bn51340,21172170,91063576,69891406,TNL
chr12,Bn51341,94912853,97143985,2231132,CN
chr12,Bn51342,60963072,97956018,36992946,CN
chr12,Bn51343,42519398,42543509,24111,RLK
chr12,Bn51344,29620150,73892900,44272750,CN
chr12,Bn51345,73434393,77196621,3762228,TNL
chr12,Bn51346,22167815,38655458,16487643,NBS
chr12,Bn51347,67197055,73975425,6778370,TNL
chr12,Bn51348,99149709,99354578,204869,TN
chr12,Bn51349,72611952,83094622,10482670,RLP
chr12,Bn51350,81136289,89677454,8541165,RLK
chr12,Bn51351,70493491,85714187,15220696,RLP
chr12,Bn51352,11399035,61737716,50338681,NBS
chr12,Bn51353,5442372,34568839,29126467,TNL
chr12,Bn51354,21281047,37048535,15767488,CN
chr12,Bn51355,36352982,51370951,15017969,RLP
chr12,Bn51356,18608482,73610502,55002020,CNL
chr12,Bn51357,81025973,92219847,11193874,RLK
chr12,Bn51358,89054691,98793178,9738487,RLK
chr12,Bn51359,17255695,55720750,38465055,RLK
chr12,Bn51360,56926460,57978251,1051791,TN
chr12,Bn51361,16636253,85454189,68817936,RLP
chr12,Bn51362,79188565,87620786,8432221,RLP
chr12,Bn51363,64494982,74951718,10456736,RLP
chr12,Bn51364,64990722,80257070,15266348,CNL
chr12,Bn51365,68192242,87778855,19586613,TN
chr12,Bn51366,36644305,63927381,27283076,CNL
chr12,Bn51367,39310737,79308816,39998079,RLP
chr12,Bn51368,20624115,37622822,16998707,RLP
chr12,Bn51369,38666417,65384546,26718129,RLP
chr12,Bn51370,46174060,62925784,16751724,RLK
chr12,Bn51371,88878514,90140433,1261919,RLP
chr12,Bn51372,45931088,51150597,5219509,CN
chr12,Bn51373,92189792,94618309,2428517,TNL
chr12,Bn51374,80495608,86704046,6208438,RLK
chr12,Bn51375,96016665,99019372,3002707,CN
chr12,Bn51376,32705626,63366453,30660827,NBS
chr12,Bn51377,40388392,96361646,55973254,RLP
chr12,Bn51378,73452167,92857604,19405437,CN
chr12,Bn51379,35509547,52131634,16622087,CN
chr12,Bn51380,42459878,87232446,44772568,CNL
chr12,Bn51381,99224891,99333355,108464,NBS
chr12,Bn51382,69790718,71815243,2024525,TNL
chr12,Bn51383,35417629,36988445,1570816,TNL
chr12,Bn51384,59256883,75981751,16724868,TNL
chr12,Bn51385,80664641,92148484,11483843,RLP
chr12,Bn51386,82830902,88468172,5637270,RLP
chr12,Bn51387,32351691,81353392,49001701,RLK
chr12,Bn51388,71855177,87201702,15346525,CNL
chr12,Bn51389,27399499,61057890,33658391,TN
chr12,Bn51390,86660537,99895768,13235231,CN
chr12,Bn51391,51014136,70146729,19132593,RLP
chr12,Bn51392,12592078,23820033,11227955,RLP
chr12,Bn51393,85857744,87400056,1542312,CN
chr12,Bn51394,43771398,96422079,52650681,NBS
chr12,Bn51395,40725735,56548932,15823197,RLK
chr12,Bn51396,54655787,69999763,15343976,TNL
chr12,Bn51397,62089287,74677059,12587772,TNL
chr12,Bn51398,5633858,83507764,77873906,RLK
chr12,Bn51399,36788351,92836661,56048310,RLK
chr12,Bn51400,14761935,75610390,60848455,CN
chr12,Bn51401,53378848,73873232,20494384,CN
chr12,Bn51402,2854216,31275206,28420990,RLK
chr12,Bn51403,89013811,97921382,8907571,NBS
chr12,Bn51404,57993749,74386513,16392764,TNL
chr12,Bn51405,7765925,47419431,39653506,TNL
chr12,Bn51406,42002983,66054982,24051999,CN
chr12,Bn51407,26746233,87757243,61011010,NBS
chr12,Bn51408,3701743,6006268,2304525,RLK
chr12,Bn51409,52844093,87070921,34226828,RLK
chr12,Bn51410,5959113,38643209,32684096,CN
chr12,Bn51411,87035400,94501548,7466148,NBS
chr12,Bn51412,14150011,73938832,59788821,RLK
chr12,Bn51413,52752592,91579790,38827198,CNL
chr12,Bn51414,77554344,98912062,21357718,TNL
chr12,Bn51415,62258457,74876193,12617736,NBS
chr12,Bn51416,50663964,58622426,7958462,TN
chr12,Bn51417,7974851,90616728,82641877,TN
chr12,Bn51418,54527732,92303489,37775757,RLK
chr12,Bn51419,51912916,56553532,4640616,RLK
chr12,Bn51420,6001257,92124665,86123408,CN
chr12,Bn51421,56829975,66131095,9301120,TN
chr12,Bn51422,42195380,79715256,37519876,RLK
chr12,Bn51423,23768188,46582124,22813936,CN
chr12,Bn51424,85790911,86397399,606488,RLK
chr12,Bn51425,18286555,33848452,15561897,RLP
chr12,Bn51426,97731249,99941606,2210357,RLK
chr12,Bn51427,67174535,89674855,22500320,CN
chr12,Bn51428,22491576,97909372,75417796,CN
chr12,Bn51429,1046581,49536771,48490190,CNL
chr12,Bn51430,68977161,75135377,6158216,TNL
chr12,Bn51431,27986496,78524597,50538101,TNL
chr12,Bn51432,7477363,85367893,77890530,TNL
chr12,Bn51433,26717172,70008295,43291123,TNL
chr12,Bn51434,40225014,57292804,17067790,NBS
chr12,Bn51435,31854914,80233559,48378645,NBS
chr12,Bn51436,41206496,70048713,28842217,NBS
chr12,Bn51437,77771467,90817943,13046476,TN
chr12,Bn51438,25883822,79287365,53403543,TNL
chr12,Bn51439,25163864,97127077,71963213,TN
chr12,Bn51440,51102861,62856653,11753792,TN
chr12,Bn51441,21619643,63083754,41464111,RLP
chr12,Bn51442,27507679,88480581,60972902,TNL
chr12,Bn51443,73342642,81362334,8019692,NBS
chr12,Bn51444,26734709,58676159,31941450,CNL
chr12,Bn51445,6269573,14813206,8543633,CNL
chr12,Bn51446,4698465,77378364,72679899,CN
chr12,Bn51447,96177546,99338737,3161191,RLK
chr12,Bn51448,43635766,95303024,51667258,RLK
chr12,Bn51449,8855854,72261151,63405297,RLK
chr12,Bn51450,12718801,30875525,18156724,NBS
chr12,Bn51451,75769031,76823848,1054817,CNL
chr12,Bn51452,72547259,92595259,20048000,TN
chr12,Bn51453,47767076,86900745,39133669,CN
chr12,Bn51454,64768609,73712945,8944336,RLP
chr12,Bn51455,13478494,50536961,37058467,RLK
chr12,Bn51456,48358990,75116998,26758008,CNL
chr12,Bn51457,28705889,98188809,69482920,RLP
chr12,Bn51458,7635370,9683543,2048173,CNL
chr12,Bn51459,25944700,53990038,28045338,TN
chr12,Bn51460,69122993,97425802,28302809,TNL
chr12,Bn51461,85871950,98641729,12769779,RLK
chr12,Bn51462,93875507,96711276,2835769,RLP
chr12,Bn51463,48810483,92598852,43788369,CN
chr12,Bn51464,39108161,95192155,56083994,TNL
chr12,Bn51465,43624122,64468743,20844621,RLK
chr12,Bn51466,5023866,73501553,68477687,RLK
chr12,Bn51467,43405616,63562777,20157161,TN
chr12,Bn51468,19175496,60985483,41809987,RLK
chr12,Bn51469,19964990,62181117,42216127,CNL
chr12,Bn51470,10178644,43616801,33438157,NBS
chr12,Bn51471,48583902,99254395,50670493,TNL
chr12,Bn51472,54890842,88579454,33688612,RLP
chr12,Bn51473,71455375,84750254,13294879,NBS
chr12,Bn51474,74049602,96590517,22540915,TNL
chr12,Bn51475,98872531,99330306,457775,RLP
chr12,Bn51476,92840232,96106407,3266175,TN
chr12,Bn51477,1399781,61115378,59715597,RLK
chr12,Bn51478,60936904,71084889,10147985,CNL
chr12,Bn51479,94670307,95360725,690418,CN
chr12,Bn51480,8986039,27766584,18780545,NBS
chr12,Bn51481,5113511,21108302,15994791,RLP
chr12,Bn51482,9484168,78405930,68921762,RLK
chr12,Bn51483,65211443,71323354,6111911,RLK
chr12,Bn51484,5404139,87778289,82374150,TNL
chr12,Bn51485,80890366,93772023,12881657,TN
chr12,Bn51486,93755282,94364246,608964,RLP
chr12,Bn51487,41739927,60036942,18297015,NBS
chr12,Bn51488,55424851,56270276,845425,TNL
chr12,Bn51489,54711984,56032044,1320060,RLP
chr12,Bn51490,85464572,95374002,9909430,TN
chr12,Bn51491,32106901,47775666,15668765,TN
chr12,Bn51492,44065322,86408159,42342837,CNL
chr12,Bn51493,30126174,91496880,61370706,RLK
chr12,Bn51494,18928514,39811645,20883131,NBS
chr12,Bn51495,48955380,66980825,18025445,RLP
chr12,Bn51496,70488111,71764911,1276800,TN
chr12,Bn51497,33703772,80911199,47207427,NBS
chr12,Bn51498,52121610,57071233,4949623,CN
chr12,Bn51499,69097698,69283658,185960,CN
chr12,Bn51500,62648356,90425159,27776803,CNL
chr12,Bn51501,86303544,88505080,2201536,NBS
chr12,Bn51502,47112229,53211712,6099483,RLK
chr12,Bn51503,86676033,98926825,12250792,NBS
chr12,Bn51504,64321552,74648911,10327359,RLP
chr12,Bn51505,27891733,65402905,37511172,RLK
chr12,Bn51506,23060484,61958347,38897863,CNL
chr12,Bn51507,3794724,30979593,27184869,RLK
chr12,Bn51508,52801333,71395756,18594423,NBS
chr12,Bn51509,6362453,7360925,998472,RLK
chr12,Bn51510,51923061,83009211,31086150,TN
chr12,Bn51511,98381018,98724846,343828,NBS
chr12,Bn51512,91539198,94359543,2820345,RLK
chr12,Bn51513,80772160,82511202,1739042,RLK
chr12,Bn51514,16453295,27489555,11036260,RLK
chr12,Bn51515,3495019,47005430,43510411,CN
chr12,Bn51516,25786588,87365643,61579055,CN
chr12,Bn51517,12455988,62695645,50239657,NBS
chr12,Bn51518,57285493,93304974,36019481,CN
chr12,Bn51519,23098294,95406189,72307895,TN
chr12,Bn51520,5446851,48142964,42696113,NBS
chr12,Bn51521,11523907,58156028,46632121,CNL
chr12,Bn51522,39906571,70500675,30594104,NBS
chr12,Bn51523,49126571,76627469,27500898,TNL
chr12,Bn51524,37742756,62288530,24545774,NBS
chr12,Bn51525,1327823,56505351,55177528,CN
chr12,Bn51526,47015102,76669586,29654484,RLK
chr12,Bn51527,89175353,97706573,8531220,RLP
chr12,Bn51528,13582797,52124213,38541416,RLP
chr12,Bn51529,74222483,87211492,12989009,RLK
chr12,Bn51530,55779038,83182578,27403540,CN
chr12,Bn51531,22410317,61716373,39306056,TNL
chr12,Bn51532,88484459,95637637,7153178,TN
chr12,Bn51533,75490800,83819975,8329175,CN
chr12,Bn51534,60175762,64162067,3986305,CNL
chr12,Bn51535,20267269,54631978,34364709,CN
chr12,Bn51536,22556846,55234814,32677968,RLP
chr12,Bn51537,63149553,86249542,23099989,TNL
chr12,Bn51538,82607652,92061780,9454128,TN
chr12,Bn51539,58345083,77231856,18886773,RLP
chr12,Bn51540,70072977,87552623,17479646,RLK
chr12,Bn51541,59625388,75895581,16270193,TNL
chr12,Bn51542,43387922,67520376,24132454,TNL
chr12,Bn51543,28145080,98982983,70837903,RLP
chr12,Bn51544,1324585,68779258,67454673,NBS
chr12,Bn51545,35694129,71571684,35877555,RLK
chr12,Bn51546,8358227,67112368,58754141,TNL
chr12,Bn51547,99730701,99775213,44512,TN
chr12,Bn51548,87550370,90325131,2774761,CN
chr12,Bn51549,54275598,96426468,42150870,CNL
chr12,Bn51550,64731524,70694919,5963395,CNL
chr12,Bn51551,54565499,58395742,3830243,TN
chr12,Bn51552,17928474,66123433,48194959,TN
chr12,Bn51553,28830431,84285125,55454694,RLK
chr12,Bn51554,21993375,71480322,49486947,RLP
chr12,Bn51555,67719044,83566714,15847670,TN
chr12,Bn51556,19191782,39352938,20161156,CNL
chr12,Bn51557,61231075,99683329,38452254,NBS
chr12,Bn51558,57246279,81887664,24641385,NBS
chr12,Bn51559,6730924,42688088,35957164,TNL
chr12,Bn51560,56854790,58221048,1366258,RLP
chr12,Bn51561,58968484,61802076,2833592,RLP
chr12,Bn51562,82514814,88892358,6377544,RLP
chr12,Bn51563,26832733,49554980,22722247,RLP
chr12,Bn51564,35153071,66185852,31032781,RLP
chr12,Bn51565,33718272,95736950,62018678,CNL
chr12,Bn51566,21696975,68419223,46722248,CNL
chr12,Bn51567,22626450,67101624,44475174,RLP
chr12,Bn51568,42942854,95650491,52707637,NBS
chr12,Bn51569,67535293,69567682,2032389,TN
chr12,Bn51570,87904613,91755925,3851312,RLK
chr12,Bn51571,65759087,99475718,33716631,RLK
chr12,Bn51572,50966273,97367737,46401464,TN
chr12,Bn51573,10366663,41844487,31477824,TN
chr12,Bn51574,14371802,92544270,78172468,CN
chr12,Bn51575,78707220,88523476,9816256,CNL
chr12,Bn51576,33445965,50745607,17299642,NBS
chr12,Bn51577,84777334,88606709,3829375,NBS
chr12,Bn51578,7685467,47900082,40214615,RLK
chr12,Bn51579,34364481,73085629,38721148,NBS
chr12,Bn51580,25441634,32302972,6861338,NBS
chr12,Bn51581,41135765,93408274,52272509,TN
chr12,Bn51582,46766406,48543340,1776934,TNL
chr12,Bn51583,48698653,49298956,600303,CN
chr12,Bn51584,75342404,76909010,1566606,CNL
chr12,Bn51585,36596300,88180292,51583992,RLP
chr12,Bn51586,37273953,62073694,24799741,RLP
chr12,Bn51587,84425582,90149132,5723550,CN
chr12,Bn51588,93163759,95964863,2801104,NBS
chr12,Bn51589,63296173,82209959,18913786,TNL
chr12,Bn51590,51643294,86349554,34706260,CNL
chr12,Bn51591,48936355,58737498,9801143,NBS
chr12,Bn51592,33619666,69187634,35567968,CNL
chr12,Bn51593,13184902,28562043,15377141,TNL
chr12,Bn51594,43692445,98414495,54722050,CNL
chr12,Bn51595,30394018,97998862,67604844,CN
chr12,Bn51596,60228355,80353100,20124745,RLK
chr12,Bn51597,77306815,91646078,14339263,NBS
chr12,Bn51598,29188772,72066332,42877560,TN
chr12,Bn51599,21012829,60332125,39319296,NBS
chr12,Bn51600,21623005,26652330,5029325,RLK
chr12,Bn51601,28973249,65730750,36757501,NBS
chr12,Bn51602,2383064,57138760,54755696,RLK
chr12,Bn51603,23559304,58173637,34614333,NBS
chr12,Bn51604,3649525,39643586,35994061,RLP
chr12,Bn51605,47951946,55359576,7407630,RLP
chr12,Bn51606,9218777,14935693,5716916,RLP
chr12,Bn51607,47044798,72037178,24992380,TN
chr12,Bn51608,37952095,79463291,41511196,CN
chr12,Bn51609,42057294,66926179,24868885,RLK
chr12,Bn51610,53690686,87029272,33338586,NBS
chr12,Bn51611,99809386,99846178,36792,TNL
chr12,Bn51612,1727272,16410885,14683613,RLP
chr12,Bn51613,66339370,79046201,12706831,NBS
chr12,Bn51614,71717197,96376685,24659488,NBS
chr12,Bn51615,22834622,85659546,62824924,TNL
chr12,Bn51616,56568353,67179025,10610672,CN
chr12,Bn51617,69579035,70318316,739281,RLP
chr12,Bn51618,57542995,60743237,3200242,TNL
chr12,Bn51619,20658288,29264235,8605947,TNL
chr12,Bn51620,80612003,98636056,18024053,RLP
chr12,Bn51621,19263393,95665170,76401777,TN
chr12,Bn51622,81794556,82732843,938287,RLK
chr12,Bn51623,1538332,50335428,48797096,CN
chr12,Bn51624,46178606,90690586,44511980,TNL
chr12,Bn51625,9294815,26563131,17268316,CN
chr12,Bn51626,92655766,93091735,435969,TNL
chr12,Bn51627,27122961,37786824,10663863,CN
chr12,Bn51628,75124972,90583816,15458844,CN
chr12,Bn51629,4692157,67158870,62466713,TN
chr12,Bn51630,34782018,41568171,6786153,CNL
chr12,Bn51631,1440921,37466347,36025426,RLP
chr12,Bn51632,83137594,98807477,15669883,CN
chr12,Bn51633,27255329,50813511,23558182,RLK
chr12,Bn51634,67111484,76744072,9632588,TNL
chr12,Bn51635,54965553,91215857,36250304,NBS
chr12,Bn51636,6277476,39798844,33521368,RLP
chr12,Bn51637,47958734,86990607,39031873,CNL
chr12,Bn51638,87617003,99574271,11957268,RLK
chr12,Bn51639,51211120,98842554,47631434,NBS
chr12,Bn51640,56335936,69857426,13521490,RLK
chr12,Bn51641,77067430,77264006,196576,TNL
chr12,Bn51642,77156480,91403547,14247067,CNL
chr12,Bn51643,47483977,64653051,17169074,NBS
chr12,Bn51644,54362851,92248783,37885932,CN
chr12,Bn51645,92719619,99130105,6410486,CN
chr12,Bn51646,84789255,96130313,11341058,RLP
chr12,Bn51647,13914194,50794265,36880071,CNL
chr12,Bn51648,35481224,49425968,13944744,RLK
chr12,Bn51649,90196062,94682432,4486370,RLK
chr12,Bn51650,24264791,93078666,68813875,RLP
chr12,Bn51651,54074956,60689798,6614842,CNL
chr12,Bn51652,10821119,48312288,37491169,TN
chr12,Bn51653,88445358,88919731,474373,CNL
chr12,Bn51654,80730357,85768801,5038444,NBS
chr12,Bn51655,15204641,24177311,8972670,CN
chr12,Bn51656,11273603,97400588,86126985,NBS
chr12,Bn51657,72396203,81287961,8891758,RLK
chr12,Bn51658,44183821,69675550,25491729,NBS
chr12,Bn51659,95772930,96480988,708058,RLP
chr12,Bn51660,28068949,71950301,43881352,NBS
chr12,Bn51661,58412849,90533226,32120377,CNL
chr12,Bn51662,68327467,89957549,21630082,RLP
chr12,Bn51663,48939127,66861504,17922377,NBS
chr12,Bn51664,96794761,99881801,3087040,TNL
chr12,Bn51665,96823566,99597815,2774249,RLK
chr12,Bn51666,89927771,89937117,9346,TNL
chr12,Bn51667,35356429,57611300,22254871,NBS
chr12,Bn51668,67461018,78811214,11350196,TNL
chr12,Bn51669,98408464,99976577,1568113,CNL
chr12,Bn51670,77488558,87907402,10418844,NBS
chr12,Bn51671,19374603,93115280,73740677,NBS
chr12,Bn51672,17330738,69701502,52370764,RLK
chr12,Bn51673,98127023,98922786,795763,RLK
chr12,Bn51674,20810068,63404881,42594813,NBS
chr12,Bn51675,77389972,83543580,6153608,TN
chr12,Bn51676,66106734,75887283,9780549,RLP
chr12,Bn51677,84330136,99180929,14850793,RLP
chr12,Bn51678,70329031,91283113,20954082,RLP
chr12,Bn51679,45033924,85613102,40579178,TNL
chr12,Bn51680,99956718,99969087,12369,TNL
chr12,Bn51681,63304890,82768281,19463391,CN
chr12,Bn51682,56612553,87178200,30565647,RLK
chr12,Bn51683,60976886,90137247,29160361,TN
chr12,Bn51684,14197329,50075613,35878284,TN
chr12,Bn51685,71579700,89452395,17872695,CN
chr12,Bn51686,78399836,79301877,902041,CN
chr12,Bn51687,42760690,85232547,42471857,RLK
chr12,Bn51688,51037346,73192751,22155405,TNL
chr12,Bn51689,55999241,87069765,31070524,NBS
chr12,Bn51690,48237251,99152021,50914770,NBS
chr12,Bn51691,4567191,59114423,54547232,NBS
chr12,Bn51692,13897651,94768713,80871062,CNL
chr12,Bn51693,92117683,97556834,5439151,RLK
chr12,Bn51694,24698991,87079572,62380581,TN
chr12,Bn51695,8058947,14105868,6046921,RLP
chr12,Bn51696,95539526,98335685,2796159,TN
chr12,Bn51697,65021645,72559530,7537885,RLP
chr12,Bn51698,60140250,76530145,16389895,CNL
chr12,Bn51699,57209121,86556649,29347528,RLK
chr12,Bn51700,3964943,50402742,46437799,RLK
chr12,Bn51701,26268727,54067552,27798825,TNL
chr12,Bn51702,14949445,64494027,49544582,CNL
chr12,Bn51703,39338140,45163380,5825240,RLP
chr12,Bn51704,62373885,63395637,1021752,TN
chr12,Bn51705,16666138,45267535,28601397,TNL
chr12,Bn51706,18696121,31784494,13088373,CN
chr12,Bn51707,94826099,94921942,95843,RLK
chr12,Bn51708,39954460,67929101,27974641,NBS
chr12,Bn51709,85131128,98569127,13437999,CN
chr12,Bn51710,75325009,85894635,10569626,CNL
chr12,Bn51711,2336059,37501597,35165538,RLP
chr12,Bn51712,46453595,48402891,1949296,NBS
chr12,Bn51713,43050989,46354469,3303480,RLP
chr12,Bn51714,70524797,88300518,17775721,CNL
chr12,Bn51715,1152616,72558840,71406224,TNL
chr12,Bn51716,95027860,97211771,2183911,CN
chr12,Bn51717,83144292,89579839,6435547,RLP
chr12,Bn51718,73319125,99047630,25728505,CN
chr12,Bn51719,78362994,94103712,15740718,TN
chr12,Bn51720,38916422,99881381,60964959,TN
chr12,Bn51721,20446337,97008090,76561753,CN
chr12,Bn51722,45480253,49663117,4182864,NBS
chr12,Bn51723,67933894,76923955,8990061,RLK
chr12,Bn51724,81584610,85652097,4067487,CNL
chr12,Bn51725,38019192,91389484,53370292,TN
chr12,Bn51726,8477155,98173470,89696315,TN
chr12,Bn51727,79402451,97805473,18403022,TNL
chr12,Bn51728,37797611,47345041,9547430,CN
chr12,Bn51729,78007345,93458866,15451521,NBS
chr12,Bn51730,70068514,87491180,17422666,TNL
chr12,Bn51731,22917165,93864326,70947161,TN
chr12,Bn51732,92576206,92840366,264160,TN
chr12,Bn51733,40478655,78275812,37797157,TN
chr12,Bn51734,7918381,66950905,59032524,RLP
chr12,Bn51735,75880510,80672282,4791772,TN
chr12,Bn51736,47122444,94658361,47535917,CN
chr12,Bn51737,48699252,90333710,41634458,TN
chr12,Bn51738,17644855,93843676,76198821,RLK
chr12,Bn51739,51795947,71635304,19839357,RLP
chr12,Bn51740,79174280,94896742,15722462,CNL
chr12,Bn51741,10765450,13073024,2307574,NBS
chr12,Bn51742,7543573,64805485,57261912,RLP
chr12,Bn51743,93026481,96039106,3012625,NBS
chr12,Bn51744,39751744,52457982,12706238,CN
chr12,Bn51745,27973651,59226924,31253273,TNL
chr12,Bn51746,20209937,71676237,51466300,CNL
chr12,Bn51747,54892706,62011598,7118892,RLP
chr12,Bn51748,28670091,71167857,42497766,TN
chr12,Bn51749,87952291,95904725,7952434,CNL
chr12,Bn51750,4177715,12640152,8462437,CN
chr12,Bn51751,37091414,45896810,8805396,TN
chr12,Bn51752,23784511,57033005,33248494,RLP
chr12,Bn51753,75659735,89017854,13358119,TN
chr12,Bn51754,54551102,82264717,27713615,CNL
chr12,Bn51755,64574274,91327816,26753542,NBS
chr12,Bn51756,73957856,84401112,10443256,TN
chr12,Bn51757,52936740,53620904,684164,NBS
chr12,Bn51758,33625988,36565667,2939679,TN
chr12,Bn51759,6942905,86365258,79422353,RLK
chr12,Bn51760,44389803,70657601,26267798,CN
chr12,Bn51761,52167756,81398081,29230325,TNL
chr12,Bn51762,69664298,70355155,690857,CN
chr12,Bn51763,55640117,64845404,9205287,TNL
chr12,Bn51764,6578650,9315455,2736805,RLP
chr12,Bn51765,21923114,59979020,38055906,CNL
chr12,Bn51766,2024905,90537972,88513067,CN
chr12,Bn51767,59517831,83622947,24105116,CNL
chr12,Bn51768,93379364,98291923,4912559,CN
chr12,Bn51769,29356455,38759345,9402890,RLP
chr12,Bn51770,86867345,97252383,10385038,NBS
chr12,Bn51771,44212267,81648876,37436609,TN
chr12,Bn51772,19127628,49314969,30187341,CN
chr12,Bn51773,98649774,99214826,565052,RLK
chr12,Bn51774,76157626,90378269,14220643,TNL
chr12,Bn51775,18627445,63314291,44686846,TN
chr12,Bn51776,83526764,94691242,11164478,CN
chr12,Bn51777,35972146,72375240,36403094,CN
chr12,Bn51778,93635433,95189851,1554418,NBS
chr12,Bn51779,19577264,99947495,80370231,CNL
chr12,Bn51780,57990985,71110915,13119930,CN
chr12,Bn51781,74828712,85755389,10926677,TN
chr12,Bn51782,82771641,88480781,5709140,RLP
chr12,Bn51783,30848183,71388338,40540155,TN
chr12,Bn51784,27203550,76468856,49265306,TNL
chr12,Bn51785,47581806,84034105,36452299,TNL
chr12,Bn51786,74704791,75452120,747329,TN
chr12,Bn51787,5859521,62742487,56882966,TN
chr12,Bn51788,8982835,98034314,89051479,RLP
chr12,Bn51789,13464788,37120097,23655309,CNL
chr12,Bn51790,32914304,39492226,6577922,TNL
chr12,Bn51791,4167388,25022117,20854729,TNL
chr12,Bn51792,34190573,42670128,8479555,RLK
chr12,Bn51793,56480135,96920455,40440320,RLK
chr12,Bn51794,53152001,68807238,15655237,TNL
chr12,Bn51795,51228494,91303869,40075375,CN
chr12,Bn51796,27398377,88246133,60847756,TNL
chr12,Bn51797,25780078,76083295,50303217,RLK
chr12,Bn51798,47357471,93516347,46158876,RLP
chr12,Bn51799,97293699,99090309,1796610,RLK
chr12,Bn51800,22079777,59272553,37192776,TN
chr12,Bn51801,95966536,98425034,2458498,RLK
chr12,Bn51802,73641472,74186881,545409,RLK
chr12,Bn51803,62014685,86070111,24055426,RLP
chr12,Bn51804,90105061,95248914,5143853,RLK
chr12,Bn51805,78576180,86767708,8191528,RLK
chr12,Bn51806,83575585,95597593,12022008,NBS
chr12,Bn51807,35124427,57677194,22552767,RLK
chr12,Bn51808,91081323,95483285,4401962,RLP
chr12,Bn51809,56177622,68003746,11826124,RLK
chr12,Bn51810,76543199,80214629,3671430,TNL
chr12,Bn51811,99620357,99701666,81309,TNL
chr12,Bn51812,28313004,91311732,62998728,CNL
chr12,Bn51813,83215341,86493422,3278081,RLK
chr12,Bn51814,77852056,86071075,8219019,CNL
chr12,Bn51815,98222515,98591467,368952,RLK
chr12,Bn51816,44744617,93463407,48718790,RLK
chr12,Bn51817,67726523,70091344,2364821,TN
chr12,Bn51818,38615152,64249354,25634202,RLK
chr12,Bn51819,70456493,99491068,29034575,RLP
chr12,Bn51820,7598189,25007545,17409356,NBS
chr12,Bn51821,3270645,40161973,36891328,CN
chr12,Bn51822,4984832,80630146,75645314,TNL
chr12,Bn51823,51017294,88122344,37105050,CNL
chr12,Bn51824,54939229,83596138,28656909,TNL
chr12,Bn51825,75426356,76293013,866657,RLK
chr12,Bn51826,39953452,85415255,45461803,RLK
chr12,Bn51827,57113489,57510144,396655,TNL
chr12,Bn51828,68525141,93742097,25216956,RLP
chr12,Bn51829,19569692,94378973,74809281,RLP
chr12,Bn51830,30398237,49046868,18648631,RLK
chr12,Bn51831,4785614,54865363,50079749,TNL
chr12,Bn51832,50110067,82855428,32745361,CNL
chr12,Bn51833,22896515,35503144,12606629,NBS
chr12,Bn51834,20459746,42089351,21629605,RLK
chr12,Bn51835,95854867,99851360,3996493,NBS
chr12,Bn51836,84554504,85190579,636075,RLP
chr12,Bn51837,28829542,44455927,15626385,CN
chr12,Bn51838,12287474,86872041,74584567,CN
chr12,Bn51839,75993669,79130162,3136493,TN
chr12,Bn51840,3641653,32897406,29255753,CNL
chr12,Bn51841,66050067,80467903,14417836,TN
chr12,Bn51842,95444064,97913076,2469012,TNL
chr12,Bn51843,24969232,94122415,69153183,RLP
chr12,Bn51844,20467004,31640993,11173989,NBS
chr12,Bn51845,20461086,31010178,10549092,TNL
chr12,Bn51846,13660805,96495725,82834920,TN
chr12,Bn51847,98781388,99482377,700989,TNL
chr12,Bn51848,57265753,76009883,18744130,CNL
chr12,Bn51849,9774526,71663015,61888489,CNL
chr12,Bn51850,26049780,61504922,35455142,TNL
chr12,Bn51851,40520376,53582625,13062249,CN
chr12,Bn51852,87753226,99869696,12116470,CN
chr12,Bn51853,96457572,99181213,2723641,NBS
chr12,Bn51854,29595468,79618583,50023115,RLP
chr12,Bn51855,67204320,70827206,3622886,RLK
chr12,Bn51856,74419365,82051118,7631753,RLP
chr12,Bn51857,60043707,80868913,20825206,RLK
chr12,Bn51858,3193726,82566699,79372973,CNL
chr12,Bn51859,30243650,76103863,45860213,TN
chr12,Bn51860,14822113,51012242,36190129,NBS
chr12,Bn51861,10418718,96415645,85996927,TNL
chr12,Bn51862,88891209,90946174,2054965,NBS
chr12,Bn51863,75633405,84829794,9196389,CNL
chr12,Bn51864,41732739,84510909,42778170,CNL
chr12,Bn51865,20994507,67135650,46141143,RLK
chr12,Bn51866,14170400,61486341,47315941,TN
chr12,Bn51867,98642840,98998226,355386,CNL
chr12,Bn51868,29705434,98577163,68871729,RLK
chr12,Bn51869,23706138,83414128,59707990,CN
chr12,Bn51870,21753547,36559177,14805630,CN
chr12,Bn51871,76593859,77432661,838802,TN
chr12,Bn51872,81188134,92226155,11038021,CN
chr12,Bn51873,8757819,33677643,24919824,RLK
chr12,Bn51874,78757569,94479405,15721836,RLP
chr12,Bn51875,92493685,99272042,6778357,RLK
chr12,Bn51876,83845150,87206602,3361452,NBS
chr12,Bn51877,29654664,36524098,6869434,TN
chr12,Bn51878,70467263,73148939,2681676,TN
chr12,Bn51879,96003509,99855811,3852302,TNL
chr12,Bn51880,99170103,99963567,793464,RLP
chr12,Bn51881,9717139,87360927,77643788,TN
chr12,Bn51882,47780946,78185723,30404777,TN
chr12,Bn51883,28582867,59790081,31207214,CN
chr12,Bn51884,36451694,41443650,4991956,RLP
chr12,Bn51885,69681951,83084624,13402673,CNL
chr12,Bn51886,35303317,86572747,51269430,NBS
chr12,Bn51887,28140758,44531147,16390389,CN
chr12,Bn51888,58039468,79883674,21844206,NBS
chr12,Bn51889,25878151,63932922,38054771,TNL
chr12,Bn51890,32105120,68497888,36392768,RLK
chr12,Bn51891,71949223,82210685,10261462,CN
chr12,Bn51892,16201292,33433425,17232133,CN
chr12,Bn51893,46597795,47679597,1081802,CN
chr12,Bn51894,92875121,96683145,3808024,TNL
chr12,Bn51895,51618220,86420058,34801838,TN
chr12,Bn51896,13083311,26583896,13500585,CN
chr12,Bn51897,32233383,53335981,21102598,CN
chr12,Bn51898,39561857,60546250,20984393,RLP
chr12,Bn51899,36468555,44215042,7746487,NBS
chr12,Bn51900,86130461,94171440,8040979,NBS
chr12,Bn51901,95716859,97832828,2115969,RLP
chr12,Bn51902,57800009,87997680,30197671,RLP
chr12,Bn51903,80108211,83577276,3469065,RLP
chr12,Bn51904,74867999,90430846,15562847,NBS
chr12,Bn51905,85759154,91006826,5247672,CN
chr12,Bn51906,10151224,73502255,63351031,RLP
chr12,Bn51907,18167858,22828298,4660440,TN
chr12,Bn51908,11663317,29616598,17953281,RLK
chr12,Bn51909,39983470,71411815,31428345,RLK
chr12,Bn51910,76567708,77390041,822333,TNL
chr12,Bn51911,44569211,76162166,31592955,RLK
chr12,Bn51912,61831307,96267126,34435819,TN
chr12,Bn51913,65495443,70464305,4968862,RLP
chr12,Bn51914,50716936,61916700,11199764,NBS
chr12,Bn51915,80974179,98105276,17131097,RLK
chr12,Bn51916,26470068,33076712,6606644,TN
chr12,Bn51917,79273539,82364878,3091339,NBS
chr12,Bn51918,43926181,98836719,54910538,TNL
chr12,Bn51919,53070504,72722129,19651625,RLP
chr12,Bn51920,6761318,43299020,36537702,RLK
chr12,Bn51921,8844559,92981465,84136906,CN
chr12,Bn51922,95452785,99018224,3565439,RLK
chr12,Bn51923,10031826,65677511,55645685,TN
chr12,Bn51924,6156373,69872773,63716400,TNL
chr12,Bn51925,79176095,90880748,11704653,TNL
chr12,Bn51926,41990006,85269863,43279857,RLK
chr12,Bn51927,77749813,82659084,4909271,CNL
chr12,Bn51928,28543785,50737438,22193653,CN
chr12,Bn51929,56616831,87907167,31290336,TN
chr12,Bn51930,43392378,56383520,12991142,RLK
chr12,Bn51931,96200559,97765334,1564775,NBS
chr12,Bn51932,48517093,72629149,24112056,TN
chr12,Bn51933,35748021,39779040,4031019,RLP
chr12,Bn51934,49898031,56461121,6563090,NBS
chr12,Bn51935,34371747,97797133,63425386,CN
chr12,Bn51936,72525699,91220607,18694908,TN
chr12,Bn51937,89470855,97890780,8419925,CN
chr12,Bn51938,63079099,93976819,30897720,NBS
chr12,Bn51939,28875881,75047674,46171793,RLP
chr12,Bn51940,92969709,95942768,2973059,TN
chr12,Bn51941,4435700,72191115,67755415,TN
chr12,Bn51942,79144023,83514831,4370808,RLK
chr12,Bn51943,23264399,33088297,9823898,RLK
chr12,Bn51944,49388725,79891603,30502878,NBS
chr12,Bn51945,4282674,35700188,31417514,RLP
chr12,Bn51946,72586195,81085841,8499646,TN
chr12,Bn51947,65526611,97610876,32084265,CNL
chr12,Bn51948,23018795,69680977,46662182,NBS
chr12,Bn51949,51915436,95345968,43430532,RLP
chr12,Bn51950,93045350,95656217,2610867,RLK
chr12,Bn51951,51540189,56555124,5014935,NBS
chr12,Bn51952,66950206,74409185,7458979,TNL
chr12,Bn51953,2505203,82543616,80038413,RLP
chr12,Bn51954,80973176,95952273,14979097,TN
chr12,Bn51955,92938791,98466451,5527660,CNL
chr12,Bn51956,71964727,79027573,7062846,TN
chr12,Bn51957,2317841,79740939,77423098,RLK
chr12,Bn51958,61624644,94347535,32722891,CN
chr12,Bn51959,25471364,52159757,26688393,RLP
chr12,Bn51960,43230046,90317636,47087590,RLK
chr12,Bn51961,90972365,98748296,7775931,TN
chr12,Bn51962,15259113,88350335,73091222,TN
chr12,Bn51963,74276342,82869626,8593284,TNL
chr12,Bn51964,33557780,51713491,18155711,CN
chr12,Bn51965,55941912,73810870,17868958,RLK
chr12,Bn51966,46211372,92498054,46286682,CNL
chr12,Bn51967,50174214,92896981,42722767,CNL
chr12,Bn51968,6401532,46573424,40171892,RLP
chr12,Bn51969,91566536,97975495,6408959,TNL
chr12,Bn51970,11797064,85315102,73518038,RLK
chr12,Bn51971,90333192,93242263,2909071,CNL
chr12,Bn51972,78243300,82434739,4191439,RLP
chr12,Bn51973,51767077,60774059,9006982,RLP
chr12,Bn51974,94333857,95196964,863107,RLK
chr12,Bn51975,85734753,88063948,2329195,TN
chr12,Bn51976,77583023,96149101,18566078,CNL
chr12,Bn51977,17846766,67456323,49609557,NBS
chr12,Bn51978,80789117,86257246,5468129,CNL
chr12,Bn51979,7526520,84276502,76749982,CNL
chr12,Bn51980,71878249,86557658,14679409,RLP
chr12,Bn51981,99193361,99340155,146794,CNL
chr12,Bn51982,4574340,80867155,76292815,TN
chr12,Bn51983,73422603,79288242,5865639,TNL
chr12,Bn51984,39248040,39498541,250501,RLK
chr12,Bn51985,55637379,60796441,5159062,RLP
chr12,Bn51986,87342205,90166861,2824656,TN
chr12,Bn51987,98194433,98376823,182390,NBS
chr12,Bn51988,50422348,78701428,28279080,NBS
chr12,Bn51989,57558858,80010316,22451458,CNL
chr12,Bn51990,36974846,94569791,57594945,TNL
chr12,Bn51991,3477257,57897978,54420721,RLP
chr12,Bn51992,28080499,98246296,70165797,NBS
chr12,Bn51993,35705916,98870585,63164669,TN
chr12,Bn51994,78136835,89282750,11145915,CN
chr12,Bn51995,92031318,99090122,7058804,CNL
chr12,Bn51996,64224488,85545995,21321507,TN
chr12,Bn51997,22533510,91272187,68738677,TNL
chr12,Bn51998,33830693,97962176,64131483,CNL
chr12,Bn51999,58199667,83683346,25483679,CN
chr12,Bn52000,58250454,67818585,9568131,TNL
chr12,Bn52001,30058272,99492007,69433735,TNL
chr12,Bn52002,40994558,70505094,29510536,CN
chr12,Bn52003,34984657,63049373,28064716,CNL
chr12,Bn52004,4549910,52096044,47546134,CNL
chr12,Bn52005,90176646,95622220,5445574,CN
chr12,Bn52006,32565395,97952393,65386998,RLK
chr12,Bn52007,75244301,94370661,19126360,CN
chr12,Bn52008,48788458,81247494,32459036,RLP
chr12,Bn52009,1434613,94763757,93329144,TN
chr12,Bn52010,48999123,96932135,47933012,RLP
chr12,Bn52011,53155503,69405695,16250192,TN
chr12,Bn52012,65474793,76415365,10940572,RLK
chr12,Bn52013,79480007,95300529,15820522,CNL
chr12,Bn52014,23386271,78632403,55246132,TNL
chr12,Bn52015,84304191,91146534,6842343,RLK
chr12,Bn52016,50100050,88745965,38645915,TN
chr12,Bn52017,81372252,91032787,9660535,CNL
chr12,Bn52018,77540201,77634293,94092,CNL
chr12,Bn52019,52284881,94716847,42431966,TNL
chr12,Bn52020,90245490,98582143,8336653,TNL
chr12,Bn52021,68952874,69364346,411472,CNL
chr12,Bn52022,26693638,29299699,2606061,CNL
chr12,Bn52023,5499501,93081757,87582256,TNL
chr12,Bn52024,35672074,38675792,3003718,RLP
chr12,Bn52025,20546543,59023865,38477322,RLP
chr12,Bn52026,10113225,92102310,81989085,TN
chr12,Bn52027,46663816,89543684,42879868,TNL
chr12,Bn52028,88569754,97240860,8671106,TNL
chr12,Bn52029,52279354,82131087,29851733,TNL
chr12,Bn52030,19981345,43903073,23921728,NBS
chr12,Bn52031,48530930,88477331,39946401,RLK
chr12,Bn52032,52620247,59843244,7222997,TN
chr12,Bn52033,4394948,65740901,61345953,CN
chr12,Bn52034,28932064,82550695,53618631,RLK
chr12,Bn52035,53698092,73642026,19943934,CNL
chr12,Bn52036,88535554,93394890,4859336,NBS
chr12,Bn52037,2563954,15801737,13237783,NBS
chr12,Bn52038,2849085,58682097,55833012,CN
chr12,Bn52039,24265336,73802174,49536838,RLP
chr12,Bn52040,71958355,80242772,8284417,CNL
chr12,Bn52041,29622865,88839601,59216736,RLK
chr12,Bn52042,24579130,91741161,67162031,RLP
chr12,Bn52043,99222009,99419230,197221,TN
chr12,Bn52044,85560787,95817829,10257042,NBS
chr12,Bn52045,76449071,88262264,11813193,RLP
chr12,Bn52046,48623623,76544616,27920993,CNL
chr12,Bn52047,56127120,96189355,40062235,CN
chr12,Bn52048,76236809,93517854,17281045,RLK
chr12,Bn52049,85899286,96462584,10563298,RLP
chr12,Bn52050,51306171,80759538,29453367,CNL
chr12,Bn52051,54787670,88801882,34014212,CNL
chr12,Bn52052,19611583,86233973,66622390,RLP
chr12,Bn52053,64139415,79612451,15473036,CNL
chr12,Bn52054,46741715,66917142,20175427,CNL
chr12,Bn52055,23434319,46367993,22933674,CN
chr12,Bn52056,41970918,96076173,54105255,TN
chr12,Bn52057,87391344,93197913,5806569,RLP
chr12,Bn52058,4572081,13512687,8940606,CNL
chr12,Bn52059,64805705,71216949,6411244,NBS
chr12,Bn52060,87010676,93093439,6082763,RLK
chr12,Bn52061,39525050,61849154,22324104,TN
chr12,Bn52062,61833392,85640847,23807455,TN
chr12,Bn52063,54288519,83049697,28761178,CNL
chr12,Bn52064,28666818,89854791,61187973,RLP
chr12,Bn52065,13552880,34610854,21057974,CN
chr12,Bn52066,51803220,98144226,46341006,RLK
chr12,Bn52067,22452479,95234109,72781630,RLK
chr12,Bn52068,95774390,98166843,2392453,CNL
chr12,Bn52069,65148012,81453596,16305584,RLK
chr12,Bn52070,96318643,96525235,206592,NBS
chr12,Bn52071,1949701,87724175,85774474,CNL
chr12,Bn52072,5539054,6058462,519408,CN
chr12,Bn52073,76952663,96674445,19721782,RLP
chr12,Bn52074,2129658,83971909,81842251,NBS
chr12,Bn52075,20071797,30315336,10243539,TN
chr12,Bn52076,94978340,98699345,3721005,NBS
chr12,Bn52077,94089148,95425427,1336279,RLK
chr12,Bn52078,9837338,30728955,20891617,CN
chr12,Bn52079,85228831,90888441,5659610,RLK
chr12,Bn52080,14238359,82929472,68691113,CN
chr12,Bn52081,64088031,66940210,2852179,NBS
chr12,Bn52082,63906977,86512478,22605501,NBS
chr12,Bn52083,12652284,69806937,57154653,TN
chr12,Bn52084,8180110,24483160,16303050,RLK
chr12,Bn52085,11637632,14406050,2768418,CN
chr12,Bn52086,46310728,56089267,9778539,RLP
chr12,Bn52087,3743678,17870645,14126967,RLP
chr12,Bn52088,81596693,83428727,1832034,RLK
chr12,Bn52089,62213626,86352442,24138816,RLK
chr12,Bn52090,12317128,19158351,6841223,TNL
chr12,Bn52091,72350574,81353250,9002676,TNL
chr12,Bn52092,12330497,69504800,57174303,TN
chr12,Bn52093,10069649,67383504,57313855,TN
chr12,Bn52094,75964028,77326713,1362685,TN
chr12,Bn52095,95918774,97770851,1852077,CN
chr12,Bn52096,41271783,46384350,5112567,TN
chr12,Bn52097,91062069,92529247,1467178,NBS
chr12,Bn52098,90797496,98443393,7645897,RLP
chr12,Bn52099,94666679,97303647,2636968,RLK
chr12,Bn52100,99998651,99999781,1130,TNL
chr12,Bn52101,38039575,64207224,26167649,NBS
chr12,Bn52102,24561493,82537051,57975558,CNL
chr12,Bn52103,69198446,85428372,16229926,CNL
chr12,Bn52104,26349924,59522624,33172700,NBS
chr12,Bn52105,44175430,79702816,35527386,CNL
chr12,Bn52106,70341724,80567853,10226129,NBS
chr12,Bn52107,88223956,94054925,5830969,CNL
chr12,Bn52108,24939890,93176929,68237039,NBS
chr12,Bn52109,73656444,94090887,20434443,NBS
chr12,Bn52110,78174452,84128584,5954132,TN
chr12,Bn52111,19582401,31928705,12346304,RLP
chr12,Bn52112,70933327,74717649,3784322,RLK
chr12,Bn52113,11335346,52113263,40777917,TN
chr12,Bn52114,54100342,82359312,28258970,NBS
chr12,Bn52115,41514219,49502962,7988743,RLP
chr12,Bn52116,79057458,87622616,8565158,NBS
chr12,Bn52117,85900279,92238423,6338144,RLP
chr12,Bn52118,78333069,97132653,18799584,CNL
chr12,Bn52119,17218270,63561389,46343119,CN
chr12,Bn52120,48652649,71640723,22988074,CN
chr12,Bn52121,68138387,88684314,20545927,CN
chr12,Bn52122,39966339,81950478,41984139,RLK
chr12,Bn52123,79269005,90335725,11066720,TNL
chr12,Bn52124,92660254,97216315,4556061,CNL
chr12,Bn52125,97771808,98696601,924793,CNL
chr12,Bn52126,32979897,99871879,66891982,TNL
chr12,Bn52127,19026093,49322991,30296898,CN
chr12,Bn52128,37831316,77415367,39584051,CNL
chr12,Bn52129,32886564,88573422,55686858,RLP
chr12,Bn52130,4807193,76777808,71970615,CN
chr12,Bn52131,52607547,62745622,10138075,TNL
chr12,Bn52132,23324747,82594976,59270229,CNL
chr12,Bn52133,23565947,23956174,390227,NBS
chr12,Bn52134,94625299,96911711,2286412,TNL
chr12,Bn52135,90239861,94752388,4512527,RLK
chr12,Bn52136,72870416,95958202,23087786,TNL
chr12,Bn52137,92107333,94056525,1949192,TNL
chr12,Bn52138,38397589,77622149,39224560,NBS
chr12,Bn52139,34234993,35147599,912606,TNL
chr12,Bn52140,55101577,93653701,38552124,TN
chr12,Bn52141,30521123,32043671,1522548,NBS
chr12,Bn52142,27805083,95863336,68058253,CN
chr12,Bn52143,82787503,99574825,16787322,RLK
chr12,Bn52144,9766944,61694101,51927157,TN
chr12,Bn52145,93330955,93557706,226751,TNL
chr12,Bn52146,70894892,93266141,22371249,CN
chr12,Bn52147,97876647,99861273,1984626,CNL
chr12,Bn52148,94728229,99889730,5161501,TN
chr12,Bn52149,84433339,94606439,10173100,NBS
chr12,Bn52150,87744706,89413259,1668553,CNL
chr12,Bn52151,60130678,70332839,10202161,CNL
chr12,Bn52152,26146167,69357646,43211479,RLP
chr12,Bn52153,79416638,96549663,17133025,RLP
chr12,Bn52154,81027664,87898622,6870958,RLP
chr12,Bn52155,92637891,93900256,1262365,CNL
chr12,Bn52156,20098696,98942314,78843618,NBS
chr12,Bn52157,82280292,83025742,745450,CNL
chr12,Bn52158,48391187,97022524,48631337,RLK
chr12,Bn52159,35146231,55776018,20629787,CN
chr12,Bn52160,8434548,93954871,85520323,RLK
chr12,Bn52161,65593364,89068453,23475089,RLP
chr12,Bn52162,14665148,65240218,50575070,TNL
chr12,Bn52163,19296430,58533000,39236570,RLK
chr12,Bn52164,21490387,82215041,60724654,CNL
chr12,Bn52165,47598248,98413341,50815093,RLK
chr12,Bn52166,65194712,80310112,15115400,TN
chr12,Bn52167,32282412,73708673,41426261,CNL
chr12,Bn52168,72182536,92439937,20257401,RLK
chr12,Bn52169,61714293,87998487,26284194,CNL
chr12,Bn52170,44854238,50670493,5816255,TNL
chr12,Bn52171,30635460,74675872,44040412,TN
chr12,Bn52172,56520315,95316067,38795752,CNL
chr12,Bn52173,6498368,86647062,80148694,CNL
chr12,Bn52174,23475908,66084469,42608561,TNL
chr12,Bn52175,27346377,67890913,40544536,CN
chr12,Bn52176,30137763,88066726,57928963,NBS
chr12,Bn52177,10471903,74065939,63594036,RLP
chr12,Bn52178,45701411,88581442,42880031,RLK
chr12,Bn52179,81100925,93131037,12030112,NBS
chr12,Bn52180,13021677,15801826,2780149,NBS
chr12,Bn52181,34084879,57408019,23323140,TN
chr12,Bn52182,16434921,21328787,4893866,RLK
chr12,Bn52183,51888952,66337636,14448684,CN
chr12,Bn52184,60762830,85897113,25134283,RLP
chr12,Bn52185,52792373,72558385,19766012,CN
chr12,Bn52186,88665888,93648509,4982621,NBS
chr12,Bn52187,75575043,93804679,18229636,TN
chr12,Bn52188,36286589,46689440,10402851,RLP
chr12,Bn52189,95059902,97121816,2061914,RLP
chr12,Bn52190,45453161,88055300,42602139,RLK
chr12,Bn52191,63364559,85659186,22294627,CN
chr12,Bn52192,19690559,28316535,8625976,RLK
chr12,Bn52193,29114076,50901190,21787114,RLK
chr12,Bn52194,68530886,77022764,8491878,CN
chr12,Bn52195,92354185,95027113,2672928,CNL
chr12,Bn52196,98689654,99482441,792787,TNL
chr12,Bn52197,18697958,39344464,20646506,TNL
chr12,Bn52198,30946883,61256505,30309622,NBS
chr12,Bn52199,95692799,98091166,2398367,RLK
chr12,Bn52200,20050385,75875087,55824702,TNL
chr12,Bn52201,70978185,96748165,25769980,NBS
chr12,Bn52202,20586437,22322429,1735992,RLK
chr12,Bn52203,57789354,89574641,31785287,NBS
chr12,Bn52204,14486161,67934196,53448035,RLP
chr12,Bn52205,10397430,47729438,37332008,TN
chr12,Bn52206,70306765,73779634,3472869,TNL
chr12,Bn52207,77919598,85188855,7269257,TNL
chr12,Bn52208,23488718,82516912,59028194,RLK
chr12,Bn52209,16620916,40510825,23889909,NBS
chr12,Bn52210,80032950,84408039,4375089,RLK
chr12,Bn52211,73132649,73407185,274536,RLK
chr12,Bn52212,83413891,96808580,13394689,CN
chr12,Bn52213,85780174,88842435,3062261,CN
chr12,Bn52214,95931303,99119332,3188029,TNL
chr12,Bn52215,31300953,86177659,54876706,CNL
chr12,Bn52216,68372061,95278066,26906005,NBS
chr12,Bn52217,75197961,97838199,22640238,RLP
chr12,Bn52218,19653090,93587748,73934658,RLP
chr12,Bn52219,83284957,99359660,16074703,CNL
chr12,Bn52220,8033509,88771141,80737632,NBS
chr12,Bn52221,27075776,61190999,34115223,NBS
chr12,Bn52222,99960696,99979663,18967,TN
chr12,Bn52223,88089447,90712017,2622570,NBS
chr12,Bn52224,56855096,77627551,20772455,TNL
chr12,Bn52225,82495974,93212089,10716115,TN
chr12,Bn52226,81620652,99828282,18207630,RLK
chr12,Bn52227,22337313,96970636,74633323,CNL
chr12,Bn52228,93246638,95714191,2467553,RLP
chr12,Bn52229,7559829,11380002,3820173,CNL
chr12,Bn52230,50138431,52768865,2630434,RLP
chr12,Bn52231,88459388,90710443,2251055,RLP
chr12,Bn52232,76732229,76898453,166224,RLK
chr12,Bn52233,84537114,94303332,9766218,CNL
chr12,Bn52234,74203867,97487066,23283199,CNL
chr12,Bn52235,80083402,85564073,5480671,NBS
chr12,Bn52236,21513097,91840460,70327363,TN
chr12,Bn52237,96077932,98697994,2620062,RLP
chr12,Bn52238,31813203,63109023,31295820,CNL
chr12,Bn52239,43927292,50490703,6563411,RLK
chr12,Bn52240,6514301,57600717,51086416,TN
chr12,Bn52241,72140234,80114607,7974373,CN
chr12,Bn52242,94652152,98624851,3972699,CNL
chr12,Bn52243,97986137,98929898,943761,TN
chr12,Bn52244,36299296,51501255,15201959,TNL
chr12,Bn52245,57930140,77023703,19093563,NBS
chr12,Bn52246,49313811,70867901,21554090,TNL
chr12,Bn52247,68271074,75499204,7228130,CN
chr12,Bn52248,33885616,70056151,36170535,TN
chr12,Bn52249,24635328,65463474,40828146,CNL
chr12,Bn52250,4261017,92469675,88208658,NBS
chr12,Bn52251,60904499,84864710,23960211,RLK
chr12,Bn52252,50096887,82411386,32314499,CNL
chr12,Bn52253,57757485,95696872,37939387,RLK
chr12,Bn52254,17661904,49644357,31982453,TNL
chr12,Bn52255,9092200,80954546,71862346,TN
chr12,Bn52256,74300408,76651523,2351115,RLK
chr12,Bn52257,39864484,74197443,34332959,CN
chr12,Bn52258,14734000,44943707,30209707,RLP
chr12,Bn52259,34946607,81667500,46720893,TNL
chr12,Bn52260,32583725,81629933,49046208,CNL
chr12,Bn52261,15203995,76323667,61119672,CNL
chr12,Bn52262,23424329,67903750,44479421,RLP
chr12,Bn52263,7312515,92332107,85019592,RLK
chr12,Bn52264,35237130,80194037,44956907,CN
chr12,Bn52265,89535847,97520461,7984614,TNL
chr12,Bn52266,6783722,55780251,48996529,TNL
chr12,Bn52267,15540723,44740221,29199498,CNL
chr12,Bn52268,50388130,77304086,26915956,CN
chr12,Bn52269,17683341,94570524,76887183,CN
chr12,Bn52270,87500102,93785244,6285142,CN
chr12,Bn52271,15662612,33412875,17750263,NBS
chr12,Bn52272,84899213,95930194,11030981,CNL
chr12,Bn52273,82004538,83947804,1943266,RLK
chr12,Bn52274,18597561,42303049,23705488,TN
chr12,Bn52275,23811281,72942689,49131408,CNL
chr12,Bn52276,13062396,29031228,15968832,TN
chr12,Bn52277,94800140,95882581,1082441,NBS
chr12,Bn52278,41583207,51290291,9707084,RLK
chr12,Bn52279,98229385,98491787,262402,NBS
chr12,Bn52280,68701725,83619124,14917399,NBS
chr12,Bn52281,26612267,50297611,23685344,CN
chr12,Bn52282,75864107,78228464,2364357,TN
chr12,Bn52283,32155938,53939590,21783652,RLP
chr12,Bn52284,75112451,93607594,18495143,TNL
chr12,Bn52285,96097055,99675188,3578133,NBS
chr12,Bn52286,60018446,71021131,11002685,TN
chr12,Bn52287,49140730,57542930,8402200,RLP
chr12,Bn52288,30178391,82799882,52621491,TNL
chr12,Bn52289,29809600,52054633,22245033,TN
chr12,Bn52290,55729590,97401961,41672371,CN
chr12,Bn52291,52993919,77723535,24729616,RLP
chr12,Bn52292,42169439,68293676,26124237,CNL
chr12,Bn52293,48805667,52194453,3388786,NBS
chr12,Bn52294,98387935,99087394,699459,CN
chr12,Bn52295,44680002,49199254,4519252,CN
chr12,Bn52296,40964224,81219007,40254783,RLP
chr12,Bn52297,78971980,79652435,680455,CN
chr12,Bn52298,59107523,73500437,14392914,RLK
chr12,Bn52299,49623513,82301274,32677761,TNL
chr12,Bn52300,95034525,97694232,2659707,RLP
chr12,Bn52301,63595612,90986160,27390548,NBS
chr12,Bn52302,35881914,93227119,57345205,TNL
chr12,Bn52303,45993531,61305461,15311930,CNL
chr12,Bn52304,99262223,99927085,664862,CNL
chr12,Bn52305,59703413,75971301,16267888,CN
chr12,Bn52306,4976157,91729247,86753090,CNL
chr12,Bn52307,74251753,90507847,16256094,CN
chr12,Bn52308,3229247,36622156,33392909,TN
chr12,Bn52309,10254823,67210237,56955414,TN
chr12,Bn52310,16342634,68340107,51997473,CN
chr12,Bn52311,31043814,72865857,41822043,TNL
chr12,Bn52312,40416283,67877063,27460780,CNL
chr12,Bn52313,26848188,94406753,67558565,NBS
chr12,Bn52314,65980278,88033890,22053612,CNL
chr12,Bn52315,51373372,95899123,44525751,CNL
chr12,Bn52316,46467967,82487399,36019432,TN
chr12,Bn52317,20261367,45177370,24916003,TN
chr12,Bn52318,28461495,67145234,38683739,TNL
chr12,Bn52319,95009022,98881920,3872898,RLP
chr12,Bn52320,54874589,70890175,16015586,NBS
chr12,Bn52321,59369561,91349393,31979832,TNL
chr12,Bn52322,24886353,79007019,54120666,TNL
chr12,Bn52323,38587022,81859586,43272564,CN
chr12,Bn52324,14284845,15109722,824877,TN
chr12,Bn52325,84484098,91470379,6986281,RLK
chr12,Bn52326,96192256,97871978,1679722,RLP
chr12,Bn52327,43738417,84314911,40576494,NBS
chr12,Bn52328,61022795,93261736,32238941,TN
chr12,Bn52329,54372546,94973511,40600965,CNL
chr12,Bn52330,24575718,44098587,19522869,TN
chr12,Bn52331,27920083,31983076,4062993,NBS
chr12,Bn52332,40839548,75224990,34385442,CNL
chr12,Bn52333,65531614,78876561,13344947,RLP
chr12,Bn52334,82600836,88175160,5574324,TN
chr12,Bn52335,70049656,78395105,8345449,CNL
chr12,Bn52336,77819552,87626283,9806731,CN
chr12,Bn52337,12741581,90729861,77988280,CN
chr12,Bn52338,44233388,65961963,21728575,RLK
chr12,Bn52339,91207810,99467528,8259718,RLK
chr12,Bn52340,18969610,71901662,52932052,RLK
chr12,Bn52341,53524857,83176017,29651160,RLK
chr12,Bn52342,64629183,88781809,24152626,TN
chr12,Bn52343,62362649,94609282,32246633,TNL
chr12,Bn52344,20093746,38156315,18062569,TN
chr12,Bn52345,56489217,65037993,8548776,CNL
chr12,Bn52346,55227004,62758189,7531185,RLP
chr12,Bn52347,78673068,95237898,16564830,NBS
chr12,Bn52348,35860659,81217770,45357111,CN
chr12,Bn52349,56647111,58360470,1713359,RLP
chr12,Bn52350,73776978,91651329,17874351,CN
chr12,Bn52351,97141130,98916506,1775376,RLP
chr12,Bn52352,44403931,86599822,42195891,RLK
chr12,Bn52353,79236431,84178531,4942100,RLP
chr12,Bn52354,64010150,81142386,17132236,RLK
chr12,Bn52355,20255359,22433632,2178273,RLP
chr12,Bn52356,60912111,99141831,38229720,CNL
chr12,Bn52357,78101002,96702452,18601450,TN
chr12,Bn52358,93551763,97386129,3834366,NBS
chr12,Bn52359,14819203,45742703,30923500,TN
chr12,Bn52360,10807077,69582088,58775011,RLK
chr12,Bn52361,40448228,94543837,54095609,RLP
chr12,Bn52362,93238600,94049173,810573,TNL
chr12,Bn52363,68875125,80494373,11619248,NBS
chr12,Bn52364,57487560,95417931,37930371,RLK
chr12,Bn52365,10023312,27498505,17475193,CN
chr12,Bn52366,70128827,96342026,26213199,CN
chr12,Bn52367,64309108,79729689,15420581,TNL
chr12,Bn52368,59653771,89006815,29353044,RLK
chr12,Bn52369,51816612,75638521,23821909,TNL
chr12,Bn52370,16585179,89640882,73055703,RLP
chr12,Bn52371,95689908,96858871,1168963,TN
chr12,Bn52372,19391936,82427410,63035474,RLP
chr12,Bn52373,80636335,94425015,13788680,NBS
chr12,Bn52374,21109578,96279521,75169943,RLK
chr12,Bn52375,49765581,67700019,17934438,TNL
chr12,Bn52376,91953946,99553255,7599309,RLP
chr12,Bn52377,63626565,76678951,13052386,RLP
chr12,Bn52378,23173419,37991912,14818493,RLP
chr12,Bn52379,88650236,95642954,6992718,TNL
chr12,Bn52380,30006310,45546719,15540409,TN
chr12,Bn52381,87932673,89985962,2053289,RLK
chr12,Bn52382,14259094,34389044,20129950,CN
chr12,Bn52383,57225647,90951260,33725613,CN
chr12,Bn52384,73969018,86382257,12413239,CNL
chr12,Bn52385,79921125,90373251,10452126,RLP
chr12,Bn52386,14276314,18651727,4375413,CN
chr12,Bn52387,57949818,66238014,8288196,RLP
chr12,Bn52388,71392593,85583534,14190941,CN
chr12,Bn52389,66460918,70234441,3773523,TNL
chr12,Bn52390,41427100,73454037,32026937,RLP
chr12,Bn52391,67046412,96347729,29301317,TN
chr12,Bn52392,3835808,63730157,59894349,CNL
chr12,Bn52393,41064442,68033061,26968619,RLP
chr12,Bn52394,29338248,61729528,32391280,RLP
chr12,Bn52395,17335029,71881451,54546422,RLK
chr12,Bn52396,95303161,95925375,622214,TNL
chr12,Bn52397,83125827,93053706,9927879,NBS
chr12,Bn52398,31142357,61788856,30646499,TN
chr12,Bn52399,62408494,90712646,28304152,CNL
chr12,Bn52400,62197142,78718278,16521136,TNL
chr12,Bn52401,42285603,58265088,15979485,RLK
chr12,Bn52402,80713450,85643584,4930134,CNL
chr12,Bn52403,53017415,78134232,25116817,TN
chr12,Bn52404,91464923,93454680,1989757,TN
chr12,Bn52405,11009175,99042508,88033333,RLP
chr12,Bn52406,35317471,99780921,64463450,RLK
chr12,Bn52407,82078608,92218684,10140076,CNL
chr12,Bn52408,65672982,78530274,12857292,TN
chr12,Bn52409,37933987,70495366,32561379,CNL
chr12,Bn52410,76136025,91112157,14976132,TN
chr12,Bn52411,30367779,65164633,34796854,TN
chr12,Bn52412,46596665,98064769,51468104,RLP
chr12,Bn52413,25365445,91069134,65703689,CNL
chr12,Bn52414,40795849,84110554,43314705,CN
chr12,Bn52415,87682334,92637928,4955594,TN
chr12,Bn52416,28537495,68067003,39529508,TNL
chr12,Bn52417,27648481,47773321,20124840,TN
chr12,Bn52418,23750487,98353696,74603209,TNL
chr12,Bn52419,49948282,67404039,17455757,TNL
chr12,Bn52420,38119121,58396319,20277198,CN
chr12,Bn52421,97064892,97541460,476568,RLK
chr12,Bn52422,75167161,83785208,8618047,CN
chr12,Bn52423,44346343,89558912,45212569,NBS
chr12,Bn52424,96489703,98566652,2076949,CNL
chr12,Bn52425,67475540,87254924,19779384,TN
chr12,Bn52426,68127356,97863676,29736320,TNL
chr12,Bn52427,28315366,70685685,42370319,RLK
chr12,Bn52428,10856900,59527976,48671076,RLK
chr12,Bn52429,75575235,90493452,14918217,CNL
chr12,Bn52430,65495121,77497193,12002072,TNL
chr12,Bn52431,62985267,64872070,1886803,TNL
chr12,Bn52432,21935842,59150335,37214493,NBS
chr12,Bn52433,3169490,54964674,51795184,CNL
chr12,Bn52434,76027046,79175189,3148143,TNL
chr12,Bn52435,33299751,58457903,25158152,NBS
chr12,Bn52436,39438316,72133291,32694975,TNL
chr12,Bn52437,85657463,90570128,4912665,CNL
chr12,Bn52438,27716046,99942085,72226039,RLK
chr12,Bn52439,40653494,60687954,20034460,RLK
chr12,Bn52440,96431447,97099663,668216,RLK
chr12,Bn52441,4258981,76168639,71909658,CNL
chr12,Bn52442,14427333,70619598,56192265,CNL
chr12,Bn52443,45357736,66807645,21449909,TNL
chr12,Bn52444,5382960,48280000,42897040,RLK
chr12,Bn52445,9217729,50524465,41306736,CNL
chr12,Bn52446,14741277,51678572,36937295,TN
chr12,Bn52447,18504936,64538529,46033593,RLP
chr12,Bn52448,49364993,72935719,23570726,RLP
chr12,Bn52449,46661882,52669621,6007739,TNL
chr12,Bn52450,23734043,65935803,42201760,RLP
chr12,Bn52451,45710076,82066814,36356738,RLK
chr12,Bn52452,67990966,84731758,16740792,TN
chr12,Bn52453,39264231,59844455,20580224,TNL
chr12,Bn52454,58184048,74177332,15993284,RLK
chr12,Bn52455,90322388,92737582,2415194,CN
chr12,Bn52456,50092330,97797712,47705382,TN
chr12,Bn52457,55691102,81490390,25799288,RLK
chr12,Bn52458,81470238,95587634,14117396,CN
chr12,Bn52459,54395622,59681847,5286225,TN
chr12,Bn52460,63415922,67401115,3985193,CNL
chr12,Bn52461,86660290,95312691,8652401,CNL
chr12,Bn52462,25984805,54133993,28149188,TNL
chr12,Bn52463,13840273,73342412,59502139,CN
chr12,Bn52464,90094690,91070261,975571,TNL
chr12,Bn52465,61976208,65086402,3110194,CNL
chr12,Bn52466,65985167,73041223,7056056,RLP
chr12,Bn52467,99067566,99113766,46200,TN
chr12,Bn52468,40842897,67085532,26242635,NBS
chr12,Bn52469,79710389,84890763,5180374,TN
chr12,Bn52470,23102884,99078132,75975248,TN
chr12,Bn52471,81271902,84360007,3088105,CNL
chr12,Bn52472,64256475,66860615,2604140,NBS
chr12,Bn52473,80739324,93235991,12496667,CN
chr12,Bn52474,82586573,87448448,4861875,CNL
chr12,Bn52475,2510215,64003705,61493490,CNL
chr12,Bn52476,4028706,8486197,4457491,NBS
chr12,Bn52477,54898566,92864184,37965618,NBS
chr12,Bn52478,83791721,87847404,4055683,CN
chr12,Bn52479,82812439,87877204,5064765,RLP
chr12,Bn52480,22338426,78232505,55894079,TN
chr12,Bn52481,6344969,59535436,53190467,RLP
chr12,Bn52482,55293682,55616537,322855,RLK
chr12,Bn52483,38845459,68704645,29859186,TNL
chr12,Bn52484,76841100,87621497,10780397,CN
chr12,Bn52485,61210186,95200944,33990758,TNL
chr12,Bn52486,51258609,65897878,14639269,TNL
chr12,Bn52487,64376859,97940649,33563790,TN
chr12,Bn52488,44964440,53865589,8901149,CN
chr12,Bn52489,25714360,85743357,60028997,CNL
chr12,Bn52490,58074448,61791572,3717124,TN
chr12,Bn52491,6199472,93502785,87303313,NBS
chr12,Bn52492,33623758,43153719,9529961,RLK
chr12,Bn52493,26888243,39880069,12991826,CNL
chr12,Bn52494,1277613,21578921,20301308,TN
chr12,Bn52495,75033340,87666311,12632971,RLP
chr12,Bn52496,53391193,66799876,13408683,TNL
chr12,Bn52497,94052380,94995029,942649,NBS
chr12,Bn52498,43637403,86942661,43305258,CNL
chr12,Bn52499,78394620,87830083,9435463,CNL
chr12,Bn52500,9271611,60996770,51725159,TNL
chr12,Bn52501,59254684,92524559,33269875,TNL
chr12,Bn52502,49282841,89097175,39814334,RLK
chr12,Bn52503,42273527,68031212,25757685,RLP
chr12,Bn52504,93707229,96203856,2496627,TNL
chr12,Bn52505,59918389,86204723,26286334,TN
chr12,Bn52506,79932923,87523765,7590842,TNL
chr12,Bn52507,61592404,78361858,16769454,NBS
chr12,Bn52508,15461320,68333233,52871913,CN
chr12,Bn52509,56395088,97990205,41595117,TN
chr12,Bn52510,28427203,91717111,63289908,TNL
chr12,Bn52511,35418445,91589869,56171424,NBS
chr12,Bn52512,2209249,34260012,32050763,TNL
chr12,Bn52513,21870852,58860524,36989672,CN
chr12,Bn52514,28490182,90814061,62323879,RLP
chr12,Bn52515,44267291,81470613,37203322,TNL
chr12,Bn52516,87472789,97277840,9805051,CNL
chr12,Bn52517,9742276,25082254,15339978,RLP
chr12,Bn52518,17334899,28884304,11549405,CNL
chr12,Bn52519,22389498,54063877,31674379,RLK
chr12,Bn52520,36781285,74381899,37600614,CNL
chr12,Bn52521,91706462,99532054,7825592,NBS
chr12,Bn52522,3715828,25454000,21738172,NBS
chr12,Bn52523,20673656,50887296,30213640,NBS
chr12,Bn52524,64246611,68349713,4103102,CNL
chr12,Bn52525,52032941,63121134,11088193,TN
chr12,Bn52526,57800155,98710180,40910025,TN
chr12,Bn52527,2734534,10184964,7450430,TN
chr12,Bn52528,6579574,93987791,87408217,NBS
chr12,Bn52529,50760034,61180218,10420184,CN
chr12,Bn52530,46263507,48471194,2207687,CNL
chr12,Bn52531,91386006,95792404,4406398,CNL
chr12,Bn52532,67184713,90734424,23549711,TN
chr12,Bn52533,12162853,28976016,16813163,TNL
chr12,Bn52534,68541249,95410543,26869294,RLP
chr12,Bn52535,5222146,61285400,56063254,NBS
chr12,Bn52536,14599424,35337981,20738557,RLK
chr12,Bn52537,30548364,71615982,41067618,CN
chr12,Bn52538,43635560,91689001,48053441,TNL
chr12,Bn52539,10540632,39188634,28648002,CNL
chr12,Bn52540,52866750,92878509,40011759,TN
chr12,Bn52541,65627754,86361841,20734087,NBS
chr12,Bn52542,17133242,45581630,28448388,RLK
chr12,Bn52543,7574055,21277176,13703121,TN
chr12,Bn52544,36909350,75549309,38639959,TNL
chr12,Bn52545,83936453,99901517,15965064,RLP
chr12,Bn52546,15377028,58615949,43238921,RLP
chr12,Bn52547,53843459,54970391,1126932,CN
chr12,Bn52548,58122868,90319497,32196629,TNL
chr12,Bn52549,75395382,88853372,13457990,RLK
chr12,Bn52550,48445473,74599490,26154017,RLK
chr12,Bn52551,75845995,99944473,24098478,TN
chr12,Bn52552,91788780,98902170,7113390,CNL
chr12,Bn52553,89729724,91372628,1642904,CNL
chr12,Bn52554,16438901,62090812,45651911,RLP
chr12,Bn52555,40292837,90413878,50121041,NBS
chr12,Bn52556,20145536,43812372,23666836,TN
chr12,Bn52557,21519375,40593828,19074453,TNL
chr12,Bn52558,57061333,80738383,23677050,NBS
chr12,Bn52559,14592410,99959140,85366730,RLP
chr12,Bn52560,63954549,74673773,10719224,NBS
chr12,Bn52561,29702100,56657919,26955819,RLK
chr12,Bn52562,37524954,82115133,44590179,CNL
chr12,Bn52563,21728318,82998014,61269696,RLP
chr12,Bn52564,10401015,77159259,66758244,TNL
chr12,Bn52565,88091530,90407407,2315877,RLP
chr12,Bn52566,2422823,77994725,75571902,RLP
chr12,Bn52567,23856705,75182960,51326255,CN
chr12,Bn52568,77428730,87429328,10000598,TN
chr12,Bn52569,63028396,86705378,23676982,TNL
chr12,Bn52570,43733040,82915674,39182634,TN
chr12,Bn52571,57089835,98962979,41873144,RLK
chr12,Bn52572,92337388,92412233,74845,CN
chr12,Bn52573,84557383,90320565,5763182,CNL
chr12,Bn52574,21576279,49841684,28265405,CNL
chr12,Bn52575,90868498,94063396,3194898,NBS
chr12,Bn52576,66309078,66450560,141482,NBS
chr12,Bn52577,20629875,45720876,25091001,NBS
chr12,Bn52578,34116562,47596402,13479840,TN
chr12,Bn52579,53444649,71428683,17984034,RLK
chr12,Bn52580,66479237,70814572,4335335,TN
chr12,Bn52581,65953721,76060434,10106713,RLP
chr12,Bn52582,90871306,94228941,3357635,CNL
chr12,Bn52583,73841761,79060310,5218549,NBS
chr12,Bn52584,91470783,95150484,3679701,NBS
chr12,Bn52585,5177464,59622350,54444886,TNL
chr12,Bn52586,35094074,64199167,29105093,CNL
chr12,Bn52587,57305553,78583322,21277769,RLP
chr12,Bn52588,66058059,85359802,19301743,CNL
chr12,Bn52589,14195824,71627743,57431919,NBS
chr12,Bn52590,46697778,61385201,14687423,TNL
chr12,Bn52591,42491996,92206247,49714251,TNL
chr12,Bn52592,65429747,95565194,30135447,NBS
chr12,Bn52593,12669367,55959699,43290332,TN
chr12,Bn52594,91835734,93743695,1907961,TNL
chr12,Bn52595,84847607,88637099,3789492,NBS
chr12,Bn52596,38891407,68825602,29934195,NBS
chr12,Bn52597,82911864,85813577,2901713,CN
chr12,Bn52598,74269634,77279207,3009573,TNL
chr12,Bn52599,92184435,98619749,6435314,TN
chr12,Bn52600,95546813,99152872,3606059,CNL
chr12,Bn52601,12307798,89505323,77197525,CNL
chr12,Bn52602,2297756,57153636,54855880,TN
chr12,Bn52603,37686812,90081726,52394914,NBS
chr12,Bn52604,11252247,98318396,87066149,CNL
chr12,Bn52605,91093422,97996512,6903090,RLP
chr12,Bn52606,4882974,98172301,93289327,CN
chr12,Bn52607,71338859,94272506,22933647,TN
chr12,Bn52608,18541330,34188744,15647414,NBS
chr12,Bn52609,76348665,99076120,22727455,RLK
chr12,Bn52610,74010057,79134141,5124084,CN
chr12,Bn52611,19686321,89074529,69388208,RLK
chr12,Bn52612,66122396,79562765,13440369,CN
chr12,Bn52613,75849197,76590619,741422,CN
chr12,Bn52614,62066691,67668125,5601434,NBS
chr12,Bn52615,33748793,63271428,29522635,CNL
chr12,Bn52616,43618154,83964358,40346204,RLK
chr12,Bn52617,65724916,73220534,7495618,CN
chr12,Bn52618,58090153,99768214,41678061,TN
chr12,Bn52619,50553008,56471336,5918328,TN
chr12,Bn52620,98981606,99961094,979488,CNL
chr12,Bn52621,70703954,99240701,28536747,TNL
chr12,Bn52622,20925592,92384633,71459041,TNL
chr12,Bn52623,90494899,92938214,2443315,CN
chr12,Bn52624,58027622,71129264,13101642,RLK
chr12,Bn52625,79150958,94082340,14931382,CNL
chr12,Bn52626,90568602,91594583,1025981,CNL
chr12,Bn52627,67576425,86596438,19020013,CN
chr12,Bn52628,89084429,99064252,9979823,TNL
chr12,Bn52629,72843125,96748850,23905725,CNL
chr12,Bn52630,94347795,96044759,1696964,RLK
chr12,Bn52631,98263693,98939495,675802,RLP
chr12,Bn52632,43577296,62405737,18828441,NBS
chr12,Bn52633,24913164,45870018,20956854,NBS
chr12,Bn52634,70031726,84201463,14169737,RLP
chr12,Bn52635,81800488,90995008,9194520,TN
chr12,Bn52636,80978758,97918027,16939269,NBS
chr12,Bn52637,78009267,98681639,20672372,TN
chr12,Bn52638,68878942,97847716,28968774,RLK
chr12,Bn52639,98758912,99278420,519508,RLP
chr12,Bn52640,1356908,39397785,38040877,RLP
chr12,Bn52641,92023350,96816506,4793156,CN
chr12,Bn52642,12422234,78001041,65578807,TNL
chr12,Bn52643,30620294,96027678,65407384,TN
chr12,Bn52644,12606017,22010576,9404559,TNL
chr12,Bn52645,41036304,60571355,19535051,RLP
chr12,Bn52646,19264242,73852609,54588367,TNL
chr12,Bn52647,70275471,92135084,21859613,CN
chr12,Bn52648,33810544,64675118,30864574,NBS
chr12,Bn52649,2672246,67668415,64996169,RLK
chr12,Bn52650,46405494,68289602,21884108,CNL
chr12,Bn52651,63873654,91802106,27928452,CN
chr12,Bn52652,67048655,92804769,25756114,NBS
chr12,Bn52653,11744143,43096069,31351926,CN
chr12,Bn52654,92065105,99702992,7637887,CNL
chr12,Bn52655,2487893,17557192,15069299,RLK
chr12,Bn52656,86242126,92710289,6468163,TN
chr12,Bn52657,66796776,97016054,30219278,TNL
chr12,Bn52658,47476559,76058881,28582322,RLK
chr12,Bn52659,14929893,76571239,61641346,CN
chr12,Bn52660,99987628,99999037,11409,RLP
chr12,Bn52661,53575144,87342109,33766965,TN
chr12,Bn52662,81688279,90820221,9131942,TN
chr12,Bn52663,57695237,87965430,30270193,NBS
chr12,Bn52664,37914963,57094907,19179944,TNL
chr12,Bn52665,11882132,47239525,35357393,RLK
chr12,Bn52666,75533664,97446045,21912381,NBS
chr12,Bn52667,38903034,99351432,60448398,TNL
chr12,Bn52668,21402070,69696119,48294049,CN
chr12,Bn52669,92335750,93506520,1170770,CNL
chr12,Bn52670,69750685,90945835,21195150,TNL
chr12,Bn52671,89318543,97358540,8039997,RLK
chr12,Bn52672,57058451,72202475,15144024,RLP
chr12,Bn52673,51409805,68649755,17239950,RLK
chr12,Bn52674,22963974,65503314,42539340,TNL
chr12,Bn52675,7738262,82588896,74850634,RLK
chr12,Bn52676,65089860,99965817,34875957,TN
chr12,Bn52677,20631576,91502986,70871410,CNL
chr12,Bn52678,33066275,72226777,39160502,CNL
chr12,Bn52679,17535477,98664063,81128586,RLK
chr12,Bn52680,50999984,53678803,2678819,RLP
chr12,Bn52681,10178896,43601088,33422192,TN
chr12,Bn52682,17065047,53536832,36471785,NBS
chr12,Bn52683,48324289,98017617,49693328,RLK
chr12,Bn52684,71697504,75165924,3468420,NBS
chr12,Bn52685,10114768,55586878,45472110,TN
chr12,Bn52686,40754663,95547764,54793101,TN
chr12,Bn52687,14208957,70201343,55992386,CNL
chr12,Bn52688,50208575,78605032,28396457,CN
chr12,Bn52689,88941200,99268376,10327176,TNL
chr12,Bn52690,25277867,34271890,8994023,CN
chr12,Bn52691,35618498,77524345,41905847,TNL
chr12,Bn52692,78300892,82390855,4089963,CNL
chr12,Bn52693,1910976,90137537,88226561,CNL
chr12,Bn52694,97808901,99993638,2184737,CNL
chr12,Bn52695,61325582,85752567,24426985,TNL
chr12,Bn52696,29354769,89853764,60498995,TNL
chr12,Bn52697,13078616,82001789,68923173,TNL
chr12,Bn52698,12144473,74568978,62424505,CN
chr12,Bn52699,26212567,51152872,24940305,TNL
chr12,Bn52700,76631481,92125247,15493766,RLP
chr12,Bn52701,25436079,90732281,65296202,CN
chr12,Bn52702,58546936,59426128,879192,NBS
chr12,Bn52703,63428123,78736299,15308176,NBS
chr12,Bn52704,86962712,89063052,2100340,TNL
chr12,Bn52705,15699441,66171072,50471631,NBS
chr12,Bn52706,10649426,10813170,163744,CNL
chr12,Bn52707,73316810,94321382,21004572,CNL
chr12,Bn52708,93486376,97260224,3773848,RLP
chr12,Bn52709,18325722,49763796,31438074,CN
chr12,Bn52710,23408660,26394668,2986008,RLP
chr12,Bn52711,12294341,84231491,71937150,TN
chr12,Bn52712,78227058,87855991,9628933,CN
chr12,Bn52713,4787386,59033231,54245845,TNL
chr12,Bn52714,94629434,98378117,3748683,TN
chr12,Bn52715,52117244,53325627,1208383,RLK
chr12,Bn52716,57855774,98031229,40175455,NBS
chr12,Bn52717,87959439,96088761,8129322,RLP
chr12,Bn52718,17337355,81967284,64629929,CNL
chr12,Bn52719,26805836,58768599,31962763,CNL
chr12,Bn52720,69290092,78875302,9585210,TNL
chr12,Bn52721,99153942,99338144,184202,CNL
chr12,Bn52722,61542083,84205019,22662936,TNL
chr12,Bn52723,81743050,97182241,15439191,CNL
chr12,Bn52724,98688859,99073772,384913,TN
chr12,Bn52725,49062025,64917657,15855632,CNL
chr12,Bn52726,62680252,87384629,24704377,NBS
chr12,Bn52727,12306354,35684121,23377767,TNL
chr12,Bn52728,4641499,56847849,52206350,CNL
chr12,Bn52729,59458130,76678696,17220566,CNL
chr12,Bn52730,38916216,43726376,4810160,TN
chr12,Bn52731,76398741,98914440,22515699,TN
chr12,Bn52732,17036699,92532535,75495836,NBS
chr12,Bn52733,3993121,82458228,78465107,RLK
chr12,Bn52734,48148865,61171919,13023054,CN
chr12,Bn52735,30672853,40324783,9651930,TN
chr12,Bn52736,68630536,84131781,15501245,NBS
chr12,Bn52737,44174030,75290702,31116672,TNL
chr12,Bn52738,7869594,54698695,46829101,TN
chr12,Bn52739,44479504,95385030,50905526,CNL
chr12,Bn52740,6463624,48177668,41714044,CN
chr12,Bn52741,80892092,87197039,6304947,TNL
chr12,Bn52742,86013100,95519914,9506814,TN
chr12,Bn52743,82418446,94756042,12337596,RLP
chr12,Bn52744,10104565,93161070,83056505,TN
chr12,Bn52745,35760820,36957579,1196759,RLK
chr12,Bn52746,17581300,62145834,44564534,TNL
chr12,Bn52747,85407027,98140125,12733098,TN
chr12,Bn52748,71951091,84373263,12422172,NBS
chr12,Bn52749,22756141,77309791,54553650,CN
chr12,Bn52750,10165685,94294432,84128747,CN
chr12,Bn52751,58909360,90921252,32011892,CNL
chr12,Bn52752,42584452,92290801,49706349,CNL
chr12,Bn52753,83351938,95399250,12047312,TNL
chr12,Bn52754,10768816,19819281,9050465,TN
chr12,Bn52755,81774585,96540423,14765838,NBS
chr12,Bn52756,30816911,85429068,54612157,RLP
chr12,Bn52757,22678522,77006985,54328463,RLP
chr12,Bn52758,1113657,56865229,55751572,CN
chr12,Bn52759,61719363,62750430,1031067,RLK
chr12,Bn52760,36297579,52140997,15843418,TN
chr12,Bn52761,69811670,78494994,8683324,NBS
chr12,Bn52762,63250970,87734311,24483341,TNL
chr12,Bn52763,11768361,79098276,67329915,TNL
chr12,Bn52764,79111542,79565818,454276,NBS
chr12,Bn52765,94462483,97109693,2647210,CNL
chr12,Bn52766,96684040,99718213,3034173,RLK
chr12,Bn52767,98180691,98913429,732738,TNL
chr12,Bn52768,39191001,39891849,700848,TN
chr12,Bn52769,3576317,51517626,47941309,CN
chr12,Bn52770,62714441,91356074,28641633,NBS
chr12,Bn52771,95723532,97478250,1754718,TNL
chr12,Bn52772,38992420,75879672,36887252,TN
chr12,Bn52773,23361076,99663679,76302603,RLK
chr12,Bn52774,63932181,96148387,32216206,TNL
chr12,Bn52775,42894737,65444759,22550022,TN
chr12,Bn52776,60447112,85711395,25264283,CN
chr12,Bn52777,10074245,94949508,84875263,CN
chr12,Bn52778,29811180,38694873,8883693,CN
chr12,Bn52779,47095547,63278769,16183222,TN
chr12,Bn52780,79387384,98896469,19509085,RLK
chr12,Bn52781,39706535,69970393,30263858,CN
chr12,Bn52782,50866345,99423285,48556940,TNL
chr12,Bn52783,9159534,13577538,4418004,RLP
chr12,Bn52784,43222546,83156681,39934135,TN
chr12,Bn52785,3551150,34221767,30670617,RLK
chr12,Bn52786,45448442,72146030,26697588,TN
chr12,Bn52787,31648472,60575056,28926584,TN
chr12,Bn52788,12606772,28639036,16032264,RLP
chr12,Bn52789,62007870,62266613,258743,RLK
chr12,Bn52790,52995181,54350200,1355019,NBS
chr12,Bn52791,53326205,82750680,29424475,RLK
chr12,Bn52792,73100870,86287405,13186535,TNL
chr12,Bn52793,41997211,52197507,10200296,CN
chr12,Bn52794,45479952,73002227,27522275,TNL
chr12,Bn52795,28718529,29175574,457045,TNL
chr12,Bn52796,21574844,54090336,32515492,TNL
chr12,Bn52797,15051206,16253512,1202306,RLP
chr12,Bn52798,54006490,57948563,3942073,CNL
chr12,Bn52799,62039112,79324425,17285313,CN
chr12,Bn52800,54724954,77403583,22678629,CNL
chr12,Bn52801,71086898,97178402,26091504,RLK
chr12,Bn52802,94880337,96093003,1212666,CNL
chr12,Bn52803,57563157,77272239,19709082,NBS
chr12,Bn52804,60445887,93726631,33280744,RLP
chr12,Bn52805,68457984,80435611,11977627,CNL
chr12,Bn52806,82509057,82555811,46754,RLP
chr12,Bn52807,41904631,78566205,36661574,CN
chr12,Bn52808,18828951,25050849,6221898,TNL
chr12,Bn52809,55756450,66238244,10481794,RLP
chr12,Bn52810,24087520,99349122,75261602,TNL
chr12,Bn52811,82048863,95110525,13061662,CN
chr12,Bn52812,86973998,89871581,2897583,TN
chr12,Bn52813,60744317,71826854,11082537,TNL
chr12,Bn52814,99128569,99138198,9629,NBS
chr12,Bn52815,36974193,67139345,30165152,NBS
chr12,Bn52816,26264322,30560189,4295867,NBS
chr12,Bn52817,96210175,96885004,674829,TN
chr12,Bn52818,8054489,34095027,26040538,RLK
chr12,Bn52819,22517875,85641247,63123372,NBS
chr12,Bn52820,87710730,98162602,10451872,TNL
chr12,Bn52821,20854187,31021036,10166849,RLK
chr12,Bn52822,27822600,36656823,8834223,TN
chr12,Bn52823,66546913,74739295,8192382,RLP
chr12,Bn52824,39967871,65180194,25212323,TN
chr12,Bn52825,22044765,37531814,15487049,RLP
chr12,Bn52826,32026073,61195034,29168961,RLP
chr12,Bn52827,11253360,84643215,73389855,CN
chr12,Bn52828,90994535,94909067,3914532,CN
chr12,Bn52829,24430551,86337948,61907397,CNL
chr12,Bn52830,78690756,96309056,17618300,CN
chr12,Bn52831,73270312,97853109,24582797,RLK
chr12,Bn52832,9094795,25231839,16137044,RLP
chr12,Bn52833,91930866,94947484,3016618,CN
chr12,Bn52834,25484727,35301412,9816685,TN
chr12,Bn52835,27727777,46417366,18689589,CN
chr12,Bn52836,69567073,74423917,4856844,NBS
chr12,Bn52837,65806320,88631903,22825583,CNL
chr12,Bn52838,49057749,65554377,16496628,TNL
chr12,Bn52839,60919859,61552887,633028,CN
chr12,Bn52840,63356966,99142625,35785659,TNL
chr12,Bn52841,55288248,95273299,39985051,CN
chr12,Bn52842,25958791,26410717,451926,CN
chr12,Bn52843,39058242,50514084,11455842,RLP
chr12,Bn52844,55134936,59358027,4223091,TN
chr12,Bn52845,25002120,35422149,10420029,NBS
chr12,Bn52846,1078532,78937345,77858813,TN
chr12,Bn52847,80082379,94118828,14036449,CN
chr12,Bn52848,2381786,95749848,93368062,RLP
chr12,Bn52849,19016187,32288205,13272018,CNL
chr12,Bn52850,62554391,77955689,15401298,TNL
chr12,Bn52851,29566620,30154553,587933,TN
chr12,Bn52852,43056900,45652777,2595877,CNL
chr12,Bn52853,29779893,40376528,10596635,TN
chr12,Bn52854,17849626,82272903,64423277,NBS
chr12,Bn52855,3272880,24801113,21528233,CN
chr12,Bn52856,89079559,95759435,6679876,RLP
chr12,Bn52857,14930537,93713499,78782962,RLK
chr12,Bn52858,25820031,85773533,59953502,NBS
chr12,Bn52859,54745260,94195338,39450078,NBS
chr12,Bn52860,63509027,70045326,6536299,NBS
chr12,Bn52861,56016412,70450925,14434513,NBS
chr12,Bn52862,1281884,54013309,52731425,RLK
chr12,Bn52863,63716983,65572137,1855154,CN
chr12,Bn52864,58445785,98931806,40486021,RLP
chr12,Bn52865,75902789,97017127,21114338,RLK
chr12,Bn52866,7973772,28106850,20133078,NBS
chr12,Bn52867,78707518,94388653,15681135,NBS
chr12,Bn52868,50059229,70175126,20115897,TNL
chr12,Bn52869,46203953,80964794,34760841,TN
chr12,Bn52870,4265163,38777543,34512380,RLP
chr12,Bn52871,69030825,85670544,16639719,CNL
chr12,Bn52872,34139324,76097039,41957715,CN
chr12,Bn52873,76527484,88442284,11914800,NBS
chr12,Bn52874,54542347,61742007,7199660,TN
chr12,Bn52875,42761743,54895514,12133771,TNL
chr12,Bn52876,62368990,70874691,8505701,TNL
chr12,Bn52877,95922553,98880690,2958137,TNL
chr12,Bn52878,37788019,53262355,15474336,RLK
chr12,Bn52879,42611144,65747128,23135984,TNL
chr12,Bn52880,46566952,64512528,17945576,TN
chr12,Bn52881,14126237,17631264,3505027,NBS
chr12,Bn52882,91728093,99700465,7972372,RLK
chr12,Bn52883,51059706,69154325,18094619,RLP
chr12,Bn52884,15950713,38476104,22525391,CN
chr12,Bn52885,95595605,97146794,1551189,NBS
chr12,Bn52886,96659007,96701248,42241,RLP
chr12,Bn52887,10863177,35463895,24600718,NBS
chr12,Bn52888,5835975,69742375,63906400,TNL
chr12,Bn52889,93536511,97701499,4164988,RLK
chr12,Bn52890,57421818,75245578,17823760,TNL
chr12,Bn52891,29669212,67234570,37565358,RLK
chr12,Bn52892,49930957,93437808,43506851,RLK
chr12,Bn52893,60020509,87839428,27818919,TNL
chr12,Bn52894,97004983,99324504,2319521,CN
chr12,Bn52895,69035334,69611693,576359,TN
chr12,Bn52896,87467716,94021482,6553766,CN
chr12,Bn52897,22172321,23513073,1340752,RLK
chr12,Bn52898,1992083,10642592,8650509,RLK
chr12,Bn52899,56727832,95110716,38382884,RLP
chr12,Bn52900,54301486,64219766,9918280,TN
chr12,Bn52901,67471715,69416651,1944936,CN
chr12,Bn52902,52391974,54294895,1902921,TN
chr12,Bn52903,13165088,73844954,60679866,RLK
chr12,Bn52904,44539806,68633531,24093725,TN
chr12,Bn52905,5663598,89215667,83552069,TNL
chr12,Bn52906,11075817,81143927,70068110,NBS
chr12,Bn52907,82613268,89018318,6405050,RLK
chr12,Bn52908,90658397,95141144,4482747,RLP
chr12,Bn52909,91406170,95345641,3939471,TNL
chr12,Bn52910,47570105,77725019,30154914,RLK
chr12,Bn52911,12318224,35853235,23535011,RLP
chr12,Bn52912,70265449,71566611,1301162,TNL
chr12,Bn52913,67803669,78024051,10220382,RLP
chr12,Bn52914,87462832,92268462,4805630,NBS
chr12,Bn52915,45754076,48752251,2998175,RLP
chr12,Bn52916,12754320,45324200,32569880,CN
chr12,Bn52917,23744739,87791802,64047063,RLP
chr12,Bn52918,61346297,94555978,33209681,NBS
chr12,Bn52919,53162767,57995189,4832422,CNL
chr12,Bn52920,10868556,23355948,12487392,TNL
chr12,Bn52921,28715584,58048890,29333306,NBS
chr12,Bn52922,49924581,94983433,45058852,TNL
chr12,Bn52923,46187318,96941346,50754028,RLK
chr12,Bn52924,46467152,86717024,40249872,RLK
chr12,Bn52925,97654981,99660209,2005228,RLP
chr12,Bn52926,72988651,89978655,16990004,CNL
chr12,Bn52927,14182150,71435398,57253248,NBS
chr12,Bn52928,52699197,83937005,31237808,RLP
chr12,Bn52929,93004314,95174673,2170359,CNL
chr12,Bn52930,34108620,77980432,43871812,TN
chr12,Bn52931,2825844,32472390,29646546,CN
chr12,Bn52932,92154425,98723929,6569504,TN
chr12,Bn52933,80721963,87173936,6451973,TNL
chr12,Bn52934,7761038,30286933,22525895,RLK
chr12,Bn52935,10796378,54275454,43479076,RLK
chr12,Bn52936,4483033,15136210,10653177,NBS
chr12,Bn52937,2741639,92397900,89656261,CNL
chr12,Bn52938,21347191,46470624,25123433,RLP
chr12,Bn52939,3792320,84674358,80882038,TNL
chr12,Bn52940,70056020,86079606,16023586,CN
chr12,Bn52941,62780099,74565916,11785817,CN
chr12,Bn52942,7775173,71721610,63946437,TN
chr12,Bn52943,88245834,95916532,7670698,NBS
chr12,Bn52944,38682026,77377481,38695455,TN
chr12,Bn52945,22679925,93238305,70558380,TN
chr12,Bn52946,53277679,77939142,24661463,RLK
chr12,Bn52947,47335107,78610880,31275773,TNL
chr12,Bn52948,51887251,60170588,8283337,RLP
chr12,Bn52949,71808536,87953038,16144502,TN
chr12,Bn52950,38426682,63432543,25005861,TN
chr12,Bn52951,29388130,30704648,1316518,TNL
chr12,Bn52952,44484082,72815172,28331090,TN
chr12,Bn52953,58577581,83240602,24663021,RLK
chr12,Bn52954,27881150,33982428,6101278,TNL
chr12,Bn52955,67031055,95370828,28339773,RLP
chr12,Bn52956,36007469,94004017,57996548,RLK
chr12,Bn52957,56320882,62610141,6289259,CNL
chr12,Bn52958,19152533,53562495,34409962,RLP
chr12,Bn52959,97755888,99332701,1576813,NBS
chr12,Bn52960,78065133,90585562,12520429,NBS
chr12,Bn52961,80639797,90449228,9809431,RLP
chr12,Bn52962,45841534,74936387,29094853,CN
chr12,Bn52963,17324586,70449757,53125171,CN
chr12,Bn52964,32169968,37839195,5669227,RLP
chr12,Bn52965,32308976,97328360,65019384,RLP
chr12,Bn52966,54619842,96911456,42291614,CN
chr12,Bn52967,96668042,99387645,2719603,TN
chr12,Bn52968,54425541,56612151,2186610,TNL
chr12,Bn52969,10895004,29146080,18251076,CNL
chr12,Bn52970,77043175,96855264,19812089,TN
chr12,Bn52971,9790896,83594399,73803503,RLP
chr12,Bn52972,6258455,96292151,90033696,RLP
chr12,Bn52973,42306774,89092050,46785276,NBS
chr12,Bn52974,31992960,93864625,61871665,RLK
chr12,Bn52975,72595095,81903059,9307964,CNL
chr12,Bn52976,92656749,98259509,5602760,NBS
chr12,Bn52977,43643567,80439018,36795451,CNL
chr12,Bn52978,63426032,69406414,5980382,RLP
chr12,Bn52979,5327315,70174821,64847506,TNL
chr12,Bn52980,47728922,55441237,7712315,CNL
chr12,Bn52981,57778932,69382201,11603269,CNL
chr12,Bn52982,24859834,85192686,60332852,RLP
chr12,Bn52983,23016009,46691368,23675359,TNL
chr12,Bn52984,84956214,99691745,14735531,CNL
chr12,Bn52985,38256320,58150569,19894249,RLP
chr12,Bn52986,20299127,29251389,8952262,NBS
chr12,Bn52987,8648031,79851662,71203631,CN
chr12,Bn52988,42950831,87342722,44391891,RLK
chr12,Bn52989,17930784,51989070,34058286,RLP
chr12,Bn52990,7855013,27452958,19597945,NBS
chr12,Bn52991,53191292,59327167,6135875,TNL
chr12,Bn52992,22437757,25904622,3466865,RLP
chr12,Bn52993,28514219,99475546,70961327,TN
chr12,Bn52994,39908428,42296331,2387903,NBS
chr12,Bn52995,72063239,95398692,23335453,CN
chr12,Bn52996,29860057,89914122,60054065,TNL
chr12,Bn52997,11163708,70432745,59269037,NBS
chr12,Bn52998,54878820,64053379,9174559,CN
chr12,Bn52999,49964871,79763444,29798573,RLP
chr12,Bn53000,69137736,87706667,18568931,RLK
chr12,Bn53001,40591006,98668538,58077532,RLK
chr12,Bn53002,88208335,96421498,8213163,CN
chr12,Bn53003,79957888,97970903,18013015,RLK
chr12,Bn53004,59524080,68620056,9095976,CN
chr12,Bn53005,77407597,95510107,18102510,NBS
chr12,Bn53006,27006269,88349414,61343145,RLK
chr12,Bn53007,55811044,77526196,21715152,NBS
chr12,Bn53008,56968927,97090658,40121731,TNL
chr12,Bn53009,11985231,65999798,54014567,CN
chr12,Bn53010,25781033,54566189,28785156,RLK
chr12,Bn53011,92975986,99147738,6171752,RLP
chr12,Bn53012,50250916,55358319,5107403,RLK
chr12,Bn53013,41687073,84322854,42635781,CN
chr12,Bn53014,64081251,71047656,6966405,TN
chr12,Bn53015,7270838,30095396,22824558,CN
chr12,Bn53016,85756537,95993502,10236965,CN
chr12,Bn53017,38619717,95536939,56917222,TNL
chr12,Bn53018,71826291,76947236,5120945,RLK
chr12,Bn53019,81433900,95878393,14444493,TN
chr12,Bn53020,62620564,75967996,13347432,RLP
chr12,Bn53021,29616403,30614615,998212,NBS
chr12,Bn53022,55258813,67444643,12185830,CN
chr12,Bn53023,35807518,99148194,63340676,CNL
chr12,Bn53024,66094360,73912471,7818111,RLK
chr12,Bn53025,68279435,70195767,1916332,CN
chr12,Bn53026,24965318,52967226,28001908,CN
chr12,Bn53027,30200357,83147502,52947145,CNL
chr12,Bn53028,27105742,50003991,22898249,CN
chr12,Bn53029,70653588,99584991,28931403,TN
chr12,Bn53030,43242768,72756539,29513771,TNL
chr12,Bn53031,58779260,81510659,22731399,NBS
chr12,Bn53032,34182404,81512520,47330116,RLK
chr12,Bn53033,98035008,98102783,67775,TNL
chr12,Bn53034,36153287,59161515,23008228,RLP
chr12,Bn53035,89349843,96874295,7524452,NBS
chr12,Bn53036,72124946,99134713,27009767,NBS
chr12,Bn53037,26461789,87859458,61397669,TN
chr12,Bn53038,14168777,35034414,20865637,RLP
chr12,Bn53039,24958419,26594018,1635599,RLK
chr12,Bn53040,99920912,99999235,78323,NBS
chr12,Bn53041,87195513,87682099,486586,RLK
chr12,Bn53042,69084495,83306925,14222430,RLP
chr12,Bn53043,20958797,43372652,22413855,RLK
chr12,Bn53044,5605987,90475926,84869939,TN
chr12,Bn53045,83743413,94416562,10673149,RLP
chr12,Bn53046,35177678,46706818,11529140,TN
chr12,Bn53047,82357158,98630684,16273526,NBS
chr12,Bn53048,5876163,43816407,37940244,TNL
chr12,Bn53049,16199922,62849391,46649469,CNL
chr12,Bn53050,41992633,68361809,26369176,TNL
chr12,Bn53051,76350759,81527234,5176475,TNL
chr12,Bn53052,32190908,96107365,63916457,TNL
chr12,Bn53053,45026324,60226078,15199754,NBS
chr12,Bn53054,42709113,77173776,34464663,RLP
chr12,Bn53055,64269385,73903421,9634036,RLK
chr12,Bn53056,6268668,85445287,79176619,TNL
chr12,Bn53057,94912099,98028292,3116193,RLK
chr12,Bn53058,33875172,67470252,33595080,TNL
chr12,Bn53059,44901259,99834843,54933584,CN
chr12,Bn53060,91511194,93246554,1735360,TNL
chr12,Bn53061,19104230,48331946,29227716,TN
chr12,Bn53062,9308766,50270753,40961987,NBS
chr12,Bn53063,58316297,88670495,30354198,RLK
chr12,Bn53064,21340611,56931519,35590908,RLP
chr12,Bn53065,86523893,98402838,11878945,CN
chr12,Bn53066,81520270,84270730,2750460,CNL
chr12,Bn53067,5621423,90485818,84864395,TNL
chr12,Bn53068,43293782,80693921,37400139,TN
chr12,Bn53069,53000397,96521968,43521571,RLP
chr12,Bn53070,84788090,97275091,12487001,RLK
chr12,Bn53071,20645218,75395758,54750540,RLK
chr12,Bn53072,99849902,99899800,49898,NBS
chr12,Bn53073,8345480,27706188,19360708,CNL
chr12,Bn53074,17442351,30967673,13525322,CN
chr12,Bn53075,23812011,85303335,61491324,CN
chr12,Bn53076,53292011,71138368,17846357,TN
chr12,Bn53077,34652468,50274361,15621893,RLP
chr12,Bn53078,73634246,79590893,5956647,RLK
chr12,Bn53079,47062303,60768810,13706507,RLP
chr12,Bn53080,82956547,97661535,14704988,TN
chr12,Bn53081,43268452,70306501,27038049,CN
chr12,Bn53082,48970713,63168672,14197959,TN
chr12,Bn53083,28404676,41724677,13320001,NBS
chr12,Bn53084,50024189,80932783,30908594,RLP
chr12,Bn53085,56722962,88073715,31350753,NBS
chr12,Bn53086,28284143,46342668,18058525,NBS
chr12,Bn53087,76676663,96671914,19995251,CNL
chr12,Bn53088,27259009,83240745,55981736,TNL
chr12,Bn53089,47702423,48884334,1181911,TN
chr12,Bn53090,93359661,96717654,3357993,NBS
chr12,Bn53091,73843653,83442973,9599320,CN
chr12,Bn53092,34524497,95402887,60878390,NBS
chr12,Bn53093,61129922,71691470,10561548,CNL
chr12,Bn53094,53130966,85697156,32566190,RLK
chr12,Bn53095,80382019,95248363,14866344,TN
chr12,Bn53096,14569332,63406742,48837410,CN
chr12,Bn53097,56483324,65477411,8994087,TN
chr12,Bn53098,13770384,50842650,37072266,CNL
chr12,Bn53099,86107533,87513968,1406435,CNL
chr12,Bn53100,61772628,99671106,37898478,RLP
chr12,Bn53101,15892604,71455991,55563387,RLP
chr12,Bn53102,98937151,99828938,891787,TNL
chr12,Bn53103,75756423,89652387,13895964,TNL
chr12,Bn53104,49451114,57205770,7754656,TNL
chr12,Bn53105,74159967,80048323,5888356,RLK
chr12,Bn53106,29063173,69147179,40084006,TNL
chr12,Bn53107,6897710,38693755,31796045,RLK
chr12,Bn53108,23388735,41748885,18360150,RLK
chr12,Bn53109,95949637,97386300,1436663,RLK
chr12,Bn53110,29310550,61121171,31810621,TN
chr12,Bn53111,54657837,69725239,15067402,RLK
chr12,Bn53112,88611997,99696257,11084260,RLK
chr12,Bn53113,74604817,82365836,7761019,NBS
chr12,Bn53114,8519837,13005863,4486026,TN
chr12,Bn53115,40823302,74081922,33258620,NBS
chr12,Bn53116,91164960,92956533,1791573,RLP
chr12,Bn53117,75627500,81994225,6366725,CNL
chr12,Bn53118,5698706,72702838,67004132,CNL
chr12,Bn53119,56169006,96049862,39880856,CN
chr12,Bn53120,82599979,93717739,11117760,RLP
chr12,Bn53121,75716450,92875218,17158768,TNL
chr12,Bn53122,46034738,64721578,18686840,NBS
chr12,Bn53123,93896092,98527278,4631186,RLP
chr12,Bn53124,85620007,89505467,3885460,NBS
chr12,Bn53125,21243229,27418934,6175705,TNL
chr12,Bn53126,2906462,78529217,75622755,RLP
chr12,Bn53127,75865550,87345811,11480261,RLK
chr12,Bn53128,43914623,74956574,31041951,TN
chr12,Bn53129,62722819,63100182,377363,RLP
chr12,Bn53130,4587850,67297233,62709383,TN
chr12,Bn53131,25555351,66113446,40558095,TN
chr12,Bn53132,69276194,91553813,22277619,RLP
chr12,Bn53133,41683179,62891474,21208295,RLP
chr12,Bn53134,7602381,49385113,41782732,NBS
chr12,Bn53135,38465832,73735922,35270090,CN
chr12,Bn53136,87315099,98395486,11080387,NBS
chr12,Bn53137,21764123,63005223,41241100,CN
chr12,Bn53138,59068665,90643277,31574612,CN
chr12,Bn53139,13427030,58061020,44633990,CNL
chr12,Bn53140,3254552,32656049,29401497,CN
chr12,Bn53141,7968633,64623301,56654668,RLP
chr12,Bn53142,47846208,64060762,16214554,TNL
chr12,Bn53143,88410313,89243946,833633,TNL
chr12,Bn53144,52844620,66929834,14085214,RLK
chr12,Bn53145,53330632,73675986,20345354,NBS
chr12,Bn53146,28966286,83417936,54451650,CNL
chr12,Bn53147,13825348,15811766,1986418,NBS
chr12,Bn53148,24115547,82194738,58079191,RLK
chr12,Bn53149,44221320,62833701,18612381,TN
chr12,Bn53150,5786473,81419599,75633126,TNL
chr12,Bn53151,53402033,77258747,23856714,CNL
chr12,Bn53152,56546352,99044247,42497895,TNL
chr12,Bn53153,21762509,69457609,47695100,TN
chr12,Bn53154,55819683,89354435,33534752,TN
chr12,Bn53155,48988257,52231964,3243707,TN
chr12,Bn53156,47265340,63927049,16661709,TNL
chr12,Bn53157,2403567,53609491,51205924,RLP
chr12,Bn53158,9506273,86976649,77470376,RLP
chr12,Bn53159,10800979,12078818,1277839,CN
chr12,Bn53160,21189125,80141021,58951896,TNL
chr12,Bn53161,54003373,75840121,21836748,RLK
chr12,Bn53162,89575178,96718293,7143115,CN
chr12,Bn53163,47068510,52529316,5460806,CN
chr12,Bn53164,37967321,88884327,50917006,NBS
chr12,Bn53165,27307498,62145706,34838208,NBS
chr12,Bn53166,67628503,73847267,6218764,TN
chr12,Bn53167,19580017,56036471,36456454,CNL
chr12,Bn53168,25215539,79593094,54377555,TN
chr12,Bn53169,65717737,99493644,33775907,RLK
chr12,Bn53170,42452331,58759586,16307255,TNL
chr12,Bn53171,45129809,73271115,28141306,NBS
chr12,Bn53172,86571860,99946386,13374526,CNL
chr12,Bn53173,1391820,80219511,78827691,NBS
chr12,Bn53174,64190997,83342650,19151653,RLP
chr12,Bn53175,88090164,96300909,8210745,CNL
chr12,Bn53176,35037261,96569704,61532443,TNL
chr12,Bn53177,95458495,99122014,3663519,RLK
chr12,Bn53178,79853901,89028840,9174939,NBS
chr12,Bn53179,91505061,95572300,4067239,CN
chr12,Bn53180,42132866,49830655,7697789,RLP
chr12,Bn53181,42971548,55104387,12132839,RLP
chr12,Bn53182,48006097,52982473,4976376,CNL
chr12,Bn53183,55343116,91440764,36097648,CNL
chr12,Bn53184,49390103,52092119,2702016,CNL
chr12,Bn53185,32613860,77964438,45350578,CNL
chr12,Bn53186,39254726,63402993,24148267,CN
chr12,Bn53187,81812601,93937381,12124780,CN
chr12,Bn53188,60932441,68661586,7729145,TNL
chr12,Bn53189,52166968,81403167,29236199,TN
chr12,Bn53190,52974052,84809939,31835887,RLK
chr12,Bn53191,36665873,62683584,26017711,CN
chr12,Bn53192,13248073,97945482,84697409,CN
chr12,Bn53193,11660419,41813722,30153303,RLK
chr12,Bn53194,74368619,92920396,18551777,NBS
chr12,Bn53195,44568508,56478479,11909971,TNL
chr12,Bn53196,26998244,88809983,61811739,CNL
chr12,Bn53197,11746258,15513058,3766800,CNL
chr12,Bn53198,58650704,62905513,4254809,TN
chr12,Bn53199,35635213,90786593,55151380,NBS
chr12,Bn53200,55197927,77332849,22134922,NBS
chr12,Bn53201,9486351,52423896,42937545,TNL
chr12,Bn53202,62786727,67653450,4866723,TNL
chr12,Bn53203,72491138,75150438,2659300,CN
chr12,Bn53204,55640497,72254519,16614022,RLP
chr12,Bn53205,77306352,94390963,17084611,RLP
chr12,Bn53206,33385812,86939866,53554054,CNL
chr12,Bn53207,59586063,93172959,33586896,RLK
chr12,Bn53208,98635761,98648015,12254,TN
chr12,Bn53209,19076337,55683012,36606675,NBS
chr12,Bn53210,74593382,75139567,546185,RLP
chr12,Bn53211,25423416,67792175,42368759,CNL
chr12,Bn53212,42494143,57630074,15135931,CN
chr12,Bn53213,32981327,36136998,3155671,TN
chr12,Bn53214,19171423,84914856,65743433,TN
chr12,Bn53215,64751754,75485216,10733462,NBS
chr12,Bn53216,59271934,94065539,34793605,TN
chr12,Bn53217,55708919,66878310,11169391,CN
chr12,Bn53218,70741389,78888067,8146678,RLK
chr12,Bn53219,57488851,66853453,9364602,CN
chr12,Bn53220,74929156,81637392,6708236,NBS
chr12,Bn53221,73012556,95538939,22526383,TNL
chr12,Bn53222,48017337,59732844,11715507,TNL
chr12,Bn53223,40900727,42689404,1788677,TNL
chr12,Bn53224,64902469,83472986,18570517,TN
chr12,Bn53225,77216238,86762649,9546411,TNL
chr12,Bn53226,65296877,90460941,25164064,TNL
chr12,Bn53227,78183552,98849574,20666022,TNL
chr12,Bn53228,69989416,95314634,25325218,CNL
chr12,Bn53229,18758305,67114591,48356286,CNL
chr12,Bn53230,88254994,94326175,6071181,TN
chr12,Bn53231,66776853,84958150,18181297,TNL
chr12,Bn53232,49044254,72076690,23032436,CNL
chr12,Bn53233,91305254,94607063,3301809,RLP
chr12,Bn53234,52547249,85361148,32813899,CN
chr12,Bn53235,55764140,73456476,17692336,TN
chr12,Bn53236,30728063,92382787,61654724,CNL
chr12,Bn53237,59611491,78195512,18584021,CN
chr12,Bn53238,34234781,68642174,34407393,CN
chr12,Bn53239,22545380,42890031,20344651,CNL
chr12,Bn53240,22434251,92911091,70476840,NBS
chr12,Bn53241,53513729,54647607,1133878,RLK
chr12,Bn53242,88441948,95512511,7070563,TNL
chr12,Bn53243,49106377,83154709,34048332,RLK
chr12,Bn53244,56956844,73996860,17040016,TN
chr12,Bn53245,28638147,67667174,39029027,TN
chr12,Bn53246,62715531,89012597,26297066,CN
chr12,Bn53247,89875691,92566332,2690641,CNL
chr12,Bn53248,97640927,99520913,1879986,CNL
chr12,Bn53249,86739699,93872936,7133237,RLK
chr12,Bn53250,30873760,69683531,38809771,CN
chr12,Bn53251,9148952,87339663,78190711,CN
chr12,Bn53252,55724227,89424507,33700280,TNL
chr12,Bn53253,6484860,55098785,48613925,CNL
chr12,Bn53254,41879801,46016554,4136753,CNL
chr12,Bn53255,84164793,96766726,12601933,TNL
chr12,Bn53256,92288193,94800435,2512242,RLK
chr12,Bn53257,76281148,83729636,7448488,RLK
chr12,Bn53258,99910477,99991004,80527,TN
chr12,Bn53259,8392129,53699095,45306966,CNL
chr12,Bn53260,99514215,99946277,432062,TN
chr12,Bn53261,16938766,21436033,4497267,RLK
chr12,Bn53262,26487465,47929050,21441585,RLK
chr12,Bn53263,28743958,76202810,47458852,NBS
chr12,Bn53264,23826739,75061343,51234604,TNL
chr12,Bn53265,43576352,82539819,38963467,CNL
chr12,Bn53266,17053280,33994993,16941713,NBS
chr13,Bn53267,7394742,9308001,1913259,CNL
chr13,Bn53268,83990838,86306865,2316027,TNL
chr13,Bn53269,98170911,99594532,1423621,RLK
chr13,Bn53270,1546763,79257633,77710870,CNL
chr13,Bn53271,76429156,98326756,21897600,NBS
chr13,Bn53272,89519584,99787348,10267764,CNL
chr13,Bn53273,91549060,94380883,2831823,CNL
chr13,Bn53274,94013155,99975572,5962417,NBS
chr13,Bn53275,25009693,41128928,16119235,TNL
chr13,Bn53276,13311345,46669944,33358599,CN
chr13,Bn53277,19610025,49207046,29597021,CN
chr13,Bn53278,45566948,62088239,16521291,CN
chr13,Bn53279,54538797,89564019,35025222,TNL
chr13,Bn53280,9494060,37488250,27994190,NBS
chr13,Bn53281,17531940,98606514,81074574,NBS
chr13,Bn53282,51426375,51598415,172040,CNL
chr13,Bn53283,37528203,48412938,10884735,RLK
chr13,Bn53284,25069312,35559672,10490360,CN
chr13,Bn53285,42021231,78437076,36415845,RLP
chr13,Bn53286,88976562,90918627,1942065,CNL
chr13,Bn53287,15486136,43447477,27961341,CNL
chr13,Bn53288,73372018,86668160,13296142,CN
chr13,Bn53289,26381890,97040344,70658454,TN
chr13,Bn53290,97757809,99322505,1564696,CNL
chr13,Bn53291,13854675,35005496,21150821,CN
chr13,Bn53292,80635365,83183279,2547914,RLP
chr13,Bn53293,33768001,90540287,56772286,RLK
chr13,Bn53294,16674719,93687079,77012360,CNL
chr13,Bn53295,88599151,97061552,8462401,CNL
chr13,Bn53296,55785884,91278639,35492755,TNL
chr13,Bn53297,36323614,90976054,54652440,CN
chr13,Bn53298,37132260,97928815,60796555,NBS
chr13,Bn53299,40355449,43725267,3369818,CN
chr13,Bn53300,32583425,73668536,41085111,NBS
chr13,Bn53301,90910689,99410897,8500208,CNL
chr13,Bn53302,40042850,96852129,56809279,CNL
chr13,Bn53303,31443544,97138802,65695258,RLK
chr13,Bn53304,13147075,37137359,23990284,TN
chr13,Bn53305,54764816,93054340,38289524,CNL
chr13,Bn53306,66433778,86904294,20470516,NBS
chr13,Bn53307,37296386,43020525,5724139,TNL
chr13,Bn53308,95083403,95491012,407609,RLP
chr13,Bn53309,44815937,53344204,8528267,RLK
chr13,Bn53310,70013886,95519390,25505504,CNL
chr13,Bn53311,46417618,59682408,13264790,TN
chr13,Bn53312,47814614,74417271,26602657,TN
chr13,Bn53313,95150904,98019454,2868550,RLP
chr13,Bn53314,92738342,95575641,2837299,NBS
chr13,Bn53315,98950665,99029789,79124,RLK
chr13,Bn53316,57081311,91572179,34490868,CN
chr13,Bn53317,13022713,54808116,41785403,CN
chr13,Bn53318,22142620,82817801,60675181,TN
chr13,Bn53319,13740296,52581094,38840798,TN
chr13,Bn53320,65632076,95079361,29447285,TN
chr13,Bn53321,17283506,65456729,48173223,RLK
chr13,Bn53322,9708745,68366250,58657505,NBS
chr13,Bn53323,31148390,34598841,3450451,RLK
chr13,Bn53324,81361876,88151234,6789358,NBS
chr13,Bn53325,26512272,31709382,5197110,NBS
chr13,Bn53326,73563424,79054791,5491367,CN
chr13,Bn53327,16721965,43387862,26665897,RLK
chr13,Bn53328,27753082,61622951,33869869,TNL
chr13,Bn53329,84721351,87706781,2985430,RLK
chr13,Bn53330,61512329,95372448,33860119,TNL
chr13,Bn53331,97996399,98423557,427158,NBS
chr13,Bn53332,96164173,99851255,3687082,CNL
chr13,Bn53333,33118154,63874264,30756110,RLP
chr13,Bn53334,29796929,83400718,53603789,RLP
chr13,Bn53335,19514738,53712286,34197548,CN
chr13,Bn53336,37487948,83830380,46342432,RLP
chr13,Bn53337,40436446,90229388,49792942,CN
chr13,Bn53338,73969707,84564010,10594303,NBS
chr13,Bn53339,56652375,68918710,12266335,CN
chr13,Bn53340,25809751,98674702,72864951,CNL
chr13,Bn53341,51694470,57333619,5639149,RLP
chr13,Bn53342,65363241,84160850,18797609,TN
chr13,Bn53343,39105933,69377047,30271114,RLP
chr13,Bn53344,63281102,68517767,5236665,NBS
chr13,Bn53345,39403398,74572886,35169488,NBS
chr13,Bn53346,50728576,55152412,4423836,TNL
chr13,Bn53347,7974180,69434466,61460286,TN
chr13,Bn53348,49645668,65150092,15504424,NBS
chr13,Bn53349,72536447,87911565,15375118,TNL
chr13,Bn53350,10294306,65387773,55093467,RLK
chr13,Bn53351,7774926,94435560,86660634,RLP
chr13,Bn53352,97533037,98406909,873872,RLK
chr13,Bn53353,77709517,95353359,17643842,NBS
chr13,Bn53354,31528466,54517554,22989088,CN
chr13,Bn53355,19902956,94454028,74551072,CNL
chr13,Bn53356,22746953,34377526,11630573,TN
chr13,Bn53357,41810905,92911936,51101031,TNL
chr13,Bn53358,37692944,59207319,21514375,TNL
chr13,Bn53359,47166859,59544080,12377221,TN
chr13,Bn53360,11217165,23439622,12222457,CNL
chr13,Bn53361,23179202,89334926,66155724,TNL
chr13,Bn53362,84597184,90054407,5457223,RLP
chr13,Bn53363,99330151,99598676,268525,RLP
chr13,Bn53364,90858904,95262631,4403727,RLK
chr13,Bn53365,82225741,95740553,13514812,NBS
chr13,Bn53366,72857780,95446398,22588618,TN
chr13,Bn53367,55273601,63941337,8667736,TN
chr13,Bn53368,88892299,91943263,3050964,RLP
chr13,Bn53369,32424537,57410668,24986131,RLK
chr13,Bn53370,7651089,37184511,29533422,CN
chr13,Bn53371,39140575,86263949,47123374,NBS
chr13,Bn53372,67187063,94724366,27537303,TNL
chr13,Bn53373,11385055,40724704,29339649,RLP
chr13,Bn53374,6024409,30032516,24008107,NBS
chr13,Bn53375,85927378,96729029,10801651,RLP
chr13,Bn53376,79153629,95918104,16764475,TNL
chr13,Bn53377,48570094,84046836,35476742,RLP
chr13,Bn53378,17263442,34043898,16780456,RLK
chr13,Bn53379,38814685,43942397,5127712,CNL
chr13,Bn53380,67643611,86716020,19072409,TNL
chr13,Bn53381,49167980,76425724,27257744,NBS
chr13,Bn53382,64654833,78644734,13989901,RLP
chr13,Bn53383,31143000,35480263,4337263,NBS
chr13,Bn53384,81011049,95696547,14685498,TNL
chr13,Bn53385,33177919,74195856,41017937,RLP
chr13,Bn53386,15455060,44380525,28925465,RLK
chr13,Bn53387,67242226,92325275,25083049,TNL
chr13,Bn53388,75982354,90337007,14354653,RLK
chr13,Bn53389,41795381,47425598,5630217,CN
chr13,Bn53390,10859258,44236838,33377580,NBS
chr13,Bn53391,7873028,43662210,35789182,RLK
chr13,Bn53392,31640480,47972251,16331771,TN
chr13,Bn53393,44775454,88499263,43723809,TN
chr13,Bn53394,61586107,67812572,6226465,NBS
chr13,Bn53395,68125393,95412488,27287095,CN
chr13,Bn53396,6927386,78807905,71880519,CNL
chr13,Bn53397,80207018,93962277,13755259,RLK
chr13,Bn53398,84092756,96068542,11975786,TN
chr13,Bn53399,45652936,92578608,46925672,NBS
chr13,Bn53400,9587017,13433372,3846355,NBS
chr13,Bn53401,29761600,75620486,45858886,NBS
chr13,Bn53402,24375019,67243087,42868068,TN
chr13,Bn53403,97889343,99607162,1717819,TN
chr13,Bn53404,97092093,99379665,2287572,TNL
chr13,Bn53405,87442403,95044401,7601998,CNL
chr13,Bn53406,86806096,95905362,9099266,RLP
chr13,Bn53407,45736474,50509338,4772864,NBS
chr13,Bn53408,97579574,97890554,310980,RLK
chr13,Bn53409,3809597,78241025,74431428,TNL
chr13,Bn53410,48490166,98045174,49555008,TNL
chr13,Bn53411,77466817,96551537,19084720,NBS
chr13,Bn53412,46766807,91851179,45084372,CNL
chr13,Bn53413,23997755,29333609,5335854,RLK
chr13,Bn53414,21115000,74869340,53754340,RLP
chr13,Bn53415,73256109,81790625,8534516,TNL
chr13,Bn53416,98887081,99413892,526811,RLK
chr13,Bn53417,73661459,90580133,16918674,TNL
chr13,Bn53418,74994303,85267067,10272764,CN
chr13,Bn53419,71512218,77314571,5802353,TN
chr13,Bn53420,58311473,86331360,28019887,RLK
chr13,Bn53421,8305180,82468955,74163775,NBS
chr13,Bn53422,6428905,86307718,79878813,NBS
chr13,Bn53423,10650425,14766253,4115828,RLK
chr13,Bn53424,53465430,93360565,39895135,TNL
chr13,Bn53425,42113814,69410764,27296950,CNL
chr13,Bn53426,66082730,74575516,8492786,NBS
chr13,Bn53427,80294790,84537652,4242862,RLP
chr13,Bn53428,24649453,57006227,32356774,RLK
chr13,Bn53429,81168375,85815441,4647066,RLP
chr13,Bn53430,30941595,82804535,51862940,NBS
chr13,Bn53431,6614917,74178713,67563796,CN
chr13,Bn53432,37192197,43624043,6431846,RLK
chr13,Bn53433,83984970,94406988,10422018,TN
chr13,Bn53434,54378463,69522788,15144325,TN
chr13,Bn53435,59547048,85803466,26256418,TN
chr13,Bn53436,2381735,6840677,4458942,TN
chr13,Bn53437,85987451,86139276,151825,RLK
chr13,Bn53438,78930440,90567497,11637057,CNL
chr13,Bn53439,60108270,61770171,1661901,CN
chr13,Bn53440,98025724,99327792,1302068,CNL
chr13,Bn53441,33754749,55392337,21637588,TNL
chr13,Bn53442,5630298,26212682,20582384,CN
chr13,Bn53443,60596657,94350243,33753586,TNL
chr13,Bn53444,87503161,95516121,8012960,CNL
chr13,Bn53445,93092147,97111396,4019249,TNL
chr13,Bn53446,78087529,96433574,18346045,CN
chr13,Bn53447,82695093,99410876,16715783,RLP
chr13,Bn53448,17766198,32764785,14998587,RLP
chr13,Bn53449,77975748,79658368,1682620,TN
chr13,Bn53450,54476776,76920031,22443255,RLK
chr13,Bn53451,93031210,98339729,5308519,TN
chr13,Bn53452,11282227,73065715,61783488,CNL
chr13,Bn53453,78558259,92408857,13850598,CN
chr13,Bn53454,12381818,24771142,12389324,CNL
chr13,Bn53455,79503671,89792383,10288712,RLP
chr13,Bn53456,29579601,88436502,58856901,RLK
chr13,Bn53457,44580413,83427969,38847556,RLK
chr13,Bn53458,60952515,77837752,16885237,CN
chr13,Bn53459,61630395,78095634,16465239,CN
chr13,Bn53460,6820286,33837624,27017338,NBS
chr13,Bn53461,78660832,85773950,7113118,CNL
chr13,Bn53462,7339189,36356677,29017488,RLP
chr13,Bn53463,96049497,97354205,1304708,RLP
chr13,Bn53464,53465306,96325518,42860212,TNL
chr13,Bn53465,80794487,81442560,648073,TNL
chr13,Bn53466,22961612,61085718,38124106,RLP
chr13,Bn53467,40414840,86689905,46275065,CN
chr13,Bn53468,56868142,60346731,3478589,RLK
chr13,Bn53469,99269650,99948701,679051,NBS
chr13,Bn53470,61061823,83689443,22627620,NBS
chr13,Bn53471,11029677,29140653,18110976,CN
chr13,Bn53472,31209242,63623407,32414165,CN
chr13,Bn53473,25303497,39505377,14201880,RLP
chr13,Bn53474,82853943,99487882,16633939,CN
chr13,Bn53475,44044593,67915906,23871313,TN
chr13,Bn53476,46541588,98135354,51593766,TNL
chr13,Bn53477,63867472,83749539,19882067,CN
chr13,Bn53478,61767332,92010703,30243371,NBS
chr13,Bn53479,20871843,29416513,8544670,RLK
chr13,Bn53480,10288384,93042963,82754579,TNL
chr13,Bn53481,39964397,56713130,16748733,CN
chr13,Bn53482,93615452,97604506,3989054,TNL
chr13,Bn53483,76570813,92629602,16058789,CN
chr13,Bn53484,16930473,30040401,13109928,CNL
chr13,Bn53485,46560334,72326584,25766250,RLP
chr13,Bn53486,71068085,91564781,20496696,TNL
chr13,Bn53487,2099489,18787782,16688293,TN
chr13,Bn53488,36637962,84639904,48001942,RLP
chr13,Bn53489,2527561,20658343,18130782,RLP
chr13,Bn53490,34436818,88686810,54249992,RLK
chr13,Bn53491,46434696,50145101,3710405,RLK
chr13,Bn53492,22031180,73810301,51779121,CN
chr13,Bn53493,93046272,93484833,438561,TNL
chr13,Bn53494,70238089,86563244,16325155,TNL
chr13,Bn53495,97655516,98214742,559226,RLK
chr13,Bn53496,61284664,90908522,29623858,RLK
chr13,Bn53497,81050840,82815266,1764426,TNL
chr13,Bn53498,69593166,81663502,12070336,CNL
chr13,Bn53499,39648020,88682824,49034804,NBS
chr13,Bn53500,58773712,95017860,36244148,CN
chr13,Bn53501,86046602,98653861,12607259,RLP
chr13,Bn53502,5562772,35750811,30188039,CN
chr13,Bn53503,25536194,44181293,18645099,RLK
chr13,Bn53504,44498379,96138389,51640010,TNL
chr13,Bn53505,28088491,92367060,64278569,TNL
chr13,Bn53506,42534195,81111462,38577267,RLP
chr13,Bn53507,50292472,69738169,19445697,TN
chr13,Bn53508,7593271,39543242,31949971,RLP
chr13,Bn53509,94588131,98306087,3717956,CNL
chr13,Bn53510,87876392,93036051,5159659,CNL
chr13,Bn53511,63595507,64891274,1295767,RLK
chr13,Bn53512,11682722,96678863,84996141,RLP
chr13,Bn53513,43956499,47874522,3918023,CN
chr13,Bn53514,8382412,88932357,80549945,TN
chr13,Bn53515,70885883,83732246,12846363,CN
chr13,Bn53516,71231910,76946065,5714155,NBS
chr13,Bn53517,54025892,91602908,37577016,NBS
chr13,Bn53518,57764803,61864505,4099702,CNL
chr13,Bn53519,49535444,55290087,5754643,TNL
chr13,Bn53520,13788170,20075004,6286834,CNL
chr13,Bn53521,61779474,75306410,13526936,TN
chr13,Bn53522,10546381,18538240,7991859,RLP
chr13,Bn53523,80066794,89845998,9779204,TNL
chr13,Bn53524,3731402,38122865,34391463,CNL
chr13,Bn53525,40996643,70325538,29328895,CNL
chr13,Bn53526,91020198,91475120,454922,NBS
chr13,Bn53527,31844003,74087465,42243462,TN
chr13,Bn53528,38295893,99247138,60951245,CN
chr13,Bn53529,40896683,41184352,287669,CNL
chr13,Bn53530,49013054,69573202,20560148,TN
chr13,Bn53531,59801625,65430334,5628709,CN
chr13,Bn53532,23660558,75110251,51449693,RLK
chr13,Bn53533,34325394,36587344,2261950,RLK
chr13,Bn53534,47105102,64977635,17872533,CNL
chr13,Bn53535,4340413,28697449,24357036,NBS
chr13,Bn53536,54080100,98565873,44485773,CN
chr13,Bn53537,14445046,56270598,41825552,TN
chr13,Bn53538,68074771,96243920,28169149,RLK
chr13,Bn53539,71888279,94509474,22621195,RLK
chr13,Bn53540,47974349,72081339,24106990,CN
chr13,Bn53541,32506017,69218806,36712789,NBS
chr13,Bn53542,70392762,73257808,2865046,RLP
chr13,Bn53543,4167786,11587324,7419538,RLP
chr13,Bn53544,87537883,89397945,1860062,RLP
chr13,Bn53545,61291753,97108915,35817162,RLP
chr13,Bn53546,27582129,58134409,30552280,CNL
chr13,Bn53547,34809872,62750305,27940433,TN
chr13,Bn53548,73348729,87622868,14274139,CN
chr13,Bn53549,95032007,97828052,2796045,RLK
chr13,Bn53550,51762842,61284924,9522082,CN
chr13,Bn53551,60237683,68493573,8255890,RLP
chr13,Bn53552,42055377,68332543,26277166,TNL
chr13,Bn53553,78594108,92082465,13488357,TN
chr13,Bn53554,6706119,53601339,46895220,RLK
chr13,Bn53555,91158041,92631049,1473008,RLP
chr13,Bn53556,24693513,71483261,46789748,RLK
chr13,Bn53557,50868766,90913927,40045161,NBS
chr13,Bn53558,76867541,88958893,12091352,CN
chr13,Bn53559,48724041,67859085,19135044,TN
chr13,Bn53560,92822487,99336287,6513800,NBS
chr13,Bn53561,87747085,93540278,5793193,TN
chr13,Bn53562,63112064,77750737,14638673,RLP
chr13,Bn53563,58790832,69315902,10525070,CNL
chr13,Bn53564,97454531,99944952,2490421,RLK
chr13,Bn53565,30270697,47041525,16770828,TNL
chr13,Bn53566,66511440,93928143,27416703,CNL
chr13,Bn53567,36702568,57635034,20932466,CN
chr13,Bn53568,22564986,49997570,27432584,TNL
chr13,Bn53569,36607008,66717564,30110556,CNL
chr13,Bn53570,20723455,36338452,15614997,TN
chr13,Bn53571,99094338,99390058,295720,RLP
chr13,Bn53572,7008825,64500142,57491317,TN
chr13,Bn53573,23942323,67136421,43194098,RLK
chr13,Bn53574,90581100,92040875,1459775,CNL
chr13,Bn53575,63982786,85159596,21176810,CNL
chr13,Bn53576,21570455,61612166,40041711,CNL
chr13,Bn53577,35278062,90713259,55435197,NBS
chr13,Bn53578,13664950,76488712,62823762,TNL
chr13,Bn53579,90783071,91019926,236855,RLK
chr13,Bn53580,49577839,68472740,18894901,CN
chr13,Bn53581,44676970,91012416,46335446,CNL
chr13,Bn53582,89474501,93400231,3925730,TNL
chr13,Bn53583,47364991,52664665,5299674,NBS
chr13,Bn53584,69005865,80045999,11040134,CN
chr13,Bn53585,93444734,95416470,1971736,TN
chr13,Bn53586,29201983,70024602,40822619,RLP
chr13,Bn53587,37736688,73924176,36187488,TNL
chr13,Bn53588,89189059,90697912,1508853,RLK
chr13,Bn53589,57179443,87995841,30816398,RLP
chr13,Bn53590,24264307,97916342,73652035,TN
chr13,Bn53591,47762413,68012200,20249787,TNL
chr13,Bn53592,62484760,85982612,23497852,RLK
chr13,Bn53593,16139843,81050987,64911144,RLP
chr13,Bn53594,73566693,75597823,2031130,NBS
chr13,Bn53595,67788651,83223401,15434750,CN
chr13,Bn53596,25082969,98192013,73109044,RLP
chr13,Bn53597,55218401,59744790,4526389,CNL
chr13,Bn53598,3818152,78020140,74201988,NBS
chr13,Bn53599,18065929,47225113,29159184,TNL
chr13,Bn53600,67489507,74479533,6990026,NBS
chr13,Bn53601,12911740,75852018,62940278,CNL
chr13,Bn53602,54723608,66041085,11317477,RLP
chr13,Bn53603,40968942,93056729,52087787,NBS
chr13,Bn53604,19112607,81004123,61891516,CN
chr13,Bn53605,9843129,19827650,9984521,RLP
chr13,Bn53606,78006178,91750252,13744074,RLK
chr13,Bn53607,59456066,94155891,34699825,TNL
chr13,Bn53608,58065957,81841714,23775757,NBS
chr13,Bn53609,73399991,76220182,2820191,CNL
chr13,Bn53610,59322072,66589905,7267833,RLK
chr13,Bn53611,43932643,62729748,18797105,CNL
chr13,Bn53612,4649128,16484116,11834988,RLK
chr13,Bn53613,32615620,94154034,61538414,NBS
chr13,Bn53614,73389342,77654100,4264758,TN
chr13,Bn53615,99831536,99966821,135285,TN
chr13,Bn53616,80496511,93957916,13461405,TN
chr13,Bn53617,21008322,55991920,34983598,TNL
chr13,Bn53618,32375791,80809740,48433949,RLP
chr13,Bn53619,74595863,79556204,4960341,CN
chr13,Bn53620,36668301,51538276,14869975,NBS
chr13,Bn53621,15533714,92994481,77460767,RLP
chr13,Bn53622,89940000,92336739,2396739,RLK
chr13,Bn53623,94450267,95446025,995758,CN
chr13,Bn53624,50313405,59559079,9245674,TNL
chr13,Bn53625,79097703,86753125,7655422,CN
chr13,Bn53626,17654858,81187231,63532373,RLK
chr13,Bn53627,99143380,99495551,352171,CNL
chr13,Bn53628,5625642,69022745,63397103,RLK
chr13,Bn53629,25977592,57938695,31961103,TN
chr13,Bn53630,98539832,99115369,575537,TN
chr13,Bn53631,96160540,99406229,3245689,TN
chr13,Bn53632,54850687,81203078,26352391,TNL
chr13,Bn53633,95506388,98915863,3409475,RLP
chr13,Bn53634,94851218,99425249,4574031,RLP
chr13,Bn53635,92241931,95562322,3320391,CNL
chr13,Bn53636,51318686,63965058,12646372,RLK
chr13,Bn53637,24961371,81761850,56800479,RLP
chr13,Bn53638,35767544,77328423,41560879,NBS
chr13,Bn53639,31298894,87956064,56657170,CNL
chr13,Bn53640,39181798,48101036,8919238,TNL
chr13,Bn53641,83443539,96601462,13157923,CNL
chr13,Bn53642,65677958,88668383,22990425,TNL
chr13,Bn53643,76693067,95249907,18556840,RLP
chr13,Bn53644,39998216,70295776,30297560,RLP
chr13,Bn53645,72149631,82141952,9992321,CN
chr13,Bn53646,64413486,96573631,32160145,RLK
chr13,Bn53647,62833939,80192582,17358643,RLK
chr13,Bn53648,10622262,97129760,86507498,CN
chr13,Bn53649,66655932,68474251,1818319,RLK
chr13,Bn53650,77975273,91415830,13440557,CN
chr13,Bn53651,63635670,81214923,17579253,NBS
chr13,Bn53652,19055506,42561845,23506339,NBS
chr13,Bn53653,91285012,91488619,203607,NBS
chr13,Bn53654,88174350,93361914,5187564,RLK
chr13,Bn53655,89262181,90074503,812322,TN
chr13,Bn53656,69193297,87486481,18293184,TNL
chr13,Bn53657,8538754,57475758,48937004,RLP
chr13,Bn53658,56751249,66080286,9329037,RLK
chr13,Bn53659,12241766,47742797,35501031,TNL
chr13,Bn53660,43149119,92100368,48951249,CNL
chr13,Bn53661,97677214,99973129,2295915,RLK
chr13,Bn53662,21774657,50155643,28380986,NBS
chr13,Bn53663,95139692,97161970,2022278,RLP
chr13,Bn53664,8978479,24330498,15352019,RLK
chr13,Bn53665,82707194,99655167,16947973,RLK
chr13,Bn53666,48570444,66725037,18154593,CNL
chr13,Bn53667,93070570,95660330,2589760,TN
chr13,Bn53668,83877122,93660851,9783729,TNL
chr13,Bn53669,6469200,51032417,44563217,TNL
chr13,Bn53670,61516645,66573855,5057210,TNL
chr13,Bn53671,39009006,96690101,57681095,NBS
chr13,Bn53672,18457470,56259277,37801807,CNL
chr13,Bn53673,50573506,59987851,9414345,RLK
chr13,Bn53674,14265937,68492107,54226170,RLP
chr13,Bn53675,40170216,77560096,37389880,CNL
chr13,Bn53676,16676130,40073151,23397021,RLP
chr13,Bn53677,2618015,2934184,316169,TNL
chr13,Bn53678,6919536,23106067,16186531,CN
chr13,Bn53679,12358949,63409032,51050083,TNL
chr13,Bn53680,67654281,81037280,13382999,TNL
chr13,Bn53681,91167054,94112235,2945181,TN
chr13,Bn53682,37782865,45126803,7343938,TN
chr13,Bn53683,66895558,84863081,17967523,TNL
chr13,Bn53684,82799315,86752961,3953646,CNL
chr13,Bn53685,14867830,71825769,56957939,TN
chr13,Bn53686,54344782,71467385,17122603,CNL
chr13,Bn53687,63141547,94833550,31692003,RLP
chr13,Bn53688,51944820,90808114,38863294,RLK
chr13,Bn53689,25819878,66176381,40356503,CNL
chr13,Bn53690,17471738,18489977,1018239,RLK
chr13,Bn53691,47404144,48602966,1198822,CN
chr13,Bn53692,15357611,90193401,74835790,CN
chr13,Bn53693,84080433,89718989,5638556,CN
chr13,Bn53694,2868496,81550339,78681843,CNL
chr13,Bn53695,58691333,74312873,15621540,CN
chr13,Bn53696,11071558,98103743,87032185,TN
chr13,Bn53697,85806463,89974683,4168220,NBS
chr13,Bn53698,66518407,90589914,24071507,CNL
chr13,Bn53699,92965115,98100994,5135879,RLK
chr13,Bn53700,61299454,76221698,14922244,RLK
chr13,Bn53701,27415686,87538662,60122976,TNL
chr13,Bn53702,37982712,60776005,22793293,TNL
chr13,Bn53703,30450709,74500349,44049640,TN
chr13,Bn53704,63602044,87780946,24178902,TN
chr13,Bn53705,4927970,77208222,72280252,TNL
chr13,Bn53706,2751949,64016946,61264997,CNL
chr13,Bn53707,63340103,69745694,6405591,NBS
chr13,Bn53708,98638754,98840462,201708,RLP
chr13,Bn53709,73271048,85430837,12159789,RLP
chr13,Bn53710,43379366,53944082,10564716,NBS
chr13,Bn53711,53415700,96718899,43303199,CN
chr13,Bn53712,46163452,98698649,52535197,RLP
chr13,Bn53713,61930843,72750723,10819880,RLP
chr13,Bn53714,83149229,91609748,8460519,CNL
chr13,Bn53715,32851766,91337881,58486115,TN
chr13,Bn53716,56429899,85737585,29307686,NBS
chr13,Bn53717,2180761,40041927,37861166,NBS
chr13,Bn53718,7407403,13559448,6152045,CN
chr13,Bn53719,2151781,92056585,89904804,TNL
chr13,Bn53720,53959622,86289564,32329942,CNL
chr13,Bn53721,54419190,72684391,18265201,TN
chr13,Bn53722,69955916,94604463,24648547,RLK
chr13,Bn53723,18141043,32244367,14103324,RLP
chr13,Bn53724,49530026,61325913,11795887,RLP
chr13,Bn53725,51146624,72533965,21387341,TN
chr13,Bn53726,29566511,89241761,59675250,TN
chr13,Bn53727,3821724,74375041,70553317,RLP
chr13,Bn53728,86958098,91408710,4450612,CN
chr13,Bn53729,46997306,56619956,9622650,RLK
chr13,Bn53730,83962165,99503972,15541807,RLP
chr13,Bn53731,69373225,70716174,1342949,CN
chr13,Bn53732,29632719,33918789,4286070,NBS
chr13,Bn53733,58439485,60087255,1647770,TN
chr13,Bn53734,4843880,50033461,45189581,CN
chr13,Bn53735,86851594,99218560,12366966,CN
chr13,Bn53736,51417389,51893447,476058,CNL
chr13,Bn53737,69097908,74052211,4954303,TN
chr13,Bn53738,9940252,88888430,78948178,RLK
chr13,Bn53739,92299203,94205037,1905834,RLK
chr13,Bn53740,38319819,46128229,7808410,RLK
chr13,Bn53741,92621098,95404619,2783521,RLK
chr13,Bn53742,30997694,33634281,2636587,TNL
chr13,Bn53743,11632922,58935265,47302343,CNL
chr13,Bn53744,87482964,90410973,2928009,TNL
chr13,Bn53745,20288822,75616020,55327198,NBS
chr13,Bn53746,28688473,99270022,70581549,CNL
chr13,Bn53747,13664759,62851645,49186886,RLP
chr13,Bn53748,13498953,80054003,66555050,TNL
chr13,Bn53749,68076182,76380837,8304655,NBS
chr13,Bn53750,97949315,98030913,81598,NBS
chr13,Bn53751,27280638,74606236,47325598,RLK
chr13,Bn53752,44651055,51303497,6652442,CN
chr13,Bn53753,50277596,62519961,12242365,CN
chr13,Bn53754,54691233,73062282,18371049,RLK
chr13,Bn53755,61942906,85316297,23373391,TN
chr13,Bn53756,22548383,83588520,61040137,RLP
chr13,Bn53757,95761496,98121071,2359575,RLK
chr13,Bn53758,36501353,75144840,38643487,CNL
chr13,Bn53759,49950417,76108997,26158580,TNL
chr13,Bn53760,80351504,87226872,6875368,CN
chr13,Bn53761,31293625,53475950,22182325,CNL
chr13,Bn53762,17316679,69756903,52440224,CNL
chr13,Bn53763,94919900,95019718,99818,RLP
chr13,Bn53764,89034694,97501041,8466347,NBS
chr13,Bn53765,58130742,67616782,9486040,RLK
chr13,Bn53766,69941555,86687709,16746154,CN
chr13,Bn53767,33741487,63699125,29957638,RLP
chr13,Bn53768,97699672,98925251,1225579,CNL
chr13,Bn53769,33438752,41687648,8248896,CN
chr13,Bn53770,34767311,66083942,31316631,TNL
chr13,Bn53771,90891521,99268825,8377304,CNL
chr13,Bn53772,32903381,74135677,41232296,CNL
chr13,Bn53773,87617414,92607486,4990072,NBS
chr13,Bn53774,32895647,63994221,31098574,CN
chr13,Bn53775,59435695,92059206,32623511,RLP
chr13,Bn53776,97709894,98870754,1160860,CNL
chr14,Bn53777,53350866,86215682,32864816,CN
chr14,Bn53778,29724216,54560274,24836058,RLP
chr14,Bn53779,82129594,88263910,6134316,TN
chr14,Bn53780,19320961,99054367,79733406,RLK
chr14,Bn53781,79857439,84673453,4816014,TN
chr14,Bn53782,40353514,93192073,52838559,TNL
chr14,Bn53783,8199518,18751449,10551931,RLP
chr14,Bn53784,64530809,67226267,2695458,RLP
chr14,Bn53785,64143030,82573272,18430242,NBS
chr14,Bn53786,94719544,97969429,3249885,NBS
chr14,Bn53787,66027917,82785923,16758006,TNL
chr14,Bn53788,32703493,48809446,16105953,RLP
chr14,Bn53789,49635314,71726356,22091042,CNL
chr14,Bn53790,53414457,73193785,19779328,NBS
chr14,Bn53791,99312735,99459067,146332,TN
chr14,Bn53792,70991635,73455027,2463392,TNL
chr14,Bn53793,82276609,99700333,17423724,TNL
chr14,Bn53794,46012666,90283927,44271261,RLP
chr14,Bn53795,67223459,90638006,23414547,CNL
chr14,Bn53796,45089342,94098194,49008852,RLP
chr14,Bn53797,70356774,95147508,24790734,RLK
chr14,Bn53798,20202967,55824738,35621771,TNL
chr14,Bn53799,23373896,28427181,5053285,CNL
chr14,Bn53800,12702397,96758624,84056227,TN
chr14,Bn53801,35485197,89208286,53723089,CNL
chr14,Bn53802,86405071,99979594,13574523,RLK
chr14,Bn53803,69053328,94599938,25546610,NBS
chr14,Bn53804,95793657,96787901,994244,TN
chr14,Bn53805,30041577,31630198,1588621,RLP
chr14,Bn53806,55403103,61901880,6498777,NBS
chr14,Bn53807,4495214,69446059,64950845,RLK
chr14,Bn53808,65805484,70105266,4299782,TNL
chr14,Bn53809,29715004,80480945,50765941,NBS
chr14,Bn53810,77278357,90808647,13530290,RLK
chr14,Bn53811,18870444,70089655,51219211,TN
chr14,Bn53812,70653633,83921684,13268051,CN
chr14,Bn53813,57163983,75550704,18386721,NBS
chr14,Bn53814,42443155,69991560,27548405,RLK
chr14,Bn53815,96987705,97126733,139028,RLK
chr14,Bn53816,94695525,96877830,2182305,TNL
chr14,Bn53817,24879387,88001296,63121909,CNL
chr14,Bn53818,8841036,73655309,64814273,TN
chr14,Bn53819,18619146,87171291,68552145,CNL
chr14,Bn53820,68628183,69223367,595184,RLK
chr14,Bn53821,76428454,90436483,14008029,TN
chr14,Bn53822,40112981,52342410,12229429,TN
chr14,Bn53823,63105658,85079206,21973548,CN
chr14,Bn53824,56344319,62421366,6077047,RLK
chr14,Bn53825,73544802,75712482,2167680,RLP
chr14,Bn53826,27172494,73828939,46656445,TNL
chr14,Bn53827,23652116,81488257,57836141,CN
chr14,Bn53828,84497088,99483420,14986332,RLP
chr14,Bn53829,97426487,97963903,537416,RLK
chr14,Bn53830,78083237,99957294,21874057,TNL
chr14,Bn53831,30238390,52407821,22169431,NBS
chr14,Bn53832,85787258,98451726,12664468,RLK
chr14,Bn53833,71655101,74630890,2975789,CNL
chr14,Bn53834,29437321,42812778,13375457,TN
chr14,Bn53835,88723228,93177140,4453912,TN
chr14,Bn53836,53569680,85377281,31807601,TN
chr14,Bn53837,78551908,92352114,13800206,NBS
chr14,Bn53838,84587563,92313327,7725764,NBS
chr14,Bn53839,83996359,85058605,1062246,RLP
chr14,Bn53840,85817748,96756345,10938597,CNL
chr14,Bn53841,92396180,93728162,1331982,CNL
chr14,Bn53842,79716107,94217500,14501393,CNL
chr14,Bn53843,81104104,82659615,1555511,CNL
chr14,Bn53844,59091511,75611619,16520108,RLP
chr14,Bn53845,53802500,56158779,2356279,TN
chr14,Bn53846,61905225,81899964,19994739,CN
chr14,Bn53847,51831988,53455989,1624001,RLP
chr14,Bn53848,64046774,71696801,7650027,CN
chr14,Bn53849,45308638,53452069,8143431,NBS
chr14,Bn53850,14937916,84111921,69174005,TN
chr14,Bn53851,7365231,74984089,67618858,RLP
chr14,Bn53852,47907877,56530996,8623119,CN
chr14,Bn53853,75074257,94720210,19645953,TNL
chr14,Bn53854,86051416,86999802,948386,NBS
chr14,Bn53855,38229736,90267498,52037762,CN
chr14,Bn53856,13697957,93366193,79668236,TNL
chr14,Bn53857,13910152,73907851,59997699,NBS
chr14,Bn53858,78989084,85879525,6890441,CN
chr14,Bn53859,46368896,54879132,8510236,NBS
chr14,Bn53860,70833376,77132777,6299401,TN
chr14,Bn53861,13373882,83993111,70619229,TNL
chr14,Bn53862,27196011,73397312,46201301,TN
chr14,Bn53863,29231190,97825222,68594032,RLP
chr14,Bn53864,71441306,96111283,24669977,RLK
chr14,Bn53865,87572656,96327682,8755026,CN
chr14,Bn53866,90146295,91942718,1796423,NBS
chr14,Bn53867,32457908,64891609,32433701,CNL
chr14,Bn53868,96936315,99953406,3017091,NBS
chr14,Bn53869,75846468,75951203,104735,NBS
chr14,Bn53870,52741003,83003304,30262301,RLK
chr14,Bn53871,9216721,58740193,49523472,CN
chr14,Bn53872,19678222,85878119,66199897,RLK
chr14,Bn53873,11591255,99267504,87676249,TNL
chr14,Bn53874,64022145,65112321,1090176,TNL
chr14,Bn53875,99086590,99555672,469082,CN
chr14,Bn53876,96973997,97969444,995447,CN
chr14,Bn53877,82998553,84910560,1912007,NBS
chr14,Bn53878,7615316,29753872,22138556,NBS
chr14,Bn53879,84306594,86805928,2499334,RLP
chr14,Bn53880,68094892,94316233,26221341,RLP
chr14,Bn53881,93008966,96837256,3828290,CNL
chr14,Bn53882,95224153,95812645,588492,TN
chr14,Bn53883,45948043,63896383,17948340,TN
chr14,Bn53884,35865172,40747901,4882729,RLK
chr14,Bn53885,59154777,91884124,32729347,RLK
chr14,Bn53886,12534661,45394494,32859833,RLP
chr14,Bn53887,89152817,97070638,7917821,CN
chr14,Bn53888,36580943,93270997,56690054,NBS
chr14,Bn53889,47853993,63626741,15772748,CN
chr14,Bn53890,83166944,93501330,10334386,TN
chr14,Bn53891,97073382,99506266,2432884,RLP
chr14,Bn53892,70504934,83879963,13375029,RLP
chr14,Bn53893,11828250,55673628,43845378,RLP
chr14,Bn53894,91023039,95599072,4576033,TN
chr14,Bn53895,10143620,98951451,88807831,RLP
chr14,Bn53896,68573890,74484805,5910915,RLP
chr14,Bn53897,80953632,89104550,8150918,TNL
chr14,Bn53898,7494905,47585835,40090930,RLK
chr14,Bn53899,89070050,94355777,5285727,TN
chr14,Bn53900,92048308,92316373,268065,TN
chr14,Bn53901,67087714,77625839,10538125,RLK
chr14,Bn53902,10896215,37049509,26153294,CN
chr14,Bn53903,39405314,89919381,50514067,CNL
chr14,Bn53904,55054807,64616905,9562098,CNL
chr14,Bn53905,60435581,92406950,31971369,TN
chr14,Bn53906,61641828,65080256,3438428,NBS
chr14,Bn53907,42441373,98638230,56196857,CN
chr14,Bn53908,69955043,83394192,13439149,NBS
chr14,Bn53909,36378978,84446352,48067374,TNL
chr14,Bn53910,91747365,98593727,6846362,CN
chr14,Bn53911,78058291,93543543,15485252,TN
chr14,Bn53912,85761999,86867899,1105900,RLK
chr14,Bn53913,96358645,98970391,2611746,TN
chr14,Bn53914,86568113,97160249,10592136,CNL
chr14,Bn53915,76589626,77780890,1191264,NBS
chr14,Bn53916,67672658,96891021,29218363,CNL
chr14,Bn53917,24536628,66801415,42264787,CN
chr14,Bn53918,64602447,77352971,12750524,RLK
chr14,Bn53919,24579108,73471909,48892801,RLK
chr14,Bn53920,79680068,99781346,20101278,RLP
chr14,Bn53921,97956337,99986901,2030564,NBS
chr14,Bn53922,82067478,93699089,11631611,TN
chr14,Bn53923,1745554,89306928,87561374,CNL
chr14,Bn53924,2495378,38690855,36195477,RLK
chr14,Bn53925,51000144,95026408,44026264,NBS
chr14,Bn53926,28748760,58017744,29268984,RLK
chr14,Bn53927,27933212,69199199,41265987,CN
chr14,Bn53928,17199629,67034210,49834581,TNL
chr14,Bn53929,81003030,82385251,1382221,CN
chr14,Bn53930,80474265,83101276,2627011,TN
chr14,Bn53931,98838066,99413380,575314,CNL
chr14,Bn53932,15690594,23172227,7481633,CNL
chr14,Bn53933,81675755,87074111,5398356,CN
chr14,Bn53934,55434688,93453764,38019076,TNL
chr14,Bn53935,91977154,98890407,6913253,RLP
chr14,Bn53936,16694659,51621082,34926423,RLP
chr14,Bn53937,96620488,97164472,543984,RLK
chr14,Bn53938,87236295,99701200,12464905,RLK
chr14,Bn53939,99223763,99302403,78640,RLK
chr14,Bn53940,38245222,52180367,13935145,NBS
chr14,Bn53941,40406672,96372023,55965351,TN
chr14,Bn53942,6700497,98102337,91401840,NBS
chr14,Bn53943,99192362,99862996,670634,NBS
chr14,Bn53944,76397474,77923513,1526039,TN
chr14,Bn53945,71294395,85188731,13894336,CNL
chr14,Bn53946,94447574,95221882,774308,NBS
chr14,Bn53947,65700104,81368623,15668519,RLP
chr14,Bn53948,51719420,77507476,25788056,TN
chr14,Bn53949,4535623,85793325,81257702,RLP
chr14,Bn53950,41249797,53394592,12144795,CN
chr14,Bn53951,50059498,62193461,12133963,CN
chr14,Bn53952,11402895,24204863,12801968,CNL
chr14,Bn53953,28170581,60118267,31947686,TN
chr14,Bn53954,28058517,88899806,60841289,RLK
chr14,Bn53955,14598383,21681273,7082890,TN
chr14,Bn53956,17288443,30046473,12758030,CN
chr14,Bn53957,96874331,99950556,3076225,NBS
chr14,Bn53958,64664397,79348316,14683919,TNL
chr14,Bn53959,44730052,59339460,14609408,CNL
chr14,Bn53960,69859776,79881894,10022118,TNL
chr14,Bn53961,32513648,96677575,64163927,CNL
chr14,Bn53962,58972960,81609852,22636892,CN
chr14,Bn53963,50461249,65965532,15504283,RLP
chr14,Bn53964,72771661,94572691,21801030,TNL
chr14,Bn53965,95485861,98580053,3094192,RLP
chr14,Bn53966,12473603,69278681,56805078,TN
chr14,Bn53967,78508003,96040578,17532575,TN
chr14,Bn53968,3862624,48397876,44535252,RLP
chr14,Bn53969,52700054,99100079,46400025,CNL
chr14,Bn53970,64192519,68997535,4805016,TNL
chr14,Bn53971,62927131,80299938,17372807,NBS
chr14,Bn53972,1343489,78369561,77026072,TNL
chr14,Bn53973,27981402,66737024,38755622,RLP
chr14,Bn53974,7262907,89066498,81803591,CNL
chr14,Bn53975,67982545,77338740,9356195,CN
chr14,Bn53976,76874157,84515263,7641106,TN
chr14,Bn53977,62141474,64150104,2008630,TNL
chr14,Bn53978,52794748,83061622,30266874,CN
chr14,Bn53979,55338322,82166785,26828463,RLP
chr14,Bn53980,17703370,93686261,75982891,RLK
chr14,Bn53981,18868897,62481898,43613001,CNL
chr14,Bn53982,99064659,99248218,183559,TN
chr14,Bn53983,19385774,92121919,72736145,RLP
chr14,Bn53984,62339053,84016108,21677055,CN
chr14,Bn53985,89583733,94396721,4812988,CNL
chr14,Bn53986,89202197,94665292,5463095,RLK
chr14,Bn53987,21293948,91398916,70104968,TN
chr14,Bn53988,77223887,95855110,18631223,TN
chr14,Bn53989,32295197,76249980,43954783,CN
chr14,Bn53990,78370714,89740573,11369859,TNL
chr14,Bn53991,80815353,87915363,7100010,TN
chr14,Bn53992,44348251,72482018,28133767,RLP
chr14,Bn53993,76889222,98214799,21325577,NBS
chr14,Bn53994,1756720,46473929,44717209,CNL
chr14,Bn53995,39697053,84129609,44432556,RLK
chr14,Bn53996,80344091,98139635,17795544,CN
chr14,Bn53997,96301165,98367916,2066751,RLK
chr14,Bn53998,78289050,89790131,11501081,RLK
chr14,Bn53999,1598628,22739543,21140915,RLP
chr14,Bn54000,78073093,98595620,20522527,CNL
chr14,Bn54001,9413898,87258257,77844359,CNL
chr14,Bn54002,19939140,34625486,14686346,CN
chr14,Bn54003,5678127,87501794,81823667,NBS
chr14,Bn54004,43481713,85670459,42188746,NBS
chr14,Bn54005,79441437,91624565,12183128,CN
chr14,Bn54006,61070920,68288614,7217694,TN
chr14,Bn54007,46871141,91911343,45040202,CNL
chr14,Bn54008,92894057,95319712,2425655,RLK
chr14,Bn54009,58967282,84079866,25112584,CN
chr14,Bn54010,87346964,88159927,812963,RLK
chr14,Bn54011,63667291,69072397,5405106,CN
chr14,Bn54012,29034155,96230300,67196145,CN
chr14,Bn54013,86086675,88988586,2901911,CN
chr14,Bn54014,55227870,72405498,17177628,RLP
chr14,Bn54015,63786857,87582662,23795805,CNL
chr14,Bn54016,41841577,59838438,17996861,CN
chr14,Bn54017,81752382,94030706,12278324,TN
chr14,Bn54018,13993304,15680582,1687278,TN
chr14,Bn54019,83672815,87482746,3809931,RLP
chr14,Bn54020,6195725,73101278,66905553,NBS
chr14,Bn54021,94454565,98850047,4395482,TNL
chr14,Bn54022,3809581,80857115,77047534,TNL
chr14,Bn54023,41464701,42865061,1400360,RLK
chr14,Bn54024,96796210,98893184,2096974,TNL
chr14,Bn54025,98649969,98752741,102772,CN
chr14,Bn54026,91270557,95865093,4594536,CN
chr14,Bn54027,33280029,54152523,20872494,CNL
chr14,Bn54028,16988905,79657717,62668812,RLK
chr14,Bn54029,72354038,98766151,26412113,RLK
chr14,Bn54030,94493087,95164234,671147,TNL
chr14,Bn54031,56329782,58944211,2614429,NBS
chr14,Bn54032,49610585,94692806,45082221,RLP
chr14,Bn54033,84077830,96184957,12107127,NBS
chr14,Bn54034,12358925,98708905,86349980,RLK
chr14,Bn54035,17313218,34047810,16734592,TN
chr14,Bn54036,18288698,88752354,70463656,NBS
chr14,Bn54037,38347344,47026017,8678673,RLK
chr14,Bn54038,70561655,91355358,20793703,NBS
chr14,Bn54039,80857790,89722211,8864421,TNL
chr14,Bn54040,25682001,43902450,18220449,CN
chr14,Bn54041,36141308,36534063,392755,CNL
chr14,Bn54042,20281423,57892860,37611437,CN
chr14,Bn54043,7319638,73675274,66355636,RLP
chr14,Bn54044,26480403,40568858,14088455,NBS
chr14,Bn54045,1876277,31508984,29632707,NBS
chr14,Bn54046,86433236,92542877,6109641,CN
chr14,Bn54047,66818565,99875733,33057168,TN
chr14,Bn54048,98879542,99140184,260642,CNL
chr14,Bn54049,2699177,26239442,23540265,RLP
chr14,Bn54050,98903561,98931334,27773,TNL
chr14,Bn54051,18922181,75205734,56283553,CNL
chr14,Bn54052,73162362,83212947,10050585,TN
chr14,Bn54053,33683600,99067446,65383846,RLP
chr14,Bn54054,98531029,99724838,1193809,RLK
chr14,Bn54055,34040905,60184030,26143125,RLP
chr14,Bn54056,2453778,15367195,12913417,NBS
chr14,Bn54057,18194314,77971618,59777304,RLK
chr14,Bn54058,88168690,89884942,1716252,RLK
chr14,Bn54059,21112364,39779967,18667603,CNL
chr14,Bn54060,89065785,92682551,3616766,NBS
chr14,Bn54061,58685969,65995090,7309121,TN
chr14,Bn54062,12962058,34387696,21425638,CN
chr14,Bn54063,75969461,94705211,18735750,RLP
chr14,Bn54064,20640906,72270320,51629414,CNL
chr14,Bn54065,59410472,67086360,7675888,RLP
chr14,Bn54066,78178691,78495075,316384,RLP
chr14,Bn54067,91874734,97373925,5499191,TN
chr14,Bn54068,5052913,43924774,38871861,TNL
chr14,Bn54069,15671457,46635535,30964078,RLP
chr14,Bn54070,50409203,51973653,1564450,RLK
chr14,Bn54071,20200151,88090685,67890534,TNL
chr14,Bn54072,17700673,74532954,56832281,CN
chr14,Bn54073,99048103,99397206,349103,TN
chr14,Bn54074,60613739,76077757,15464018,RLK
chr14,Bn54075,87925435,88171462,246027,TN
chr14,Bn54076,5327278,79141705,73814427,TN
chr14,Bn54077,85043786,90167870,5124084,CNL
chr14,Bn54078,64270934,84171386,19900452,TN
chr14,Bn54079,68145751,84625898,16480147,RLP
chr14,Bn54080,32327814,82500627,50172813,TNL
chr14,Bn54081,63552013,67288011,3735998,CN
chr14,Bn54082,27413901,99003185,71589284,RLP
chr14,Bn54083,38783749,43062506,4278757,NBS
chr14,Bn54084,93223360,94601864,1378504,RLK
chr14,Bn54085,3585517,38993547,35408030,CNL
chr14,Bn54086,65062052,76610142,11548090,TNL
chr14,Bn54087,27722472,36282138,8559666,TNL
chr14,Bn54088,63610391,83337415,19727024,CN
chr14,Bn54089,17797927,77870017,60072090,NBS
chr14,Bn54090,4620985,21331492,16710507,CN
chr14,Bn54091,78255715,86581347,8325632,CNL
chr14,Bn54092,96083105,96830651,747546,CN
chr14,Bn54093,34857724,44025752,9168028,CN
chr14,Bn54094,74114974,91075277,16960303,RLK
chr14,Bn54095,82104739,89151598,7046859,RLK
chr14,Bn54096,21267531,42456278,21188747,NBS
chr14,Bn54097,13349226,88799982,75450756,TNL
chr14,Bn54098,40121816,85076884,44955068,CNL
chr14,Bn54099,15647108,50237614,34590506,RLK
chr14,Bn54100,57770093,70696621,12926528,CNL
chr14,Bn54101,98794640,99182425,387785,CNL
chr14,Bn54102,67982957,80296492,12313535,TN
chr14,Bn54103,81212090,95670842,14458752,NBS
chr14,Bn54104,92247640,94016343,1768703,RLP
chr14,Bn54105,35179326,88531585,53352259,RLK
chr14,Bn54106,73832309,84739812,10907503,CNL
chr14,Bn54107,39878497,51295093,11416596,CN
chr14,Bn54108,85139055,85370949,231894,RLP
chr14,Bn54109,47126483,97065054,49938571,CNL
chr14,Bn54110,79851887,86440183,6588296,RLK
chr14,Bn54111,84595647,86801116,2205469,TNL
chr14,Bn54112,11175073,98059606,86884533,TNL
chr14,Bn54113,57997147,82923274,24926127,NBS
chr14,Bn54114,18892340,88348456,69456116,NBS
chr14,Bn54115,94055507,99962064,5906557,NBS
chr14,Bn54116,37763166,50234358,12471192,CN
chr14,Bn54117,21026038,53963432,32937394,CN
chr14,Bn54118,82406048,90822364,8416316,CNL
chr14,Bn54119,66329940,88826949,22497009,CN
chr14,Bn54120,82817710,94765595,11947885,TNL
chr14,Bn54121,91713126,93241866,1528740,RLP
chr14,Bn54122,57044150,72304792,15260642,TN
chr14,Bn54123,98829594,99245146,415552,TN
chr14,Bn54124,67035936,84855974,17820038,RLK
chr14,Bn54125,27785218,88901357,61116139,RLK
chr14,Bn54126,73810725,85474929,11664204,RLK
chr14,Bn54127,34693853,40674013,5980160,NBS
chr14,Bn54128,2345885,92293670,89947785,TNL
chr14,Bn54129,5383108,90266610,84883502,CNL
chr14,Bn54130,5785005,28351828,22566823,RLP
chr14,Bn54131,13174723,69221457,56046734,CN
chr14,Bn54132,47191194,64512979,17321785,CN
chr14,Bn54133,85415956,88206789,2790833,TN
chr14,Bn54134,65874976,99622995,33748019,RLP
chr14,Bn54135,33677416,50787455,17110039,NBS
chr14,Bn54136,14075990,70489729,56413739,CN
chr14,Bn54137,76090156,92954878,16864722,CN
chr14,Bn54138,39213604,61509175,22295571,CN
chr14,Bn54139,48041707,54931082,6889375,TN
chr14,Bn54140,75721916,84020125,8298209,CNL
chr14,Bn54141,54248462,93545591,39297129,TNL
chr14,Bn54142,36019175,48100299,12081124,CN
chr14,Bn54143,10276625,68611408,58334783,TN
chr14,Bn54144,58424196,73498619,15074423,TNL
chr14,Bn54145,12470902,68350318,55879416,CN
chr14,Bn54146,48523476,65606412,17082936,RLK
chr14,Bn54147,49674784,62139527,12464743,NBS
chr14,Bn54148,22506126,80620838,58114712,RLP
chr14,Bn54149,47612351,99215011,51602660,TN
chr14,Bn54150,59204370,60996363,1791993,CNL
chr14,Bn54151,44222098,63918444,19696346,TN
chr14,Bn54152,70848677,91790335,20941658,NBS
chr14,Bn54153,93077139,97651365,4574226,TNL
chr14,Bn54154,40451028,43622779,3171751,CN
chr14,Bn54155,15267714,45089766,29822052,CNL
chr14,Bn54156,93988277,94062189,73912,CN
chr14,Bn54157,30220094,89804142,59584048,CNL
chr14,Bn54158,86108574,90386040,4277466,CN
chr14,Bn54159,97166698,99518262,2351564,CNL
chr14,Bn54160,97732392,99474280,1741888,NBS
chr14,Bn54161,99849213,99866223,17010,CN
chr14,Bn54162,82273868,85452051,3178183,CN
chr14,Bn54163,58722205,91274743,32552538,TNL
chr14,Bn54164,71277022,90938769,19661747,NBS
chr14,Bn54165,4895300,27847386,22952086,RLP
chr14,Bn54166,53011023,67522003,14510980,TN
chr14,Bn54167,96301422,97960761,1659339,TNL
chr14,Bn54168,34974250,60112150,25137900,NBS
chr14,Bn54169,51469114,66995177,15526063,CNL
chr14,Bn54170,18670595,93967952,75297357,TN
chr14,Bn54171,73201168,93620712,20419544,RLK
chr14,Bn54172,46192288,95227898,49035610,NBS
chr14,Bn54173,92127622,97740330,5612708,CN
chr14,Bn54174,92226862,92566559,339697,TNL
chr14,Bn54175,21028420,40990494,19962074,RLK
chr14,Bn54176,55516608,83875348,28358740,CNL
chr14,Bn54177,58471688,64712279,6240591,RLK
chr14,Bn54178,72541656,85891189,13349533,CN
chr14,Bn54179,81976332,91937103,9960771,TNL
chr14,Bn54180,98836106,99816489,980383,RLK
chr14,Bn54181,84096693,99335528,15238835,CNL
chr14,Bn54182,40804122,55166323,14362201,TN
chr14,Bn54183,89020282,92587385,3567103,RLK
chr14,Bn54184,78158979,97845264,19686285,TN
chr14,Bn54185,39108468,94174640,55066172,CN
chr14,Bn54186,45808460,96369785,50561325,RLP
chr14,Bn54187,87700492,98927959,11227467,RLP
chr14,Bn54188,98242203,99541776,1299573,TNL
chr14,Bn54189,31798205,46302461,14504256,NBS
chr14,Bn54190,97278917,99438947,2160030,RLK
chr14,Bn54191,50245551,53415134,3169583,CNL
chr14,Bn54192,84850120,94036515,9186395,TNL
chr14,Bn54193,29855495,54295518,24440023,CNL
chr14,Bn54194,77972731,90779854,12807123,TNL
chr14,Bn54195,55019836,60861002,5841166,CNL
chr14,Bn54196,59005893,68595211,9589318,TNL
chr14,Bn54197,61144765,89509022,28364257,RLP
chr14,Bn54198,29320502,80127688,50807186,RLK
chr14,Bn54199,55070448,97790908,42720460,CN
chr14,Bn54200,19784958,24573394,4788436,TN
chr14,Bn54201,9356497,29534299,20177802,CNL
chr14,Bn54202,20185074,44414888,24229814,RLK
chr14,Bn54203,2186334,10669055,8482721,RLK
chr14,Bn54204,50016474,87059147,37042673,TN
chr14,Bn54205,46662499,62922329,16259830,NBS
chr14,Bn54206,41549840,48318904,6769064,NBS
chr14,Bn54207,39607367,64420138,24812771,NBS
chr14,Bn54208,14134776,83568753,69433977,RLK
chr14,Bn54209,62261280,73734784,11473504,TNL
chr14,Bn54210,88325886,96187102,7861216,CN
chr14,Bn54211,19571171,72311603,52740432,CN
chr14,Bn54212,28854954,35768230,6913276,TNL
chr14,Bn54213,85700001,98371044,12671043,CN
chr14,Bn54214,66468620,89413177,22944557,TN
chr14,Bn54215,54499198,95709582,41210384,TN
chr14,Bn54216,65777277,93936361,28159084,RLK
chr14,Bn54217,4661718,72717168,68055450,TN
chr14,Bn54218,30137183,32539984,2402801,TN
chr14,Bn54219,50882253,65364778,14482525,CN
chr14,Bn54220,38123023,66873579,28750556,NBS
chr14,Bn54221,61701252,91118155,29416903,TNL
chr14,Bn54222,98613006,99581879,968873,NBS
chr14,Bn54223,40130972,98063707,57932735,TNL
chr14,Bn54224,5079487,69929333,64849846,NBS
chr14,Bn54225,40327235,83104029,42776794,CNL
chr14,Bn54226,32491171,34264779,1773608,RLK
chr14,Bn54227,68336699,68866701,530002,CNL
chr14,Bn54228,92774620,94789124,2014504,TNL
chr14,Bn54229,27517505,62357196,34839691,RLK
chr14,Bn54230,8255066,10477704,2222638,TN
chr14,Bn54231,71933900,83640344,11706444,CN
chr14,Bn54232,52934967,96706793,43771826,CN
chr14,Bn54233,16819319,52457545,35638226,CNL
chr14,Bn54234,65672981,81545174,15872193,RLP
chr14,Bn54235,48128396,51813640,3685244,NBS
chr14,Bn54236,92457610,98894749,6437139,CN
chr14,Bn54237,31236846,83187714,51950868,RLP
chr14,Bn54238,55725915,61132016,5406101,NBS
chr14,Bn54239,8932271,45782704,36850433,RLK
chr14,Bn54240,44927641,85927313,40999672,RLK
chr14,Bn54241,55125326,72638723,17513397,CN
chr14,Bn54242,6728956,68216767,61487811,CNL
chr14,Bn54243,85619500,96560596,10941096,RLP
chr14,Bn54244,67831797,77183598,9351801,CN
chr14,Bn54245,23473884,37524682,14050798,RLK
chr14,Bn54246,27651868,57633565,29981697,NBS
chr14,Bn54247,39900872,99593583,59692711,TNL
chr14,Bn54248,79293133,86421285,7128152,RLP
chr14,Bn54249,5805537,99391617,93586080,CNL
chr14,Bn54250,33565182,98155639,64590457,RLK
chr14,Bn54251,39502444,87314272,47811828,RLK
chr14,Bn54252,70824636,92590029,21765393,TNL
chr14,Bn54253,97747834,97778944,31110,CN
chr14,Bn54254,66357738,67494377,1136639,RLP
chr14,Bn54255,22041608,92390736,70349128,CNL
chr14,Bn54256,4452307,95961582,91509275,RLK
chr14,Bn54257,85854418,86841477,987059,CN
chr14,Bn54258,86342414,93427638,7085224,CN
chr14,Bn54259,93465730,99060708,5594978,NBS
chr14,Bn54260,35324707,68652373,33327666,TN
chr14,Bn54261,94405091,94803580,398489,TNL
chr14,Bn54262,87931259,88870576,939317,RLK
chr14,Bn54263,17507476,24730979,7223503,TN
chr14,Bn54264,98263490,98325932,62442,RLK
chr14,Bn54265,63450806,94789913,31339107,NBS
chr14,Bn54266,58350130,73902327,15552197,TNL
chr14,Bn54267,8423637,87988443,79564806,TN
chr14,Bn54268,68304298,93342036,25037738,CN
chr14,Bn54269,57592549,72607423,15014874,CN
chr14,Bn54270,93830444,97545786,3715342,TN
chr14,Bn54271,31765888,45034340,13268452,NBS
chr14,Bn54272,85853431,95151597,9298166,CN
chr14,Bn54273,26387073,28171273,1784200,CNL
chr14,Bn54274,27913252,90132574,62219322,TN
chr14,Bn54275,5009858,19368334,14358476,RLK
chr14,Bn54276,17364099,90286262,72922163,TN
chr14,Bn54277,26907300,41936044,15028744,NBS
chr14,Bn54278,93507079,96857420,3350341,CNL
chr14,Bn54279,33533984,57018117,23484133,CN
chr14,Bn54280,42932326,73752154,30819828,NBS
chr14,Bn54281,42328021,70492968,28164947,CN
chr14,Bn54282,44372379,55045466,10673087,RLK
chr14,Bn54283,15568682,99139392,83570710,TNL
chr14,Bn54284,9502342,68942598,59440256,NBS
chr14,Bn54285,6848931,65844767,58995836,RLP
chr14,Bn54286,34502654,55026109,20523455,RLP
chr14,Bn54287,49352155,64459163,15107008,TNL
chr14,Bn54288,15639975,91574974,75934999,CNL
chr14,Bn54289,21311065,71129718,49818653,NBS
chr14,Bn54290,20258800,58143979,37885179,TNL
chr14,Bn54291,33162294,86868051,53705757,CN
chr14,Bn54292,51574255,84326230,32751975,CN
chr14,Bn54293,45905585,85785756,39880171,RLP
chr14,Bn54294,94566145,97320988,2754843,TN
chr14,Bn54295,54883144,72072005,17188861,CN
chr14,Bn54296,39471292,91442477,51971185,CN
chr14,Bn54297,39240009,73840911,34600902,NBS
chr14,Bn54298,85392917,89788992,4396075,RLP
chr14,Bn54299,77793103,92976680,15183577,RLK
chr14,Bn54300,63626411,91863097,28236686,NBS
chr14,Bn54301,50395534,89636498,39240964,CN
chr14,Bn54302,68435443,70757689,2322246,RLK
chr14,Bn54303,68856867,70857303,2000436,NBS
chr14,Bn54304,95420419,96783679,1363260,NBS
chr14,Bn54305,73097085,88670542,15573457,CNL
chr14,Bn54306,46202570,51305581,5103011,RLP
chr14,Bn54307,50464288,85254972,34790684,CNL
chr14,Bn54308,99609882,99860349,250467,RLP
chr14,Bn54309,67477570,79322121,11844551,CN
chr14,Bn54310,17818326,36031084,18212758,RLP
chr14,Bn54311,59633627,91371863,31738236,NBS
chr14,Bn54312,60330377,84023137,23692760,CNL
chr14,Bn54313,52398225,82445972,30047747,CNL
chr14,Bn54314,26166877,68149840,41982963,CN
chr14,Bn54315,19032441,82511587,63479146,CNL
chr14,Bn54316,80782367,97133919,16351552,CNL
chr14,Bn54317,85214591,94293507,9078916,CN
chr14,Bn54318,40540909,44231459,3690550,RLP
chr14,Bn54319,14655865,53106131,38450266,CNL
chr14,Bn54320,87527587,91203342,3675755,TN
chr14,Bn54321,30497535,68799271,38301736,CN
chr14,Bn54322,38327896,92511712,54183816,CN
chr14,Bn54323,51184227,63749633,12565406,CN
chr14,Bn54324,4369954,8271147,3901193,RLP
chr14,Bn54325,97145051,98030792,885741,RLK
chr14,Bn54326,93778281,98451497,4673216,CN
chr14,Bn54327,9772996,34695189,24922193,TN
chr14,Bn54328,44082190,82243980,38161790,CNL
chr14,Bn54329,73641234,77482200,3840966,RLK
chr14,Bn54330,13707129,89711382,76004253,RLP
chr14,Bn54331,79492067,80740036,1247969,CN
chr14,Bn54332,7521489,40269600,32748111,TNL
chr14,Bn54333,91003869,91940182,936313,TN
chr14,Bn54334,77368080,86700792,9332712,CN
chr14,Bn54335,7104583,24568046,17463463,CNL
chr14,Bn54336,34706328,58150786,23444458,CNL
chr14,Bn54337,51945087,81593264,29648177,NBS
chr14,Bn54338,51103770,78650180,27546410,NBS
chr14,Bn54339,19680489,26027927,6347438,CNL
chr14,Bn54340,39048495,75438810,36390315,RLK
chr14,Bn54341,59712483,95005658,35293175,RLK
chr14,Bn54342,24874153,59698233,34824080,CN
chr14,Bn54343,25912920,92308649,66395729,CNL
chr14,Bn54344,14650112,35660707,21010595,RLP
chr14,Bn54345,17557946,63727598,46169652,RLK
chr14,Bn54346,13018214,77515985,64497771,NBS
chr14,Bn54347,51538909,85193256,33654347,NBS
chr14,Bn54348,23850842,99192382,75341540,RLK
chr14,Bn54349,90247403,97646740,7399337,RLP
chr14,Bn54350,40356008,52650028,12294020,TNL
chr14,Bn54351,15388824,87592700,72203876,NBS
chr14,Bn54352,17438562,69268766,51830204,CNL
chr14,Bn54353,53554304,72126283,18571979,TN
chr14,Bn54354,75940606,98364645,22424039,CN
chr14,Bn54355,97608896,99218995,1610099,CN
chr14,Bn54356,98999825,99797971,798146,TN
chr14,Bn54357,83574031,90317895,6743864,RLK
chr14,Bn54358,88883463,89784492,901029,NBS
chr14,Bn54359,85205381,85828541,623160,TNL
chr14,Bn54360,31749762,65539730,33789968,CN
chr14,Bn54361,7535706,74338549,66802843,RLK
chr14,Bn54362,25998387,26763287,764900,RLP
chr14,Bn54363,47868583,50563007,2694424,RLP
chr14,Bn54364,19199386,65610859,46411473,RLP
chr14,Bn54365,22209810,46687387,24477577,CNL
chr14,Bn54366,13119409,21218297,8098888,NBS
chr14,Bn54367,9988548,29903475,19914927,RLP
chr14,Bn54368,39863691,96806572,56942881,RLK
chr14,Bn54369,45482790,73885810,28403020,NBS
chr14,Bn54370,38706958,77450515,38743557,TN
chr14,Bn54371,10430004,63796013,53366009,NBS
chr14,Bn54372,46543618,67322249,20778631,CN
chr14,Bn54373,56723029,69396127,12673098,RLP
chr14,Bn54374,6718439,25452950,18734511,CN
chr14,Bn54375,98048929,99751379,1702450,RLK
chr14,Bn54376,97027823,97169373,141550,CN
chr14,Bn54377,76587788,90816356,14228568,NBS
chr14,Bn54378,42235806,66179916,23944110,RLP
chr14,Bn54379,40461451,94771744,54310293,CN
chr14,Bn54380,69116272,90633234,21516962,TNL
chr14,Bn54381,45407061,69913220,24506159,RLP
chr14,Bn54382,9149742,32889100,23739358,NBS
chr14,Bn54383,57170356,69459849,12289493,CNL
chr14,Bn54384,84035398,88899675,4864277,CNL
chr14,Bn54385,25489863,66149319,40659456,CNL
chr14,Bn54386,23807057,64818832,41011775,TN
chr14,Bn54387,51844432,93816715,41972283,CN
chr14,Bn54388,75340656,80389096,5048440,NBS
chr14,Bn54389,29428460,43950527,14522067,RLP
chr14,Bn54390,48201709,80573153,32371444,CN
chr14,Bn54391,85955901,88290852,2334951,NBS
chr14,Bn54392,73528873,74213656,684783,TN
chr14,Bn54393,58128025,77037592,18909567,CN
chr14,Bn54394,98231574,98941262,709688,TN
chr14,Bn54395,61606594,76698096,15091502,NBS
chr14,Bn54396,41677922,72507088,30829166,RLK
chr14,Bn54397,89578816,99699203,10120387,RLK
chr14,Bn54398,90259987,91523361,1263374,NBS
chr14,Bn54399,42120748,48276396,6155648,TN
chr14,Bn54400,93279859,95295053,2015194,RLK
chr14,Bn54401,99379837,99583128,203291,NBS
chr14,Bn54402,13331963,54813260,41481297,TN
chr14,Bn54403,67081367,81698381,14617014,RLK
chr14,Bn54404,58051899,60547219,2495320,CNL
chr14,Bn54405,40406460,41117173,710713,RLK
chr14,Bn54406,93048412,96483106,3434694,RLK
chr14,Bn54407,28284291,45791370,17507079,RLP
chr14,Bn54408,55495347,99292823,43797476,RLK
chr14,Bn54409,58140634,60525194,2384560,RLK
chr14,Bn54410,51928793,72863691,20934898,NBS
chr14,Bn54411,83280043,92888585,9608542,CN
chr14,Bn54412,82297593,89229652,6932059,TNL
chr14,Bn54413,34772152,92506314,57734162,RLK
chr14,Bn54414,1219404,57181937,55962533,RLK
chr14,Bn54415,36170464,37128970,958506,TNL
chr14,Bn54416,66761346,69673817,2912471,CN
chr14,Bn54417,20347113,83641264,63294151,NBS
chr14,Bn54418,12022070,78368015,66345945,TN
chr14,Bn54419,50763388,96369802,45606414,NBS
chr14,Bn54420,36761592,98295773,61534181,CNL
chr14,Bn54421,81946637,85683404,3736767,RLK
chr14,Bn54422,99144547,99499904,355357,TN
chr14,Bn54423,85010462,87743809,2733347,CNL
chr14,Bn54424,46163414,58934403,12770989,CNL
chr14,Bn54425,55310614,69794057,14483443,CN
chr14,Bn54426,5105421,11119169,6013748,NBS
chr14,Bn54427,94109182,98994281,4885099,RLP
chr14,Bn54428,67814309,70880184,3065875,TNL
chr14,Bn54429,40850160,41669367,819207,RLP
chr14,Bn54430,27217065,76027605,48810540,RLP
chr14,Bn54431,69515141,77748106,8232965,RLK
chr14,Bn54432,85731896,99108596,13376700,TNL
chr14,Bn54433,4464019,91272223,86808204,RLK
chr14,Bn54434,75150506,92936134,17785628,RLK
chr14,Bn54435,17143500,39415555,22272055,CNL
chr14,Bn54436,21392925,26316474,4923549,CNL
chr14,Bn54437,42807925,84072372,41264447,TNL
chr14,Bn54438,40066447,44990893,4924446,CN
chr14,Bn54439,65712925,73967414,8254489,RLP
chr14,Bn54440,65331428,90044430,24713002,RLP
chr14,Bn54441,76420569,80989967,4569398,NBS
chr14,Bn54442,16557887,49434339,32876452,CNL
chr14,Bn54443,96433663,98142312,1708649,TN
chr14,Bn54444,3840431,37533438,33693007,RLP
chr14,Bn54445,71354772,90963708,19608936,TN
chr14,Bn54446,34173273,79587608,45414335,TN
chr14,Bn54447,55209774,80819411,25609637,TN
chr14,Bn54448,67501898,84236991,16735093,CN
chr14,Bn54449,31012589,66080222,35067633,RLK
chr14,Bn54450,49769330,79797622,30028292,TNL
chr14,Bn54451,68973228,81388263,12415035,TNL
chr14,Bn54452,26770147,62505846,35735699,TN
chr14,Bn54453,97452774,98768110,1315336,TNL
chr14,Bn54454,97257540,99768375,2510835,RLP
chr14,Bn54455,5265081,37403136,32138055,CNL
chr14,Bn54456,55223529,98023090,42799561,RLP
chr14,Bn54457,76832227,88797346,11965119,CNL
chr14,Bn54458,35091279,72895788,37804509,RLK
chr14,Bn54459,16668804,16977523,308719,NBS
chr14,Bn54460,83207849,95641008,12433159,CNL
chr14,Bn54461,1345060,75082457,73737397,TNL
chr14,Bn54462,25637739,57116125,31478386,TN
chr14,Bn54463,74514438,91009982,16495544,TN
chr14,Bn54464,52969609,99168169,46198560,RLP
chr14,Bn54465,5324433,86819218,81494785,NBS
chr14,Bn54466,31399378,98452049,67052671,TNL
chr14,Bn54467,77299308,89460269,12160961,RLP
chr14,Bn54468,75437820,92756333,17318513,TNL
chr14,Bn54469,76284216,92956347,16672131,TNL
chr14,Bn54470,17796099,58204364,40408265,TNL
chr14,Bn54471,19421261,31745719,12324458,NBS
chr14,Bn54472,41681825,56662896,14981071,NBS
chr14,Bn54473,20676131,45910712,25234581,RLK
chr14,Bn54474,93337229,95866482,2529253,CN
chr14,Bn54475,62912277,70105584,7193307,TN
chr14,Bn54476,36540774,99464199,62923425,TNL
chr14,Bn54477,75962936,87209933,11246997,TNL
chr14,Bn54478,31986943,59485968,27499025,TN
chr14,Bn54479,20000368,99774065,79773697,TN
chr14,Bn54480,70525991,91576027,21050036,NBS
chr14,Bn54481,89247991,91104536,1856545,CNL
chr14,Bn54482,16268434,28469541,12201107,TN
chr14,Bn54483,9603602,15475006,5871404,NBS
chr14,Bn54484,76458200,98013106,21554906,RLP
chr14,Bn54485,24006131,57243555,33237424,RLK
chr14,Bn54486,70636114,99865881,29229767,NBS
chr14,Bn54487,81888726,85779278,3890552,RLP
chr14,Bn54488,6801567,33609158,26807591,TNL
chr14,Bn54489,10608780,83299253,72690473,CN
chr14,Bn54490,95367101,95685726,318625,CNL
chr14,Bn54491,72946828,77006895,4060067,NBS
chr14,Bn54492,25142590,94571908,69429318,TNL
chr14,Bn54493,51667903,98792176,47124273,TN
chr14,Bn54494,6332978,91301886,84968908,TNL
chr14,Bn54495,24639675,97021092,72381417,RLK
chr14,Bn54496,41523379,46536275,5012896,NBS
chr14,Bn54497,76548277,91489278,14941001,TNL
chr14,Bn54498,56193681,88659860,32466179,CN
chr14,Bn54499,29369160,80106890,50737730,CNL
chr14,Bn54500,15798578,42382684,26584106,TNL
chr14,Bn54501,40078387,72683949,32605562,CNL
chr14,Bn54502,45904336,59188441,13284105,CN
chr14,Bn54503,40155671,59584180,19428509,RLP
chr14,Bn54504,70463306,71882961,1419655,CNL
chr14,Bn54505,73398043,74564033,1165990,RLP
chr14,Bn54506,80451054,84116097,3665043,TN
chr14,Bn54507,51405436,92986871,41581435,RLK
chr14,Bn54508,15604234,41629910,26025676,TNL
chr14,Bn54509,89510354,90994719,1484365,TN
chr14,Bn54510,33458881,61254476,27795595,TNL
chr14,Bn54511,51334237,93786107,42451870,TN
chr14,Bn54512,46071204,52540203,6468999,RLK
chr14,Bn54513,44209926,95585237,51375311,NBS
chr14,Bn54514,57964443,77603841,19639398,RLP
chr14,Bn54515,23491963,85217389,61725426,CNL
chr14,Bn54516,46124538,53965043,7840505,TN
chr14,Bn54517,23007328,69216747,46209419,TN
chr14,Bn54518,44034137,78800603,34766466,CN
chr14,Bn54519,17076470,51769131,34692661,RLP
chr14,Bn54520,39983740,42418047,2434307,NBS
chr14,Bn54521,39268450,87446088,48177638,TN
chr14,Bn54522,54032050,99808291,45776241,NBS
chr14,Bn54523,33979171,38614152,4634981,TN
chr14,Bn54524,65614510,80137637,14523127,NBS
chr14,Bn54525,22509025,33313177,10804152,RLP
chr14,Bn54526,60210750,95818491,35607741,CN
chr14,Bn54527,4973859,59848218,54874359,CNL
chr14,Bn54528,48194167,70809038,22614871,TN
chr14,Bn54529,28807518,48365587,19558069,RLK
chr14,Bn54530,57946525,76967673,19021148,RLP
chr14,Bn54531,91371788,98108419,6736631,RLP
chr14,Bn54532,33494302,50636897,17142595,CNL
chr14,Bn54533,27539374,77345211,49805837,CN
chr14,Bn54534,96871349,98033152,1161803,CN
chr14,Bn54535,47550723,55041297,7490574,RLK
chr14,Bn54536,88025888,90708653,2682765,CN
chr14,Bn54537,36381046,54022389,17641343,RLP
chr14,Bn54538,8413042,34869127,26456085,NBS
chr14,Bn54539,45220756,54918613,9697857,RLP
chr14,Bn54540,89848099,94340965,4492866,NBS
chr14,Bn54541,32151705,74141809,41990104,TN
chr14,Bn54542,83845262,93262362,9417100,CN
chr14,Bn54543,77679091,85754090,8074999,CNL
chr14,Bn54544,81416686,98858416,17441730,TNL
chr14,Bn54545,39883360,64356134,24472774,RLP
chr14,Bn54546,88388092,92224176,3836084,RLK
chr14,Bn54547,51311044,78598860,27287816,RLK
chr14,Bn54548,69880622,71990705,2110083,TNL
chr14,Bn54549,78928542,79336613,408071,TNL
chr14,Bn54550,55543512,72306265,16762753,RLK
chr14,Bn54551,10033562,51481146,41447584,RLK
chr14,Bn54552,86161710,87654267,1492557,TNL
chr14,Bn54553,93404889,97938083,4533194,CN
chr14,Bn54554,25868275,67413713,41545438,CNL
chr14,Bn54555,26728308,66552085,39823777,TNL
chr14,Bn54556,54922237,63561430,8639193,NBS
chr14,Bn54557,32409576,40566345,8156769,RLK
chr14,Bn54558,84280112,89090285,4810173,CNL
chr14,Bn54559,81876727,87486338,5609611,CNL
chr14,Bn54560,41319683,58831294,17511611,TN
chr14,Bn54561,53199829,79827325,26627496,TN
chr14,Bn54562,12363686,23529149,11165463,TNL
chr14,Bn54563,58425066,82058195,23633129,CN
chr14,Bn54564,48183553,95115915,46932362,CN
chr14,Bn54565,93641665,97510256,3868591,TNL
chr14,Bn54566,3624047,13406063,9782016,CNL
chr14,Bn54567,10968873,72415522,61446649,CNL
chr14,Bn54568,52323400,78344345,26020945,RLK
chr14,Bn54569,61576393,96011203,34434810,TN
chr14,Bn54570,15586712,64283412,48696700,RLK
chr14,Bn54571,29240592,32904226,3663634,CNL
chr14,Bn54572,79400186,86868175,7467989,RLP
chr14,Bn54573,77193086,87692303,10499217,RLK
chr14,Bn54574,19772412,50496266,30723854,RLK
chr14,Bn54575,96317640,99935716,3618076,RLK
chr14,Bn54576,89191302,93265557,4074255,TN
chr14,Bn54577,52069525,81320296,29250771,CN
chr14,Bn54578,34136370,44439935,10303565,CN
chr14,Bn54579,27011520,49824618,22813098,RLK
chr14,Bn54580,66596621,68544125,1947504,CN
chr14,Bn54581,68551283,69062007,510724,CN
chr14,Bn54582,59313285,78046574,18733289,RLP
chr14,Bn54583,9873555,57075888,47202333,TN
chr14,Bn54584,65480319,91553498,26073179,CN
chr14,Bn54585,47950948,64103102,16152154,NBS
chr14,Bn54586,95797842,99729352,3931510,RLK
chr14,Bn54587,38113364,83129948,45016584,RLP
chr14,Bn54588,35724802,94935111,59210309,RLP
chr14,Bn54589,13169679,40201187,27031508,TNL
chr14,Bn54590,35558137,81844109,46285972,RLK
chr14,Bn54591,4527952,56838498,52310546,NBS
chr14,Bn54592,75736474,91828716,16092242,NBS
chr14,Bn54593,86334182,89454676,3120494,RLK
chr14,Bn54594,88659571,91253271,2593700,CN
chr14,Bn54595,84052060,85497690,1445630,TN
chr14,Bn54596,26484918,40088173,13603255,CNL
chr14,Bn54597,12649434,92232005,79582571,NBS
chr14,Bn54598,7665124,65447019,57781895,RLP
chr14,Bn54599,88918428,90672612,1754184,TN
chr14,Bn54600,57558434,92521472,34963038,TNL
chr14,Bn54601,20973714,59452502,38478788,RLP
chr14,Bn54602,8012534,23726697,15714163,TNL
chr14,Bn54603,51818461,58808967,6990506,TN
chr14,Bn54604,80818798,99413573,18594775,NBS
chr14,Bn54605,68986720,87274328,18287608,CNL
chr14,Bn54606,77731519,83373449,5641930,TNL
chr14,Bn54607,95304238,99973127,4668889,TN
chr14,Bn54608,1729577,58607213,56877636,CN
chr14,Bn54609,42615289,80359878,37744589,TNL
chr14,Bn54610,18733040,72384749,53651709,TN
chr14,Bn54611,48039926,89132885,41092959,TN
chr14,Bn54612,37292016,75764162,38472146,CN
chr14,Bn54613,31521183,56986171,25464988,RLK
chr14,Bn54614,21068326,94899070,73830744,TNL
chr14,Bn54615,78298778,98374322,20075544,NBS
chr14,Bn54616,29227257,67174588,37947331,CN
chr14,Bn54617,14030670,22118117,8087447,CNL
chr14,Bn54618,26091847,98107016,72015169,TN
chr14,Bn54619,28284490,86219460,57934970,RLK
chr14,Bn54620,26142634,83291554,57148920,TN
chr14,Bn54621,59099280,82606044,23506764,CNL
chr14,Bn54622,26402224,35409371,9007147,NBS
chr14,Bn54623,56590321,76094618,19504297,RLK
chr14,Bn54624,70806823,85520556,14713733,CNL
chr14,Bn54625,70441226,97295197,26853971,RLK
chr14,Bn54626,53108475,70824757,17716282,CN
chr14,Bn54627,9692627,14090530,4397903,RLP
chr14,Bn54628,63810762,78456761,14645999,RLK
chr14,Bn54629,18542901,48365225,29822324,TN
chr14,Bn54630,71310992,92792100,21481108,RLK
chr14,Bn54631,23148247,63423689,40275442,RLP
chr14,Bn54632,82843347,83208146,364799,CNL
chr14,Bn54633,42798033,93634025,50835992,TNL
chr14,Bn54634,73621064,76967041,3345977,CN
chr14,Bn54635,34383098,84746222,50363124,TN
chr14,Bn54636,91340566,99844350,8503784,CNL
chr14,Bn54637,54027335,80309121,26281786,RLP
chr14,Bn54638,58269561,88313923,30044362,TN
chr14,Bn54639,66143658,73397646,7253988,CN
chr14,Bn54640,28449712,78304728,49855016,RLK
chr14,Bn54641,28896741,85058400,56161659,CNL
chr14,Bn54642,70364005,85214246,14850241,NBS
chr14,Bn54643,4341213,9416140,5074927,TNL
chr14,Bn54644,47509187,50188930,2679743,CNL
chr14,Bn54645,78581843,94991015,16409172,NBS
chr14,Bn54646,78164343,94557583,16393240,NBS
chr14,Bn54647,75275836,96750241,21474405,RLP
chr14,Bn54648,20558082,65821911,45263829,RLK
chr14,Bn54649,92607907,94114571,1506664,RLK
chr14,Bn54650,82082762,82325516,242754,TN
chr14,Bn54651,9668177,35157532,25489355,CNL
chr14,Bn54652,66180263,69301908,3121645,RLP
chr14,Bn54653,78765767,96629349,17863582,TNL
chr14,Bn54654,25446212,41526567,16080355,TN
chr14,Bn54655,66049927,80618449,14568522,TN
chr14,Bn54656,36545278,68864876,32319598,CN
chr14,Bn54657,14842752,59705844,44863092,NBS
chr14,Bn54658,43899893,80134381,36234488,CN
chr14,Bn54659,33567192,82059657,48492465,TNL
chr14,Bn54660,39941891,98609625,58667734,RLP
chr14,Bn54661,45905557,47483059,1577502,TN
chr14,Bn54662,79859681,87321849,7462168,NBS
chr14,Bn54663,99856115,99940353,84238,NBS
chr14,Bn54664,76662542,89164877,12502335,CNL
chr14,Bn54665,11526238,98666623,87140385,NBS
chr14,Bn54666,42435030,51454672,9019642,RLP
chr14,Bn54667,35255197,86677817,51422620,TNL
chr14,Bn54668,9437447,34513854,25076407,NBS
chr14,Bn54669,63731942,93241794,29509852,RLK
chr14,Bn54670,93887426,97098786,3211360,RLP
chr14,Bn54671,27839207,72857068,45017861,NBS
chr14,Bn54672,86809925,86981537,171612,NBS
chr14,Bn54673,53076538,91512561,38436023,TNL
chr14,Bn54674,98609899,99936089,1326190,RLP
chr14,Bn54675,8755152,23664138,14908986,TN
chr14,Bn54676,15325042,77092724,61767682,NBS
chr14,Bn54677,75503912,97329096,21825184,RLK
chr14,Bn54678,54272139,99183700,44911561,CN
chr14,Bn54679,17739528,23815108,6075580,CNL
chr14,Bn54680,51272057,99124299,47852242,TNL
chr14,Bn54681,3556449,37117562,33561113,RLP
chr14,Bn54682,17357161,37369626,20012465,CNL
chr14,Bn54683,42689805,85423543,42733738,RLK
chr14,Bn54684,76406184,98854212,22448028,CNL
chr14,Bn54685,52890769,75922389,23031620,TNL
chr14,Bn54686,74564213,86264206,11699993,TN
chr14,Bn54687,53581437,73761031,20179594,NBS
chr14,Bn54688,69853941,77239337,7385396,CN
chr14,Bn54689,88770717,95841820,7071103,TN
chr14,Bn54690,15751812,63889406,48137594,CN
chr14,Bn54691,50255653,76522174,26266521,CNL
chr14,Bn54692,12542290,95682398,83140108,TNL
chr14,Bn54693,9858797,28883401,19024604,RLK
chr14,Bn54694,48272194,84606272,36334078,RLP
chr14,Bn54695,16215522,34435310,18219788,RLP
chr14,Bn54696,33673481,87841645,54168164,CN
chr14,Bn54697,89441560,94572053,5130493,RLK
chr14,Bn54698,65755539,81188267,15432728,RLP
chr14,Bn54699,43189629,71244464,28054835,TN
chr14,Bn54700,20012266,54426753,34414487,RLK
chr14,Bn54701,38812983,90418307,51605324,TN
chr14,Bn54702,58556418,85334701,26778283,CNL
chr14,Bn54703,40749818,72001147,31251329,TNL
chr14,Bn54704,95830064,97200906,1370842,TNL
chr14,Bn54705,28848252,66793175,37944923,CN
chr14,Bn54706,62355756,73113624,10757868,CN
chr14,Bn54707,18574495,32511593,13937098,CN
chr14,Bn54708,10480634,63606958,53126324,CN
chr14,Bn54709,6291265,83958608,77667343,TN
chr14,Bn54710,65357838,67108202,1750364,CNL
chr14,Bn54711,66880625,76236680,9356055,CNL
chr14,Bn54712,9861057,92924771,83063714,CN
chr14,Bn54713,43842718,83059536,39216818,RLP
chr14,Bn54714,40705846,51425275,10719429,RLK
chr14,Bn54715,46614658,88250761,41636103,RLK
chr14,Bn54716,19863599,24769451,4905852,CNL
chr14,Bn54717,49455600,89299986,39844386,CN
chr14,Bn54718,16703486,71971646,55268160,TN
chr14,Bn54719,61260073,79576578,18316505,NBS
chr14,Bn54720,55062814,77950329,22887515,CN
chr14,Bn54721,42182581,67819357,25636776,CN
chr14,Bn54722,70919532,86216978,15297446,TN
chr14,Bn54723,77946071,92495932,14549861,TN
chr14,Bn54724,85230330,98283246,13052916,TN
chr14,Bn54725,33752900,71949901,38197001,RLK
chr14,Bn54726,20213140,25102127,4888987,TN
chr14,Bn54727,47437342,50167306,2729964,CN
chr14,Bn54728,33259056,79076210,45817154,RLP
chr14,Bn54729,85153815,85665696,511881,TNL
chr14,Bn54730,72728881,77875123,5146242,RLP
chr14,Bn54731,60521152,68171522,7650370,TNL
chr14,Bn54732,19808739,33204349,13395610,TNL
chr14,Bn54733,24044745,84089762,60045017,RLP
chr14,Bn54734,7117885,98347586,91229701,TN
chr14,Bn54735,9255630,23955863,14700233,TNL
chr14,Bn54736,39753247,48611445,8858198,RLK
chr14,Bn54737,15776513,85845809,70069296,CN
chr14,Bn54738,71555445,94549797,22994352,NBS
chr14,Bn54739,86794098,99408516,12614418,TN
chr14,Bn54740,33852839,53806548,19953709,CN
chr14,Bn54741,15170952,86024544,70853592,TNL
chr14,Bn54742,61503460,81868792,20365332,RLK
chr14,Bn54743,81396018,83881708,2485690,RLP
chr14,Bn54744,17299025,96659844,79360819,NBS
chr14,Bn54745,57647818,97831771,40183953,TNL
chr14,Bn54746,58574879,98677072,40102193,TNL
chr14,Bn54747,88027641,91643698,3616057,NBS
chr14,Bn54748,31380391,76624625,45244234,NBS
chr14,Bn54749,93247208,93376051,128843,CN
chr14,Bn54750,89350793,97078543,7727750,RLP
chr14,Bn54751,24675551,34581554,9906003,RLP
chr14,Bn54752,51759112,76049907,24290795,TN
chr14,Bn54753,89161925,98365614,9203689,RLP
chr14,Bn54754,46231200,52796469,6565269,CN
chr14,Bn54755,69772401,77272586,7500185,RLP
chr14,Bn54756,18770145,77878923,59108778,RLP
chr14,Bn54757,91483256,98729815,7246559,RLP
chr14,Bn54758,36439242,58744081,22304839,CNL
chr14,Bn54759,26714994,28290145,1575151,RLK
chr14,Bn54760,52729536,86936363,34206827,RLK
chr14,Bn54761,23225796,59304346,36078550,RLK
chr14,Bn54762,23685047,26528565,2843518,TNL
chr14,Bn54763,89837591,94375494,4537903,CN
chr14,Bn54764,15176784,22264598,7087814,CN
chr14,Bn54765,36461344,59462299,23000955,RLK
chr14,Bn54766,14270220,83111194,68840974,CN
chr14,Bn54767,89322886,91710110,2387224,NBS
chr14,Bn54768,27949075,67952527,40003452,TNL
chr14,Bn54769,2085282,64549888,62464606,CNL
chr14,Bn54770,86957794,98248744,11290950,CNL
chr14,Bn54771,17077618,92639616,75561998,CN
chr14,Bn54772,10240460,47288438,37047978,RLK
chr14,Bn54773,63647909,96688339,33040430,RLK
chr14,Bn54774,87862300,90513782,2651482,CN
chr14,Bn54775,92278238,95388469,3110231,RLK
chr14,Bn54776,30657225,35079355,4422130,RLK
chr14,Bn54777,67935403,93212417,25277014,CN
chr14,Bn54778,46205585,89549193,43343608,RLK
chr14,Bn54779,78354771,83101830,4747059,TNL
chr14,Bn54780,36270225,38386222,2115997,RLP
chr14,Bn54781,58492591,99110123,40617532,RLK
chr14,Bn54782,13792868,89895748,76102880,CNL
chr14,Bn54783,22504589,71764911,49260322,RLP
chr14,Bn54784,23510547,49151666,25641119,CNL
chr14,Bn54785,94789906,97831585,3041679,CNL
chr14,Bn54786,26084194,68848250,42764056,TN
chr14,Bn54787,63813739,86876047,23062308,RLK
chr14,Bn54788,90560877,94824640,4263763,NBS
chr14,Bn54789,65314767,66102590,787823,RLP
chr14,Bn54790,4681933,11421853,6739920,CNL
chr14,Bn54791,62120863,77733763,15612900,CN
chr14,Bn54792,22126220,61370458,39244238,RLP
chr14,Bn54793,92827074,95107797,2280723,TN
chr14,Bn54794,20496497,76905584,56409087,CN
chr14,Bn54795,54757239,55880644,1123405,NBS
chr14,Bn54796,69035792,98371721,29335929,RLP
chr14,Bn54797,22764159,97122668,74358509,NBS
chr14,Bn54798,19519632,94710704,75191072,TN
chr14,Bn54799,9505912,54068556,44562644,NBS
chr14,Bn54800,15833912,56811210,40977298,CNL
chr14,Bn54801,30146912,90428201,60281289,NBS
chr14,Bn54802,84835319,85448289,612970,RLP
chr14,Bn54803,62922659,96334518,33411859,TN
chr14,Bn54804,66955593,75910249,8954656,TNL
chr14,Bn54805,82037033,87077774,5040741,RLK
chr14,Bn54806,25092812,84142302,59049490,TN
chr14,Bn54807,51915795,90181120,38265325,TN
chr14,Bn54808,26789921,61268715,34478794,RLK
chr14,Bn54809,47124623,85147628,38023005,RLK
chr14,Bn54810,43135820,85154735,42018915,TNL
chr14,Bn54811,44799530,62938783,18139253,RLP
chr14,Bn54812,38089880,70937402,32847522,CNL
chr14,Bn54813,71061744,93495807,22434063,NBS
chr14,Bn54814,37485666,99030492,61544826,TNL
chr14,Bn54815,77057464,90255186,13197722,CNL
chr14,Bn54816,58014880,88172713,30157833,CNL
chr14,Bn54817,20317201,65462346,45145145,RLP
chr14,Bn54818,94472930,97606132,3133202,CN
chr14,Bn54819,21015962,59673773,38657811,NBS
chr14,Bn54820,31938347,95770273,63831926,NBS
chr14,Bn54821,96917092,99783315,2866223,RLP
chr14,Bn54822,96182329,97207171,1024842,RLK
chr14,Bn54823,29642607,45557499,15914892,CN
chr14,Bn54824,69172638,86766559,17593921,NBS
chr14,Bn54825,67486466,92231083,24744617,CNL
chr14,Bn54826,7156582,28742590,21586008,RLP
chr14,Bn54827,50171547,76792584,26621037,TNL
chr14,Bn54828,78894081,85966780,7072699,RLK
chr14,Bn54829,88933611,97982973,9049362,TNL
chr14,Bn54830,60585690,79051091,18465401,RLP
chr14,Bn54831,42258834,87088653,44829819,RLP
chr14,Bn54832,39140879,42582362,3441483,CNL
chr14,Bn54833,87177916,88898648,1720732,RLK
chr14,Bn54834,19307510,27897214,8589704,NBS
chr14,Bn54835,79072544,85789372,6716828,CN
chr14,Bn54836,80095919,83606457,3510538,RLP
chr14,Bn54837,4450016,53805964,49355948,CNL
chr14,Bn54838,62649963,85819704,23169741,NBS
chr14,Bn54839,30896918,92513930,61617012,TNL
chr14,Bn54840,84192108,93469661,9277553,TNL
chr14,Bn54841,67537409,76701581,9164172,RLK
chr14,Bn54842,39945622,51984137,12038515,TNL
chr14,Bn54843,74819051,98346299,23527248,CN
chr14,Bn54844,13398575,53839666,40441091,RLK
chr14,Bn54845,20440991,45301669,24860678,RLP
chr14,Bn54846,65340061,86668442,21328381,RLP
chr14,Bn54847,65826481,94738787,28912306,RLP
chr14,Bn54848,13574335,56407336,42833001,RLP
chr14,Bn54849,97835435,98188087,352652,TNL
chr14,Bn54850,18888216,74553579,55665363,NBS
chr14,Bn54851,52495635,97594373,45098738,CN
chr14,Bn54852,50565810,75037175,24471365,RLP
chr14,Bn54853,74587205,77515667,2928462,TNL
chr14,Bn54854,1318769,19601592,18282823,RLP
chr14,Bn54855,99699208,99749855,50647,TN
chr14,Bn54856,89938382,94060356,4121974,TNL
chr14,Bn54857,1207442,77228972,76021530,TN
chr14,Bn54858,97270232,98774082,1503850,CNL
chr14,Bn54859,35562520,44599511,9036991,TN
chr14,Bn54860,78485443,92942886,14457443,RLK
chr14,Bn54861,8905397,34687134,25781737,RLK
chr14,Bn54862,41590917,65396483,23805566,TN
chr14,Bn54863,36223837,41897268,5673431,NBS
chr14,Bn54864,18241931,45237826,26995895,CN
chr14,Bn54865,41214292,67232413,26018121,NBS
chr14,Bn54866,70931439,83619270,12687831,CN
chr14,Bn54867,17609356,96924237,79314881,NBS
chr14,Bn54868,62730570,94245780,31515210,NBS
chr14,Bn54869,83000214,90667784,7667570,CNL
chr14,Bn54870,91746507,95581015,3834508,CN
chr14,Bn54871,5487497,83541020,78053523,NBS
chr14,Bn54872,54339897,78606553,24266656,TNL
chr14,Bn54873,31251149,88249191,56998042,RLP
chr14,Bn54874,41701537,51800145,10098608,TN
chr14,Bn54875,83879112,87313459,3434347,CN
chr14,Bn54876,28031718,83983398,55951680,TN
chr14,Bn54877,63306503,67968141,4661638,RLK
chr14,Bn54878,21790848,29731050,7940202,CN
chr14,Bn54879,91721809,98019728,6297919,TNL
chr14,Bn54880,24610442,54250766,29640324,TN
chr14,Bn54881,66174121,77646659,11472538,RLP
chr14,Bn54882,9804534,48862731,39058197,CNL
chr14,Bn54883,84675009,86841628,2166619,TNL
chr14,Bn54884,46190647,89952494,43761847,CN
chr14,Bn54885,87932764,88774873,842109,CN
chr14,Bn54886,19529852,39500185,19970333,CN
chr14,Bn54887,94065952,99910059,5844107,TN
chr14,Bn54888,36023026,42569510,6546484,NBS
chr14,Bn54889,44068074,81214567,37146493,RLK
chr14,Bn54890,29878105,76216967,46338862,NBS
chr14,Bn54891,64317872,86618997,22301125,CN
chr14,Bn54892,94147838,97251880,3104042,CNL
chr14,Bn54893,32125035,75736946,43611911,TNL
chr14,Bn54894,52046976,75075851,23028875,CN
chr14,Bn54895,70330022,95296994,24966972,NBS
chr14,Bn54896,51653910,60932048,9278138,TN
chr14,Bn54897,46545178,68834144,22288966,TN
chr14,Bn54898,3197347,25822177,22624830,NBS
chr14,Bn54899,47072043,51057245,3985202,CN
chr14,Bn54900,15062853,49739452,34676599,RLP
chr14,Bn54901,4245927,72955506,68709579,RLK
chr14,Bn54902,64759551,86965841,22206290,NBS
chr14,Bn54903,59573297,65250292,5676995,TNL
chr14,Bn54904,24514186,56515928,32001742,CNL
chr14,Bn54905,34224080,61250872,27026792,RLP
chr14,Bn54906,20952631,78366612,57413981,NBS
chr14,Bn54907,22600312,58475335,35875023,RLP
chr14,Bn54908,90339464,99164765,8825301,CNL
chr14,Bn54909,88210182,98257709,10047527,RLK
chr14,Bn54910,27439069,33041604,5602535,NBS
chr14,Bn54911,69211021,76444874,7233853,RLP
chr14,Bn54912,60410088,62031545,1621457,RLP
chr14,Bn54913,53890592,99645411,45754819,TNL
chr14,Bn54914,30994488,61771029,30776541,RLP
chr14,Bn54915,53688636,96431251,42742615,CNL
chr14,Bn54916,13399880,92323799,78923919,RLP
chr14,Bn54917,70734544,74566651,3832107,NBS
chr14,Bn54918,59445487,79556839,20111352,RLK
chr14,Bn54919,61473984,83507418,22033434,TNL
chr14,Bn54920,16100620,47057865,30957245,CN
chr14,Bn54921,39610778,69809312,30198534,TN
chr14,Bn54922,94933183,95622279,689096,RLK
chr14,Bn54923,85258253,94578683,9320430,CNL
chr14,Bn54924,26341103,82146848,55805745,CNL
chr14,Bn54925,90348546,96758320,6409774,CN
chr14,Bn54926,6930863,71924052,64993189,RLK
chr14,Bn54927,61265855,64125902,2860047,TNL
chr14,Bn54928,15219658,86202990,70983332,TNL
chr14,Bn54929,36793346,88781614,51988268,RLK
chr14,Bn54930,81209407,98234607,17025200,NBS
chr14,Bn54931,51102879,98651857,47548978,TN
chr14,Bn54932,40241819,52151094,11909275,NBS
chr14,Bn54933,59969156,86101611,26132455,RLP
chr14,Bn54934,41622046,71441918,29819872,RLP
chr14,Bn54935,72502089,91728157,19226068,CNL
chr14,Bn54936,45375725,99763616,54387891,TNL
chr14,Bn54937,41903642,68513562,26609920,NBS
chr14,Bn54938,35111110,73423259,38312149,TNL
chr14,Bn54939,97394951,99342608,1947657,CN
chr14,Bn54940,84594911,95389928,10795017,CN
chr14,Bn54941,85184537,98475447,13290910,CNL
chr14,Bn54942,42474570,92611895,50137325,TNL
chr14,Bn54943,58503335,60041792,1538457,RLP
chr14,Bn54944,95815330,96576026,760696,TNL
chr14,Bn54945,1804344,40881348,39077004,RLK
chr14,Bn54946,66214221,70092007,3877786,CNL
chr14,Bn54947,10880572,32102639,21222067,TNL
chr14,Bn54948,20083672,49254958,29171286,CN
chr14,Bn54949,5627723,57019029,51391306,TN
chr14,Bn54950,69859716,79934681,10074965,NBS
chr14,Bn54951,3349573,77984353,74634780,RLK
chr14,Bn54952,97135327,99577274,2441947,NBS
chr14,Bn54953,78918557,99154649,20236092,NBS
chr14,Bn54954,29906078,93995628,64089550,CN
chr14,Bn54955,78492367,97808145,19315778,TN
chr14,Bn54956,7379729,14181989,6802260,RLK
chr14,Bn54957,92910899,93855370,944471,NBS
chr14,Bn54958,78664875,87130323,8465448,CNL
chr14,Bn54959,78601765,86110579,7508814,CNL
chr14,Bn54960,85003784,87816470,2812686,NBS
chr14,Bn54961,8261613,61918796,53657183,TN
chr14,Bn54962,22281738,64861218,42579480,CNL
chr14,Bn54963,27265582,74239576,46973994,TNL
chr14,Bn54964,54125369,96486374,42361005,CNL
chr14,Bn54965,96983308,99963791,2980483,CNL
chr14,Bn54966,2543006,14682931,12139925,TNL
chr14,Bn54967,14901847,84833420,69931573,CNL
chr14,Bn54968,88219666,91182244,2962578,CN
chr14,Bn54969,35076042,84359131,49283089,NBS
chr14,Bn54970,42004180,91244419,49240239,NBS
chr14,Bn54971,70801937,76934978,6133041,TN
chr14,Bn54972,76265276,96483355,20218079,RLP
chr14,Bn54973,85062942,90287654,5224712,NBS
chr14,Bn54974,94390913,94996065,605152,NBS
chr14,Bn54975,31077543,80254523,49176980,TN
chr14,Bn54976,88022901,90777215,2754314,CN
chr14,Bn54977,61684341,79918268,18233927,NBS
chr14,Bn54978,84120517,99016138,14895621,TNL
chr14,Bn54979,14582499,91177306,76594807,RLK
chr14,Bn54980,49790811,61625350,11834539,CNL
chr14,Bn54981,47029029,74853596,27824567,NBS
chr14,Bn54982,55833066,66538502,10705436,RLK
chr14,Bn54983,4402534,32473439,28070905,TN
chr14,Bn54984,45644051,65725715,20081664,NBS
chr14,Bn54985,64708751,81666891,16958140,RLK
chr14,Bn54986,6391229,7184713,793484,RLK
chr14,Bn54987,80239721,95976143,15736422,TN
chr14,Bn54988,88184669,98808744,10624075,RLP
chr14,Bn54989,23103820,62270101,39166281,CNL
chr14,Bn54990,25763065,56020657,30257592,RLK
chr14,Bn54991,58778593,95853199,37074606,CNL
chr14,Bn54992,86057718,86955019,897301,NBS
chr14,Bn54993,37131419,56402281,19270862,RLK
chr14,Bn54994,95862354,98432089,2569735,RLK
chr14,Bn54995,89876149,97789939,7913790,TN
chr14,Bn54996,93172679,93298917,126238,RLP
chr14,Bn54997,29249537,31990296,2740759,CN
chr14,Bn54998,55715795,70650305,14934510,NBS
chr14,Bn54999,53815571,69248259,15432688,NBS
chr14,Bn55000,57842531,77403232,19560701,NBS
chr14,Bn55001,16854456,84090138,67235682,RLP
chr14,Bn55002,42591652,75282276,32690624,TNL
chr14,Bn55003,97743716,98986954,1243238,RLP
chr14,Bn55004,80830079,89331501,8501422,TNL
chr14,Bn55005,80499527,81419065,919538,TNL
chr14,Bn55006,81854736,87386763,5532027,NBS
chr14,Bn55007,43445450,45667177,2221727,TNL
chr14,Bn55008,59886180,62493890,2607710,RLK
chr14,Bn55009,68898686,95029251,26130565,TNL
chr14,Bn55010,35764859,98687794,62922935,RLK
chr14,Bn55011,58136201,98542393,40406192,TNL
chr14,Bn55012,65694948,77048958,11354010,CN
chr14,Bn55013,92203717,97941920,5738203,CNL
chr14,Bn55014,70526866,84195454,13668588,RLP
chr14,Bn55015,62134891,90068889,27933998,RLP
chr14,Bn55016,73373357,96934740,23561383,TNL
chr14,Bn55017,43384082,54591478,11207396,CN
chr14,Bn55018,89784855,93966154,4181299,RLK
chr14,Bn55019,96438674,97968870,1530196,TNL
chr14,Bn55020,8064387,37197993,29133606,TN
chr14,Bn55021,52645089,74815343,22170254,RLK
chr14,Bn55022,93597154,93991684,394530,CN
chr14,Bn55023,18556081,77289278,58733197,RLP
chr14,Bn55024,5375805,79947310,74571505,RLP
chr14,Bn55025,14295627,60379082,46083455,NBS
chr14,Bn55026,21719192,38393186,16673994,TN
chr14,Bn55027,47257655,66265589,19007934,CN
chr14,Bn55028,89161040,92008063,2847023,TN
chr14,Bn55029,21699134,39965419,18266285,TNL
chr14,Bn55030,76214334,97170736,20956402,NBS
chr14,Bn55031,35894079,37222337,1328258,CNL
chr14,Bn55032,83715283,84314881,599598,TN
chr14,Bn55033,22113313,27206992,5093679,NBS
chr14,Bn55034,55897784,77472535,21574751,RLP
chr14,Bn55035,27473889,54840931,27367042,CN
chr14,Bn55036,96339291,97939508,1600217,CNL
chr14,Bn55037,97827571,99680182,1852611,TNL
chr14,Bn55038,78109033,91964766,13855733,NBS
chr14,Bn55039,4532302,77594630,73062328,RLK
chr14,Bn55040,17509333,88073054,70563721,CNL
chr14,Bn55041,55581857,67506248,11924391,CN
chr14,Bn55042,60047450,67919295,7871845,RLK
chr14,Bn55043,80101569,97405690,17304121,NBS
chr14,Bn55044,48913616,65286003,16372387,CN
chr14,Bn55045,23173879,58352360,35178481,CN
chr14,Bn55046,54130719,80174429,26043710,TNL
chr14,Bn55047,84206921,85002968,796047,CNL
chr14,Bn55048,35357461,82379342,47021881,CNL
chr14,Bn55049,91387281,96339131,4951850,TNL
chr14,Bn55050,30419995,87265563,56845568,NBS
chr14,Bn55051,9486320,49726734,40240414,TN
chr14,Bn55052,75268433,89625366,14356933,RLK
chr14,Bn55053,41965996,50894704,8928708,TN
chr14,Bn55054,16949351,76202203,59252852,CN
chr14,Bn55055,98585202,99579877,994675,CNL
chr14,Bn55056,34102656,61556862,27454206,NBS
chr14,Bn55057,94369189,97051060,2681871,CN
chr14,Bn55058,69990285,73985880,3995595,CN
chr14,Bn55059,91546583,95428528,3881945,NBS
chr14,Bn55060,76865369,96197402,19332033,RLP
chr14,Bn55061,68599518,75115315,6515797,CNL
chr14,Bn55062,77834087,89442543,11608456,NBS
chr14,Bn55063,73494303,76982327,3488024,TNL
chr14,Bn55064,79043449,89543973,10500524,RLP
chr14,Bn55065,71307227,96246252,24939025,RLK
chr14,Bn55066,3716324,33118056,29401732,TN
chr14,Bn55067,60509112,86795152,26286040,CNL
chr14,Bn55068,4813888,22124251,17310363,NBS
chr14,Bn55069,90308858,99869239,9560381,NBS
chr14,Bn55070,16828767,96921215,80092448,CNL
chr14,Bn55071,71341616,87993657,16652041,TNL
chr14,Bn55072,7370208,83197605,75827397,NBS
chr14,Bn55073,94515665,99454753,4939088,NBS
chr14,Bn55074,79008083,97092511,18084428,RLK
chr14,Bn55075,35179430,43609894,8430464,RLP
chr14,Bn55076,7106456,43659603,36553147,TN
chr14,Bn55077,48414614,77750920,29336306,CN
chr14,Bn55078,60131659,90911252,30779593,NBS
chr14,Bn55079,43241559,79071783,35830224,RLP
chr14,Bn55080,30013650,85319455,55305805,RLK
chr14,Bn55081,18523107,24424952,5901845,NBS
chr14,Bn55082,85409377,89589454,4180077,TNL
chr14,Bn55083,63514737,91240135,27725398,TN
chr14,Bn55084,60683080,73074059,12390979,NBS
chr14,Bn55085,34615583,37219112,2603529,TN
chr14,Bn55086,57989543,69934564,11945021,RLP
chr14,Bn55087,47769854,55747942,7978088,NBS
chr14,Bn55088,99718772,99809433,90661,CNL
chr14,Bn55089,85269662,89009572,3739910,TN
chr14,Bn55090,61738488,90093658,28355170,TNL
chr14,Bn55091,30409554,96809365,66399811,CNL
chr14,Bn55092,54475499,58490257,4014758,CNL
chr14,Bn55093,82859894,94500741,11640847,RLK
chr14,Bn55094,37042275,62539439,25497164,TN
chr14,Bn55095,44604082,73683288,29079206,CNL
chr14,Bn55096,92900810,96690511,3789701,TNL
chr14,Bn55097,26477256,70492956,44015700,TN
chr14,Bn55098,94322462,94443790,121328,RLP
chr14,Bn55099,94344328,95614108,1269780,RLK
chr14,Bn55100,84399457,97422672,13023215,CNL
chr14,Bn55101,65611378,71712207,6100829,RLP
chr14,Bn55102,97501718,98199483,697765,NBS
chr14,Bn55103,12737058,72790859,60053801,CN
chr14,Bn55104,28425835,92383548,63957713,RLP
chr14,Bn55105,14626646,68617247,53990601,TNL
chr14,Bn55106,67200714,80121586,12920872,RLK
chr14,Bn55107,47929829,74387964,26458135,CNL
chr14,Bn55108,46756693,76346208,29589515,NBS
chr14,Bn55109,58840120,78362812,19522692,TNL
chr14,Bn55110,63615908,77647027,14031119,TN
chr14,Bn55111,75453077,81347023,5893946,CN
chr14,Bn55112,41588141,97235275,55647134,TN
chr14,Bn55113,24914652,76134215,51219563,CNL
chr14,Bn55114,20341455,73735865,53394410,RLP
chr14,Bn55115,67086665,81509149,14422484,TN
chr14,Bn55116,62974216,91648024,28673808,NBS
chr14,Bn55117,49746214,93332597,43586383,NBS
chr14,Bn55118,27123632,81808872,54685240,RLP
chr14,Bn55119,7089034,59146374,52057340,CN
chr14,Bn55120,38295807,65896616,27600809,RLK
chr14,Bn55121,15725575,72950840,57225265,NBS
chr14,Bn55122,92849195,95093029,2243834,CN
chr14,Bn55123,79828941,80762755,933814,RLK
chr14,Bn55124,4264879,8671550,4406671,NBS
chr14,Bn55125,92413767,97263224,4849457,CN
chr14,Bn55126,98652509,99853449,1200940,RLP
chr14,Bn55127,12537784,53861363,41323579,TN
chr14,Bn55128,57232493,74604498,17372005,NBS
chr14,Bn55129,11612007,58194163,46582156,TNL
chr14,Bn55130,15300233,69096780,53796547,RLK
chr14,Bn55131,83825131,90324971,6499840,CN
chr14,Bn55132,38641251,41198247,2556996,RLP
chr14,Bn55133,37841857,91642469,53800612,CNL
chr14,Bn55134,15943263,39460696,23517433,CN
chr14,Bn55135,26894309,62976758,36082449,CN
chr14,Bn55136,64581935,96186737,31604802,CN
chr14,Bn55137,52027511,74165836,22138325,RLK
chr14,Bn55138,33872018,53347451,19475433,RLP
chr14,Bn55139,35983724,74567261,38583537,CNL
chr14,Bn55140,23490531,68345235,44854704,NBS
chr14,Bn55141,15910589,71800090,55889501,RLK
chr14,Bn55142,53364504,81444546,28080042,CNL
chr14,Bn55143,29043604,70665736,41622132,TN
chr14,Bn55144,42769823,60698509,17928686,TNL
chr14,Bn55145,60218224,87444512,27226288,TNL
chr14,Bn55146,53316869,74938372,21621503,CNL
chr14,Bn55147,50200186,56366767,6166581,RLK
chr14,Bn55148,22188631,99905297,77716666,TNL
chr14,Bn55149,21494951,25415709,3920758,CN
chr14,Bn55150,73954272,86873620,12919348,RLK
chr14,Bn55151,54487626,63107012,8619386,TN
chr14,Bn55152,60865815,71984108,11118293,TN
chr14,Bn55153,73673310,96522526,22849216,RLP
chr14,Bn55154,48696677,77290311,28593634,TN
chr14,Bn55155,47460336,97971320,50510984,TNL
chr14,Bn55156,76642105,80868830,4226725,CN
chr14,Bn55157,76644557,78533725,1889168,RLP
chr14,Bn55158,71446234,75909085,4462851,TN
chr14,Bn55159,12003803,77737359,65733556,CNL
chr14,Bn55160,30851069,78015556,47164487,CN
chr14,Bn55161,87300719,90693678,3392959,CN
chr14,Bn55162,84923746,94176154,9252408,RLP
chr14,Bn55163,89182633,93270317,4087684,CNL
chr14,Bn55164,48535474,54929450,6393976,RLP
chr14,Bn55165,96969312,97353763,384451,RLP
chr14,Bn55166,67507794,87771322,20263528,NBS
chr14,Bn55167,94534189,95437676,903487,CN
chr14,Bn55168,27186447,86629782,59443335,NBS
chr14,Bn55169,29218723,71394710,42175987,TN
chr14,Bn55170,59570551,90217679,30647128,NBS
chr14,Bn55171,73675252,81525518,7850266,TN
chr14,Bn55172,42007616,49825060,7817444,NBS
chr14,Bn55173,70020492,81153113,11132621,CN
chr14,Bn55174,50691292,75409738,24718446,RLK
chr14,Bn55175,51182618,93919164,42736546,NBS
chr14,Bn55176,98665618,99389443,723825,TNL
chr14,Bn55177,25115434,37037898,11922464,CN
chr14,Bn55178,98204680,99430060,1225380,RLK
chr14,Bn55179,38135345,99783931,61648586,CNL
chr14,Bn55180,40328706,49903625,9574919,NBS
chr14,Bn55181,50415602,56820588,6404986,TN
chr14,Bn55182,47780816,81669951,33889135,CN
chr14,Bn55183,31283047,59318900,28035853,CN
chr14,Bn55184,1024099,11078639,10054540,RLK
chr14,Bn55185,78270982,92169136,13898154,RLP
chr14,Bn55186,25738325,40101482,14363157,NBS
chr14,Bn55187,27119683,61398712,34279029,TN
chr14,Bn55188,49422977,95808531,46385554,RLK
chr14,Bn55189,78381319,80363317,1981998,TN
chr14,Bn55190,39298276,98666697,59368421,CN
chr14,Bn55191,33420669,65914575,32493906,TN
chr14,Bn55192,74126825,90712955,16586130,TN
chr14,Bn55193,22480164,47538573,25058409,RLP
chr14,Bn55194,70856060,79855304,8999244,TN
chr14,Bn55195,21615743,31093943,9478200,NBS
chr14,Bn55196,99288375,99705292,416917,CNL
chr14,Bn55197,74647452,93559116,18911664,TN
chr14,Bn55198,57688816,75049535,17360719,RLP
chr14,Bn55199,46441278,64741463,18300185,CN
chr14,Bn55200,92742718,93915007,1172289,RLK
chr14,Bn55201,14945741,22565046,7619305,NBS
chr14,Bn55202,97511350,99489766,1978416,RLP
chr14,Bn55203,66666728,78707609,12040881,CN
chr14,Bn55204,76243257,86787092,10543835,CNL
chr14,Bn55205,82519273,92239419,9720146,CN
chr14,Bn55206,49257269,73719221,24461952,TN
chr14,Bn55207,17199917,99650703,82450786,TN
chr14,Bn55208,29566509,52271834,22705325,NBS
chr14,Bn55209,29612954,46511148,16898194,CNL
chr14,Bn55210,38585465,92374483,53789018,RLP
chr14,Bn55211,6308941,79173490,72864549,CN
chr14,Bn55212,25444817,62624324,37179507,CNL
chr14,Bn55213,55576187,97623626,42047439,TN
chr14,Bn55214,51803129,86073176,34270047,RLK
chr14,Bn55215,79605493,91920962,12315469,CNL
chr14,Bn55216,63372487,64251587,879100,RLK
chr14,Bn55217,68016952,77066691,9049739,NBS
chr14,Bn55218,4269729,91734734,87465005,CNL
chr14,Bn55219,25439247,52842442,27403195,RLP
chr14,Bn55220,73197528,86480328,13282800,CN
chr14,Bn55221,24287713,24749526,461813,TNL
chr14,Bn55222,12338043,50841724,38503681,CN
chr14,Bn55223,10012362,37427527,27415165,TN
chr14,Bn55224,83030436,90858756,7828320,RLK
chr14,Bn55225,52757677,82946867,30189190,NBS
chr14,Bn55226,6976269,29930563,22954294,CN
chr14,Bn55227,51962311,75201574,23239263,CN
chr14,Bn55228,76974067,87889041,10914974,CN
chr14,Bn55229,75399853,81809131,6409278,TNL
chr14,Bn55230,74641416,83067625,8426209,TN
chr14,Bn55231,59595186,78613270,19018084,RLK
chr14,Bn55232,51722351,98369506,46647155,CNL
chr14,Bn55233,64285468,92675386,28389918,TNL
chr14,Bn55234,98586836,99334571,747735,NBS
chr14,Bn55235,10942302,14584784,3642482,RLK
chr14,Bn55236,86388747,88681725,2292978,RLK
chr14,Bn55237,79594089,87444152,7850063,NBS
chr14,Bn55238,69367736,76963494,7595758,CN
chr14,Bn55239,86513102,90684329,4171227,RLP
chr14,Bn55240,83587840,85622076,2034236,TN
chr14,Bn55241,65730812,68557348,2826536,TN
chr14,Bn55242,50739910,87853544,37113634,TNL
chr14,Bn55243,13091506,42635434,29543928,NBS
chr14,Bn55244,2006506,93078622,91072116,RLP
chr14,Bn55245,4156672,98804338,94647666,RLP
chr14,Bn55246,64871708,77380136,12508428,TNL
chr14,Bn55247,57320245,80819584,23499339,CNL
chr14,Bn55248,68695022,70717624,2022602,RLP
chr14,Bn55249,5330077,85816844,80486767,NBS
chr14,Bn55250,13399764,83456366,70056602,RLP
chr14,Bn55251,47151598,48475089,1323491,CN
chr14,Bn55252,19780735,28654680,8873945,RLP
chr14,Bn55253,71599416,85801771,14202355,RLP
chr14,Bn55254,8551109,25677053,17125944,RLK
chr14,Bn55255,5483036,93948510,88465474,TN
chr14,Bn55256,30773371,98717194,67943823,CN
chr14,Bn55257,41446812,57152354,15705542,NBS
chr14,Bn55258,13311410,71721121,58409711,RLP
chr14,Bn55259,43174193,51558431,8384238,RLK
chr14,Bn55260,52507371,86587689,34080318,TN
chr14,Bn55261,90302331,92970263,2667932,RLP
chr14,Bn55262,34586525,83954361,49367836,TNL
chr14,Bn55263,30161524,46571588,16410064,CNL
chr14,Bn55264,60312282,64219496,3907214,TNL
chr14,Bn55265,24314734,45578954,21264220,RLP
chr14,Bn55266,60281452,87812648,27531196,TNL
chr14,Bn55267,87966741,96529126,8562385,RLP
chr14,Bn55268,77968674,78666179,697505,RLK
chr14,Bn55269,42220989,76399369,34178380,RLP
chr14,Bn55270,69735690,86052355,16316665,RLP
chr14,Bn55271,84826810,89537651,4710841,CN
chr14,Bn55272,72208794,77362071,5153277,TN
chr14,Bn55273,59292395,81583490,22291095,RLP
chr14,Bn55274,89735222,92368572,2633350,RLP
chr14,Bn55275,49272980,85689030,36416050,NBS
chr14,Bn55276,40898019,87877473,46979454,RLP
chr14,Bn55277,20954233,48726875,27772642,NBS
chr14,Bn55278,53376771,66201376,12824605,TN
chr14,Bn55279,92470791,99633358,7162567,CN
chr14,Bn55280,53438442,91950568,38512126,TN
chr14,Bn55281,9132946,43709120,34576174,CNL
chr14,Bn55282,2628346,22721706,20093360,NBS
chr14,Bn55283,3423281,9416773,5993492,CN
chr14,Bn55284,64124914,75853588,11728674,CNL
chr14,Bn55285,62276161,92860692,30584531,NBS
chr14,Bn55286,69280835,85622639,16341804,RLK
chr14,Bn55287,76302037,93913738,17611701,NBS
chr14,Bn55288,9506931,67778704,58271773,CN
chr14,Bn55289,89339385,89382983,43598,TN
chr14,Bn55290,33709463,62043978,28334515,RLP
chr14,Bn55291,24180198,93914400,69734202,CNL
chr14,Bn55292,85637850,98101686,12463836,TN
chr14,Bn55293,59817885,84513884,24695999,RLK
chr14,Bn55294,64979254,99658076,34678822,TNL
chr14,Bn55295,63321868,78087900,14766032,NBS
chr14,Bn55296,80780744,86198457,5417713,TN
chr14,Bn55297,10308405,41806320,31497915,CNL
chr14,Bn55298,50799053,63329158,12530105,RLK
chr14,Bn55299,6318435,87128096,80809661,RLP
chr14,Bn55300,49299735,91920907,42621172,CNL
chr14,Bn55301,63740162,97858263,34118101,RLK
chr14,Bn55302,43528259,65703918,22175659,TNL
chr14,Bn55303,57109811,83458618,26348807,TNL
chr14,Bn55304,13773586,29602045,15828459,RLP
chr14,Bn55305,54080282,79127771,25047489,TNL
chr14,Bn55306,21350364,87411141,66060777,CN
chr14,Bn55307,63569194,84412653,20843459,TNL
chr14,Bn55308,80080457,82404162,2323705,RLK
chr14,Bn55309,30719409,38896135,8176726,NBS
chr14,Bn55310,67130045,98872152,31742107,TN
chr14,Bn55311,10542508,66608021,56065513,RLP
chr14,Bn55312,24145682,43664112,19518430,CN
chr14,Bn55313,37958473,67272824,29314351,TNL
chr14,Bn55314,30874884,97801675,66926791,TNL
chr14,Bn55315,37759542,94774886,57015344,RLP
chr14,Bn55316,37089364,94796082,57706718,RLP
chr14,Bn55317,65352760,91641308,26288548,CNL
chr14,Bn55318,48643583,80698083,32054500,RLK
chr14,Bn55319,17153094,32801546,15648452,CNL
chr14,Bn55320,18510311,64369118,45858807,RLK
chr14,Bn55321,53218146,67827423,14609277,TN
chr14,Bn55322,59290389,96483007,37192618,CN
chr14,Bn55323,22468839,64308464,41839625,CNL
chr14,Bn55324,85664716,89092170,3427454,NBS
chr14,Bn55325,66674677,76504187,9829510,CNL
chr14,Bn55326,42502438,55972877,13470439,TNL
chr14,Bn55327,55380114,67859246,12479132,RLP
chr14,Bn55328,22069646,40659688,18590042,RLP
chr14,Bn55329,62163719,98087516,35923797,RLP
chr14,Bn55330,9978751,89102151,79123400,NBS
chr14,Bn55331,7516742,31830067,24313325,CN
chr14,Bn55332,67886109,74404725,6518616,TN
chr14,Bn55333,18704514,71409202,52704688,CN
chr14,Bn55334,70421446,89673277,19251831,RLK
chr14,Bn55335,34266752,71926374,37659622,CNL
chr14,Bn55336,54062658,94809761,40747103,TNL
chr14,Bn55337,81727921,81794637,66716,CN
chr14,Bn55338,39435442,56510634,17075192,TN
chr14,Bn55339,62815660,75630963,12815303,CN
chr14,Bn55340,21745276,60877857,39132581,CN
chr14,Bn55341,79394966,95243793,15848827,NBS
chr14,Bn55342,91291648,92975736,1684088,NBS
chr14,Bn55343,34992640,57142042,22149402,RLP
chr14,Bn55344,98109608,99778291,1668683,CN
chr14,Bn55345,36183726,53178368,16994642,NBS
chr14,Bn55346,89560463,99162679,9602216,TNL
chr14,Bn55347,10246350,55590169,45343819,CN
chr14,Bn55348,85048583,99373914,14325331,RLK
chr14,Bn55349,86375311,98084079,11708768,CN
chr14,Bn55350,52185078,56614093,4429015,CNL
chr14,Bn55351,42859745,45627326,2767581,RLP
chr14,Bn55352,90456582,92433911,1977329,RLP
chr14,Bn55353,19500673,46883428,27382755,TN
chr14,Bn55354,33389325,45436846,12047521,CN
chr14,Bn55355,86071569,91725801,5654232,TNL
chr14,Bn55356,79913532,97385675,17472143,TNL
chr14,Bn55357,7370068,20857869,13487801,TN
chr14,Bn55358,63095324,90079864,26984540,TN
chr14,Bn55359,27778692,93131783,65353091,TNL
chr14,Bn55360,77315242,82662725,5347483,NBS
chr14,Bn55361,73636024,75098569,1462545,TN
chr14,Bn55362,15923724,77040580,61116856,CN
chr14,Bn55363,4798779,30842198,26043419,CN
chr14,Bn55364,23938317,79750101,55811784,NBS
chr14,Bn55365,57649213,89739395,32090182,RLP
chr14,Bn55366,6671321,86081896,79410575,TNL
chr14,Bn55367,68057982,71992711,3934729,RLK
chr14,Bn55368,90242961,93038768,2795807,RLK
chr14,Bn55369,20266905,25953298,5686393,TNL
chr14,Bn55370,52753821,97211268,44457447,CN
chr14,Bn55371,43846883,80977748,37130865,TNL
chr14,Bn55372,58935794,90265002,31329208,CN
chr14,Bn55373,97844502,99073842,1229340,TN
chr14,Bn55374,92041892,96917171,4875279,CNL
chr14,Bn55375,33048531,52088067,19039536,CNL
chr14,Bn55376,71593068,95851521,24258453,RLK
chr14,Bn55377,96498132,99829920,3331788,CNL
chr14,Bn55378,88098055,94223343,6125288,RLK
chr14,Bn55379,3774662,5509389,1734727,RLP
chr14,Bn55380,23971505,93124131,69152626,TN
chr14,Bn55381,35548303,60578404,25030101,RLK
chr14,Bn55382,89530756,89881272,350516,RLP
chr14,Bn55383,26595148,83695858,57100710,RLP
chr14,Bn55384,78512866,93013855,14500989,CN
chr14,Bn55385,94874157,97626963,2752806,RLK
chr14,Bn55386,30485918,67840857,37354939,TN
chr14,Bn55387,6941860,89384312,82442452,TN
chr14,Bn55388,24598573,26801473,2202900,NBS
chr14,Bn55389,51015032,94558677,43543645,CNL
chr14,Bn55390,59450466,98445793,38995327,TN
chr14,Bn55391,32476780,53931000,21454220,NBS
chr14,Bn55392,17381199,22843887,5462688,RLK
chr14,Bn55393,71233799,93484483,22250684,RLK
chr14,Bn55394,75971451,78116132,2144681,TN
chr14,Bn55395,66446515,83378078,16931563,TNL
chr14,Bn55396,26622487,85498780,58876293,NBS
chr14,Bn55397,82514347,87040063,4525716,RLK
chr14,Bn55398,69244736,70019992,775256,TN
chr14,Bn55399,77471230,89072729,11601499,TNL
chr14,Bn55400,39823116,81258883,41435767,RLK
chr14,Bn55401,81859148,89144550,7285402,CNL
chr14,Bn55402,77110059,79475605,2365546,TNL
chr14,Bn55403,92290819,99671738,7380919,RLP
chr14,Bn55404,43145900,88140156,44994256,TN
chr14,Bn55405,46604369,60977503,14373134,CNL
chr14,Bn55406,75529330,95960386,20431056,TNL
chr14,Bn55407,19146201,93639875,74493674,TN
chr14,Bn55408,73909796,85574468,11664672,RLK
chr14,Bn55409,27242329,53428177,26185848,RLP
chr14,Bn55410,61692172,74342130,12649958,NBS
chr14,Bn55411,31747007,41608389,9861382,RLP
chr14,Bn55412,78972028,96230796,17258768,CN
chr14,Bn55413,40865223,54003789,13138566,RLP
chr14,Bn55414,26840682,40888705,14048023,TNL
chr14,Bn55415,32331880,40883318,8551438,TNL
chr14,Bn55416,7223700,18937545,11713845,CN
chr14,Bn55417,10720594,71108132,60387538,CN
chr14,Bn55418,32373395,56618133,24244738,TN
chr14,Bn55419,9312725,62186685,52873960,TN
chr14,Bn55420,27157047,65385184,38228137,CNL
chr14,Bn55421,6014221,51366926,45352705,CNL
chr14,Bn55422,58816096,60137724,1321628,RLP
chr14,Bn55423,13146738,31179028,18032290,RLP
chr14,Bn55424,11816048,83546210,71730162,TN
chr14,Bn55425,14558085,56194205,41636120,RLK
chr14,Bn55426,11319010,67788940,56469930,CN
chr14,Bn55427,19639762,32859334,13219572,TN
chr14,Bn55428,65774607,78144610,12370003,CNL
chr14,Bn55429,85924384,89499082,3574698,NBS
chr14,Bn55430,16381160,63212532,46831372,TN
chr14,Bn55431,51106772,84215850,33109078,CN
chr14,Bn55432,33116435,93018384,59901949,RLK
chr14,Bn55433,43882710,70148688,26265978,NBS
chr14,Bn55434,89203087,92132340,2929253,NBS
chr14,Bn55435,39026642,40857093,1830451,CNL
chr14,Bn55436,81570292,98078566,16508274,TN
chr14,Bn55437,95245933,99622491,4376558,RLP
chr14,Bn55438,89619434,91101249,1481815,TN
chr14,Bn55439,22602898,92459627,69856729,CN
chr14,Bn55440,37203875,40988781,3784906,TN
chr14,Bn55441,25025359,52692896,27667537,NBS
chr14,Bn55442,67765450,77098795,9333345,CNL
chr14,Bn55443,80713731,88452682,7738951,CN
chr14,Bn55444,38544892,86456282,47911390,CNL
chr14,Bn55445,46037753,73839246,27801493,CN
chr14,Bn55446,75090649,87525680,12435031,RLK
chr14,Bn55447,89506613,99746880,10240267,TNL
chr14,Bn55448,7252241,68477095,61224854,CNL
chr14,Bn55449,52084475,62245399,10160924,TNL
chr14,Bn55450,6415535,68102964,61687429,CN
chr14,Bn55451,44429227,65982648,21553421,CNL
chr14,Bn55452,22766972,74231537,51464565,NBS
chr14,Bn55453,90772255,99198009,8425754,TNL
chr14,Bn55454,81151964,85670394,4518430,RLP
chr14,Bn55455,1623584,20335413,18711829,CNL
chr14,Bn55456,63151794,72010429,8858635,TN
chr14,Bn55457,28528601,30865731,2337130,TNL
chr14,Bn55458,60958802,89268813,28310011,CNL
chr14,Bn55459,63570133,81619183,18049050,TNL
chr14,Bn55460,82381478,94404591,12023113,TNL
chr14,Bn55461,44267546,51444231,7176685,CNL
chr14,Bn55462,81828655,88815277,6986622,RLP
chr14,Bn55463,51676062,61266546,9590484,NBS
chr14,Bn55464,77670854,95185802,17514948,NBS
chr14,Bn55465,49528123,68965563,19437440,RLP
chr14,Bn55466,50221036,71174449,20953413,TNL
chr14,Bn55467,75827153,83267091,7439938,CNL
chr14,Bn55468,76582675,78370268,1787593,NBS
chr14,Bn55469,64386320,82456245,18069925,NBS
chr14,Bn55470,49140164,65867728,16727564,RLP
chr14,Bn55471,2418217,29611208,27192991,TNL
chr14,Bn55472,47306913,86487053,39180140,CNL
chr14,Bn55473,49097744,89215576,40117832,CN
chr14,Bn55474,6095467,93868364,87772897,TN
chr14,Bn55475,59050508,85032802,25982294,TN
chr14,Bn55476,55351090,68655304,13304214,NBS
chr14,Bn55477,69487502,93084530,23597028,TNL
chr14,Bn55478,20738446,78789590,58051144,TNL
chr14,Bn55479,28293227,80285919,51992692,CNL
chr14,Bn55480,70036901,96148210,26111309,TNL
chr14,Bn55481,58820946,97695972,38875026,TNL
chr14,Bn55482,3321684,67250436,63928752,TNL
chr14,Bn55483,63658875,84220966,20562091,RLK
chr14,Bn55484,81805291,92690920,10885629,CNL
chr14,Bn55485,8487037,8677139,190102,NBS
chr14,Bn55486,44933900,90964097,46030197,RLK
chr14,Bn55487,47485977,55103236,7617259,RLK
chr14,Bn55488,60782810,73070422,12287612,NBS
chr14,Bn55489,80581022,99676504,19095482,NBS
chr14,Bn55490,40053691,74316058,34262367,RLK
chr14,Bn55491,90300458,94697996,4397538,CN
chr14,Bn55492,68007511,70633631,2626120,TNL
chr14,Bn55493,49331662,96327894,46996232,CN
chr14,Bn55494,11815324,14833333,3018009,RLP
chr14,Bn55495,71705952,94928580,23222628,RLK
chr14,Bn55496,26828811,82666672,55837861,NBS
chr14,Bn55497,29510989,34055290,4544301,RLK
chr14,Bn55498,73833868,79002282,5168414,CNL
chr14,Bn55499,50964619,58213001,7248382,RLP
chr14,Bn55500,13863632,90937908,77074276,RLP
chr14,Bn55501,5656884,59294385,53637501,NBS
chr14,Bn55502,10536198,76152498,65616300,NBS
chr14,Bn55503,16468845,68241300,51772455,RLK
chr14,Bn55504,81623813,95139434,13515621,TN
chr14,Bn55505,83539663,88677017,5137354,RLP
chr14,Bn55506,75288108,83756602,8468494,RLK
chr14,Bn55507,88754698,93533006,4778308,TNL
chr14,Bn55508,50189640,76030728,25841088,RLP
chr14,Bn55509,55633229,73871126,18237897,RLP
chr14,Bn55510,10002527,25669804,15667277,NBS
chr14,Bn55511,58954569,65664076,6709507,CNL
chr14,Bn55512,39130583,79483735,40353152,TNL
chr14,Bn55513,31759830,58927710,27167880,TN
chr14,Bn55514,22415791,65516824,43101033,CN
chr14,Bn55515,50150988,58955425,8804437,CN
chr14,Bn55516,43057732,79779495,36721763,NBS
chr14,Bn55517,72911714,91815838,18904124,RLK
chr14,Bn55518,8791003,41119032,32328029,CN
chr14,Bn55519,14110154,86122250,72012096,CN
chr14,Bn55520,34540379,42772104,8231725,CN
chr14,Bn55521,20242862,52448560,32205698,RLK
chr14,Bn55522,27373033,37296872,9923839,CNL
chr14,Bn55523,48223047,80180040,31956993,CNL
chr14,Bn55524,83977574,84459477,481903,NBS
chr14,Bn55525,34625746,77412756,42787010,RLK
chr14,Bn55526,82590846,89576946,6986100,CNL
chr14,Bn55527,96429111,96980990,551879,NBS
chr14,Bn55528,27457484,97822831,70365347,NBS
chr14,Bn55529,68006999,94371631,26364632,RLK
chr14,Bn55530,43487107,48655940,5168833,TNL
chr14,Bn55531,41373676,59042621,17668945,NBS
chr14,Bn55532,28451002,54319247,25868245,TNL
chr14,Bn55533,2955803,56597431,53641628,CN
chr14,Bn55534,43077041,63853585,20776544,NBS
chr14,Bn55535,65603955,93227998,27624043,TNL
chr14,Bn55536,88712226,92579194,3866968,RLP
chr14,Bn55537,66901765,98045042,31143277,RLP
chr14,Bn55538,51988682,92786653,40797971,TN
chr14,Bn55539,79260322,82554382,3294060,RLK
chr14,Bn55540,70438052,95832164,25394112,CN
chr14,Bn55541,70715401,81260181,10544780,RLK
chr14,Bn55542,93033335,96772730,3739395,RLP
chr14,Bn55543,10217607,23313530,13095923,CN
chr14,Bn55544,70460272,92772930,22312658,TNL
chr14,Bn55545,33729452,38973525,5244073,TNL
chr14,Bn55546,26603366,93988257,67384891,CN
chr14,Bn55547,27055314,63599210,36543896,RLK
chr14,Bn55548,51234875,85678569,34443694,TN
chr14,Bn55549,79949737,88811162,8861425,TNL
chr14,Bn55550,82281909,85135452,2853543,NBS
chr14,Bn55551,6889285,13981198,7091913,CN
chr14,Bn55552,8228133,40368402,32140269,RLK
chr14,Bn55553,16808625,97885914,81077289,RLK
chr14,Bn55554,13824945,24680295,10855350,CN
chr14,Bn55555,91547206,94450714,2903508,RLP
chr14,Bn55556,89841431,99977437,10136006,CNL
chr14,Bn55557,71347447,77201873,5854426,CN
chr14,Bn55558,98584829,99807494,1222665,RLK
chr14,Bn55559,90423888,95298533,4874645,NBS
chr14,Bn55560,43635891,63487129,19851238,CN
chr14,Bn55561,77310183,85562601,8252418,CN
chr14,Bn55562,79593491,95862771,16269280,RLP
chr14,Bn55563,55455790,64520159,9064369,RLP
chr14,Bn55564,5628806,31764494,26135688,RLP
chr14,Bn55565,20047843,40706975,20659132,RLP
chr14,Bn55566,73715535,87116023,13400488,RLK
chr14,Bn55567,36009444,82553393,46543949,CN
chr14,Bn55568,15784404,42614278,26829874,CNL
chr14,Bn55569,80958367,86825495,5867128,TNL
chr14,Bn55570,82992498,92687894,9695396,TNL
chr14,Bn55571,68410396,88307385,19896989,TNL
chr14,Bn55572,66754948,79143094,12388146,CN
chr14,Bn55573,5806887,35999950,30193063,RLP
chr14,Bn55574,17194362,38454894,21260532,TNL
chr14,Bn55575,24473201,87445834,62972633,TNL
chr14,Bn55576,46744925,92976029,46231104,TN
chr14,Bn55577,98324599,99661029,1336430,CNL
chr14,Bn55578,30526461,59166629,28640168,TN
chr14,Bn55579,50826059,73873293,23047234,TNL
chr14,Bn55580,3363460,66479177,63115717,TNL
chr14,Bn55581,83368821,88369328,5000507,CN
chr14,Bn55582,7762332,87368247,79605915,NBS
chr14,Bn55583,63996741,91802423,27805682,RLK
chr14,Bn55584,10578469,96734789,86156320,NBS
chr14,Bn55585,18537594,99342728,80805134,RLK
chr14,Bn55586,31779085,95431544,63652459,TNL
chr14,Bn55587,31697984,72032002,40334018,TN
chr14,Bn55588,45617383,96491179,50873796,TN
chr14,Bn55589,45045267,98583346,53538079,TNL
chr14,Bn55590,17124190,21291982,4167792,TNL
chr14,Bn55591,98100486,99987840,1887354,TNL
chr14,Bn55592,59288418,99480837,40192419,TNL
chr14,Bn55593,39073795,42651606,3577811,RLP
chr14,Bn55594,1302743,21518329,20215586,TNL
chr14,Bn55595,48705195,99478281,50773086,NBS
chr14,Bn55596,54837961,94000395,39162434,RLP
chr14,Bn55597,35392286,60332741,24940455,TN
chr14,Bn55598,17789527,35133393,17343866,CNL
chr14,Bn55599,91796619,97202608,5405989,TN
chr14,Bn55600,85267523,99209323,13941800,RLP
chr14,Bn55601,73844519,83701296,9856777,CNL
chr14,Bn55602,57386634,76508239,19121605,CNL
chr14,Bn55603,25050415,78159107,53108692,CN
chr14,Bn55604,17292097,82059029,64766932,RLK
chr14,Bn55605,85953482,91740503,5787021,TNL
chr14,Bn55606,77299241,89494206,12194965,TN
chr14,Bn55607,78908925,97859955,18951030,TNL
chr14,Bn55608,77400324,86497808,9097484,NBS
chr14,Bn55609,28041817,38300587,10258770,TN
chr14,Bn55610,49535042,54751621,5216579,RLP
chr14,Bn55611,27269609,50475063,23205454,NBS
chr14,Bn55612,26652206,45466408,18814202,NBS
chr14,Bn55613,10301706,44041428,33739722,CNL
chr14,Bn55614,60616412,71737581,11121169,NBS
chr14,Bn55615,40372176,73630869,33258693,RLK
chr14,Bn55616,53056554,80633970,27577416,CNL
chr14,Bn55617,11906370,39816347,27909977,TNL
chr14,Bn55618,58460073,98134584,39674511,TN
chr14,Bn55619,11071893,47837908,36766015,CNL
chr14,Bn55620,89463802,92963469,3499667,RLP
chr14,Bn55621,55556331,60655419,5099088,NBS
chr14,Bn55622,18606376,70862592,52256216,CN
chr14,Bn55623,46335291,96427649,50092358,NBS
chr14,Bn55624,70606089,87488438,16882349,RLK
chr14,Bn55625,11466333,46190414,34724081,CN
chr14,Bn55626,90743744,91887488,1143744,RLP
chr14,Bn55627,39653334,93819627,54166293,TNL
chr14,Bn55628,42231689,54334635,12102946,CNL
chr14,Bn55629,51007517,51684376,676859,RLK
chr14,Bn55630,18889239,48799575,29910336,TNL
chr14,Bn55631,22273811,24428518,2154707,RLK
chr14,Bn55632,13550954,41221063,27670109,TN
chr14,Bn55633,18558982,18957225,398243,TNL
chr14,Bn55634,52102214,80157296,28055082,TN
chr14,Bn55635,39429409,75930069,36500660,RLP
chr14,Bn55636,94686140,96782633,2096493,RLK
chr14,Bn55637,12497055,79608812,67111757,CN
chr15,Bn55638,60149978,89968063,29818085,TNL
chr15,Bn55639,65871875,75434668,9562793,NBS
chr15,Bn55640,42300933,55023289,12722356,RLP
chr15,Bn55641,14250366,78079028,63828662,TN
chr15,Bn55642,99542204,99544749,2545,TNL
chr15,Bn55643,93743447,98931368,5187921,TN
chr15,Bn55644,42418488,95902788,53484300,TNL
chr15,Bn55645,77673918,94420564,16746646,NBS
chr15,Bn55646,58189555,81120810,22931255,TN
chr15,Bn55647,45404316,80261497,34857181,CNL
chr15,Bn55648,91969757,98952716,6982959,TN
chr15,Bn55649,19930075,69163309,49233234,CN
chr15,Bn55650,82210460,97341843,15131383,TNL
chr15,Bn55651,93289944,97734409,4444465,TNL
chr15,Bn55652,62450554,90394125,27943571,NBS
chr15,Bn55653,43960101,69776260,25816159,NBS
chr15,Bn55654,44139877,67856172,23716295,RLP
chr15,Bn55655,73491410,88516716,15025306,TNL
chr15,Bn55656,5303210,52377719,47074509,NBS
chr15,Bn55657,14473030,67354949,52881919,RLK
chr15,Bn55658,36477783,64079231,27601448,CN
chr15,Bn55659,27896643,45923020,18026377,NBS
chr15,Bn55660,87005641,97369723,10364082,TNL
chr15,Bn55661,20772864,77913164,57140300,TNL
chr15,Bn55662,78263053,87472995,9209942,TN
chr15,Bn55663,84167798,94253868,10086070,CNL
chr15,Bn55664,9536233,61189149,51652916,RLP
chr15,Bn55665,85649652,93486724,7837072,RLP
chr15,Bn55666,88385741,92149387,3763646,TN
chr15,Bn55667,73543513,99453197,25909684,TN
chr15,Bn55668,53520268,90589778,37069510,RLP
chr15,Bn55669,99233211,99275482,42271,TN
chr15,Bn55670,32144364,63409230,31264866,RLK
chr15,Bn55671,24869349,83208342,58338993,NBS
chr15,Bn55672,8001901,83875738,75873837,TNL
chr15,Bn55673,29405782,89995380,60589598,NBS
chr15,Bn55674,6348134,94758351,88410217,RLK
chr15,Bn55675,32000287,60734875,28734588,RLK
chr15,Bn55676,96894083,97518958,624875,TN
chr15,Bn55677,1699016,55776746,54077730,TNL
chr15,Bn55678,8313283,46746687,38433404,NBS
chr15,Bn55679,68180696,87260689,19079993,RLP
chr15,Bn55680,70774840,93395355,22620515,CNL
chr15,Bn55681,14640759,77663024,63022265,RLK
chr15,Bn55682,86164761,90102084,3937323,CNL
chr15,Bn55683,77120196,86321176,9200980,NBS
chr15,Bn55684,88900172,89052994,152822,TNL
chr15,Bn55685,88138927,97549504,9410577,TN
chr15,Bn55686,13613295,44433676,30820381,NBS
chr15,Bn55687,96783735,99303345,2519610,TN
chr15,Bn55688,42865674,45663527,2797853,TN
chr15,Bn55689,27170112,81419328,54249216,CNL
chr15,Bn55690,76018333,78156129,2137796,TNL
chr15,Bn55691,48605667,92116955,43511288,RLK
chr15,Bn55692,66995264,80996144,14000880,RLP
chr15,Bn55693,97201004,98036451,835447,CN
chr15,Bn55694,99338901,99630449,291548,TNL
chr15,Bn55695,7648539,61021001,53372462,TN
chr15,Bn55696,3938381,69848141,65909760,RLK
chr15,Bn55697,14498831,35013294,20514463,RLP
chr15,Bn55698,74011802,83821348,9809546,TNL
chr15,Bn55699,64101231,99367022,35265791,CN
chr15,Bn55700,50705884,97397481,46691597,RLP
chr15,Bn55701,22372328,23836528,1464200,RLK
chr15,Bn55702,60364591,91594469,31229878,TNL
chr15,Bn55703,23517438,39438695,15921257,NBS
chr15,Bn55704,35634317,71155320,35521003,TNL
chr15,Bn55705,99495861,99841756,345895,NBS
chr15,Bn55706,47220270,57931412,10711142,RLK
chr15,Bn55707,19098814,98035320,78936506,TN
chr15,Bn55708,32276985,40270152,7993167,TNL
chr15,Bn55709,21659790,97555171,75895381,RLP
chr15,Bn55710,50482709,52155891,1673182,TN
chr15,Bn55711,69541309,95841666,26300357,TNL
chr15,Bn55712,9963081,77934907,67971826,RLK
chr15,Bn55713,52694696,77742911,25048215,NBS
chr15,Bn55714,8252856,80202610,71949754,RLK
chr15,Bn55715,41585754,82034786,40449032,CNL
chr15,Bn55716,61851718,70445312,8593594,RLK
chr15,Bn55717,90133158,93409864,3276706,CN
chr15,Bn55718,25767755,42121767,16354012,TNL
chr15,Bn55719,95547188,97376062,1828874,CNL
chr15,Bn55720,90003644,91522446,1518802,RLP
chr15,Bn55721,57501406,74148679,16647273,CNL
chr15,Bn55722,21986394,54982493,32996099,TNL
chr15,Bn55723,24910335,95562762,70652427,RLP
chr15,Bn55724,60173915,62883376,2709461,TNL
chr15,Bn55725,33715953,57658491,23942538,CNL
chr15,Bn55726,41716870,51361817,9644947,TNL
chr15,Bn55727,11737951,24211136,12473185,RLK
chr15,Bn55728,30937345,53941702,23004357,TNL
chr15,Bn55729,8744585,69291569,60546984,CN
chr15,Bn55730,87475704,94509966,7034262,CNL
chr15,Bn55731,16327214,39157896,22830682,NBS
chr15,Bn55732,13366471,66068263,52701792,CNL
chr15,Bn55733,92605569,95805829,3200260,CNL
chr15,Bn55734,24715615,31972917,7257302,TN
chr15,Bn55735,1206291,15629331,14423040,TNL
chr15,Bn55736,93005228,99463929,6458701,TNL
chr15,Bn55737,78799868,98061448,19261580,CNL
chr15,Bn55738,92257843,96276012,4018169,TN
chr15,Bn55739,25863878,43532254,17668376,TNL
chr15,Bn55740,46016941,57201968,11185027,NBS
chr15,Bn55741,66107723,91450453,25342730,RLK
chr15,Bn55742,77345133,83418217,6073084,RLK
chr15,Bn55743,62155635,99622430,37466795,NBS
chr15,Bn55744,97858850,99651819,1792969,TN
chr15,Bn55745,95998588,96054962,56374,TN
chr15,Bn55746,20540275,95195610,74655335,CNL
chr15,Bn55747,58502962,90197813,31694851,RLK
chr15,Bn55748,27112262,55419124,28306862,NBS
chr15,Bn55749,84249891,93325909,9076018,RLK
chr15,Bn55750,42711948,44502055,1790107,CNL
chr15,Bn55751,39395751,68570787,29175036,TNL
chr15,Bn55752,89972196,91800119,1827923,TN
chr15,Bn55753,66046567,87583158,21536591,CN
chr15,Bn55754,33329958,48307239,14977281,RLK
chr15,Bn55755,76990661,97150033,20159372,TNL
chr15,Bn55756,69066757,83439334,14372577,CN
chr15,Bn55757,10599726,86830414,76230688,CN
chr15,Bn55758,51294066,97058462,45764396,TN
chr15,Bn55759,41022879,80826523,39803644,TN
chr15,Bn55760,91945178,96581347,4636169,CNL
chr15,Bn55761,4112475,49906975,45794500,RLK
chr15,Bn55762,28770584,72157704,43387120,NBS
chr15,Bn55763,13251138,34234292,20983154,RLK
chr15,Bn55764,76610306,99974690,23364384,TN
chr15,Bn55765,4113577,45558940,41445363,CN
chr15,Bn55766,28065029,81349778,53284749,TN
chr15,Bn55767,56543020,64818762,8275742,CN
chr15,Bn55768,35791382,62621945,26830563,RLP
chr15,Bn55769,49275336,52566421,3291085,TN
chr15,Bn55770,97395371,98838825,1443454,NBS
chr15,Bn55771,35060614,36421980,1361366,TNL
chr15,Bn55772,6490477,64225051,57734574,NBS
chr15,Bn55773,71766504,97677138,25910634,CN
chr15,Bn55774,7645562,71356164,63710602,TN
chr15,Bn55775,75156291,77342241,2185950,NBS
chr15,Bn55776,43386002,50859384,7473382,NBS
chr15,Bn55777,61938703,97694211,35755508,CNL
chr15,Bn55778,31743994,56530192,24786198,TNL
chr15,Bn55779,79298813,95199549,15900736,CN
chr15,Bn55780,71585638,73476891,1891253,CN
chr15,Bn55781,2906050,61160642,58254592,NBS
chr15,Bn55782,57373789,79082593,21708804,TNL
chr15,Bn55783,89582992,97915241,8332249,TN
chr15,Bn55784,83203617,85273732,2070115,CN
chr15,Bn55785,95754862,97368420,1613558,TNL
chr15,Bn55786,35469273,75416422,39947149,TNL
chr15,Bn55787,43838214,88909492,45071278,TNL
chr15,Bn55788,8978343,55482335,46503992,CN
chr15,Bn55789,24087612,38270269,14182657,RLK
chr15,Bn55790,87988163,91907353,3919190,TN
chr15,Bn55791,94411383,94784922,373539,RLP
chr15,Bn55792,89900397,97386968,7486571,RLP
chr15,Bn55793,92015666,92741972,726306,NBS
chr15,Bn55794,27463117,85039586,57576469,TN
chr15,Bn55795,32273637,53211954,20938317,RLP
chr15,Bn55796,25922265,63393880,37471615,CN
chr15,Bn55797,94339386,96957047,2617661,CN
chr15,Bn55798,93676971,96001657,2324686,CNL
chr15,Bn55799,77922540,86711215,8788675,CN
chr15,Bn55800,94475025,97218326,2743301,NBS
chr15,Bn55801,27440113,61121930,33681817,CNL
chr15,Bn55802,58435833,67367523,8931690,CNL
chr15,Bn55803,37330822,96701101,59370279,RLK
chr15,Bn55804,9136775,65685611,56548836,TNL
chr15,Bn55805,69178913,91716184,22537271,RLK
chr15,Bn55806,16333714,42465487,26131773,CN
chr15,Bn55807,61482612,67305245,5822633,RLP
chr15,Bn55808,58560463,97683629,39123166,NBS
chr15,Bn55809,40762662,73584586,32821924,TN
chr15,Bn55810,21303903,83607456,62303553,RLK
chr15,Bn55811,38196734,87236483,49039749,RLP
chr15,Bn55812,82521827,97973617,15451790,RLP
chr15,Bn55813,46373550,67983551,21610001,CN
chr15,Bn55814,82021919,99927965,17906046,RLP
chr15,Bn55815,37619885,76166223,38546338,TNL
chr15,Bn55816,92578432,98177231,5598799,RLP
chr15,Bn55817,26789183,78426176,51636993,RLK
chr15,Bn55818,74424737,99760901,25336164,RLK
chr15,Bn55819,17523179,53759564,36236385,RLP
chr15,Bn55820,71523202,83576502,12053300,TNL
chr15,Bn55821,25554845,81184742,55629897,TNL
chr15,Bn55822,47083739,85903958,38820219,RLK
chr15,Bn55823,18292281,71534124,53241843,CNL
chr15,Bn55824,68133153,71669036,3535883,CN
chr15,Bn55825,57935760,61415859,3480099,TNL
chr15,Bn55826,70406190,81413336,11007146,RLK
chr15,Bn55827,71059210,81687313,10628103,TNL
chr15,Bn55828,49113372,92199287,43085915,RLK
chr15,Bn55829,6365464,14054711,7689247,NBS
chr15,Bn55830,98408662,99322828,914166,RLP
chr15,Bn55831,40484644,69903306,29418662,RLK
chr15,Bn55832,91680543,94064290,2383747,TN
chr15,Bn55833,73437073,81266742,7829669,RLP
chr15,Bn55834,53979453,74757883,20778430,TNL
chr15,Bn55835,93860484,96998453,3137969,TN
chr15,Bn55836,61080413,78587220,17506807,RLP
chr15,Bn55837,17955396,79834342,61878946,RLK
chr15,Bn55838,43859918,87478153,43618235,NBS
chr15,Bn55839,84938432,99428819,14490387,TN
chr15,Bn55840,73530104,87570199,14040095,TNL
chr15,Bn55841,30230025,73517918,43287893,RLK
chr15,Bn55842,42000449,73775262,31774813,TNL
chr15,Bn55843,20616244,94391054,73774810,CNL
chr15,Bn55844,2106312,67736442,65630130,TN
chr15,Bn55845,83176136,89880930,6704794,RLP
chr15,Bn55846,66614787,77961875,11347088,CNL
chr15,Bn55847,62805040,68167145,5362105,RLP
chr15,Bn55848,36387948,98752005,62364057,RLP
chr15,Bn55849,86044139,95832706,9788567,TN
chr15,Bn55850,25630916,81172420,55541504,RLK
chr15,Bn55851,54302712,98072829,43770117,TN
chr15,Bn55852,87075244,99688191,12612947,TNL
chr15,Bn55853,15662147,76422443,60760296,RLK
chr15,Bn55854,63281094,75840899,12559805,CN
chr15,Bn55855,65434247,71702532,6268285,TNL
chr15,Bn55856,35806245,43157904,7351659,CN
chr15,Bn55857,44439507,73832371,29392864,TNL
chr15,Bn55858,52609291,63142676,10533385,RLK
chr15,Bn55859,58826555,90716912,31890357,RLK
chr15,Bn55860,14721330,73104644,58383314,TN
chr15,Bn55861,80675896,88565746,7889850,TN
chr15,Bn55862,75442533,86183102,10740569,TN
chr15,Bn55863,8016778,21782236,13765458,TN
chr15,Bn55864,41980849,94186017,52205168,TNL
chr15,Bn55865,85909954,95603849,9693895,CNL
chr15,Bn55866,14270080,59610434,45340354,CNL
chr15,Bn55867,50183430,75993414,25809984,TN
chr15,Bn55868,56673283,78429582,21756299,CNL
chr15,Bn55869,40328577,51994355,11665778,CNL
chr15,Bn55870,17009359,57706237,40696878,NBS
chr15,Bn55871,21684833,44779041,23094208,RLP
chr15,Bn55872,92707537,94853234,2145697,RLP
chr15,Bn55873,85996774,97256662,11259888,CN
chr15,Bn55874,57083183,74279099,17195916,CN
chr15,Bn55875,51697564,80273804,28576240,TNL
chr15,Bn55876,83776671,91012347,7235676,NBS
chr15,Bn55877,99115706,99305703,189997,TN
chr15,Bn55878,95956625,99785985,3829360,CNL
chr15,Bn55879,18217760,75617703,57399943,RLK
chr15,Bn55880,70519620,99662711,29143091,NBS
chr15,Bn55881,47769316,89778900,42009584,CNL
chr15,Bn55882,96084434,98790829,2706395,RLK
chr15,Bn55883,77781006,95472021,17691015,RLP
chr15,Bn55884,7592173,90418923,82826750,RLK
chr15,Bn55885,6517492,68890508,62373016,RLP
chr15,Bn55886,77172576,92852815,15680239,CN
chr15,Bn55887,96503748,97701830,1198082,RLK
chr15,Bn55888,67887037,98149286,30262249,TN
chr15,Bn55889,75709611,96271629,20562018,RLP
chr15,Bn55890,80629429,93950065,13320636,TN
chr15,Bn55891,80458942,97011098,16552156,TNL
chr15,Bn55892,53088925,60088671,6999746,CN
chr15,Bn55893,25990519,53062356,27071837,CN
chr15,Bn55894,15586426,18524662,2938236,RLK
chr15,Bn55895,20682167,21649050,966883,RLP
chr15,Bn55896,40322125,41838978,1516853,CN
chr15,Bn55897,63956929,87760196,23803267,CN
chr15,Bn55898,17574427,55623058,38048631,CNL
chr15,Bn55899,19934015,60190672,40256657,TNL
chr15,Bn55900,22611555,31764181,9152626,CNL
chr15,Bn55901,2062312,42011760,39949448,RLK
chr15,Bn55902,55842451,76204356,20361905,TN
chr15,Bn55903,28191965,68456969,40265004,CN
chr15,Bn55904,76724091,95467966,18743875,CN
chr15,Bn55905,42899042,82476844,39577802,TN
chr15,Bn55906,75277300,88569571,13292271,TN
chr15,Bn55907,14737886,52591528,37853642,CNL
chr15,Bn55908,90448681,99427736,8979055,RLK
chr15,Bn55909,32379418,38637857,6258439,TN
chr15,Bn55910,93344240,95139312,1795072,TNL
chr15,Bn55911,48242680,56950502,8707822,RLP
chr15,Bn55912,56992042,95136405,38144363,NBS
chr15,Bn55913,34260098,57812162,23552064,TNL
chr15,Bn55914,20657719,60633269,39975550,RLP
chr15,Bn55915,82111603,92062186,9950583,CNL
chr15,Bn55916,79608493,98718745,19110252,RLK
chr15,Bn55917,36234703,86430318,50195615,CN
chr15,Bn55918,96481374,98635749,2154375,RLK
chr15,Bn55919,8184912,42333794,34148882,CN
chr15,Bn55920,31845060,64254058,32408998,RLK
chr15,Bn55921,71143204,97768770,26625566,NBS
chr15,Bn55922,13007670,63796834,50789164,CN
chr15,Bn55923,50804746,87725980,36921234,NBS
chr15,Bn55924,32585564,84200990,51615426,TNL
chr15,Bn55925,41150579,58310338,17159759,TN
chr15,Bn55926,70824677,72722701,1898024,TNL
chr15,Bn55927,28191979,99139614,70947635,NBS
chr15,Bn55928,53165219,65111254,11946035,RLP
chr15,Bn55929,79972263,80975747,1003484,CNL
chr15,Bn55930,81506942,87870645,6363703,NBS
chr15,Bn55931,83837538,98136511,14298973,RLK
chr15,Bn55932,73167335,87512450,14345115,NBS
chr15,Bn55933,87941579,96854997,8913418,CNL
chr15,Bn55934,87121082,91200446,4079364,TNL
chr15,Bn55935,35657151,36775619,1118468,TN
chr15,Bn55936,9332455,54333369,45000914,NBS
chr15,Bn55937,19965308,59427905,39462597,RLP
chr15,Bn55938,54763133,60814449,6051316,CN
chr15,Bn55939,80061079,85337212,5276133,NBS
chr15,Bn55940,75602199,90029872,14427673,TNL
chr15,Bn55941,2137244,94666063,92528819,NBS
chr15,Bn55942,83612265,97459877,13847612,RLP
chr15,Bn55943,29555028,67307616,37752588,CN
chr15,Bn55944,5811454,41459767,35648313,CNL
chr15,Bn55945,53615144,61778713,8163569,RLK
chr15,Bn55946,86138770,86312391,173621,CN
chr15,Bn55947,98939155,99661221,722066,NBS
chr15,Bn55948,38938079,44256088,5318009,CNL
chr15,Bn55949,34210127,40498569,6288442,CN
chr15,Bn55950,65471462,78807257,13335795,NBS
chr15,Bn55951,57325838,61781202,4455364,NBS
chr15,Bn55952,85922102,89721552,3799450,NBS
chr15,Bn55953,63944416,89228986,25284570,NBS
chr15,Bn55954,19059142,91799799,72740657,TN
chr15,Bn55955,86823516,93752666,6929150,CNL
chr15,Bn55956,89232479,95792389,6559910,RLP
chr15,Bn55957,28827870,31979442,3151572,TNL
chr15,Bn55958,25756458,57672067,31915609,RLP
chr15,Bn55959,16040185,87102892,71062707,NBS
chr15,Bn55960,81715080,94478154,12763074,NBS
chr15,Bn55961,27245718,36317314,9071596,TN
chr15,Bn55962,63828374,81223137,17394763,NBS
chr15,Bn55963,92081031,93210676,1129645,CN
chr15,Bn55964,41305841,94661353,53355512,CNL
chr15,Bn55965,66237278,67925301,1688023,TN
chr15,Bn55966,66591038,91113696,24522658,RLP
chr15,Bn55967,7405544,84655146,77249602,CN
chr15,Bn55968,57239443,72255561,15016118,RLP
chr15,Bn55969,80900264,88641460,7741196,RLK
chr15,Bn55970,91223774,95037641,3813867,CNL
chr15,Bn55971,6300570,89843785,83543215,TNL
chr15,Bn55972,57467853,71659271,14191418,TN
chr15,Bn55973,59601646,73961809,14360163,TNL
chr15,Bn55974,51944202,96805699,44861497,NBS
chr15,Bn55975,79010765,87535977,8525212,CN
chr15,Bn55976,12758796,72545318,59786522,CNL
chr15,Bn55977,7612612,22491822,14879210,TN
chr15,Bn55978,41882289,96285726,54403437,CN
chr15,Bn55979,47643373,70207276,22563903,NBS
chr15,Bn55980,81334902,81389370,54468,TN
chr15,Bn55981,78510634,95236521,16725887,NBS
chr15,Bn55982,58625580,87359408,28733828,TNL
chr15,Bn55983,46500717,85390784,38890067,TN
chr15,Bn55984,82259334,95518751,13259417,NBS
chr15,Bn55985,40749268,77302344,36553076,TN
chr15,Bn55986,92344223,95870075,3525852,NBS
chr15,Bn55987,80979964,86491034,5511070,CN
chr15,Bn55988,64852733,94484205,29631472,TNL
chr15,Bn55989,80353034,91935868,11582834,RLP
chr15,Bn55990,60212821,72250628,12037807,CN
chr15,Bn55991,17165118,32709042,15543924,NBS
chr15,Bn55992,11349917,94218853,82868936,CN
chr15,Bn55993,20221777,20709448,487671,TN
chr15,Bn55994,50200227,77620356,27420129,CN
chr15,Bn55995,67306541,76411616,9105075,CNL
chr15,Bn55996,33833246,98696205,64862959,RLP
chr15,Bn55997,54395756,86745622,32349866,CN
chr15,Bn55998,98225065,99090133,865068,TN
chr15,Bn55999,15594620,67109164,51514544,NBS
chr15,Bn56000,2037547,14305130,12267583,RLP
chr15,Bn56001,32082086,52630087,20548001,CNL
chr15,Bn56002,70533600,78061860,7528260,RLK
chr15,Bn56003,14771253,31371523,16600270,RLK
chr15,Bn56004,67437890,93882013,26444123,RLP
chr15,Bn56005,81132494,90265024,9132530,RLK
chr15,Bn56006,62081903,76258428,14176525,TN
chr15,Bn56007,53827177,89278602,35451425,CN
chr15,Bn56008,39409542,90419620,51010078,TN
chr15,Bn56009,86380678,91408761,5028083,TNL
chr15,Bn56010,38628758,48790771,10162013,TNL
chr15,Bn56011,22426624,79220627,56794003,CNL
chr15,Bn56012,87357869,98374748,11016879,CN
chr15,Bn56013,21088196,93365200,72277004,CN
chr15,Bn56014,40273395,95102681,54829286,NBS
chr15,Bn56015,86217431,99657398,13439967,TNL
chr15,Bn56016,74255714,83256396,9000682,TN
chr15,Bn56017,54313506,60934228,6620722,RLK
chr15,Bn56018,65499756,84750201,19250445,CN
chr15,Bn56019,4468063,82890096,78422033,CN
chr15,Bn56020,32490568,34978463,2487895,RLK
chr15,Bn56021,22797221,36156793,13359572,NBS
chr15,Bn56022,5033575,37565444,32531869,NBS
chr15,Bn56023,31235622,83714676,52479054,TN
chr15,Bn56024,97065567,99178464,2112897,TN
chr15,Bn56025,92217378,93657034,1439656,RLP
chr15,Bn56026,61990029,80565107,18575078,NBS
chr15,Bn56027,95150122,98522018,3371896,CN
chr15,Bn56028,44486822,81035612,36548790,TNL
chr15,Bn56029,4301602,94451140,90149538,CNL
chr15,Bn56030,36669163,69159346,32490183,RLP
chr15,Bn56031,46364440,82592516,36228076,RLK
chr15,Bn56032,4618338,32466648,27848310,NBS
chr15,Bn56033,77672136,82285520,4613384,CNL
chr15,Bn56034,47688322,72888221,25199899,CNL
chr15,Bn56035,70342503,75588917,5246414,RLP
chr15,Bn56036,50926708,88751415,37824707,RLK
chr15,Bn56037,71401596,78710309,7308713,CNL
chr15,Bn56038,93486185,96698221,3212036,CNL
chr15,Bn56039,83790322,99711472,15921150,TN
chr15,Bn56040,82375456,87112935,4737479,TNL
chr15,Bn56041,46976586,98258705,51282119,CNL
chr15,Bn56042,54143854,97633537,43489683,TN
chr15,Bn56043,37757486,61409070,23651584,TN
chr15,Bn56044,39976336,47304302,7327966,RLK
chr15,Bn56045,63250776,72814585,9563809,TNL
chr15,Bn56046,94745018,99877394,5132376,TN
chr15,Bn56047,75906775,92847638,16940863,RLP
chr15,Bn56048,17363836,37314609,19950773,RLK
chr15,Bn56049,70959949,79447823,8487874,CN
chr15,Bn56050,31104376,74758427,43654051,NBS
chr15,Bn56051,48262871,76942340,28679469,RLP
chr15,Bn56052,29848313,31826065,1977752,RLP
chr15,Bn56053,50014734,76691499,26676765,RLK
chr15,Bn56054,18113745,60114258,42000513,RLK
chr15,Bn56055,66007257,81583214,15575957,CNL
chr15,Bn56056,29175096,59945949,30770853,RLP
chr15,Bn56057,96777101,98288878,1511777,TN
chr15,Bn56058,78825193,93504838,14679645,NBS
chr15,Bn56059,27504514,81676561,54172047,NBS
chr15,Bn56060,50908384,89912538,39004154,RLK
chr15,Bn56061,94381076,96757394,2376318,RLK
chr15,Bn56062,39615099,64260628,24645529,TNL
chr15,Bn56063,34918508,40490510,5572002,CN
chr15,Bn56064,50557032,97604975,47047943,NBS
chr15,Bn56065,91333402,99451501,8118099,CNL
chr15,Bn56066,95506545,95840365,333820,TN
chr15,Bn56067,38169227,48973157,10803930,RLP
chr15,Bn56068,3224325,44700251,41475926,TNL
chr15,Bn56069,18137614,35639589,17501975,CNL
chr15,Bn56070,26322246,29508182,3185936,TN
chr15,Bn56071,97842032,99748973,1906941,TNL
chr15,Bn56072,11298401,43445573,32147172,CN
chr15,Bn56073,10890660,75331356,64440696,RLK
chr15,Bn56074,49983807,64006615,14022808,RLK
chr15,Bn56075,35399568,78510032,43110464,TN
chr15,Bn56076,61198571,96019688,34821117,NBS
chr15,Bn56077,55627227,99773224,44145997,CNL
chr15,Bn56078,98267182,99759329,1492147,RLP
chr15,Bn56079,49376909,77228768,27851859,CN
chr15,Bn56080,23776387,54253070,30476683,TN
chr15,Bn56081,2350852,20129106,17778254,CNL
chr15,Bn56082,35560846,91210643,55649797,CN
chr15,Bn56083,43335986,59088217,15752231,NBS
chr15,Bn56084,2939611,14121688,11182077,RLK
chr15,Bn56085,26319419,58979800,32660381,RLP
chr15,Bn56086,17876147,57298397,39422250,CN
chr15,Bn56087,5258252,92970178,87711926,RLK
chr15,Bn56088,92693110,94827209,2134099,NBS
chr15,Bn56089,9569409,11379502,1810093,RLK
chr15,Bn56090,52067407,89434272,37366865,RLK
chr15,Bn56091,28868565,64194980,35326415,CN
chr15,Bn56092,57090156,87837994,30747838,CN
chr15,Bn56093,12373599,52665148,40291549,CNL
chr15,Bn56094,81121875,95867800,14745925,TN
chr15,Bn56095,88792291,91679839,2887548,NBS
chr15,Bn56096,20335355,44309386,23974031,RLK
chr15,Bn56097,66562801,88244123,21681322,RLK
chr15,Bn56098,88438517,93072400,4633883,RLP
chr15,Bn56099,52524084,95563038,43038954,CNL
chr15,Bn56100,18960583,51594561,32633978,RLP
chr15,Bn56101,49484030,69926566,20442536,TN
chr15,Bn56102,62092211,66027309,3935098,RLK
chr15,Bn56103,69761601,75885665,6124064,CNL
chr15,Bn56104,25363076,73961070,48597994,NBS
chr15,Bn56105,99081934,99819657,737723,CNL
chr15,Bn56106,22120610,97037137,74916527,RLP
chr15,Bn56107,51964009,57863359,5899350,TN
chr15,Bn56108,66016186,97523093,31506907,CN
chr15,Bn56109,47538316,87769917,40231601,CNL
chr15,Bn56110,59451257,90040020,30588763,CNL
chr15,Bn56111,42680400,62242455,19562055,NBS
chr15,Bn56112,84494704,98849832,14355128,TNL
chr15,Bn56113,13007826,36937634,23929808,RLK
chr15,Bn56114,78000600,91704482,13703882,CNL
chr15,Bn56115,89297250,95404309,6107059,RLP
chr15,Bn56116,31949614,74059076,42109462,NBS
chr15,Bn56117,78121954,99149412,21027458,RLK
chr15,Bn56118,25231410,54014839,28783429,CNL
chr15,Bn56119,68015671,89818507,21802836,TN
chr15,Bn56120,50806752,93820162,43013410,RLP
chr15,Bn56121,83978057,84807658,829601,TNL
chr15,Bn56122,54118506,73480666,19362160,RLP
chr15,Bn56123,13407069,88471425,75064356,TN
chr15,Bn56124,93715696,94317005,601309,RLK
chr15,Bn56125,9882176,14266281,4384105,CN
chr15,Bn56126,6310322,38040817,31730495,RLP
chr15,Bn56127,46288269,96694770,50406501,RLP
chr15,Bn56128,67928035,74025916,6097881,NBS
chr15,Bn56129,23592114,93151830,69559716,CN
chr15,Bn56130,74741469,86582508,11841039,CN
chr15,Bn56131,66884638,92454553,25569915,CNL
chr15,Bn56132,54896020,89181667,34285647,RLK
chr15,Bn56133,93158695,96556948,3398253,CN
chr15,Bn56134,15730142,21477875,5747733,CNL
chr15,Bn56135,60757511,79218154,18460643,RLK
chr15,Bn56136,53331046,66567812,13236766,CN
chr15,Bn56137,63954761,98175108,34220347,RLP
chr15,Bn56138,88990392,92586134,3595742,TN
chr15,Bn56139,92531270,98205808,5674538,NBS
chr15,Bn56140,78742547,90141429,11398882,TN
chr15,Bn56141,97432306,98396874,964568,RLP
chr15,Bn56142,95697793,99058481,3360688,RLP
chr15,Bn56143,66345283,97173683,30828400,RLP
chr15,Bn56144,62781703,82111542,19329839,TN
chr15,Bn56145,87157274,88666549,1509275,NBS
chr15,Bn56146,34335091,45862263,11527172,RLP
chr15,Bn56147,88825835,93871312,5045477,TN
chr15,Bn56148,7498840,86468399,78969559,RLK
chr15,Bn56149,19103766,19439779,336013,RLK
chr15,Bn56150,40800755,87221100,46420345,CN
chr15,Bn56151,15885369,23562588,7677219,RLP
chr15,Bn56152,43796483,83048487,39252004,TNL
chr15,Bn56153,3277301,57679300,54401999,CNL
chr15,Bn56154,89306472,93301273,3994801,CNL
chr15,Bn56155,14318548,47612941,33294393,NBS
chr15,Bn56156,85904517,93191040,7286523,CNL
chr15,Bn56157,84336633,98429896,14093263,RLP
chr15,Bn56158,12606385,77483998,64877613,NBS
chr15,Bn56159,94037003,95875925,1838922,TNL
chr15,Bn56160,3232761,13835185,10602424,CNL
chr15,Bn56161,10752539,94936463,84183924,NBS
chr15,Bn56162,70728137,97280391,26552254,TN
chr15,Bn56163,71856843,83595986,11739143,CN
chr15,Bn56164,28710223,42564794,13854571,NBS
chr15,Bn56165,96883002,99268799,2385797,TNL
chr15,Bn56166,12987419,66485794,53498375,RLP
chr15,Bn56167,75765198,93994047,18228849,CN
chr15,Bn56168,16156805,90036063,73879258,RLP
chr15,Bn56169,90685704,96323677,5637973,TN
chr15,Bn56170,26671352,75452178,48780826,CNL
chr15,Bn56171,74192540,80946818,6754278,NBS
chr15,Bn56172,54378909,88648989,34270080,TNL
chr15,Bn56173,7417496,89343576,81926080,NBS
chr15,Bn56174,63610204,75350328,11740124,CNL
chr15,Bn56175,8812282,77671418,68859136,CN
chr15,Bn56176,98033436,98418598,385162,CN
chr15,Bn56177,67764585,80143712,12379127,RLP
chr15,Bn56178,33947881,66804968,32857087,TNL
chr15,Bn56179,43894176,72999957,29105781,CN
chr15,Bn56180,54391748,59992652,5600904,NBS
chr15,Bn56181,1998669,13529288,11530619,RLK
chr15,Bn56182,55480593,56478659,998066,RLP
chr15,Bn56183,64071455,82961411,18889956,CN
chr15,Bn56184,86177758,95269431,9091673,RLK
chr15,Bn56185,61527189,77748959,16221770,RLP
chr15,Bn56186,23801735,24923579,1121844,TNL
chr15,Bn56187,16650262,65896688,49246426,CNL
chr15,Bn56188,30113578,36683417,6569839,RLP
chr15,Bn56189,14153942,36155895,22001953,TN
chr15,Bn56190,40402254,81571557,41169303,TN
chr15,Bn56191,62227280,96277586,34050306,CNL
chr15,Bn56192,16994636,32872259,15877623,RLP
chr15,Bn56193,66676079,79797391,13121312,CNL
chr15,Bn56194,42000381,80271041,38270660,RLP
chr15,Bn56195,72667899,96559341,23891442,TN
chr15,Bn56196,77151822,80357152,3205330,CNL
chr15,Bn56197,14844662,99681012,84836350,TNL
chr15,Bn56198,81946147,92903852,10957705,CNL
chr15,Bn56199,40143520,91068011,50924491,NBS
chr15,Bn56200,25155602,54222343,29066741,NBS
chr15,Bn56201,88599340,94391429,5792089,RLK
chr15,Bn56202,5242787,22480606,17237819,RLK
chr15,Bn56203,33979718,40691959,6712241,TNL
chr15,Bn56204,86232656,87945727,1713071,RLK
chr15,Bn56205,14661609,79817631,65156022,CN
chr15,Bn56206,21754147,91714392,69960245,TNL
chr15,Bn56207,63069369,72193393,9124024,CN
chr15,Bn56208,19472051,93559475,74087424,RLP
chr15,Bn56209,78921059,94868676,15947617,CN
chr15,Bn56210,93908666,97960435,4051769,NBS
chr15,Bn56211,47696543,86429005,38732462,CNL
chr15,Bn56212,19357374,50697999,31340625,RLK
chr15,Bn56213,8477901,83405560,74927659,TNL
chr15,Bn56214,32852228,33660331,808103,TNL
chr15,Bn56215,36395822,74618384,38222562,CNL
chr15,Bn56216,53366245,84407533,31041288,CNL
chr15,Bn56217,28992173,42594286,13602113,TNL
chr15,Bn56218,43560094,70912684,27352590,TNL
chr15,Bn56219,21529895,52526064,30996169,CNL
chr15,Bn56220,39399590,58145786,18746196,NBS
chr15,Bn56221,73845212,75895234,2050022,NBS
chr15,Bn56222,78508972,92540885,14031913,TNL
chr15,Bn56223,11110068,15279715,4169647,TNL
chr15,Bn56224,59402269,94901747,35499478,NBS
chr15,Bn56225,57340862,66240043,8899181,CN
chr15,Bn56226,26377302,81877551,55500249,TN
chr15,Bn56227,96074222,97739729,1665507,RLK
chr15,Bn56228,35835051,48413605,12578554,TN
chr15,Bn56229,49170688,99373501,50202813,NBS
chr15,Bn56230,21547154,81361877,59814723,NBS
chr15,Bn56231,94922614,98189873,3267259,CNL
chr15,Bn56232,53320559,74309917,20989358,NBS
chr15,Bn56233,23025594,77057410,54031816,RLP
chr15,Bn56234,5850073,5866257,16184,TN
chr15,Bn56235,35005219,77954881,42949662,TN
chr15,Bn56236,91723513,98452024,6728511,NBS
chr15,Bn56237,79088489,95655292,16566803,RLK
chr15,Bn56238,24546602,64506030,39959428,RLP
chr15,Bn56239,67967947,75382962,7415015,RLK
chr15,Bn56240,39644834,55174057,15529223,NBS
chr15,Bn56241,26029591,96940936,70911345,RLP
chr15,Bn56242,95507824,98464113,2956289,CNL
chr15,Bn56243,38791022,76332811,37541789,TN
chr15,Bn56244,55524645,58074279,2549634,TNL
chr15,Bn56245,78331618,81430925,3099307,TNL
chr15,Bn56246,96741199,99487380,2746181,NBS
chr15,Bn56247,58681346,85134791,26453445,RLK
chr15,Bn56248,3076646,76662752,73586106,TNL
chr15,Bn56249,11657363,21349133,9691770,RLK
chr15,Bn56250,76389334,78948248,2558914,RLP
chr15,Bn56251,10615462,36730107,26114645,NBS
chr15,Bn56252,41664232,49979845,8315613,TNL
chr15,Bn56253,27989511,83699053,55709542,CNL
chr15,Bn56254,45427089,85287684,39860595,RLP
chr15,Bn56255,3783932,16815708,13031776,CNL
chr15,Bn56256,12684165,39186117,26501952,TNL
chr15,Bn56257,79007822,98015900,19008078,CN
chr15,Bn56258,27022394,87933386,60910992,RLK
chr15,Bn56259,69567249,80461648,10894399,RLK
chr15,Bn56260,50853832,82308643,31454811,RLP
chr15,Bn56261,69621237,81523043,11901806,TNL
chr15,Bn56262,82053985,96947758,14893773,CN
chr15,Bn56263,93711352,94529692,818340,RLK
chr15,Bn56264,73783263,77098803,3315540,TN
chr15,Bn56265,5246659,57389793,52143134,CNL
chr15,Bn56266,31717982,90804494,59086512,TN
chr15,Bn56267,80824946,86694494,5869548,RLK
chr15,Bn56268,18598695,96518003,77919308,NBS
chr15,Bn56269,81644915,98711144,17066229,TNL
chr15,Bn56270,62883914,86942623,24058709,CN
chr15,Bn56271,56256963,58491937,2234974,NBS
chr15,Bn56272,3058181,32608459,29550278,CNL
chr15,Bn56273,79586165,91058137,11471972,RLK
chr15,Bn56274,91276936,98624402,7347466,CN
chr15,Bn56275,82669080,90473783,7804703,RLK
chr15,Bn56276,56108157,58234926,2126769,RLK
chr15,Bn56277,43998454,64749416,20750962,TNL
chr15,Bn56278,88522163,89381478,859315,TNL
chr15,Bn56279,37825840,64476869,26651029,NBS
chr15,Bn56280,76743273,94424415,17681142,NBS
chr15,Bn56281,74734966,84054846,9319880,TN
chr15,Bn56282,4982388,36312901,31330513,TNL
chr15,Bn56283,66407622,69534799,3127177,CN
chr15,Bn56284,56262983,74058730,17795747,RLK
chr15,Bn56285,92166284,96593552,4427268,NBS
chr15,Bn56286,67090215,92770692,25680477,TN
chr15,Bn56287,51565120,87420759,35855639,TN
chr15,Bn56288,87583773,95629938,8046165,TN
chr15,Bn56289,2304790,93727161,91422371,CN
chr15,Bn56290,85425831,96263808,10837977,TN
chr15,Bn56291,95477771,99045759,3567988,TNL
chr15,Bn56292,49250616,57021747,7771131,TN
chr15,Bn56293,20637340,95474690,74837350,TNL
chr15,Bn56294,40355714,44896095,4540381,TN
chr15,Bn56295,71969574,82525096,10555522,RLP
chr15,Bn56296,80057001,98452050,18395049,CN
chr15,Bn56297,71721345,97923389,26202044,CNL
chr15,Bn56298,2200380,52864163,50663783,RLK
chr15,Bn56299,1968496,82922710,80954214,TN
chr15,Bn56300,36811395,37742912,931517,TN
chr15,Bn56301,4554272,95410454,90856182,CNL
chr15,Bn56302,59992532,88795365,28802833,RLK
chr15,Bn56303,17392253,43416401,26024148,TNL
chr15,Bn56304,50366481,51827718,1461237,CNL
chr15,Bn56305,64018754,88268003,24249249,TN
chr15,Bn56306,60100218,92089735,31989517,NBS
chr15,Bn56307,43032716,58298933,15266217,TN
chr15,Bn56308,79338422,99989948,20651526,TN
chr15,Bn56309,78958131,92678964,13720833,CNL
chr15,Bn56310,5074183,37046417,31972234,CN
chr15,Bn56311,16291215,48918887,32627672,RLP
chr15,Bn56312,12278717,73857593,61578876,CN
chr15,Bn56313,14055301,80249084,66193783,RLK
chr15,Bn56314,38788964,85280267,46491303,NBS
chr15,Bn56315,46198333,90549276,44350943,TN
chr15,Bn56316,8841908,11282266,2440358,RLP
chr15,Bn56317,79720824,82055582,2334758,NBS
chr15,Bn56318,23252634,38708552,15455918,CNL
chr15,Bn56319,62914232,90395896,27481664,CN
chr15,Bn56320,49996935,61228174,11231239,CN
chr15,Bn56321,9813949,41973814,32159865,RLK
chr15,Bn56322,24406905,92954014,68547109,TNL
chr15,Bn56323,53553436,68992940,15439504,TNL
chr15,Bn56324,9195543,42702845,33507302,CN
chr15,Bn56325,89185176,94893450,5708274,RLK
chr15,Bn56326,98354404,99092438,738034,RLK
chr15,Bn56327,55465853,82091810,26625957,RLK
chr15,Bn56328,93971364,98309471,4338107,TNL
chr15,Bn56329,20587208,89671364,69084156,CNL
chr15,Bn56330,29144059,98610912,69466853,TN
chr15,Bn56331,31115689,67376059,36260370,TNL
chr15,Bn56332,87180703,98290778,11110075,RLP
chr15,Bn56333,21350191,31630504,10280313,NBS
chr15,Bn56334,21222709,53308381,32085672,RLK
chr15,Bn56335,50090419,56804767,6714348,TNL
chr15,Bn56336,17889110,40485645,22596535,TNL
chr15,Bn56337,45547348,54351469,8804121,RLP
chr15,Bn56338,30054824,32944236,2889412,CNL
chr15,Bn56339,75191314,87209762,12018448,RLP
chr15,Bn56340,23041582,49407459,26365877,CN
chr15,Bn56341,22805240,76355821,53550581,TN
chr15,Bn56342,73316373,88881502,15565129,RLK
chr15,Bn56343,37562784,39891144,2328360,TN
chr15,Bn56344,13642055,82650501,69008446,TN
chr15,Bn56345,68758780,93432729,24673949,TNL
chr15,Bn56346,5090390,76349192,71258802,TNL
chr15,Bn56347,42482888,67455773,24972885,RLP
chr15,Bn56348,82367627,87578665,5211038,TNL
chr15,Bn56349,98399044,98986798,587754,TN
chr15,Bn56350,28394634,95978324,67583690,NBS
chr15,Bn56351,54664956,64371790,9706834,RLK
chr15,Bn56352,81402481,91901233,10498752,TNL
chr15,Bn56353,93449804,98650958,5201154,RLP
chr15,Bn56354,43404142,94842330,51438188,NBS
chr15,Bn56355,34969482,73697777,38728295,CNL
chr15,Bn56356,98199267,98729578,530311,TNL
chr15,Bn56357,32504404,44301264,11796860,RLK
chr15,Bn56358,73151282,73240360,89078,NBS
chr15,Bn56359,84005250,90567978,6562728,NBS
chr15,Bn56360,43682829,75181481,31498652,CNL
chr15,Bn56361,1628026,91789187,90161161,CNL
chr15,Bn56362,35587589,70036039,34448450,NBS
chr15,Bn56363,90574355,97793239,7218884,NBS
chr15,Bn56364,47405563,86411687,39006124,TNL
chr15,Bn56365,45982032,80150326,34168294,TNL
chr15,Bn56366,89245145,96342541,7097396,CNL
chr15,Bn56367,66374796,99306007,32931211,TNL
chr15,Bn56368,54029703,94341304,40311601,NBS
chr15,Bn56369,80632818,85464141,4831323,NBS
chr15,Bn56370,44792651,77082512,32289861,TN
chr15,Bn56371,96193613,99733616,3540003,RLP
chr15,Bn56372,80224518,93566636,13342118,TNL
chr15,Bn56373,97887066,99795667,1908601,CNL
chr15,Bn56374,41482245,68650202,27167957,NBS
chr15,Bn56375,7845872,96172456,88326584,TN
chr15,Bn56376,78628869,86446967,7818098,NBS
chr15,Bn56377,35438640,70332186,34893546,NBS
chr15,Bn56378,53034106,96210816,43176710,CN
chr15,Bn56379,85764639,98095474,12330835,CNL
chr15,Bn56380,49176265,57587854,8411589,TN
chr15,Bn56381,58526521,71746460,13219939,CNL
chr15,Bn56382,40311148,80978663,40667515,TN
chr15,Bn56383,29471327,43491725,14020398,RLK
chr15,Bn56384,61450169,61794881,344712,RLK
chr15,Bn56385,58472613,71001682,12529069,CNL
chr15,Bn56386,65212848,79818464,14605616,NBS
chr15,Bn56387,39302483,74589733,35287250,TNL
chr15,Bn56388,13535537,69500403,55964866,TNL
chr15,Bn56389,86116458,87176023,1059565,RLK
chr15,Bn56390,10320457,93761114,83440657,RLP
chr15,Bn56391,39368123,96272147,56904024,CN
chr15,Bn56392,77072006,90285786,13213780,CN
chr15,Bn56393,43283306,92524622,49241316,RLP
chr15,Bn56394,4499617,29775270,25275653,TN
chr15,Bn56395,92740643,97117897,4377254,RLP
chr15,Bn56396,29036893,29860590,823697,RLK
chr15,Bn56397,71139795,88719051,17579256,CNL
chr15,Bn56398,44979094,55605476,10626382,CNL
chr15,Bn56399,19031990,59867451,40835461,NBS
chr15,Bn56400,95155845,99135308,3979463,NBS
chr15,Bn56401,30309539,95635939,65326400,NBS
chr15,Bn56402,67779122,96587270,28808148,RLK
chr15,Bn56403,92717118,93788111,1070993,CNL
chr15,Bn56404,15171079,53452557,38281478,CN
chr15,Bn56405,12238565,59893122,47654557,RLP
chr15,Bn56406,25363216,73826815,48463599,TNL
chr15,Bn56407,14788497,99221072,84432575,TN
chr15,Bn56408,42232830,81875581,39642751,RLP
chr15,Bn56409,73180504,85523491,12342987,NBS
chr15,Bn56410,1153510,89546600,88393090,TN
chr15,Bn56411,17598086,52308712,34710626,RLP
chr15,Bn56412,88668204,97436331,8768127,RLP
chr15,Bn56413,36675530,76595541,39920011,NBS
chr15,Bn56414,6684478,90625911,83941433,RLP
chr15,Bn56415,69141315,95479651,26338336,TNL
chr15,Bn56416,86532121,93777553,7245432,RLP
chr15,Bn56417,79608436,84353102,4744666,CNL
chr15,Bn56418,68899229,87775393,18876164,TN
chr15,Bn56419,79613294,89617962,10004668,NBS
chr15,Bn56420,6233818,8609854,2376036,RLK
chr15,Bn56421,68915266,74847343,5932077,RLP
chr15,Bn56422,4537047,9182057,4645010,CNL
chr15,Bn56423,53991774,64765554,10773780,TNL
chr15,Bn56424,49663773,50209101,545328,TNL
chr15,Bn56425,89893136,96559011,6665875,CNL
chr15,Bn56426,50462831,92150612,41687781,CNL
chr15,Bn56427,64176783,68234542,4057759,CNL
chr15,Bn56428,13247938,83031137,69783199,CNL
chr15,Bn56429,59696649,70933763,11237114,TNL
chr15,Bn56430,47846996,53695060,5848064,NBS
chr15,Bn56431,49382565,93020594,43638029,RLK
chr15,Bn56432,31013212,43980764,12967552,CNL
chr15,Bn56433,16859578,52309991,35450413,RLK
chr15,Bn56434,93512388,97357701,3845313,RLK
chr15,Bn56435,23695998,48631393,24935395,NBS
chr15,Bn56436,73829241,75075558,1246317,RLP
chr15,Bn56437,21206564,61690092,40483528,TN
chr15,Bn56438,38135797,48641923,10506126,TNL
chr15,Bn56439,80206996,92326645,12119649,NBS
chr15,Bn56440,62385464,63536893,1151429,CNL
chr15,Bn56441,79208961,80989953,1780992,CNL
chr15,Bn56442,52394711,53748492,1353781,CN
chr15,Bn56443,73726235,93964381,20238146,NBS
chr15,Bn56444,41464478,53255720,11791242,RLP
chr15,Bn56445,88493540,91707501,3213961,NBS
chr15,Bn56446,11396052,93813622,82417570,TNL
chr15,Bn56447,98672528,99873367,1200839,RLK
chr15,Bn56448,82884451,83041521,157070,CNL
chr15,Bn56449,97450606,97995349,544743,RLP
chr15,Bn56450,8591551,60266717,51675166,TN
chr15,Bn56451,35104646,51016909,15912263,RLP
chr15,Bn56452,76677835,91047733,14369898,CNL
chr15,Bn56453,79098788,84619267,5520479,RLK
chr15,Bn56454,61377678,95779313,34401635,TN
chr15,Bn56455,79571353,80003593,432240,CN
chr15,Bn56456,37371198,77705910,40334712,CN
chr15,Bn56457,32433328,94399365,61966037,CN
chr15,Bn56458,64691782,64767402,75620,TNL
chr15,Bn56459,21762578,25642952,3880374,TN
chr15,Bn56460,39925288,92000253,52074965,TNL
chr15,Bn56461,12966782,40962505,27995723,CN
chr15,Bn56462,52765186,93395829,40630643,CNL
chr15,Bn56463,64421469,97679119,33257650,NBS
chr15,Bn56464,91498977,96419222,4920245,CN
chr15,Bn56465,4030530,7957665,3927135,TN
chr15,Bn56466,65584611,68923101,3338490,RLK
chr15,Bn56467,25308035,33251028,7942993,RLK
chr15,Bn56468,22931280,70817494,47886214,RLP
chr15,Bn56469,16027722,68688319,52660597,RLP
chr15,Bn56470,33909838,83972361,50062523,CN
chr15,Bn56471,11092184,76357014,65264830,TN
chr15,Bn56472,3100489,69478762,66378273,CNL
chr15,Bn56473,83263517,94641685,11378168,CNL
chr15,Bn56474,64535613,81507663,16972050,NBS
chr15,Bn56475,21611310,91689787,70078477,RLK
chr15,Bn56476,60749197,88950812,28201615,RLK
chr15,Bn56477,13470494,82676180,69205686,CN
chr15,Bn56478,45728847,52733645,7004798,RLP
chr15,Bn56479,28668542,87779695,59111153,RLP
chr15,Bn56480,1200310,51998724,50798414,CN
chr15,Bn56481,58403302,88141868,29738566,CNL
chr15,Bn56482,84991937,94234380,9242443,NBS
chr15,Bn56483,58212317,59685025,1472708,TNL
chr15,Bn56484,46645974,48460723,1814749,CNL
chr15,Bn56485,49215655,53881770,4666115,RLP
chr15,Bn56486,89926725,99500370,9573645,NBS
chr15,Bn56487,20106472,43908481,23802009,CN
chr15,Bn56488,99311993,99466907,154914,NBS
chr15,Bn56489,40275235,60561991,20286756,RLP
chr15,Bn56490,3224934,55950531,52725597,NBS
chr15,Bn56491,87839621,94637670,6798049,RLK
chr15,Bn56492,61854415,84113760,22259345,RLK
chr15,Bn56493,75409480,97029314,21619834,CN
chr15,Bn56494,58933384,88538734,29605350,CN
chr15,Bn56495,30025296,58275714,28250418,CNL
chr15,Bn56496,29062282,77741079,48678797,RLP
chr15,Bn56497,54282638,66999876,12717238,NBS
chr15,Bn56498,15367693,25000842,9633149,CN
chr15,Bn56499,96786487,99009413,2222926,CN
chr15,Bn56500,60996468,79691131,18694663,TNL
chr15,Bn56501,36428279,57799100,21370821,CNL
chr15,Bn56502,83026653,91338667,8312014,CNL
chr15,Bn56503,44556363,91777945,47221582,TNL
chr15,Bn56504,58379722,77385664,19005942,TNL
chr15,Bn56505,7076650,39667619,32590969,TN
chr15,Bn56506,19331502,28097830,8766328,RLK
chr15,Bn56507,96533294,98085567,1552273,TN
chr15,Bn56508,93124589,95065563,1940974,RLP
chr15,Bn56509,51887897,87458514,35570617,TNL
chr15,Bn56510,82870987,95149772,12278785,CN
chr15,Bn56511,41029179,56856578,15827399,CNL
chr15,Bn56512,30125726,30540927,415201,RLK
chr15,Bn56513,98568703,99199529,630826,CNL
chr15,Bn56514,83520475,86520914,3000439,RLP
chr15,Bn56515,43055361,44387550,1332189,TNL
chr15,Bn56516,73493988,87168661,13674673,TNL
chr15,Bn56517,80177656,98155603,17977947,TN
chr15,Bn56518,39552948,48970549,9417601,CNL
chr15,Bn56519,53212504,76380723,23168219,CN
chr15,Bn56520,9821093,59209586,49388493,RLP
chr15,Bn56521,92758896,93788594,1029698,CN
chr15,Bn56522,47744000,86486404,38742404,CNL
chr15,Bn56523,13849482,29325123,15475641,CNL
chr15,Bn56524,78128585,84778854,6650269,TN
chr15,Bn56525,67414687,81700269,14285582,RLK
chr15,Bn56526,75517800,95346085,19828285,TNL
chr15,Bn56527,86535948,88889896,2353948,NBS
chr15,Bn56528,33271299,87162423,53891124,NBS
chr15,Bn56529,21685416,95358750,73673334,CN
chr15,Bn56530,85504315,95124336,9620021,CN
chr15,Bn56531,59801016,80624827,20823811,CN
chr15,Bn56532,32014032,92268359,60254327,TNL
chr15,Bn56533,26761493,75470833,48709340,RLK
chr15,Bn56534,45828434,75595387,29766953,NBS
chr15,Bn56535,76750491,90771252,14020761,NBS
chr15,Bn56536,7606264,66939562,59333298,RLK
chr15,Bn56537,92824508,95730708,2906200,NBS
chr15,Bn56538,70639607,87634983,16995376,TNL
chr15,Bn56539,22607873,77401819,54793946,TNL
chr15,Bn56540,92276768,99809787,7533019,RLK
chr15,Bn56541,98581885,98870013,288128,TN
chr15,Bn56542,20789904,31266349,10476445,TNL
chr15,Bn56543,81084040,83939781,2855741,NBS
chr15,Bn56544,12937915,57005034,44067119,TN
chr15,Bn56545,52891952,61767894,8875942,NBS
chr15,Bn56546,26198114,62681057,36482943,CN
chr15,Bn56547,90465568,94428990,3963422,NBS
chr15,Bn56548,74724096,83278965,8554869,CNL
chr15,Bn56549,77830129,84994092,7163963,CN
chr15,Bn56550,42466390,76617980,34151590,TNL
chr15,Bn56551,24989282,72930285,47941003,CNL
chr15,Bn56552,61351455,61389165,37710,TN
chr15,Bn56553,45660502,61550158,15889656,TN
chr15,Bn56554,15259439,64339651,49080212,RLP
chr15,Bn56555,54275417,58136874,3861457,RLK
chr15,Bn56556,97405965,99718681,2312716,RLK
chr15,Bn56557,85043659,90852490,5808831,CNL
chr15,Bn56558,72299633,99118909,26819276,RLP
chr15,Bn56559,73162228,92300897,19138669,TNL
chr15,Bn56560,30028420,85531007,55502587,RLK
chr15,Bn56561,50485671,62619510,12133839,CN
chr15,Bn56562,80782972,98905225,18122253,CN
chr15,Bn56563,92424886,95747718,3322832,RLP
chr15,Bn56564,11709994,88632155,76922161,TN
chr15,Bn56565,52490861,62416449,9925588,CN
chr15,Bn56566,75503143,79431298,3928155,TN
chr15,Bn56567,51519965,81203658,29683693,CNL
chr15,Bn56568,67825581,97899297,30073716,TN
chr15,Bn56569,1513847,35304884,33791037,TN
chr15,Bn56570,90530216,90656602,126386,TN
chr15,Bn56571,4571298,31541477,26970179,CN
chr15,Bn56572,46107883,47039407,931524,RLK
chr15,Bn56573,82274061,87333698,5059637,CNL
chr15,Bn56574,72446236,85303319,12857083,TN
chr15,Bn56575,91366325,91652665,286340,CN
chr15,Bn56576,14061206,97409474,83348268,NBS
chr15,Bn56577,62810152,66091744,3281592,RLK
chr15,Bn56578,44546903,64570948,20024045,CNL
chr15,Bn56579,75997344,84302898,8305554,RLP
chr15,Bn56580,39028860,98270324,59241464,CNL
chr15,Bn56581,96147542,97462959,1315417,RLP
chr15,Bn56582,79223984,94722890,15498906,TN
chr15,Bn56583,52754835,85915082,33160247,TN
chr15,Bn56584,44605804,55299726,10693922,CNL
chr15,Bn56585,95804404,98402097,2597693,TN
chr15,Bn56586,15237221,38483993,23246772,TNL
chr15,Bn56587,26407196,94019133,67611937,NBS
chr15,Bn56588,43180567,45345828,2165261,RLK
chr15,Bn56589,60916416,79868974,18952558,RLK
chr15,Bn56590,26693142,32831584,6138442,TN
chr15,Bn56591,42655278,73171543,30516265,CNL
chr15,Bn56592,94657600,97178366,2520766,RLP
chr15,Bn56593,24008807,57240768,33231961,NBS
chr15,Bn56594,95117498,98018659,2901161,TN
chr15,Bn56595,27940370,70214985,42274615,CN
chr15,Bn56596,51732641,84427301,32694660,CN
chr15,Bn56597,65461430,94574535,29113105,TNL
chr15,Bn56598,88647531,95115775,6468244,RLK
chr15,Bn56599,18077394,85884569,67807175,TNL
chr15,Bn56600,10428129,61055790,50627661,CNL
chr15,Bn56601,62542785,72416437,9873652,RLK
chr15,Bn56602,51241813,91302892,40061079,CN
chr15,Bn56603,64452457,88934615,24482158,NBS
chr15,Bn56604,56549792,77359038,20809246,TNL
chr15,Bn56605,68349642,94382689,26033047,TN
chr15,Bn56606,61797959,74678701,12880742,RLP
chr15,Bn56607,17852047,24260723,6408676,TN
chr15,Bn56608,93614169,97029313,3415144,NBS
chr15,Bn56609,41940572,92262627,50322055,TN
chr15,Bn56610,78939262,96322819,17383557,RLP
chr15,Bn56611,27024081,99399755,72375674,RLP
chr15,Bn56612,52490308,76712510,24222202,NBS
chr15,Bn56613,54653872,69536699,14882827,RLP
chr15,Bn56614,93736976,94492639,755663,RLP
chr15,Bn56615,2040733,33240339,31199606,RLK
chr15,Bn56616,18662321,71548865,52886544,TN
chr15,Bn56617,1948984,10460440,8511456,NBS
chr15,Bn56618,47319766,54567451,7247685,NBS
chr15,Bn56619,84522628,89475218,4952590,RLK
chr15,Bn56620,42182662,50376218,8193556,TN
chr15,Bn56621,6321923,52320854,45998931,RLK
chr15,Bn56622,21974530,99897381,77922851,CNL
chr15,Bn56623,10889385,25851193,14961808,TN
chr15,Bn56624,78228340,86986450,8758110,CNL
chr15,Bn56625,89169452,96847447,7677995,CNL
chr15,Bn56626,69410463,75665743,6255280,NBS
chr15,Bn56627,3332780,92455130,89122350,TNL
chr15,Bn56628,77472667,85028331,7555664,TN
chr15,Bn56629,89572680,91301820,1729140,RLK
chr15,Bn56630,24188607,52846739,28658132,TNL
chr15,Bn56631,29410992,33158572,3747580,NBS
chr15,Bn56632,21463198,70014271,48551073,RLK
chr15,Bn56633,25959045,54463889,28504844,CN
chr15,Bn56634,86854467,96041424,9186957,RLK
chr15,Bn56635,49453169,51656364,2203195,NBS
chr15,Bn56636,63906923,87795942,23889019,TN
chr15,Bn56637,4346665,76932416,72585751,NBS
chr15,Bn56638,94523154,95705885,1182731,CNL
chr15,Bn56639,65582704,97142415,31559711,CNL
chr15,Bn56640,60245669,70043395,9797726,TN
chr15,Bn56641,66156196,92803167,26646971,CNL
chr15,Bn56642,15347472,48103670,32756198,RLK
chr15,Bn56643,44076693,71272303,27195610,RLP
chr15,Bn56644,56498440,88936106,32437666,TNL
chr15,Bn56645,52752767,97749051,44996284,RLK
chr15,Bn56646,98676388,99480284,803896,TNL
chr15,Bn56647,32382974,79950201,47567227,TNL
chr15,Bn56648,6677014,88460870,81783856,CN
chr15,Bn56649,78914571,88128127,9213556,TNL
chr15,Bn56650,50283923,56705249,6421326,CN
chr15,Bn56651,83480171,85284276,1804105,CN
chr15,Bn56652,27096583,93125690,66029107,CN
chr15,Bn56653,47088230,91522426,44434196,CN
chr15,Bn56654,39115894,43468269,4352375,CNL
chr15,Bn56655,84203021,87948362,3745341,CN
chr15,Bn56656,8593324,90095575,81502251,CNL
chr15,Bn56657,93977577,97958998,3981421,TN
chr15,Bn56658,83183719,97290478,14106759,CNL
chr15,Bn56659,41138157,60222623,19084466,TN
chr15,Bn56660,70938617,97676684,26738067,RLP
chr15,Bn56661,24046810,34262057,10215247,CN
chr15,Bn56662,43618297,60559632,16941335,RLP
chr15,Bn56663,71692873,98051571,26358698,CN
chr15,Bn56664,79849444,98024371,18174927,RLP
chr15,Bn56665,64933850,90564751,25630901,CNL
chr15,Bn56666,44513571,64145642,19632071,TN
chr15,Bn56667,12343309,93571122,81227813,NBS
chr15,Bn56668,95123372,97717181,2593809,TNL
chr15,Bn56669,69497051,80086530,10589479,RLK
chr15,Bn56670,7494233,80487061,72992828,RLK
chr15,Bn56671,72568287,75004701,2436414,RLK
chr15,Bn56672,81287657,99917429,18629772,RLP
chr15,Bn56673,20428239,72811614,52383375,RLK
chr15,Bn56674,64889944,77951908,13061964,RLP
chr15,Bn56675,74513439,77186869,2673430,TN
chr15,Bn56676,81093792,88931274,7837482,TN
chr15,Bn56677,95508575,99280069,3771494,NBS
chr15,Bn56678,74271402,86475236,12203834,CNL
chr15,Bn56679,44462047,61471708,17009661,CN
chr15,Bn56680,13558921,67685820,54126899,CN
chr15,Bn56681,34923486,99809713,64886227,RLK
chr15,Bn56682,85940939,90710516,4769577,CNL
chr15,Bn56683,12000255,27286407,15286152,CN
chr15,Bn56684,33955494,56692010,22736516,RLP
chr15,Bn56685,4733308,54396707,49663399,TNL
chr15,Bn56686,84217753,95902562,11684809,CNL
chr15,Bn56687,35810615,74318813,38508198,NBS
chr15,Bn56688,2452531,60478003,58025472,TN
chr15,Bn56689,36425451,50893900,14468449,CN
chr15,Bn56690,17879485,34913110,17033625,TN
chr15,Bn56691,39564456,83573366,44008910,RLK
chr15,Bn56692,54253171,92604433,38351262,RLK
chr15,Bn56693,96386024,97640419,1254395,CN
chr15,Bn56694,93622139,94667072,1044933,NBS
chr15,Bn56695,93456978,97674608,4217630,NBS
chr15,Bn56696,55069171,80868773,25799602,CNL
chr15,Bn56697,84094488,99584597,15490109,RLP
chr15,Bn56698,20136970,66095664,45958694,RLP
chr15,Bn56699,16954498,93267698,76313200,RLK
chr15,Bn56700,69011691,84381379,15369688,TNL
chr15,Bn56701,84812495,86212300,1399805,TN
chr15,Bn56702,54878922,95108478,40229556,CNL
chr15,Bn56703,82350449,90162505,7812056,CN
chr15,Bn56704,82974773,89780004,6805231,RLP
chr15,Bn56705,97109873,98552116,1442243,CNL
chr15,Bn56706,5661826,76798977,71137151,RLK
chr15,Bn56707,68786271,89586180,20799909,TN
chr15,Bn56708,30617643,90564206,59946563,TN
chr15,Bn56709,45192695,82670505,37477810,CNL
chr15,Bn56710,72070104,88551772,16481668,CN
chr15,Bn56711,5550000,34096814,28546814,TNL
chr15,Bn56712,10722169,41974911,31252742,NBS
chr15,Bn56713,57018755,80555986,23537231,TNL
chr15,Bn56714,50008685,94626934,44618249,TN
chr15,Bn56715,63355859,97159574,33803715,CN
chr15,Bn56716,24631118,88334595,63703477,TN
chr15,Bn56717,99975719,99996248,20529,TNL
chr15,Bn56718,28777989,82039891,53261902,TNL
chr15,Bn56719,33735009,77233691,43498682,TN
chr15,Bn56720,28216556,69998265,41781709,TNL
chr15,Bn56721,81627209,91907457,10280248,RLK
chr15,Bn56722,82448789,99829988,17381199,RLK
chr15,Bn56723,21721976,38462005,16740029,RLP
chr15,Bn56724,75066793,87446732,12379939,TNL
chr15,Bn56725,19231523,71682739,52451216,CNL
chr15,Bn56726,87282674,90852388,3569714,CN
chr15,Bn56727,54807737,66007820,11200083,CNL
chr15,Bn56728,61954597,93024571,31069974,RLP
chr15,Bn56729,29499860,84327189,54827329,TN
chr15,Bn56730,20321913,62456278,42134365,TNL
chr15,Bn56731,2545590,78080423,75534833,TN
chr15,Bn56732,72471668,78865917,6394249,CNL
chr15,Bn56733,21956554,60974437,39017883,CNL
chr15,Bn56734,52413307,85723127,33309820,RLP
chr15,Bn56735,18789536,69445321,50655785,CNL
chr15,Bn56736,76536573,83719117,7182544,TN
chr15,Bn56737,24003041,49721763,25718722,CN
chr15,Bn56738,25660694,28131199,2470505,RLK
chr15,Bn56739,34944226,51785760,16841534,CNL
chr15,Bn56740,79023619,86659371,7635752,RLP
chr15,Bn56741,23514425,26557453,3043028,CNL
chr15,Bn56742,59247400,83005581,23758181,TNL
chr15,Bn56743,71011425,93581454,22570029,RLK
chr15,Bn56744,79845939,90576672,10730733,TN
chr15,Bn56745,85691670,92730829,7039159,NBS
chr15,Bn56746,28362166,66548218,38186052,CNL
chr15,Bn56747,3746567,4846751,1100184,CNL
chr15,Bn56748,50115786,61692594,11576808,NBS
chr15,Bn56749,25199891,77321649,52121758,CNL
chr15,Bn56750,35406467,90931436,55524969,TN
chr15,Bn56751,50708659,54755632,4046973,TNL
chr15,Bn56752,36118555,82530403,46411848,CNL
chr15,Bn56753,68713949,90264900,21550951,CN
chr15,Bn56754,13543393,56391290,42847897,RLK
chr15,Bn56755,27891283,82373263,54481980,CN
chr15,Bn56756,63287085,82643530,19356445,CN
chr15,Bn56757,95215154,98276193,3061039,CNL
chr15,Bn56758,39396531,40539609,1143078,TN
chr15,Bn56759,99296990,99767527,470537,CN
chr15,Bn56760,38247317,73267035,35019718,TNL
chr15,Bn56761,37494023,96526015,59031992,CNL
chr15,Bn56762,50945450,63613167,12667717,CN
chr15,Bn56763,48595625,88988897,40393272,NBS
chr15,Bn56764,68162140,76753610,8591470,RLK
chr15,Bn56765,85265282,91051959,5786677,TN
chr15,Bn56766,56146167,95656291,39510124,TN
chr15,Bn56767,85046190,94649655,9603465,RLK
chr15,Bn56768,37427488,39220818,1793330,RLP
chr15,Bn56769,12259195,74395966,62136771,NBS
chr15,Bn56770,58563723,67707032,9143309,CNL
chr15,Bn56771,76925372,79804779,2879407,TN
chr15,Bn56772,13122005,93949338,80827333,TNL
chr15,Bn56773,49153308,66105425,16952117,RLP
chr15,Bn56774,42203865,71755126,29551261,CN
chr15,Bn56775,54106674,80472118,26365444,CN
chr15,Bn56776,27077607,35771662,8694055,TNL
chr15,Bn56777,42342858,66755921,24413063,CNL
chr15,Bn56778,79953866,86700240,6746374,RLP
chr15,Bn56779,39868604,71650342,31781738,CN
chr15,Bn56780,82552774,85627471,3074697,RLK
chr15,Bn56781,69185778,80872657,11686879,NBS
chr15,Bn56782,22254713,95155636,72900923,RLK
chr15,Bn56783,36298390,54809074,18510684,CNL
chr15,Bn56784,46890118,50769331,3879213,RLK
chr15,Bn56785,43030942,74929617,31898675,CNL
chr15,Bn56786,20940495,94393805,73453310,TNL
chr15,Bn56787,49883947,80851048,30967101,CN
chr15,Bn56788,9833367,56180869,46347502,CNL
chr15,Bn56789,62350835,93037344,30686509,RLK
chr15,Bn56790,64598602,81985218,17386616,CN
chr15,Bn56791,99244370,99816677,572307,CN
chr15,Bn56792,20626732,94080398,73453666,NBS
chr15,Bn56793,20361858,65995218,45633360,CNL
chr15,Bn56794,26357985,35022655,8664670,NBS
chr15,Bn56795,64480715,65358087,877372,RLP
chr15,Bn56796,5751867,48338966,42587099,CN
chr15,Bn56797,84582271,85801739,1219468,TNL
chr15,Bn56798,10362400,15537502,5175102,NBS
chr15,Bn56799,63614752,92919301,29304549,TN
chr15,Bn56800,7478447,64106287,56627840,NBS
chr15,Bn56801,98355478,99356215,1000737,CN
chr15,Bn56802,20908011,89498716,68590705,RLK
chr15,Bn56803,81698181,95359993,13661812,TN
chr15,Bn56804,93010337,97303385,4293048,RLK
chr15,Bn56805,77964557,97181268,19216711,CNL
chr15,Bn56806,29171268,48805975,19634707,RLK
chr15,Bn56807,3673161,99205800,95532639,RLK
chr15,Bn56808,99144040,99937455,793415,TN
chr15,Bn56809,60782314,73140017,12357703,RLK
chr15,Bn56810,26500089,70916022,44415933,CN
chr15,Bn56811,80383871,86991798,6607927,CN
chr15,Bn56812,45578862,48998149,3419287,TNL
chr15,Bn56813,46353607,66780609,20427002,CNL
chr15,Bn56814,53220796,83741702,30520906,RLP
chr15,Bn56815,71373174,94498911,23125737,NBS
chr15,Bn56816,44623621,63124795,18501174,CN
chr15,Bn56817,17107949,59700060,42592111,CNL
chr15,Bn56818,23779014,57193878,33414864,CNL
chr15,Bn56819,36549834,43854967,7305133,CN
chr15,Bn56820,58322044,76416041,18093997,TN
chr15,Bn56821,69198360,85907422,16709062,RLK
chr15,Bn56822,29378127,97190742,67812615,TN
chr15,Bn56823,49104531,82196038,33091507,RLP
chr15,Bn56824,73922233,75975958,2053725,CNL
chr15,Bn56825,12295733,98454586,86158853,CNL
chr15,Bn56826,20863824,84221762,63357938,RLP
chr15,Bn56827,51795770,73265136,21469366,CN
chr15,Bn56828,19818802,87158453,67339651,NBS
chr15,Bn56829,28176081,39225914,11049833,RLK
chr15,Bn56830,34895487,88126591,53231104,CN
chr15,Bn56831,52415463,69271892,16856429,NBS
chr15,Bn56832,33843818,60928157,27084339,RLP
chr15,Bn56833,22236060,69541606,47305546,RLK
chr15,Bn56834,83240845,96553070,13312225,RLK
chr15,Bn56835,75323888,95944192,20620304,TN
chr15,Bn56836,50074609,57289637,7215028,RLK
chr15,Bn56837,25305690,56400062,31094372,TN
chr15,Bn56838,73008447,99200425,26191978,RLP
chr15,Bn56839,43722434,56914148,13191714,CN
chr15,Bn56840,60591168,97255301,36664133,NBS
chr15,Bn56841,82511854,97283298,14771444,RLP
chr15,Bn56842,66998985,70935439,3936454,CN
chr15,Bn56843,73777823,90906285,17128462,TNL
chr15,Bn56844,72946767,95133198,22186431,RLK
chr15,Bn56845,11797020,50876497,39079477,RLK
chr15,Bn56846,99629554,99753914,124360,TN
chr15,Bn56847,53871350,78381756,24510406,RLK
chr15,Bn56848,54574235,56447551,1873316,NBS
chr15,Bn56849,27123702,80919665,53795963,RLP
chr15,Bn56850,82366848,92032326,9665478,RLP
chr15,Bn56851,33499249,71213385,37714136,NBS
chr15,Bn56852,85758971,96057288,10298317,RLK
chr15,Bn56853,45646706,52391614,6744908,RLP
chr15,Bn56854,72767987,84435158,11667171,TNL
chr15,Bn56855,36522143,64582778,28060635,RLK
chr15,Bn56856,34994104,93175056,58180952,RLK
chr15,Bn56857,50764064,86507822,35743758,CNL
chr15,Bn56858,41486847,89598610,48111763,RLK
chr15,Bn56859,78042552,84624918,6582366,TNL
chr15,Bn56860,60399465,88957232,28557767,CN
chr15,Bn56861,78530151,86224797,7694646,TN
chr15,Bn56862,29394898,38849500,9454602,RLK
chr15,Bn56863,91036688,99640807,8604119,RLK
chr15,Bn56864,35643622,62367983,26724361,NBS
chr15,Bn56865,40320402,94876921,54556519,CNL
chr15,Bn56866,36856718,39441308,2584590,TNL
chr15,Bn56867,26856392,32123684,5267292,TN
chr15,Bn56868,81629767,90283724,8653957,NBS
chr15,Bn56869,62903812,66065953,3162141,TN
chr15,Bn56870,66172088,86754268,20582180,RLK
chr15,Bn56871,30506653,34102165,3595512,CN
chr15,Bn56872,96652047,98628408,1976361,CNL
chr15,Bn56873,82485833,93128026,10642193,RLK
chr15,Bn56874,97422702,99798653,2375951,TNL
chr15,Bn56875,23714370,24578110,863740,TN
chr15,Bn56876,88125902,93058105,4932203,NBS
chr15,Bn56877,40035020,44115468,4080448,TN
chr15,Bn56878,50858164,67161057,16302893,RLP
chr15,Bn56879,79259940,80630710,1370770,CNL
chr15,Bn56880,14587488,45770829,31183341,NBS
chr15,Bn56881,86328651,99774218,13445567,RLK
chr15,Bn56882,58473908,70822796,12348888,TN
chr15,Bn56883,99328575,99636669,308094,CNL
chr15,Bn56884,44070558,73197737,29127179,TN
chr15,Bn56885,4668162,21860486,17192324,TNL
chr15,Bn56886,81329171,85112486,3783315,TNL
chr15,Bn56887,90277039,93657395,3380356,NBS
chr15,Bn56888,63006194,90699040,27692846,RLK
chr15,Bn56889,91381387,99521033,8139646,CNL
chr15,Bn56890,95466589,97667342,2200753,CNL
chr15,Bn56891,44448137,62206622,17758485,CNL
chr15,Bn56892,60714414,72417318,11702904,RLP
chr15,Bn56893,33016822,97802281,64785459,CN
chr15,Bn56894,20303614,47471828,27168214,CN
chr15,Bn56895,13903244,60058882,46155638,RLP
chr15,Bn56896,80702830,88128218,7425388,NBS
chr15,Bn56897,83563290,93234876,9671586,NBS
chr15,Bn56898,12730427,56105111,43374684,RLK
chr15,Bn56899,16779856,94860294,78080438,CNL
chr15,Bn56900,69615985,72708961,3092976,RLP
chr15,Bn56901,38944921,74272354,35327433,TN
chr15,Bn56902,85398081,93366702,7968621,NBS
chr15,Bn56903,90533740,99911562,9377822,RLK
chr15,Bn56904,21438422,50659024,29220602,TNL
chr15,Bn56905,5646578,16083466,10436888,NBS
chr15,Bn56906,70783389,78561064,7777675,CN
chr15,Bn56907,72293248,93445657,21152409,RLP
chr15,Bn56908,18204394,49463925,31259531,CN
chr15,Bn56909,50451789,94542122,44090333,RLK
chr15,Bn56910,61340916,62586615,1245699,TN
chr15,Bn56911,7263406,40377756,33114350,RLP
chr15,Bn56912,54597582,68327630,13730048,CNL
chr15,Bn56913,1649078,81004165,79355087,TNL
chr15,Bn56914,87509288,89089776,1580488,RLP
chr15,Bn56915,4644979,12696960,8051981,RLP
chr15,Bn56916,96852787,98145341,1292554,TNL
chr15,Bn56917,10963425,98082181,87118756,RLK
chr15,Bn56918,50716035,93534363,42818328,NBS
chr15,Bn56919,59892720,78437676,18544956,TN
chr15,Bn56920,28183507,85554252,57370745,TNL
chr15,Bn56921,91998222,94290092,2291870,CNL
chr15,Bn56922,99547395,99618761,71366,RLP
chr15,Bn56923,11772644,87597127,75824483,CNL
chr15,Bn56924,46000591,70250720,24250129,NBS
chr15,Bn56925,12121924,85707917,73585993,CN
chr15,Bn56926,37701734,53429696,15727962,TNL
chr15,Bn56927,96072239,96173063,100824,CNL
chr15,Bn56928,98475348,98782544,307196,TN
chr15,Bn56929,37139291,60889968,23750677,TN
chr15,Bn56930,66760797,73492916,6732119,RLK
chr15,Bn56931,38786824,96793643,58006819,RLP
chr15,Bn56932,35398120,94356905,58958785,TN
chr15,Bn56933,59153221,61236269,2083048,CNL
chr15,Bn56934,16279881,74843101,58563220,RLP
chr15,Bn56935,51182439,98787541,47605102,TNL
chr15,Bn56936,26111913,78279944,52168031,TNL
chr15,Bn56937,70783279,81859433,11076154,CNL
chr15,Bn56938,38236619,62402488,24165869,RLK
chr15,Bn56939,62869588,99969232,37099644,RLK
chr15,Bn56940,1705862,12185258,10479396,CN
chr15,Bn56941,3612173,9968848,6356675,TNL
chr15,Bn56942,58593396,79767825,21174429,NBS
chr15,Bn56943,29787223,85023580,55236357,RLP
chr15,Bn56944,88915419,98912791,9997372,TNL
chr15,Bn56945,56927231,83261948,26334717,RLP
chr15,Bn56946,70623851,88291365,17667514,TNL
chr15,Bn56947,61340270,84549684,23209414,CNL
chr15,Bn56948,14785202,62131527,47346325,RLP
chr15,Bn56949,17928392,33991245,16062853,RLK
chr15,Bn56950,42806039,73484874,30678835,TNL
chr15,Bn56951,26832965,98904551,72071586,TN
chr15,Bn56952,64936274,69001275,4065001,RLK
chr15,Bn56953,92643802,98991891,6348089,RLP
chr15,Bn56954,20713848,32463834,11749986,CN
chr15,Bn56955,6022595,96767380,90744785,RLP
chr15,Bn56956,96310371,97915029,1604658,TN
chr15,Bn56957,43067192,99633808,56566616,TNL
chr15,Bn56958,94491353,98597784,4106431,TNL
chr15,Bn56959,91868564,99418437,7549873,CNL
chr15,Bn56960,8098685,77410324,69311639,CNL
chr15,Bn56961,46033758,70235461,24201703,CN
chr15,Bn56962,76784475,94781197,17996722,TNL
chr15,Bn56963,32466591,82029611,49563020,TN
chr15,Bn56964,2151327,37152801,35001474,RLP
chr15,Bn56965,48082458,73896377,25813919,CN
chr15,Bn56966,58950473,72802510,13852037,CNL
chr15,Bn56967,50474851,95381356,44906505,CNL
chr15,Bn56968,55947311,92857521,36910210,CN
chr15,Bn56969,45231639,67194745,21963106,CNL
chr15,Bn56970,74078088,92284086,18205998,CN
chr15,Bn56971,21339586,83016864,61677278,CN
chr15,Bn56972,31895834,76969490,45073656,TN
chr15,Bn56973,16559758,53542727,36982969,CN
chr15,Bn56974,9230125,70388196,61158071,NBS
chr15,Bn56975,34059343,36520921,2461578,CNL
chr15,Bn56976,80190988,83151383,2960395,CNL
chr15,Bn56977,59933334,69487310,9553976,NBS
chr15,Bn56978,77859186,88651715,10792529,RLK
chr15,Bn56979,24747899,50419205,25671306,RLP
chr15,Bn56980,87282266,97131641,9849375,TNL
chr15,Bn56981,15959738,93824323,77864585,CN
chr15,Bn56982,93401191,94498995,1097804,CNL
chr15,Bn56983,81685668,91135305,9449637,TNL
chr15,Bn56984,69678692,85437314,15758622,RLK
chr15,Bn56985,32342486,41269740,8927254,TNL
chr15,Bn56986,98339630,98710966,371336,TN
chr15,Bn56987,25308237,57771664,32463427,RLK
chr15,Bn56988,57747932,75123623,17375691,TNL
chr15,Bn56989,58273918,86766768,28492850,RLK
chr15,Bn56990,71637555,85906727,14269172,TN
chr15,Bn56991,54115567,90290846,36175279,TNL
chr15,Bn56992,30802793,43133029,12330236,NBS
chr15,Bn56993,1006648,31778502,30771854,TN
chr15,Bn56994,51789172,95095704,43306532,CNL
chr15,Bn56995,45190530,46031623,841093,TN
chr15,Bn56996,62036689,87353782,25317093,RLK
chr15,Bn56997,73321551,78963621,5642070,CNL
chr15,Bn56998,97767964,99730008,1962044,RLP
chr15,Bn56999,62655548,66660888,4005340,TNL
chr15,Bn57000,75731528,89886597,14155069,CN
chr15,Bn57001,59789246,73685584,13896338,CN
chr15,Bn57002,55777637,87293670,31516033,CN
chr15,Bn57003,13562136,22400220,8838084,NBS
chr15,Bn57004,92415645,95015710,2600065,TNL
chr15,Bn57005,61529537,89198532,27668995,TNL
chr15,Bn57006,98763951,99852874,1088923,CN
chr15,Bn57007,95556426,95717372,160946,NBS
chr15,Bn57008,9613041,75784499,66171458,CN
chr15,Bn57009,46109719,95834777,49725058,NBS
chr15,Bn57010,53967156,56564222,2597066,CNL
chr15,Bn57011,55697667,82298586,26600919,RLP
chr15,Bn57012,16256954,19343886,3086932,TN
chr15,Bn57013,27657775,45961141,18303366,RLP
chr15,Bn57014,79516550,85631821,6115271,RLP
chr15,Bn57015,95590149,96073254,483105,RLK
chr15,Bn57016,17010084,63217416,46207332,CNL
chr15,Bn57017,55555580,77689531,22133951,TNL
chr15,Bn57018,64989261,93720804,28731543,CN
chr15,Bn57019,33609403,74674135,41064732,RLP
chr15,Bn57020,13645621,96964955,83319334,TN
chr15,Bn57021,93553679,97558663,4004984,TNL
chr15,Bn57022,44875069,79880503,35005434,NBS
chr15,Bn57023,2875385,85811057,82935672,NBS
chr15,Bn57024,2087754,98821000,96733246,CNL
chr15,Bn57025,3519622,53987782,50468160,RLP
chr15,Bn57026,67709006,85601884,17892878,CNL
chr15,Bn57027,91064656,94799459,3734803,RLP
chr15,Bn57028,4561880,96707607,92145727,TN
chr15,Bn57029,73931819,89610218,15678399,RLK
chr15,Bn57030,68164705,78820431,10655726,TN
chr15,Bn57031,32708826,68806683,36097857,RLP
chr15,Bn57032,22094482,82700048,60605566,TN
chr15,Bn57033,48178894,75919834,27740940,TN
chr15,Bn57034,27677078,64609752,36932674,CNL
chr15,Bn57035,43730890,85248345,41517455,CN
chr15,Bn57036,55434328,73030523,17596195,RLK
chr15,Bn57037,31369104,66864454,35495350,TN
chr15,Bn57038,24474830,69854876,45380046,NBS
chr15,Bn57039,65965705,95674487,29708782,RLP
chr15,Bn57040,43665053,80566518,36901465,RLP
chr15,Bn57041,81488255,98600635,17112380,RLP
chr15,Bn57042,5101477,17293962,12192485,TN
chr15,Bn57043,28857533,97058609,68201076,RLK
chr15,Bn57044,23825858,87485259,63659401,TNL
chr15,Bn57045,43036272,99739047,56702775,CN
chr15,Bn57046,99580485,99672765,92280,NBS
chr15,Bn57047,8429014,71032995,62603981,RLK
chr15,Bn57048,64890867,67664555,2773688,NBS
chr15,Bn57049,52200505,88598062,36397557,RLK
chr15,Bn57050,88987488,89081865,94377,CN
chr15,Bn57051,32123021,89275080,57152059,CN
chr15,Bn57052,69976732,79009802,9033070,CNL
chr15,Bn57053,36801321,77049133,40247812,TN
chr15,Bn57054,55662450,71341168,15678718,RLP
chr15,Bn57055,5964341,82358209,76393868,CNL
chr15,Bn57056,36204518,47763309,11558791,TN
chr15,Bn57057,89925034,97178579,7253545,CNL
chr15,Bn57058,91965704,99646919,7681215,TN
chr15,Bn57059,73791993,90870462,17078469,NBS
chr15,Bn57060,57776283,93660638,35884355,CNL
chr15,Bn57061,33730055,81489447,47759392,CN
chr15,Bn57062,41725315,47150942,5425627,NBS
chr15,Bn57063,88410331,98681991,10271660,RLP
chr15,Bn57064,98371299,99065502,694203,NBS
chr15,Bn57065,59560472,91829014,32268542,CNL
chr15,Bn57066,25718324,99354821,73636497,CNL
chr15,Bn57067,53461088,79768380,26307292,NBS
chr15,Bn57068,95250181,96432402,1182221,RLK
chr15,Bn57069,40084617,48447695,8363078,TN
chr15,Bn57070,62465522,75011665,12546143,RLP
chr15,Bn57071,44939391,51565911,6626520,RLP
chr15,Bn57072,43143663,91182606,48038943,NBS
chr15,Bn57073,83455499,84270191,814692,TN
chr15,Bn57074,2863326,95335710,92472384,CNL
chr15,Bn57075,94249431,94500018,250587,TN
chr15,Bn57076,93209462,97054888,3845426,NBS
chr15,Bn57077,2687627,71716136,69028509,TNL
chr15,Bn57078,20465357,74697857,54232500,TNL
chr15,Bn57079,82359414,97828361,15468947,TNL
chr15,Bn57080,89399323,93868867,4469544,RLK
chr15,Bn57081,41796326,62451682,20655356,TNL
chr15,Bn57082,38447304,97750308,59303004,CNL
chr15,Bn57083,20658074,90369181,69711107,TNL
chr15,Bn57084,99431146,99683850,252704,TN
chr15,Bn57085,17816607,18250779,434172,TN
chr15,Bn57086,74536338,82344459,7808121,CNL
chr15,Bn57087,56124288,92497849,36373561,TN
chr15,Bn57088,30201398,41592583,11391185,RLP
chr15,Bn57089,6679477,76784849,70105372,CN
chr15,Bn57090,71933056,93097321,21164265,TNL
chr15,Bn57091,46738082,50772555,4034473,TNL
chr15,Bn57092,65907003,71120528,5213525,CNL
chr15,Bn57093,22211036,91563216,69352180,RLK
chr15,Bn57094,1019844,69860486,68840642,RLP
chr15,Bn57095,15790488,30414594,14624106,TNL
chr15,Bn57096,36029580,43211116,7181536,RLP
chr15,Bn57097,87544830,96982986,9438156,TN
chr15,Bn57098,11128485,21037917,9909432,TNL
chr15,Bn57099,62872862,90817889,27945027,NBS
chr15,Bn57100,60578158,73880613,13302455,RLP
chr15,Bn57101,26257021,52551944,26294923,RLP
chr15,Bn57102,57723526,62038338,4314812,TNL
chr15,Bn57103,21797948,74469892,52671944,NBS
chr15,Bn57104,83785396,97228108,13442712,TN
chr15,Bn57105,70437415,88410787,17973372,RLK
chr15,Bn57106,2720716,4588437,1867721,RLK
chr15,Bn57107,81688507,91765685,10077178,CNL
chr15,Bn57108,12792361,37026391,24234030,NBS
chr15,Bn57109,1649473,66661335,65011862,RLK
chr15,Bn57110,53100985,70266792,17165807,TN
chr15,Bn57111,82595860,96789945,14194085,TN
chr15,Bn57112,3302790,50877482,47574692,RLP
chr15,Bn57113,12514993,46440858,33925865,RLK
chr15,Bn57114,91950477,93383406,1432929,RLK
chr15,Bn57115,48051867,90109744,42057877,CN
chr15,Bn57116,69568170,77157772,7589602,RLP
chr15,Bn57117,56244821,79709755,23464934,TNL
chr15,Bn57118,6930825,69828434,62897609,TNL
chr15,Bn57119,31829882,94962227,63132345,TNL
chr15,Bn57120,95179635,97232950,2053315,NBS
chr15,Bn57121,6295220,90960306,84665086,RLK
chr15,Bn57122,70572239,73752232,3179993,CN
chr15,Bn57123,33021953,55668343,22646390,RLK
chr15,Bn57124,43764354,52093679,8329325,RLK
chr15,Bn57125,1129645,25825607,24695962,CN
chr15,Bn57126,22938976,60138691,37199715,TN
chr15,Bn57127,78820986,88322845,9501859,NBS
chr15,Bn57128,56132753,94068676,37935923,NBS
chr15,Bn57129,94153485,95105759,952274,TN
chr15,Bn57130,41935647,51659114,9723467,NBS
chr15,Bn57131,30031983,46384584,16352601,RLP
chr15,Bn57132,96918699,98612468,1693769,TNL
chr15,Bn57133,90057587,99993562,9935975,RLK
chr15,Bn57134,38979663,78913058,39933395,TNL
chr15,Bn57135,43884015,93937104,50053089,TNL
chr15,Bn57136,35460882,43572900,8112018,CNL
chr15,Bn57137,99232946,99750531,517585,CNL
chr15,Bn57138,45173427,74082044,28908617,RLK
chr15,Bn57139,99123583,99576223,452640,TN
chr15,Bn57140,43607155,56057681,12450526,CN
chr15,Bn57141,52246818,71931161,19684343,CN
chr15,Bn57142,41434723,97726753,56292030,TN
chr15,Bn57143,84854892,97771807,12916915,NBS
chr15,Bn57144,32961395,40921516,7960121,CNL
chr15,Bn57145,50130022,52799558,2669536,CN
chr15,Bn57146,99879319,99994181,114862,CNL
chr15,Bn57147,72663489,80776526,8113037,TNL
chr15,Bn57148,46046398,62490997,16444599,CN
chr15,Bn57149,18935581,62314270,43378689,RLP
chr15,Bn57150,21200435,25831883,4631448,CNL
chr15,Bn57151,14844496,57105855,42261359,CN
chr15,Bn57152,54881691,73191235,18309544,RLP
chr15,Bn57153,13141263,36161113,23019850,TN
chr15,Bn57154,95607097,97147486,1540389,NBS
chr15,Bn57155,39047027,50978015,11930988,RLK
chr15,Bn57156,39855852,93872882,54017030,RLP
chr15,Bn57157,54805035,93521447,38716412,RLP
chr15,Bn57158,84601979,90497184,5895205,CNL
chr15,Bn57159,27082879,90179047,63096168,RLK
chr15,Bn57160,58069286,66160951,8091665,TN
chr15,Bn57161,90934407,96960954,6026547,TN
chr15,Bn57162,72747031,81040488,8293457,CNL
chr15,Bn57163,55110886,96236019,41125133,RLK
chr15,Bn57164,84719774,93743322,9023548,TN
chr15,Bn57165,83263509,86503653,3240144,RLK
chr15,Bn57166,79614798,80416157,801359,NBS
chr15,Bn57167,81017744,93490594,12472850,CNL
chr15,Bn57168,11673215,63347852,51674637,TN
chr15,Bn57169,17750555,90495958,72745403,TNL
chr15,Bn57170,9019301,47166142,38146841,NBS
chr15,Bn57171,65159814,93658009,28498195,TN
chr15,Bn57172,60175370,94969831,34794461,NBS
chr15,Bn57173,36382396,87876086,51493690,RLK
chr15,Bn57174,18212393,90018956,71806563,TN
chr15,Bn57175,25305147,90542232,65237085,RLK
chr15,Bn57176,71232707,98669382,27436675,TNL
chr15,Bn57177,13681629,71564344,57882715,CNL
chr15,Bn57178,58093521,90832920,32739399,NBS
chr15,Bn57179,26254906,67907028,41652122,RLK
chr15,Bn57180,52109817,69792105,17682288,TNL
chr15,Bn57181,54684350,56458339,1773989,RLP
chr15,Bn57182,41001777,68798575,27796798,TNL
chr15,Bn57183,53729307,91775533,38046226,CNL
chr15,Bn57184,50489742,92773326,42283584,NBS
chr15,Bn57185,57463639,64785888,7322249,TNL
chr15,Bn57186,57694553,59061497,1366944,RLK
chr15,Bn57187,81337122,90040169,8703047,CN
chr15,Bn57188,28852473,91785521,62933048,RLK
chr15,Bn57189,72880547,91781800,18901253,TNL
chr15,Bn57190,53407938,96232358,42824420,CNL
chr15,Bn57191,87256677,91251638,3994961,RLP
chr15,Bn57192,80556526,85897322,5340796,CNL
chr15,Bn57193,59277970,66085301,6807331,NBS
chr15,Bn57194,26892800,54826832,27934032,NBS
chr15,Bn57195,40385288,51256828,10871540,TN
chr15,Bn57196,95554295,99767699,4213404,CN
chr15,Bn57197,64739303,64953823,214520,TNL
chr15,Bn57198,98943144,99074119,130975,TN
chr15,Bn57199,91088689,94978732,3890043,CNL
chr15,Bn57200,87365913,92487893,5121980,CN
chr15,Bn57201,93919785,99221250,5301465,RLP
chr15,Bn57202,87965044,93962848,5997804,CN
chr15,Bn57203,81744758,96157302,14412544,CNL
chr15,Bn57204,18121156,50405807,32284651,RLP
chr15,Bn57205,14844894,38301603,23456709,NBS
chr15,Bn57206,41629285,89266708,47637423,CN
chr15,Bn57207,50859248,92311702,41452454,CNL
chr15,Bn57208,22502363,83812769,61310406,TNL
chr15,Bn57209,98455934,99444401,988467,TN
chr15,Bn57210,58081565,86588085,28506520,CNL
chr15,Bn57211,80562576,87344404,6781828,CNL
chr15,Bn57212,50568284,93056360,42488076,RLK
chr15,Bn57213,44435456,62726128,18290672,TN
chr15,Bn57214,68636680,77016893,8380213,TNL
chr15,Bn57215,60086872,64637210,4550338,RLP
chr15,Bn57216,15991736,79099025,63107289,RLP
chr15,Bn57217,97940070,99173805,1233735,RLP
chr15,Bn57218,47113760,85413190,38299430,RLP
chr15,Bn57219,49579609,80463994,30884385,TNL
chr15,Bn57220,56636058,69639297,13003239,CN
chr15,Bn57221,36836938,53659125,16822187,TNL
chr15,Bn57222,41100387,88719382,47618995,NBS
chr15,Bn57223,33688888,92106725,58417837,TN
chr15,Bn57224,17999693,21115055,3115362,CNL
chr15,Bn57225,8313310,88222992,79909682,NBS
chr15,Bn57226,77965209,93754185,15788976,RLK
chr15,Bn57227,2367445,47671239,45303794,RLK
chr15,Bn57228,55549088,79009803,23460715,TN
chr15,Bn57229,37776198,38422678,646480,RLK
chr15,Bn57230,68120355,85860643,17740288,NBS
chr15,Bn57231,17215215,25355846,8140631,RLK
chr15,Bn57232,91433532,91733020,299488,CN
chr15,Bn57233,90266499,97955654,7689155,TN
chr15,Bn57234,43876792,89684384,45807592,NBS
chr15,Bn57235,76436831,95656793,19219962,CNL
chr15,Bn57236,37292821,53666566,16373745,RLP
chr15,Bn57237,96090137,96141941,51804,RLK
chr15,Bn57238,30470927,80128155,49657228,CN
chr15,Bn57239,38107808,75673455,37565647,CNL
chr15,Bn57240,70490159,96674681,26184522,NBS
chr15,Bn57241,79256670,81597859,2341189,CN
chr15,Bn57242,81473535,89837505,8363970,CN
chr15,Bn57243,67821302,69678161,1856859,NBS
chr15,Bn57244,33700320,75347989,41647669,NBS
chr15,Bn57245,62738058,80022817,17284759,TN
chr15,Bn57246,88507243,95458860,6951617,TNL
chr15,Bn57247,71907987,78897323,6989336,TNL
chr15,Bn57248,44119408,89575817,45456409,CNL
chr15,Bn57249,30744914,63117864,32372950,NBS
chr15,Bn57250,73303716,74737863,1434147,TN
chr15,Bn57251,65449791,65892203,442412,RLK
chr15,Bn57252,7486357,25170494,17684137,RLK
chr15,Bn57253,9190657,65904581,56713924,CN
chr15,Bn57254,32445711,81319752,48874041,CN
chr15,Bn57255,74884412,99337963,24453551,TNL
chr15,Bn57256,35580395,80350667,44770272,RLK
chr15,Bn57257,54076569,60950517,6873948,CNL
chr15,Bn57258,32809265,33646321,837056,RLP
chr15,Bn57259,59335328,64676944,5341616,TNL
chr15,Bn57260,48141014,68767135,20626121,CNL
chr15,Bn57261,75398169,98646910,23248741,TNL
chr15,Bn57262,44138623,70201110,26062487,RLP
chr15,Bn57263,82512699,90974895,8462196,RLP
chr15,Bn57264,62701954,65695287,2993333,RLP
chr15,Bn57265,43162522,82903794,39741272,CN
chr15,Bn57266,49794983,94679586,44884603,RLP
chr15,Bn57267,33944907,71706655,37761748,NBS
chr15,Bn57268,59880198,98558844,38678646,NBS
chr15,Bn57269,16300929,68424577,52123648,NBS
chr15,Bn57270,60340527,98334793,37994266,NBS
chr15,Bn57271,39112103,46256757,7144654,TN
chr15,Bn57272,65955462,78270394,12314932,RLK
chr15,Bn57273,71335901,82571797,11235896,CNL
chr15,Bn57274,13648482,17338364,3689882,NBS
chr15,Bn57275,18529483,72567389,54037906,NBS
chr15,Bn57276,84512918,97697218,13184300,RLK
chr15,Bn57277,26304558,29429521,3124963,CNL
chr15,Bn57278,31575238,46581037,15005799,CNL
chr15,Bn57279,67472148,70140713,2668565,TN
chr15,Bn57280,91439499,93518669,2079170,CNL
chr15,Bn57281,34502226,71550796,37048570,CN
chr15,Bn57282,32518230,99013814,66495584,CNL
chr15,Bn57283,47210272,67333153,20122881,RLP
chr15,Bn57284,9545945,42961772,33415827,TNL
chr15,Bn57285,54020709,64309688,10288979,CN
chr15,Bn57286,53250613,97739436,44488823,CNL
chr15,Bn57287,67543662,92463093,24919431,RLP
chr15,Bn57288,77595577,94111889,16516312,RLP
chr15,Bn57289,90129144,98707507,8578363,TN
chr15,Bn57290,38469925,92232416,53762491,CNL
chr15,Bn57291,24443549,47940910,23497361,CNL
chr15,Bn57292,49977046,97156234,47179188,TN
chr15,Bn57293,57223366,81436832,24213466,CNL
chr15,Bn57294,26229799,86325221,60095422,CNL
chr15,Bn57295,78299771,89024429,10724658,TN
chr15,Bn57296,86829216,98191401,11362185,RLP
chr15,Bn57297,33124734,53758090,20633356,TN
chr15,Bn57298,47224693,55720172,8495479,NBS
chr15,Bn57299,55035424,70624617,15589193,RLK
chr15,Bn57300,65745022,95375967,29630945,RLK
chr15,Bn57301,73945922,87644724,13698802,CN
chr15,Bn57302,9206305,25357600,16151295,TN
chr15,Bn57303,55394122,69520748,14126626,TN
chr15,Bn57304,8581823,38306059,29724236,CN
chr15,Bn57305,6101664,17852050,11750386,TNL
chr15,Bn57306,76901157,90031884,13130727,RLP
chr15,Bn57307,12428820,99299529,86870709,CN
chr15,Bn57308,44852978,91883198,47030220,RLK
chr15,Bn57309,47474752,99172512,51697760,RLP
chr15,Bn57310,71413060,91956306,20543246,CN
chr15,Bn57311,93858913,96453162,2594249,RLK
chr15,Bn57312,32925075,55979079,23054004,TN
chr15,Bn57313,41188256,99140906,57952650,CN
chr15,Bn57314,51181009,60651316,9470307,RLK
chr15,Bn57315,87689542,89016270,1326728,NBS
chr15,Bn57316,24888918,93678761,68789843,RLP
chr15,Bn57317,6325692,41048032,34722340,CN
chr15,Bn57318,17888520,74205555,56317035,NBS
chr15,Bn57319,39033772,55292862,16259090,RLP
chr15,Bn57320,5074921,36297824,31222903,RLK
chr15,Bn57321,62594283,73346006,10751723,CNL
chr15,Bn57322,49388590,50627361,1238771,NBS
chr15,Bn57323,79567337,79629976,62639,NBS
chr15,Bn57324,10332282,61913220,51580938,TNL
chr15,Bn57325,93472345,95450147,1977802,TN
chr15,Bn57326,85411207,85437684,26477,RLK
chr15,Bn57327,10632718,61365189,50732471,TNL
chr15,Bn57328,94696679,99167959,4471280,TN
chr15,Bn57329,18655387,51191285,32535898,TNL
chr15,Bn57330,68518522,77471552,8953030,TN
chr15,Bn57331,68603578,83940429,15336851,CNL
chr15,Bn57332,86678564,90753572,4075008,RLK
chr15,Bn57333,24524265,73352871,48828606,NBS
chr15,Bn57334,38745514,64696693,25951179,CNL
chr15,Bn57335,35067236,45957192,10889956,CNL
chr15,Bn57336,1086884,98633073,97546189,CN
chr15,Bn57337,72904979,74317703,1412724,TNL
chr15,Bn57338,20743945,54849216,34105271,CNL
chr15,Bn57339,48362400,61442505,13080105,CN
chr15,Bn57340,65004882,82536964,17532082,TN
chr15,Bn57341,32909362,57562927,24653565,TNL
chr15,Bn57342,66001468,99697676,33696208,CN
chr15,Bn57343,18243146,90677418,72434272,TNL
chr15,Bn57344,31154414,98833439,67679025,TNL
chr15,Bn57345,19219975,40714516,21494541,NBS
chr15,Bn57346,3460756,40190275,36729519,RLP
chr15,Bn57347,52895692,96703140,43807448,RLK
chr15,Bn57348,38444560,65567689,27123129,RLP
chr15,Bn57349,69566282,81165510,11599228,RLK
chr15,Bn57350,30192760,98025482,67832722,TN
chr15,Bn57351,35881343,94641874,58760531,RLK
chr15,Bn57352,75154355,79150885,3996530,TNL
chr15,Bn57353,55063283,68568217,13504934,RLP
chr15,Bn57354,1565818,44435111,42869293,NBS
chr15,Bn57355,17402112,21800937,4398825,TN
chr15,Bn57356,64784595,75920225,11135630,RLP
chr15,Bn57357,30072826,85453015,55380189,RLP
chr15,Bn57358,15589301,99660942,84071641,RLP
chr15,Bn57359,97820512,98839352,1018840,CNL
chr15,Bn57360,8163311,19452974,11289663,TNL
chr15,Bn57361,11828726,95330212,83501486,RLK
chr15,Bn57362,37142820,82006409,44863589,RLK
chr15,Bn57363,89910546,93178950,3268404,TNL
chr15,Bn57364,80016697,91309288,11292591,TNL
chr15,Bn57365,82642973,93537605,10894632,TNL
chr15,Bn57366,79635292,86174510,6539218,NBS
chr15,Bn57367,77734637,89837462,12102825,RLK
chr15,Bn57368,59272435,89882893,30610458,TN
chr15,Bn57369,62202726,85925258,23722532,TNL
chr15,Bn57370,75038331,76813853,1775522,TNL
chr15,Bn57371,95095536,97314861,2219325,TN
chr15,Bn57372,28434746,50073466,21638720,CN
chr15,Bn57373,23651932,55793053,32141121,RLK
chr15,Bn57374,86585576,99880405,13294829,NBS
chr15,Bn57375,21989641,35917885,13928244,RLK
chr15,Bn57376,51878971,66250581,14371610,CNL
chr15,Bn57377,90004727,92280592,2275865,NBS
chr15,Bn57378,76712255,76787703,75448,TNL
chr15,Bn57379,17090526,99783110,82692584,RLK
chr15,Bn57380,79846687,88403962,8557275,TN
chr15,Bn57381,11272249,85514864,74242615,RLP
chr15,Bn57382,22964380,59045161,36080781,CN
chr15,Bn57383,17470605,52879637,35409032,TNL
chr15,Bn57384,93837119,98171293,4334174,TN
chr15,Bn57385,59361040,70105033,10743993,TNL
chr15,Bn57386,42123372,93438277,51314905,TN
chr15,Bn57387,1346156,59261357,57915201,RLK
chr15,Bn57388,89049332,96693026,7643694,RLK
chr15,Bn57389,91454378,94754241,3299863,CNL
chr15,Bn57390,31814359,44352213,12537854,TNL
chr15,Bn57391,31379413,56518365,25138952,TN
chr15,Bn57392,26549339,34247481,7698142,NBS
chr15,Bn57393,3390926,9680336,6289410,CN
chr15,Bn57394,48604794,73960710,25355916,CN
chr15,Bn57395,77138336,83473070,6334734,TNL
chr15,Bn57396,37002222,55237268,18235046,RLP
chr15,Bn57397,34165251,87599850,53434599,CN
chr15,Bn57398,94414243,98549010,4134767,TN
chr15,Bn57399,81844045,96590077,14746032,NBS
chr15,Bn57400,80639162,81721517,1082355,TNL
chr15,Bn57401,71627892,90290864,18662972,RLP
chr15,Bn57402,49146715,51566964,2420249,CN
chr15,Bn57403,26141807,88456073,62314266,TNL
chr15,Bn57404,40886837,86675869,45789032,TN
chr15,Bn57405,76134523,87649404,11514881,RLK
chr15,Bn57406,33058151,51797643,18739492,CN
chr15,Bn57407,17830137,84330664,66500527,CN
chr15,Bn57408,22718393,25531724,2813331,CNL
chr15,Bn57409,46785372,89550328,42764956,RLP
chr15,Bn57410,22899222,88780728,65881506,CN
chr15,Bn57411,34730705,35522642,791937,RLP
chr15,Bn57412,39489524,89272575,49783051,CNL
chr15,Bn57413,63520344,68685999,5165655,CN
chr15,Bn57414,48206467,58064325,9857858,CN
chr15,Bn57415,75306031,99831896,24525865,TNL
chr15,Bn57416,5840785,47010253,41169468,RLP
chr15,Bn57417,32524158,34926020,2401862,RLP
chr15,Bn57418,29352642,63791658,34439016,CNL
chr15,Bn57419,73901110,78237576,4336466,RLK
chr15,Bn57420,22202770,48436383,26233613,TNL
chr15,Bn57421,74929493,99944376,25014883,RLP
chr15,Bn57422,7149915,66608882,59458967,CNL
chr15,Bn57423,8838692,91521002,82682310,RLK
chr15,Bn57424,84922842,91984477,7061635,RLP
chr15,Bn57425,27768296,29331178,1562882,TN
chr15,Bn57426,4599788,98577230,93977442,CNL
chr15,Bn57427,64129078,99494733,35365655,NBS
chr15,Bn57428,66428824,99072579,32643755,NBS
chr15,Bn57429,85959149,87191036,1231887,TN
chr15,Bn57430,94309102,94651709,342607,TNL
chr15,Bn57431,78825891,98625230,19799339,CNL
chr15,Bn57432,15403982,91276258,75872276,RLP
chr15,Bn57433,4127323,51934746,47807423,RLK
chr15,Bn57434,82952348,86603582,3651234,TNL
chr15,Bn57435,24997620,80084449,55086829,RLP
chr15,Bn57436,94149110,98735572,4586462,RLP
chr15,Bn57437,44066903,75592019,31525116,CN
chr15,Bn57438,44221243,61924975,17703732,RLP
chr15,Bn57439,3806867,67524377,63717510,CNL
chr15,Bn57440,44401840,84270813,39868973,CN
chr15,Bn57441,52987397,67726328,14738931,NBS
chr15,Bn57442,33550332,74180266,40629934,NBS
chr15,Bn57443,65054598,99718485,34663887,RLP
chr15,Bn57444,83660722,96210075,12549353,TNL
chr15,Bn57445,58549457,71767829,13218372,NBS
chr15,Bn57446,86609083,95873565,9264482,RLP
chr15,Bn57447,44971470,96104759,51133289,RLP
chr15,Bn57448,93789446,98377707,4588261,CNL
chr15,Bn57449,29352664,97565479,68212815,TNL
chr15,Bn57450,84748330,95904744,11156414,TNL
chr15,Bn57451,45765978,55652032,9886054,TN
chr15,Bn57452,65405809,87706424,22300615,TNL
chr15,Bn57453,60442679,66552387,6109708,RLK
chr15,Bn57454,63047367,76122993,13075626,RLP
chr15,Bn57455,45640993,48824858,3183865,CNL
chr15,Bn57456,85966035,95498337,9532302,NBS
chr15,Bn57457,52585847,97586064,45000217,CNL
chr15,Bn57458,81379120,94487143,13108023,RLP
chr15,Bn57459,50588716,85025563,34436847,RLP
chr15,Bn57460,62013476,71314857,9301381,TNL
chr15,Bn57461,71372815,82374428,11001613,RLP
chr15,Bn57462,57850838,94644510,36793672,RLK
chr15,Bn57463,21291703,66800335,45508632,RLP
chr15,Bn57464,14510424,68964617,54454193,CN
chr15,Bn57465,56453304,97442101,40988797,TNL
chr15,Bn57466,31381215,35922891,4541676,TN
chr15,Bn57467,2799867,99709898,96910031,TNL
chr15,Bn57468,61671854,93588700,31916846,TNL
chr15,Bn57469,87568735,93027070,5458335,NBS
chr15,Bn57470,59913032,99285948,39372916,TN
chr15,Bn57471,69613291,93270141,23656850,TN
chr15,Bn57472,55220226,72719296,17499070,RLK
chr15,Bn57473,42771300,99132336,56361036,RLK
chr15,Bn57474,49927553,61835606,11908053,TN
chr15,Bn57475,56134889,68333034,12198145,RLP
chr15,Bn57476,32706574,67213583,34507009,RLP
chr15,Bn57477,59311516,89164210,29852694,TNL
chr15,Bn57478,69916184,85796097,15879913,CNL
chr15,Bn57479,11537823,26824673,15286850,TNL
chr15,Bn57480,46906091,76682934,29776843,TNL
chr15,Bn57481,11171273,57610914,46439641,CN
chr15,Bn57482,16147862,85755400,69607538,TN
chr15,Bn57483,83340993,86006440,2665447,CNL
chr15,Bn57484,70726922,91979375,21252453,CNL
chr15,Bn57485,14315076,60567341,46252265,TN
chr15,Bn57486,24313561,63631335,39317774,TN
chr15,Bn57487,91804906,97848058,6043152,TNL
chr15,Bn57488,2485442,12468099,9982657,TNL
chr15,Bn57489,27553536,54772040,27218504,CN
chr15,Bn57490,91227863,94630399,3402536,TN
chr15,Bn57491,36883431,97818331,60934900,CNL
chr15,Bn57492,99410216,99595966,185750,RLK
chr15,Bn57493,24529578,55793287,31263709,TNL
chr15,Bn57494,95726680,98808765,3082085,CNL
chr15,Bn57495,13788917,68022387,54233470,RLP
chr15,Bn57496,90778361,91024983,246622,RLP
chr15,Bn57497,11550354,69610280,58059926,NBS
chr15,Bn57498,24831284,47051756,22220472,TN
chr15,Bn57499,67276506,99206078,31929572,NBS
chr15,Bn57500,34799218,71973880,37174662,TNL
chr15,Bn57501,99798234,99963480,165246,RLP
chr15,Bn57502,86389397,86694762,305365,CNL
chr15,Bn57503,29595432,59619995,30024563,RLK
chr15,Bn57504,41938648,68989577,27050929,CN
chr15,Bn57505,92291717,92758071,466354,RLK
chr15,Bn57506,38739465,49254696,10515231,RLP
chr15,Bn57507,66155786,99797995,33642209,RLP
chr15,Bn57508,78084111,93433493,15349382,TNL
chr15,Bn57509,44067793,48909177,4841384,CN
chr15,Bn57510,16323315,83759715,67436400,TN
chr15,Bn57511,7305092,36355238,29050146,CN
chr15,Bn57512,93155295,98613616,5458321,CNL
chr15,Bn57513,13999952,48569861,34569909,TNL
chr15,Bn57514,86058008,88273156,2215148,CNL
chr15,Bn57515,19282970,86648972,67366002,TNL
chr15,Bn57516,45941961,79044777,33102816,RLK
chr15,Bn57517,65686553,95896710,30210157,RLP
chr15,Bn57518,50260649,73042580,22781931,CNL
chr15,Bn57519,91831353,96804438,4973085,CN
chr15,Bn57520,8474159,55992264,47518105,RLP
chr15,Bn57521,31815125,49814174,17999049,TN
chr15,Bn57522,85324106,89316931,3992825,TNL
chr15,Bn57523,30187504,94620160,64432656,RLK
chr15,Bn57524,92655778,95446130,2790352,CNL
chr15,Bn57525,22918287,85153949,62235662,RLP
chr15,Bn57526,57796603,89781023,31984420,CN
chr15,Bn57527,96252023,96559908,307885,NBS
chr15,Bn57528,64651597,93193592,28541995,CN
chr15,Bn57529,35852741,91470587,55617846,TNL
chr15,Bn57530,72959771,90262075,17302304,RLP
chr15,Bn57531,15944573,59858589,43914016,RLP
chr15,Bn57532,80337371,84177814,3840443,TNL
chr15,Bn57533,24740131,67940791,43200660,TN
chr15,Bn57534,72670784,92565194,19894410,CN
chr15,Bn57535,98430460,98650780,220320,CN
chr15,Bn57536,75641694,79513555,3871861,CNL
chr15,Bn57537,78386248,97965812,19579564,NBS
chr15,Bn57538,35149647,38913581,3763934,CN
chr15,Bn57539,17709260,66126944,48417684,CNL
chr15,Bn57540,23279404,49233460,25954056,RLP
chr15,Bn57541,89065458,94043330,4977872,NBS
chr15,Bn57542,67697098,96008520,28311422,RLP
chr15,Bn57543,5993618,15801886,9808268,TNL
chr15,Bn57544,27824558,32867840,5043282,CN
chr15,Bn57545,51501878,81480200,29978322,NBS
chr15,Bn57546,72616884,79433590,6816706,TNL
chr15,Bn57547,20108042,35500196,15392154,TN
chr15,Bn57548,55575559,95048159,39472600,TN
chr15,Bn57549,96232377,99815946,3583569,TN
chr15,Bn57550,70495015,84513834,14018819,TN
chr15,Bn57551,83467395,83954923,487528,RLK
chr15,Bn57552,13331688,25490060,12158372,RLK
chr15,Bn57553,13543209,21540063,7996854,CN
chr15,Bn57554,64012044,93605108,29593064,TNL
chr15,Bn57555,40829042,57226849,16397807,CNL
chr15,Bn57556,37979252,42666269,4687017,CN
chr15,Bn57557,95423940,97931059,2507119,TN
chr15,Bn57558,10189704,74161198,63971494,RLP
chr15,Bn57559,22658414,81425154,58766740,CNL
chr15,Bn57560,84152453,88135551,3983098,RLP
chr15,Bn57561,95560486,96730836,1170350,CNL
chr15,Bn57562,28881431,83987769,55106338,NBS
chr15,Bn57563,37341086,86294197,48953111,NBS
chr15,Bn57564,68924610,93279748,24355138,RLP
chr15,Bn57565,78330601,94259083,15928482,RLK
chr15,Bn57566,78290091,99382566,21092475,CNL
chr15,Bn57567,38363626,71827943,33464317,TN
chr15,Bn57568,13344192,97301478,83957286,TNL
chr15,Bn57569,91063892,98687426,7623534,RLP
chr15,Bn57570,77573883,97459306,19885423,RLP
chr15,Bn57571,46448439,98594561,52146122,TNL
chr15,Bn57572,23413287,26033557,2620270,NBS
chr15,Bn57573,26279992,51234261,24954269,CN
chr15,Bn57574,10187046,69304602,59117556,CNL
chr15,Bn57575,91767299,93886229,2118930,TN
chr15,Bn57576,24049706,46889802,22840096,NBS
chr15,Bn57577,5409262,29137371,23728109,RLP
chr15,Bn57578,59533541,74251885,14718344,TNL
chr15,Bn57579,25859318,39176741,13317423,CNL
chr15,Bn57580,70486132,73432954,2946822,RLK
chr15,Bn57581,87296328,96826039,9529711,TN
chr15,Bn57582,41655457,77304788,35649331,RLP
chr15,Bn57583,5049758,32222705,27172947,NBS
chr15,Bn57584,61815929,88340084,26524155,CN
chr15,Bn57585,2035261,10764206,8728945,CN
chr15,Bn57586,88592058,93760428,5168370,TNL
chr15,Bn57587,87408029,93745624,6337595,TNL
chr15,Bn57588,49939645,93932191,43992546,RLP
chr15,Bn57589,48072454,63471783,15399329,RLK
chr15,Bn57590,41240574,58854199,17613625,RLP
chr15,Bn57591,36113049,39608116,3495067,CN
chr15,Bn57592,76007716,80040711,4032995,NBS
chr15,Bn57593,85789147,98364317,12575170,NBS
chr15,Bn57594,95760621,97878312,2117691,TNL
chr15,Bn57595,86998227,97125331,10127104,RLP
chr15,Bn57596,93196795,96671163,3474368,TNL
chr15,Bn57597,35343533,59902519,24558986,RLP
chr15,Bn57598,78730474,88352982,9622508,RLP
chr15,Bn57599,40089472,41321144,1231672,CN
chr15,Bn57600,3142092,73228467,70086375,RLP
chr15,Bn57601,89589525,96345595,6756070,TNL
chr15,Bn57602,60605232,65683996,5078764,CNL
chr15,Bn57603,21748386,57464559,35716173,TNL
chr15,Bn57604,95354258,97820947,2466689,RLP
chr15,Bn57605,87812182,90727389,2915207,TN
chr15,Bn57606,89968218,93217374,3249156,TNL
chr15,Bn57607,41451357,87606021,46154664,NBS
chr15,Bn57608,37242815,72267221,35024406,TNL
chr15,Bn57609,26667630,86613344,59945714,RLP
chr15,Bn57610,80732770,83003055,2270285,RLP
chr15,Bn57611,4830988,83693831,78862843,RLP
chr15,Bn57612,76088493,78267533,2179040,RLP
chr15,Bn57613,82504604,95646195,13141591,RLP
chr15,Bn57614,32848499,90451980,57603481,TNL
chr15,Bn57615,19211293,72421669,53210376,NBS
chr15,Bn57616,14270388,65140016,50869628,RLK
chr15,Bn57617,3124374,83712527,80588153,RLK
chr15,Bn57618,31326952,90600139,59273187,NBS
chr15,Bn57619,35348898,84184564,48835666,RLK
chr15,Bn57620,78853028,93618316,14765288,RLK
chr15,Bn57621,46993626,64363099,17369473,CNL
chr15,Bn57622,26074911,41395381,15320470,NBS
chr15,Bn57623,5531499,21833362,16301863,CNL
chr15,Bn57624,10535426,84001655,73466229,TN
chr15,Bn57625,17457470,70961688,53504218,TN
chr15,Bn57626,14006005,98923189,84917184,TNL
chr15,Bn57627,34486722,74805970,40319248,RLK
chr15,Bn57628,43478216,64867842,21389626,TNL
chr15,Bn57629,67907482,96942066,29034584,RLK
chr15,Bn57630,9253667,32893121,23639454,CNL
chr15,Bn57631,92859479,94226299,1366820,RLP
chr15,Bn57632,52116894,96632175,44515281,TNL
chr15,Bn57633,87356147,98922212,11566065,CNL
chr15,Bn57634,37726110,55334259,17608149,CNL
chr15,Bn57635,18159707,26402248,8242541,RLK
chr15,Bn57636,19057063,59368512,40311449,CNL
chr15,Bn57637,11816326,34016668,22200342,NBS
chr15,Bn57638,63306435,72593978,9287543,NBS
chr15,Bn57639,41460002,82497261,41037259,TNL
chr15,Bn57640,49384139,97062168,47678029,NBS
chr15,Bn57641,46375845,82133482,35757637,TN
chr15,Bn57642,33672398,66267548,32595150,CNL
chr15,Bn57643,80622842,83526942,2904100,RLK
chr15,Bn57644,53817318,70066269,16248951,TN
chr15,Bn57645,1234965,39515982,38281017,CNL
chr15,Bn57646,67440908,84868598,17427690,TN
chr15,Bn57647,25132273,47860596,22728323,NBS
chr15,Bn57648,48706100,92904570,44198470,RLK
chr15,Bn57649,80248049,93960916,13712867,CNL
chr15,Bn57650,84305539,99551837,15246298,CNL
chr15,Bn57651,90056966,96427326,6370360,TN
chr15,Bn57652,57993930,75413558,17419628,RLP
chr15,Bn57653,57783791,68268499,10484708,RLK
chr15,Bn57654,55096020,84563720,29467700,RLP
chr15,Bn57655,23776052,71790131,48014079,TN
chr15,Bn57656,41990514,73509760,31519246,CNL
chr15,Bn57657,31697829,85360407,53662578,CN
chr15,Bn57658,29689882,84197942,54508060,CNL
chr15,Bn57659,37735502,90098269,52362767,CN
chr15,Bn57660,83535429,95692475,12157046,CN
chr15,Bn57661,43230835,67873184,24642349,TNL
chr15,Bn57662,39135240,64635272,25500032,RLK
chr15,Bn57663,64011166,97985635,33974469,RLK
chr15,Bn57664,95468821,95505098,36277,CN
chr15,Bn57665,17941713,87579811,69638098,CN
chr15,Bn57666,20271280,96046827,75775547,TN
chr15,Bn57667,17536917,29539306,12002389,CNL
chr15,Bn57668,57798005,67584250,9786245,TN
chr15,Bn57669,3416864,29536020,26119156,CN
chr15,Bn57670,65383315,95783224,30399909,TN
chr15,Bn57671,69017660,69949628,931968,TNL
chr15,Bn57672,1625923,31307072,29681149,TNL
chr15,Bn57673,7046106,29266376,22220270,TNL
chr15,Bn57674,39857333,63992147,24134814,RLP
chr15,Bn57675,8530833,42065000,33534167,TN
chr15,Bn57676,29847765,47894775,18047010,RLP
chr15,Bn57677,51129804,67233147,16103343,RLK
chr15,Bn57678,22092595,63957361,41864766,TN
chr15,Bn57679,63732446,82344170,18611724,NBS
chr15,Bn57680,45244003,95907403,50663400,CN
chr15,Bn57681,44011222,89994326,45983104,CNL
chr15,Bn57682,43109016,44428610,1319594,NBS
chr15,Bn57683,6201955,39503349,33301394,RLK
chr15,Bn57684,46976136,51437180,4461044,TN
chr15,Bn57685,34100322,70388939,36288617,NBS
chr15,Bn57686,62773607,75017984,12244377,CNL
chr15,Bn57687,33417674,58424530,25006856,TN
chr15,Bn57688,57572557,62283891,4711334,TNL
chr15,Bn57689,8791629,79882085,71090456,CN
chr15,Bn57690,87662595,88780859,1118264,TNL
chr15,Bn57691,40358952,69724302,29365350,RLP
chr15,Bn57692,69967986,83307662,13339676,CN
chr15,Bn57693,92457836,99149375,6691539,CN
chr15,Bn57694,81439471,96271385,14831914,CN
chr15,Bn57695,12101656,17159619,5057963,CN
chr15,Bn57696,65596007,66318729,722722,TN
chr15,Bn57697,88618808,95802178,7183370,CN
chr15,Bn57698,27192826,95158947,67966121,NBS
chr15,Bn57699,3967683,47111818,43144135,TNL
chr15,Bn57700,95371503,96707717,1336214,TNL
chr15,Bn57701,65283036,67780153,2497117,RLP
chr15,Bn57702,7891210,87120794,79229584,CN
chr15,Bn57703,22658512,94381221,71722709,TN
chr15,Bn57704,62198470,68987657,6789187,TNL
chr15,Bn57705,25683736,52238481,26554745,TNL
chr15,Bn57706,44012640,47437352,3424712,CN
chr15,Bn57707,79929376,97170324,17240948,TNL
chr15,Bn57708,55788638,80053178,24264540,TNL
chr15,Bn57709,26952331,39316628,12364297,NBS
chr15,Bn57710,41559714,43035176,1475462,RLK
chr15,Bn57711,86140782,90621691,4480909,NBS
chr15,Bn57712,1417907,79449319,78031412,RLK
chr15,Bn57713,46235501,62385257,16149756,CN
chr15,Bn57714,55897497,85767131,29869634,RLP
chr15,Bn57715,78271249,79829208,1557959,RLK
chr15,Bn57716,13303990,16710953,3406963,RLK
chr15,Bn57717,77975826,95623665,17647839,TN
chr15,Bn57718,61933818,98887297,36953479,TNL
chr15,Bn57719,61868319,72485071,10616752,TNL
chr15,Bn57720,87481823,99176391,11694568,CNL
chr15,Bn57721,5883690,13397407,7513717,RLP
chr15,Bn57722,49556277,57279758,7723481,RLP
chr15,Bn57723,45146255,89729427,44583172,RLK
chr15,Bn57724,54655917,90518724,35862807,TN
chr15,Bn57725,65495683,96808837,31313154,RLP
chr15,Bn57726,68015882,90649785,22633903,RLK
chr15,Bn57727,79853981,98230659,18376678,TNL
chr15,Bn57728,90194369,99086216,8891847,RLP
chr15,Bn57729,55592754,97610600,42017846,CNL
chr15,Bn57730,98613443,98926061,312618,RLP
chr15,Bn57731,15003779,96598732,81594953,RLP
chr15,Bn57732,53548660,95863117,42314457,CN
chr15,Bn57733,59422146,77183020,17760874,NBS
chr15,Bn57734,58114900,76728606,18613706,CN
chr15,Bn57735,18084467,86356509,68272042,RLK
chr15,Bn57736,34043919,71655933,37612014,TNL
chr15,Bn57737,53012743,75890729,22877986,NBS
chr15,Bn57738,22857168,74248683,51391515,RLK
chr15,Bn57739,74301249,86733937,12432688,TN
chr15,Bn57740,62946001,63397551,451550,NBS
chr15,Bn57741,74215446,83369060,9153614,TNL
chr15,Bn57742,74208199,86036651,11828452,NBS
chr15,Bn57743,97159468,99741730,2582262,RLK
chr15,Bn57744,92635716,98475837,5840121,TN
chr15,Bn57745,93817623,94096182,278559,NBS
chr15,Bn57746,29450707,58935698,29484991,CNL
chr15,Bn57747,13406158,61049391,47643233,TN
chr15,Bn57748,98051902,98328953,277051,NBS
chr15,Bn57749,5034131,84452206,79418075,CN
chr15,Bn57750,27059985,53573742,26513757,TN
chr15,Bn57751,57522968,78228358,20705390,CNL
chr15,Bn57752,23380101,48177807,24797706,RLP
chr15,Bn57753,68368209,69137975,769766,NBS
chr15,Bn57754,88293719,99501766,11208047,NBS
chr15,Bn57755,52526636,57380398,4853762,NBS
chr15,Bn57756,87725467,95237396,7511929,TN
chr15,Bn57757,31980089,94975978,62995889,CNL
chr15,Bn57758,22131490,30993934,8862444,CNL
chr15,Bn57759,99562060,99614321,52261,TN
chr15,Bn57760,62339175,84060443,21721268,TN
chr15,Bn57761,59689597,94394766,34705169,TN
chr15,Bn57762,17889404,96709952,78820548,NBS
chr15,Bn57763,40992842,67508495,26515653,NBS
chr15,Bn57764,88679090,89233131,554041,NBS
chr15,Bn57765,42929963,66631077,23701114,CNL
chr15,Bn57766,65039293,94696842,29657549,CN
chr15,Bn57767,16819861,97048590,80228729,TN
chr15,Bn57768,79277599,97266076,17988477,RLK
chr15,Bn57769,85732133,98270861,12538728,TNL
chr15,Bn57770,4150689,49616978,45466289,RLP
chr15,Bn57771,13196399,44731805,31535406,TNL
chr15,Bn57772,81329910,81748465,418555,RLP
chr15,Bn57773,57080742,74266882,17186140,NBS
chr15,Bn57774,5555212,11902552,6347340,NBS
chr15,Bn57775,67170997,67952460,781463,RLP
chr15,Bn57776,10108958,70010238,59901280,RLP
chr15,Bn57777,89357063,95391287,6034224,NBS
chr15,Bn57778,79314264,82710132,3395868,RLK
chr15,Bn57779,75345104,84904955,9559851,TNL
chr15,Bn57780,76034744,95289041,19254297,CNL
chr15,Bn57781,32083901,81275515,49191614,CNL
chr15,Bn57782,31017328,88296873,57279545,CNL
chr15,Bn57783,35693424,67925655,32232231,RLK
chr15,Bn57784,17813378,44616656,26803278,RLK
chr15,Bn57785,94989907,95787361,797454,CN
chr15,Bn57786,32855027,59908694,27053667,RLP
chr15,Bn57787,84433446,94230019,9796573,TN
chr15,Bn57788,80536247,88235609,7699362,RLK
chr15,Bn57789,45483063,54163378,8680315,TNL
chr15,Bn57790,28903483,54093173,25189690,NBS
chr15,Bn57791,62253559,76425843,14172284,RLP
chr15,Bn57792,23583188,88462289,64879101,RLK
chr15,Bn57793,85302334,98814672,13512338,CN
chr15,Bn57794,80252795,96696549,16443754,CN
chr15,Bn57795,41731240,99400232,57668992,RLK
chr15,Bn57796,77282760,94892181,17609421,CN
chr15,Bn57797,60867837,95817932,34950095,RLK
chr15,Bn57798,67529896,74664423,7134527,RLK
chr15,Bn57799,28879467,69960211,41080744,NBS
chr15,Bn57800,55032494,89841445,34808951,RLK
chr15,Bn57801,24449044,70113408,45664364,TNL
chr15,Bn57802,80807353,95304820,14497467,CNL
chr15,Bn57803,28130003,85884245,57754242,CN
chr15,Bn57804,68786770,96222356,27435586,RLK
chr15,Bn57805,90277368,94240088,3962720,CN
chr15,Bn57806,8564467,12868414,4303947,NBS
chr15,Bn57807,89756847,91837095,2080248,RLK
chr15,Bn57808,38626990,77429462,38802472,CN
chr15,Bn57809,82188091,82241437,53346,TN
chr15,Bn57810,87022960,92336738,5313778,TN
chr15,Bn57811,85418767,91995724,6576957,TN
chr15,Bn57812,85891322,93873563,7982241,RLP
chr15,Bn57813,45824463,97395941,51571478,RLK
chr15,Bn57814,86021590,96765495,10743905,NBS
chr15,Bn57815,52790065,83183859,30393794,TN
chr15,Bn57816,40076743,84473013,44396270,CNL
chr15,Bn57817,18521271,73120391,54599120,TN
chr15,Bn57818,39606013,52657287,13051274,TN
chr15,Bn57819,56471338,69531475,13060137,CNL
chr15,Bn57820,62852681,77222070,14369389,CN
chr15,Bn57821,83225334,97173097,13947763,RLP
chr15,Bn57822,10771524,41845736,31074212,TNL
chr15,Bn57823,38787121,56603410,17816289,CN
chr15,Bn57824,79370856,97987725,18616869,TNL
chr15,Bn57825,90956507,96618327,5661820,NBS
chr15,Bn57826,54320607,72720460,18399853,TNL
chr15,Bn57827,38551333,92004033,53452700,CN
chr15,Bn57828,7245250,29651732,22406482,RLP
chr15,Bn57829,50112862,96835573,46722711,RLK
chr15,Bn57830,22369997,57293118,34923121,RLK
chr15,Bn57831,83692382,95463555,11771173,CNL
chr15,Bn57832,7185568,87208248,80022680,TNL
chr15,Bn57833,86277928,94159742,7881814,CN
chr15,Bn57834,60886753,79432182,18545429,CN
chr15,Bn57835,63639230,93379415,29740185,CN
chr15,Bn57836,29412174,58240354,28828180,CNL
chr15,Bn57837,36249890,74962990,38713100,RLK
chr15,Bn57838,99026393,99632850,606457,RLP
chr15,Bn57839,56982914,69542147,12559233,NBS
chr15,Bn57840,71369771,78958008,7588237,NBS
chr15,Bn57841,73324395,94915211,21590816,TNL
chr15,Bn57842,72963018,80793704,7830686,NBS
chr15,Bn57843,14027687,77948060,63920373,NBS
chr15,Bn57844,71402147,79625837,8223690,TN
chr15,Bn57845,67540989,78831383,11290394,CNL
chr15,Bn57846,75513729,87768478,12254749,RLP
chr15,Bn57847,42708175,84578567,41870392,NBS
chr15,Bn57848,54094464,93281586,39187122,RLK
chr15,Bn57849,85560522,89940775,4380253,CN
chr15,Bn57850,99763534,99849713,86179,CN
chr15,Bn57851,16997320,19468371,2471051,RLP
chr15,Bn57852,38981704,92430840,53449136,CN
chr15,Bn57853,84905995,86888864,1982869,RLK
chr15,Bn57854,76228433,87037620,10809187,RLK
chr15,Bn57855,41409962,61210373,19800411,TNL
chr15,Bn57856,14128806,41931140,27802334,CN
chr15,Bn57857,32076639,95992271,63915632,CNL
chr15,Bn57858,83114479,91571779,8457300,TNL
chr15,Bn57859,64787977,78118342,13330365,RLK
chr15,Bn57860,34567394,62897087,28329693,TN
chr15,Bn57861,90900109,94268122,3368013,CNL
chr15,Bn57862,19313826,63339511,44025685,CNL
chr15,Bn57863,14494770,94330684,79835914,RLP
chr15,Bn57864,34184092,51223121,17039029,TN
chr15,Bn57865,61571096,68611170,7040074,TN
chr15,Bn57866,89161315,98612534,9451219,CN
chr15,Bn57867,54501145,62970500,8469355,CN
chr15,Bn57868,50255041,67973595,17718554,RLP
chr15,Bn57869,10596049,82039453,71443404,TNL
chr15,Bn57870,40640835,70253283,29612448,NBS
chr15,Bn57871,91128543,95295228,4166685,CN
chr15,Bn57872,27359038,51980028,24620990,CNL
chr15,Bn57873,91947080,99290136,7343056,CNL
chr15,Bn57874,76738122,96838217,20100095,NBS
chr15,Bn57875,77283457,89083100,11799643,TN
chr15,Bn57876,53207731,69571284,16363553,TNL
chr15,Bn57877,79797550,99171378,19373828,TNL
chr15,Bn57878,69107400,76908819,7801419,RLP
chr15,Bn57879,43112554,65868125,22755571,CNL
chr15,Bn57880,12606800,73340629,60733829,CNL
chr15,Bn57881,1157758,35943306,34785548,CN
chr15,Bn57882,34288066,86075201,51787135,NBS
chr15,Bn57883,2193625,23762490,21568865,TN
chr15,Bn57884,82733950,93958632,11224682,CNL
chr15,Bn57885,17577304,23225926,5648622,RLP
chr15,Bn57886,95617687,97276509,1658822,TN
chr15,Bn57887,93328218,98185571,4857353,CN
chr15,Bn57888,85973211,92583507,6610296,RLK
chr15,Bn57889,67050669,88178124,21127455,TN
chr15,Bn57890,78685017,82186666,3501649,RLK
chr15,Bn57891,5605409,67100822,61495413,RLK
chr15,Bn57892,25797220,41998951,16201731,CNL
chr15,Bn57893,85230670,91615927,6385257,CN
chr15,Bn57894,93723299,98611088,4887789,RLP
chr15,Bn57895,92472558,95292062,2819504,NBS
chr15,Bn57896,96365824,97574492,1208668,RLP
chr15,Bn57897,94025534,94319685,294151,TN
chr15,Bn57898,22138368,77296660,55158292,TNL
chr15,Bn57899,33459224,56857642,23398418,CN
chr15,Bn57900,33130386,61458652,28328266,NBS
chr15,Bn57901,70366838,78274003,7907165,NBS
chr15,Bn57902,24655567,81271304,56615737,CN
chr15,Bn57903,83772507,93979130,10206623,RLK
chr15,Bn57904,28305653,38198959,9893306,NBS
chr15,Bn57905,62823876,63829957,1006081,RLP
chr15,Bn57906,33540266,44946262,11405996,CN
chr15,Bn57907,75226196,97349632,22123436,NBS
chr15,Bn57908,19808586,33161275,13352689,RLP
chr15,Bn57909,27659640,90896762,63237122,RLP
chr15,Bn57910,67456922,99922893,32465971,TNL
chr15,Bn57911,36799307,62923323,26124016,RLP
chr15,Bn57912,99026805,99527884,501079,NBS
chr15,Bn57913,6682080,93865984,87183904,CNL
chr15,Bn57914,71035621,89552101,18516480,TNL
chr15,Bn57915,62932019,85505143,22573124,RLP
chr15,Bn57916,83088194,98746566,15658372,CNL
chr15,Bn57917,96867584,97557288,689704,RLP
chr15,Bn57918,11412468,16093504,4681036,CNL
chr15,Bn57919,3189244,94783330,91594086,RLP
chr15,Bn57920,90038074,95138562,5100488,CNL
chr15,Bn57921,26413122,99435930,73022808,TNL
chr15,Bn57922,67078244,72172306,5094062,NBS
chr15,Bn57923,53960010,83459003,29498993,RLK
chr15,Bn57924,11492498,36701035,25208537,RLP
chr15,Bn57925,49174713,66785574,17610861,CN
chr15,Bn57926,42598316,54992004,12393688,TNL
chr15,Bn57927,68709543,84255647,15546104,TN
chr15,Bn57928,14558736,97560696,83001960,RLK
chr15,Bn57929,81660114,97432279,15772165,CNL
chr15,Bn57930,98859788,98912785,52997,TNL
chr15,Bn57931,27400353,96889542,69489189,TN
chr15,Bn57932,97068241,99357289,2289048,NBS
chr15,Bn57933,23282043,54849959,31567916,RLP
chr15,Bn57934,58140028,77613798,19473770,CNL
chr15,Bn57935,7207638,36878432,29670794,CNL
chr15,Bn57936,3757187,96602631,92845444,RLP
chr15,Bn57937,88755548,97981755,9226207,RLK
chr15,Bn57938,74463956,79664137,5200181,TN
chr15,Bn57939,79066499,91514511,12448012,CNL
chr15,Bn57940,74780756,91943866,17163110,RLK
chr15,Bn57941,29120708,47980997,18860289,TNL
chr15,Bn57942,49324165,93765202,44441037,RLK
chr15,Bn57943,48624338,89686876,41062538,RLK
chr15,Bn57944,28820850,98211983,69391133,CN
chr15,Bn57945,37835701,95996710,58161009,CNL
chr15,Bn57946,15120228,33368750,18248522,CNL
chr15,Bn57947,13127222,19763866,6636644,RLP
chr15,Bn57948,98615722,99802420,1186698,RLK
chr15,Bn57949,11164973,71279024,60114051,RLP
chr15,Bn57950,70507984,95534539,25026555,NBS
chr15,Bn57951,54278018,54367135,89117,CNL
chr15,Bn57952,28217394,75510915,47293521,RLP
chr15,Bn57953,14718010,88140375,73422365,TN
chr15,Bn57954,54402694,92345977,37943283,CNL
chr15,Bn57955,55839552,59613116,3773564,CNL
chr15,Bn57956,86497632,89226334,2728702,TNL
chr15,Bn57957,15375864,73524570,58148706,RLK
chr15,Bn57958,45208660,57313578,12104918,CNL
chr15,Bn57959,38515520,44359703,5844183,CNL
chr15,Bn57960,37193113,91494653,54301540,TN
chr15,Bn57961,27669237,78014428,50345191,TNL
chr15,Bn57962,75771710,79568940,3797230,CNL
chr15,Bn57963,39753103,50714268,10961165,RLP
chr15,Bn57964,26872135,84591579,57719444,NBS
chr15,Bn57965,55595551,83942911,28347360,TN
chr15,Bn57966,2583614,57480665,54897051,CNL
chr15,Bn57967,36598563,78579397,41980834,RLP
chr15,Bn57968,38156711,42422722,4266011,CNL
chr15,Bn57969,38545876,97505535,58959659,RLK
chr15,Bn57970,58572467,59349511,777044,CNL
chr15,Bn57971,1863932,44124759,42260827,NBS
chr15,Bn57972,99679743,99688632,8889,TN
chr15,Bn57973,98258411,98719621,461210,TNL
chr15,Bn57974,37942964,96890014,58947050,TNL
chr15,Bn57975,30922540,37532096,6609556,TN
chr15,Bn57976,87368546,97240930,9872384,TN
chr15,Bn57977,72624278,83881160,11256882,CN
chr15,Bn57978,57244418,87518727,30274309,RLK
chr15,Bn57979,65404419,96622406,31217987,CNL
chr15,Bn57980,59392065,63517764,4125699,TN
chr15,Bn57981,40709879,76317144,35607265,RLP
chr15,Bn57982,48830838,77202370,28371532,NBS
chr15,Bn57983,11986687,89653455,77666768,RLP
chr15,Bn57984,89296937,90502543,1205606,TN
chr15,Bn57985,21196782,95773064,74576282,TNL
chr15,Bn57986,55616519,97129882,41513363,NBS
chr15,Bn57987,58393119,58616004,222885,CN
chr15,Bn57988,15118520,37591815,22473295,RLK
chr15,Bn57989,85418285,95040740,9622455,RLP
chr15,Bn57990,19200517,29914230,10713713,RLK
chr15,Bn57991,5185310,13400423,8215113,RLP
chr15,Bn57992,5296246,20119783,14823537,CN
chr15,Bn57993,8306185,27780294,19474109,CN
chr15,Bn57994,65689622,97030196,31340574,CN
chr15,Bn57995,94326787,96399273,2072486,RLP
chr15,Bn57996,73458539,90712321,17253782,RLK
chr15,Bn57997,41906122,69782547,27876425,NBS
chr15,Bn57998,1655448,37217895,35562447,TN
chr15,Bn57999,42198655,65088072,22889417,CN
chr15,Bn58000,37339543,45684294,8344751,TN
chr15,Bn58001,34516569,78875253,44358684,CN
chr15,Bn58002,22915488,47268393,24352905,CN
chr15,Bn58003,56757599,80910552,24152953,RLK
chr15,Bn58004,25146068,36672804,11526736,CNL
chr15,Bn58005,67777075,68159623,382548,TNL
chr15,Bn58006,7071434,55149100,48077666,TNL
chr15,Bn58007,52209251,79370710,27161459,TN
chr15,Bn58008,81780164,98445834,16665670,TN
chr15,Bn58009,30469973,33465483,2995510,CN
chr15,Bn58010,19258031,26953445,7695414,TN
chr15,Bn58011,32465757,38209201,5743444,TN
chr15,Bn58012,65428036,73509791,8081755,CNL
chr15,Bn58013,45019603,71100907,26081304,NBS
chr15,Bn58014,97508049,99875732,2367683,CN
chr15,Bn58015,35399483,68140856,32741373,TNL
chr15,Bn58016,83335015,96817651,13482636,TN
chr15,Bn58017,49188232,76802625,27614393,TN
chr15,Bn58018,66198112,90632866,24434754,TN
chr15,Bn58019,11861412,53985390,42123978,CN
chr15,Bn58020,62321625,64851261,2529636,CNL
chr15,Bn58021,8498184,99510019,91011835,RLP
chr15,Bn58022,29850337,62764235,32913898,TN
chr15,Bn58023,31525073,73569465,42044392,TN
chr15,Bn58024,76895967,85612561,8716594,RLK
chr15,Bn58025,41414107,99984034,58569927,CN
chr15,Bn58026,51800414,98169400,46368986,CN
chr15,Bn58027,79155108,83117038,3961930,CN
chr15,Bn58028,35399141,54746805,19347664,TN
chr15,Bn58029,60031566,63069661,3038095,RLK
chr15,Bn58030,24236466,30366718,6130252,RLP
chr15,Bn58031,82699157,94175765,11476608,RLP
chr15,Bn58032,92634654,96672955,4038301,TN
chr15,Bn58033,39346330,89443025,50096695,CN
chr15,Bn58034,41362792,56709413,15346621,TNL
chr15,Bn58035,10014511,56568880,46554369,NBS
chr15,Bn58036,54287585,72563075,18275490,CN
chr15,Bn58037,54812761,85110953,30298192,RLK
chr15,Bn58038,62582946,83521408,20938462,RLP
chr15,Bn58039,77872560,88376652,10504092,CN
chr15,Bn58040,76297177,77312535,1015358,RLK
chr15,Bn58041,23507727,90602520,67094793,CNL
chr15,Bn58042,56584374,64286716,7702342,TNL
chr15,Bn58043,51606047,62552770,10946723,CN
chr15,Bn58044,63714442,81072070,17357628,CN
chr15,Bn58045,19245185,27067985,7822800,TNL
chr15,Bn58046,96576504,99506462,2929958,RLP
chr15,Bn58047,56370773,94982597,38611824,TN
chr15,Bn58048,14146512,16760527,2614015,CN
chr15,Bn58049,44226194,65560628,21334434,CNL
chr15,Bn58050,60846972,92163780,31316808,RLK
chr15,Bn58051,52979626,88130355,35150729,RLP
chr15,Bn58052,31136870,83823338,52686468,RLK
chr15,Bn58053,17597577,55057317,37459740,RLK
chr15,Bn58054,16186306,79789431,63603125,RLP
chr15,Bn58055,97548232,98107512,559280,NBS
chr15,Bn58056,44704587,72821815,28117228,RLP
chr15,Bn58057,52916788,57835395,4918607,NBS
chr15,Bn58058,42320881,48561195,6240314,TNL
chr15,Bn58059,20442983,97716383,77273400,CNL
chr15,Bn58060,61844656,90939945,29095289,RLP
chr15,Bn58061,69386294,79905596,10519302,CN
chr15,Bn58062,22115348,39133024,17017676,RLP
chr15,Bn58063,2973786,31300459,28326673,CNL
chr15,Bn58064,15099791,90978132,75878341,NBS
chr15,Bn58065,10105875,88331570,78225695,RLK
chr15,Bn58066,78495443,86585484,8090041,RLP
chr15,Bn58067,94683451,99195193,4511742,RLP
chr15,Bn58068,46783989,70472166,23688177,CNL
chr15,Bn58069,9248479,26452080,17203601,NBS
chr15,Bn58070,98738606,99766339,1027733,NBS
chr15,Bn58071,1819852,35644925,33825073,RLK
chr15,Bn58072,78381278,87435574,9054296,NBS
chr15,Bn58073,32918376,97975518,65057142,TNL
chr15,Bn58074,49653787,51047290,1393503,CNL
chr15,Bn58075,73061147,81021216,7960069,CNL
chr15,Bn58076,55849987,80591960,24741973,CNL
chr15,Bn58077,97451939,98447343,995404,RLP
chr15,Bn58078,68261834,77050175,8788341,RLP
chr15,Bn58079,73300739,92536903,19236164,CNL
chr15,Bn58080,44966106,67180519,22214413,CN
chr15,Bn58081,89338337,93999438,4661101,NBS
chr15,Bn58082,66539164,85676613,19137449,CNL
chr15,Bn58083,43337385,43975399,638014,NBS
chr15,Bn58084,4544491,30251753,25707262,RLP
chr15,Bn58085,75288548,93641181,18352633,CN
chr15,Bn58086,21979748,33197646,11217898,TN
chr15,Bn58087,69350053,69730460,380407,CNL
chr15,Bn58088,85302986,99051807,13748821,RLK
chr15,Bn58089,5990162,71634714,65644552,NBS
chr15,Bn58090,72962930,76853981,3891051,CNL
chr15,Bn58091,81155665,93418404,12262739,CN
chr15,Bn58092,52226638,62124331,9897693,CN
chr15,Bn58093,81182447,93567337,12384890,RLP
chr15,Bn58094,11848134,95032240,83184106,NBS
chr15,Bn58095,60912491,69152419,8239928,TN
chr15,Bn58096,82230451,94368217,12137766,TN
chr15,Bn58097,53880736,57532149,3651413,RLK
chr15,Bn58098,34716082,74607791,39891709,NBS
chr15,Bn58099,44286156,52223609,7937453,CN
chr15,Bn58100,83162580,97188311,14025731,NBS
chr15,Bn58101,30470036,60977248,30507212,NBS
chr15,Bn58102,37284832,83699236,46414404,TNL
chr15,Bn58103,3423677,75429314,72005637,CN
chr15,Bn58104,66484081,99725184,33241103,RLK
chr15,Bn58105,71415310,85903320,14488010,TNL
chr15,Bn58106,20799829,76602550,55802721,RLP
chr15,Bn58107,42673264,67985281,25312017,TN
chr15,Bn58108,34036653,41098660,7062007,RLK
chr15,Bn58109,73307087,92554954,19247867,CNL
chr15,Bn58110,45568973,75661739,30092766,TNL
chr15,Bn58111,36410814,67929983,31519169,RLK
chr15,Bn58112,37650389,77086438,39436049,TN
chr15,Bn58113,85270472,93451524,8181052,TN
chr15,Bn58114,83662055,86748890,3086835,TNL
chr15,Bn58115,19272896,78836801,59563905,CN
chr15,Bn58116,72880714,89095561,16214847,TNL
chr15,Bn58117,28497438,53355072,24857634,RLP
chr15,Bn58118,67204286,89562662,22358376,TN
chr15,Bn58119,92569302,97860586,5291284,RLK
chr15,Bn58120,40844068,92018485,51174417,RLK
chr15,Bn58121,83460123,87413652,3953529,TN
chr15,Bn58122,59729890,94819298,35089408,CNL
chr15,Bn58123,53985110,88786527,34801417,CN
chr15,Bn58124,56024007,64214761,8190754,CNL
chr15,Bn58125,4952404,39741159,34788755,NBS
chr15,Bn58126,21857821,23898984,2041163,TNL
chr15,Bn58127,43901624,89292299,45390675,TNL
chr15,Bn58128,67049769,78292071,11242302,RLP
chr15,Bn58129,17139615,53860764,36721149,RLK
chr15,Bn58130,44556789,93704050,49147261,CN
chr15,Bn58131,96415174,99326601,2911427,RLP
chr15,Bn58132,46571981,92390331,45818350,TNL
chr15,Bn58133,21462325,21979115,516790,CN
chr15,Bn58134,34910253,85056340,50146087,NBS
chr15,Bn58135,65250435,80099764,14849329,CNL
chr15,Bn58136,94326985,96030603,1703618,CN
chr15,Bn58137,83428289,94200393,10772104,NBS
chr15,Bn58138,77926807,96730216,18803409,CNL
chr15,Bn58139,19498847,38275970,18777123,NBS
chr15,Bn58140,76560549,91988617,15428068,TNL
chr15,Bn58141,22306013,99413821,77107808,TN
chr15,Bn58142,88826092,94962439,6136347,TN
chr15,Bn58143,89678404,96863629,7185225,RLK
chr15,Bn58144,70712139,94838545,24126406,TNL
chr15,Bn58145,33469898,43079002,9609104,RLK
chr15,Bn58146,4165178,77719211,73554033,CNL
chr15,Bn58147,46607830,90505064,43897234,CNL
chr15,Bn58148,50803162,73788188,22985026,TNL
chr15,Bn58149,3465364,51524475,48059111,CNL
chr15,Bn58150,44691546,79537721,34846175,CN
chr15,Bn58151,94848495,95453447,604952,TNL
chr15,Bn58152,95868751,98415711,2546960,NBS
chr15,Bn58153,20931563,33882086,12950523,CN
chr15,Bn58154,89306418,91272882,1966464,TN
chr15,Bn58155,20312634,90451081,70138447,CN
chr15,Bn58156,6470796,69976580,63505784,RLK
chr15,Bn58157,56829609,91320942,34491333,CNL
chr15,Bn58158,25449533,67739493,42289960,CNL
chr15,Bn58159,50824094,96885961,46061867,RLP
chr15,Bn58160,37073448,78169187,41095739,TN
chr15,Bn58161,94535479,98976772,4441293,CN
chr15,Bn58162,72495097,81731299,9236202,TNL
chr15,Bn58163,63017452,91468932,28451480,TN
chr15,Bn58164,69704906,77640868,7935962,RLP
chr15,Bn58165,72149730,82980885,10831155,RLK
chr15,Bn58166,18287369,47892113,29604744,RLK
chr15,Bn58167,37605762,52188139,14582377,TN
chr15,Bn58168,24502165,82248957,57746792,RLP
chr15,Bn58169,24076329,44806754,20730425,RLP
chr15,Bn58170,10257631,36472587,26214956,CN
chr15,Bn58171,25048133,36741057,11692924,RLK
chr15,Bn58172,1136926,91797782,90660856,TN
chr15,Bn58173,18931049,91621330,72690281,NBS
chr15,Bn58174,71087313,94530702,23443389,TN
chr15,Bn58175,2841538,96746128,93904590,CN
chr15,Bn58176,94102996,94914259,811263,RLP
chr15,Bn58177,39997130,58971215,18974085,CN
chr15,Bn58178,77028125,77055651,27526,NBS
chr15,Bn58179,73474787,82648903,9174116,RLP
chr15,Bn58180,58301526,61320572,3019046,RLK
chr15,Bn58181,90739125,98570050,7830925,CNL
chr15,Bn58182,73639218,76994619,3355401,CN
chr15,Bn58183,21580583,47528880,25948297,NBS
chr15,Bn58184,99143044,99542477,399433,NBS
chr15,Bn58185,53070547,63141643,10071096,CN
chr15,Bn58186,87688430,89851689,2163259,NBS
chr15,Bn58187,74482113,94273678,19791565,CN
chr15,Bn58188,21650052,42558224,20908172,RLK
chr15,Bn58189,94989678,96095076,1105398,RLP
chr15,Bn58190,73469297,74470551,1001254,CN
chr15,Bn58191,97368959,99319106,1950147,CNL
chr15,Bn58192,62262741,94435204,32172463,TNL
chr15,Bn58193,73831322,92653046,18821724,CNL
chr15,Bn58194,76616191,94154215,17538024,NBS
chr15,Bn58195,74905642,98458172,23552530,TN
chr15,Bn58196,35718299,83040903,47322604,RLK
chr15,Bn58197,63428352,74465979,11037627,NBS
chr15,Bn58198,65876306,91573785,25697479,CN
chr15,Bn58199,80871949,82508146,1636197,RLP
chr15,Bn58200,97696980,98632387,935407,RLP
chr15,Bn58201,14105561,27499093,13393532,CN
chr15,Bn58202,5444019,43838935,38394916,RLP
chr15,Bn58203,80401571,99147848,18746277,RLP
chr15,Bn58204,65786519,93994351,28207832,NBS
chr15,Bn58205,70629494,86969532,16340038,CN
chr15,Bn58206,43024084,62206991,19182907,CN
chr15,Bn58207,12710193,69109628,56399435,TN
chr15,Bn58208,28167958,65560990,37393032,RLP
chr15,Bn58209,83289354,99101088,15811734,CN
chr15,Bn58210,76713170,99581030,22867860,CN
chr15,Bn58211,98969545,99641941,672396,RLK
chr15,Bn58212,67071566,85330469,18258903,TN
chr15,Bn58213,26644532,41975433,15330901,RLP
chr15,Bn58214,4591162,35380310,30789148,NBS
chr15,Bn58215,38710284,88116161,49405877,RLP
chr15,Bn58216,75427498,90447831,15020333,NBS
chr15,Bn58217,99733790,99758707,24917,CNL
chr15,Bn58218,38327859,52586445,14258586,TN
chr15,Bn58219,33879827,40589675,6709848,RLK
chr15,Bn58220,34885238,79402994,44517756,NBS
chr15,Bn58221,5105990,82377597,77271607,NBS
chr15,Bn58222,30355229,38394722,8039493,TN
chr15,Bn58223,98142107,98432795,290688,CNL
chr15,Bn58224,52296171,71494336,19198165,NBS
chr15,Bn58225,35528756,68148426,32619670,TN
chr15,Bn58226,12421520,22900528,10479008,NBS
chr15,Bn58227,32652156,91432329,58780173,RLP
chr15,Bn58228,34446328,94915102,60468774,CNL
chr15,Bn58229,51500726,96736177,45235451,RLP
chr15,Bn58230,56367425,88104555,31737130,RLP
chr15,Bn58231,72198209,98433758,26235549,CNL
chr15,Bn58232,34878015,35695593,817578,CNL
chr15,Bn58233,1783367,78871461,77088094,RLK
chr15,Bn58234,5855136,67537150,61682014,CNL
chr15,Bn58235,12001316,70462307,58460991,TNL
chr15,Bn58236,96302756,99431877,3129121,TN
chr15,Bn58237,51745961,86126591,34380630,TNL
chr15,Bn58238,56382767,59265819,2883052,RLP
chr15,Bn58239,78685530,80511634,1826104,TNL
chr15,Bn58240,76788966,82284095,5495129,CN
chr15,Bn58241,73057917,73274772,216855,RLK
chr15,Bn58242,93050400,93784548,734148,NBS
chr15,Bn58243,25690181,72238267,46548086,CN
chr15,Bn58244,96180833,96588557,407724,TNL
chr15,Bn58245,6379538,82979283,76599745,RLP
chr15,Bn58246,61025181,62201670,1176489,NBS
chr15,Bn58247,55527257,91834199,36306942,NBS
chr15,Bn58248,90082714,96466009,6383295,CNL
chr15,Bn58249,67431125,77653256,10222131,NBS
chr15,Bn58250,34817061,45907499,11090438,CN
chr15,Bn58251,39285714,61327871,22042157,CN
chr15,Bn58252,50817757,74895202,24077445,TN
chr15,Bn58253,44574825,50973338,6398513,CN
chr15,Bn58254,99128495,99482588,354093,TN
chr15,Bn58255,15031174,34714428,19683254,NBS
chr15,Bn58256,33110646,86521587,53410941,RLP
chr15,Bn58257,52297209,84712304,32415095,TN
chr15,Bn58258,24986649,39757933,14771284,CN
chr15,Bn58259,76413140,77387517,974377,RLP
chr15,Bn58260,96599038,97627334,1028296,TNL
chr15,Bn58261,73470204,86672679,13202475,NBS
chr15,Bn58262,95013264,96190115,1176851,CNL
chr15,Bn58263,36752488,91556769,54804281,RLK
chr15,Bn58264,1241871,32979078,31737207,CN
chr15,Bn58265,41751768,43871064,2119296,NBS
chr15,Bn58266,11109680,94832578,83722898,CN
chr15,Bn58267,30751974,31588432,836458,TN
chr15,Bn58268,75186091,77201487,2015396,TNL
chr15,Bn58269,50637269,95974931,45337662,CNL
chr15,Bn58270,61126135,90773171,29647036,RLK
chr15,Bn58271,91310652,94775250,3464598,NBS
chr15,Bn58272,62134136,69042799,6908663,RLP
chr15,Bn58273,70083829,75277263,5193434,NBS
chr15,Bn58274,65668434,79815264,14146830,CNL
chr15,Bn58275,30431812,47106076,16674264,TNL
chr15,Bn58276,43486178,54992748,11506570,CN
chr15,Bn58277,17207816,89801199,72593383,RLK
chr15,Bn58278,4258818,33905228,29646410,TN
chr15,Bn58279,11152649,90795975,79643326,TN
chr15,Bn58280,77231459,80548320,3316861,CNL
chr15,Bn58281,53131514,55727286,2595772,NBS
chr15,Bn58282,85575672,85901056,325384,NBS
chr15,Bn58283,86469434,94172161,7702727,TN
chr15,Bn58284,96888691,99926215,3037524,RLP
chr15,Bn58285,13875363,78973417,65098054,CN
chr15,Bn58286,28957072,94566323,65609251,CNL
chr15,Bn58287,78368470,86891791,8523321,NBS
chr15,Bn58288,5176352,95124080,89947728,RLK
chr15,Bn58289,46443442,48076295,1632853,NBS
chr15,Bn58290,7409454,33040191,25630737,CNL
chr15,Bn58291,66545207,92158977,25613770,TNL
chr15,Bn58292,12590920,30953633,18362713,TNL
chr15,Bn58293,47169939,86815125,39645186,CN
chr15,Bn58294,9617181,49244497,39627316,TNL
chr15,Bn58295,55174583,99679282,44504699,CN
chr15,Bn58296,21493892,35484727,13990835,NBS
chr15,Bn58297,74464520,84722910,10258390,CNL
chr15,Bn58298,84893912,95648433,10754521,TN
chr15,Bn58299,53104714,58189806,5085092,TN
chr15,Bn58300,70039773,85914178,15874405,RLK
chr15,Bn58301,8082497,62656534,54574037,RLK
chr15,Bn58302,88951585,94746206,5794621,TNL
chr15,Bn58303,33046711,92515008,59468297,NBS
chr15,Bn58304,31258682,53554790,22296108,TNL
chr15,Bn58305,96571649,99223806,2652157,CN
chr15,Bn58306,58912249,83821494,24909245,TN
chr15,Bn58307,41334049,99604138,58270089,NBS
chr15,Bn58308,9015657,36940678,27925021,CN
chr15,Bn58309,22629691,94175512,71545821,RLP
chr15,Bn58310,2856447,64198040,61341593,RLK
chr15,Bn58311,5632973,66346413,60713440,CN
chr15,Bn58312,77578451,80855332,3276881,NBS
chr15,Bn58313,37460911,45677891,8216980,TN
chr15,Bn58314,38212680,53386416,15173736,NBS
chr15,Bn58315,95618945,97212979,1594034,RLK
chr15,Bn58316,44024383,89827248,45802865,TN
chr15,Bn58317,78989897,92350612,13360715,CN
chr15,Bn58318,3446916,96991740,93544824,RLK
chr15,Bn58319,68053870,93626174,25572304,RLK
chr15,Bn58320,3592367,41484134,37891767,RLK
chr15,Bn58321,83602695,83905357,302662,RLK
chr15,Bn58322,86123248,90015071,3891823,TNL
chr15,Bn58323,61913642,83018725,21105083,RLP
chr15,Bn58324,67907163,95176558,27269395,TN
chr15,Bn58325,28432540,84797197,56364657,TNL
chr15,Bn58326,73197576,84628935,11431359,TN
chr15,Bn58327,70242044,95026920,24784876,CNL
chr15,Bn58328,34827132,87465671,52638539,NBS
chr15,Bn58329,46699376,75620128,28920752,RLK
chr15,Bn58330,40662181,75304781,34642600,TNL
chr15,Bn58331,74475999,80104043,5628044,NBS
chr15,Bn58332,86791547,88935384,2143837,CN
chr15,Bn58333,79095296,82768272,3672976,NBS
chr15,Bn58334,22220849,32563247,10342398,CN
chr15,Bn58335,47726911,47793120,66209,CN
chr15,Bn58336,50788527,76708246,25919719,NBS
chr15,Bn58337,23021819,60728968,37707149,CN
chr15,Bn58338,39024845,61870126,22845281,CN
chr15,Bn58339,95874305,97314268,1439963,TNL
chr15,Bn58340,65339155,97350041,32010886,RLP
chr15,Bn58341,85155275,94963137,9807862,CN
chr15,Bn58342,63415752,97138196,33722444,TNL
chr15,Bn58343,15438677,75176920,59738243,TN
chr15,Bn58344,54354430,97694678,43340248,TNL
chr15,Bn58345,62304635,94009057,31704422,CNL
chr15,Bn58346,34948130,41077234,6129104,TNL
chr15,Bn58347,25908307,28885643,2977336,RLP
chr15,Bn58348,33612074,90374238,56762164,TNL
chr15,Bn58349,33060608,56733435,23672827,TNL
chr15,Bn58350,13558602,65367734,51809132,CN
chr15,Bn58351,52081962,62176880,10094918,RLK
chr15,Bn58352,84256540,84609962,353422,TNL
chr15,Bn58353,89184607,98406140,9221533,CN
chr15,Bn58354,11811092,91081784,79270692,NBS
chr15,Bn58355,94295054,94415305,120251,CNL
chr15,Bn58356,87987935,98049050,10061115,TNL
chr15,Bn58357,77748177,87674152,9925975,RLK
chr15,Bn58358,42429322,92596601,50167279,RLP
chr15,Bn58359,8280024,65875460,57595436,RLP
chr15,Bn58360,31738824,94576623,62837799,RLK
chr15,Bn58361,64494129,90349018,25854889,CNL
chr15,Bn58362,28272171,34550922,6278751,TN
chr15,Bn58363,25154210,41021190,15866980,CNL
chr15,Bn58364,97835921,99152823,1316902,TNL
chr15,Bn58365,3200520,55011970,51811450,TNL
chr15,Bn58366,6865505,29712685,22847180,RLK
chr15,Bn58367,5366072,58326862,52960790,NBS
chr15,Bn58368,76658518,86677782,10019264,NBS
chr15,Bn58369,12562428,16949767,4387339,TN
chr15,Bn58370,94075471,96285466,2209995,RLK
chr15,Bn58371,65316657,74698481,9381824,CNL
chr15,Bn58372,61750037,79724316,17974279,RLK
chr15,Bn58373,37643919,53792569,16148650,NBS
chr15,Bn58374,88110035,89412758,1302723,RLP
chr15,Bn58375,48631785,70380440,21748655,TNL
chr15,Bn58376,13166529,86125224,72958695,CN
chr15,Bn58377,69299231,99650881,30351650,RLP
chr15,Bn58378,83793301,90965292,7171991,CNL
chr15,Bn58379,60200422,63402134,3201712,RLP
chr15,Bn58380,57106919,57133893,26974,NBS
chr15,Bn58381,34334498,65990371,31655873,NBS
chr15,Bn58382,64407126,79444143,15037017,TNL
chr15,Bn58383,68112126,84431440,16319314,TN
chr15,Bn58384,50010198,89529246,39519048,TN
chr15,Bn58385,81562560,95558234,13995674,RLP
chr15,Bn58386,92908837,93762371,853534,TNL
chr15,Bn58387,78416440,91881194,13464754,TNL
chr15,Bn58388,38933664,87127575,48193911,CN
chr15,Bn58389,6347903,32406831,26058928,TN
chr15,Bn58390,92149439,92383125,233686,RLK
chr15,Bn58391,13281574,70477660,57196086,RLK
chr15,Bn58392,63932283,64891077,958794,RLK
chr15,Bn58393,95465904,95939193,473289,RLP
chr15,Bn58394,95225240,96765097,1539857,RLK
chr15,Bn58395,91573216,91816828,243612,NBS
chr15,Bn58396,14278624,53173166,38894542,RLK
chr15,Bn58397,99041678,99426524,384846,TNL
chr15,Bn58398,71975832,97605131,25629299,NBS
chr15,Bn58399,47497976,56104461,8606485,CNL
chr15,Bn58400,33320582,46569596,13249014,TNL
chr15,Bn58401,63379966,78500730,15120764,CN
chr15,Bn58402,3396225,59088964,55692739,RLK
chr15,Bn58403,18059717,76443977,58384260,RLP
chr15,Bn58404,98825836,98847049,21213,TN
chr15,Bn58405,41831305,45930068,4098763,CNL
chr15,Bn58406,65554060,89773619,24219559,RLK
chr15,Bn58407,82839656,95362479,12522823,TNL
chr15,Bn58408,71526650,82789635,11262985,CN
chr15,Bn58409,5033968,94389013,89355045,CNL
chr15,Bn58410,20074766,21665568,1590802,TN
chr15,Bn58411,79832630,89552548,9719918,CNL
chr15,Bn58412,77504755,79878660,2373905,CN
chr15,Bn58413,55709505,95286476,39576971,RLK
chr15,Bn58414,9227238,48462504,39235266,CNL
chr15,Bn58415,57873580,89014754,31141174,CN
chr15,Bn58416,22519925,23279694,759769,RLP
chr15,Bn58417,88364309,96519134,8154825,NBS
chr15,Bn58418,31217146,70251310,39034164,RLK
chr15,Bn58419,62069372,74684184,12614812,CNL
chr15,Bn58420,10264737,31541874,21277137,RLK
chr15,Bn58421,59530684,99128127,39597443,RLK
chr15,Bn58422,10101494,65281123,55179629,RLK
chr15,Bn58423,31597627,42994926,11397299,NBS
chr15,Bn58424,63274192,72858384,9584192,CN
chr15,Bn58425,23317492,48558170,25240678,CN
chr15,Bn58426,73873663,79264032,5390369,CNL
chr15,Bn58427,68011897,95694837,27682940,RLP
chr15,Bn58428,39546282,95440670,55894388,RLP
chr15,Bn58429,58568198,79995683,21427485,RLP
chr15,Bn58430,44667734,45392606,724872,TNL
chr15,Bn58431,80635721,86301607,5665886,NBS
chr15,Bn58432,65940180,83879684,17939504,RLK
chr15,Bn58433,43359717,91183339,47823622,RLP
chr15,Bn58434,35274444,43248019,7973575,CN
chr15,Bn58435,39554525,82516428,42961903,TNL
chr15,Bn58436,68324400,91018557,22694157,TN
chr15,Bn58437,95526328,96741262,1214934,RLP
chr15,Bn58438,78226944,93488406,15261462,CNL
chr15,Bn58439,19987683,88919628,68931945,TNL
chr15,Bn58440,71983157,72913817,930660,NBS
chr15,Bn58441,37680422,61052527,23372105,TNL
chr15,Bn58442,64402179,76858547,12456368,TNL
chr15,Bn58443,7267752,62388783,55121031,RLK
chr15,Bn58444,94919024,99367055,4448031,RLP
chr15,Bn58445,99575182,99817513,242331,TN
chr15,Bn58446,21169369,80235945,59066576,RLK
chr15,Bn58447,89032904,98850312,9817408,TN
chr15,Bn58448,12996151,25561191,12565040,TN
chr15,Bn58449,97112402,98883348,1770946,CN
chr15,Bn58450,46223846,97698326,51474480,RLP
chr15,Bn58451,18988216,85122477,66134261,NBS
chr15,Bn58452,56617655,78309848,21692193,RLK
chr15,Bn58453,49810649,68258246,18447597,CN
chr15,Bn58454,77616165,88636439,11020274,TNL
chr15,Bn58455,47474874,92050953,44576079,RLK
chr15,Bn58456,89945813,92507463,2561650,TNL
chr15,Bn58457,58293036,99130211,40837175,RLK
chr15,Bn58458,15647946,32903028,17255082,CN
chr15,Bn58459,82220005,93822824,11602819,CN
chr15,Bn58460,76197782,89668886,13471104,RLK
chr15,Bn58461,67663818,74353570,6689752,CN
chr15,Bn58462,88717934,98673895,9955961,NBS
chr15,Bn58463,49339572,74497855,25158283,RLK
chr15,Bn58464,48421789,94513750,46091961,TNL
chr15,Bn58465,10307217,73371540,63064323,CN
chr15,Bn58466,21444404,78400022,56955618,CN
chr15,Bn58467,82963954,97103834,14139880,CNL
chr15,Bn58468,82587143,87431223,4844080,TNL
chr15,Bn58469,53640411,56627946,2987535,RLK
chr15,Bn58470,83537872,84253432,715560,RLK
chr15,Bn58471,55025166,69881372,14856206,TN
chr15,Bn58472,15046549,21354419,6307870,CNL
chr15,Bn58473,58890038,96425636,37535598,CN
chr15,Bn58474,31587357,64330809,32743452,TNL
chr15,Bn58475,55132837,90262835,35129998,CNL
chr15,Bn58476,64123399,89771300,25647901,RLK
chr15,Bn58477,1353030,78980042,77627012,CNL
chr15,Bn58478,18223203,78511708,60288505,TNL
chr15,Bn58479,68181239,91085443,22904204,RLK
chr15,Bn58480,48552163,49152838,600675,RLK
chr15,Bn58481,52796917,92737624,39940707,RLP
chr15,Bn58482,8647646,12703946,4056300,NBS
chr15,Bn58483,95564143,99963798,4399655,CNL
chr15,Bn58484,48411236,96414203,48002967,CN
chr15,Bn58485,99947029,99980456,33427,RLK
chr15,Bn58486,95698290,97111792,1413502,TN
chr15,Bn58487,70747121,84694487,13947366,CN
chr15,Bn58488,61722663,93258988,31536325,NBS
chr15,Bn58489,69178774,92024685,22845911,CNL
chr15,Bn58490,97808440,98367850,559410,TN
chr15,Bn58491,79031379,94321565,15290186,CNL
chr15,Bn58492,46711287,53014784,6303497,NBS
chr15,Bn58493,18539938,60618668,42078730,RLP
chr15,Bn58494,12248438,45628469,33380031,RLK
chr15,Bn58495,53791775,64070082,10278307,NBS
chr15,Bn58496,36895202,63222687,26327485,CNL
chr15,Bn58497,16384249,73259568,56875319,NBS
chr15,Bn58498,52665345,92222591,39557246,TNL
chr15,Bn58499,84702292,86748379,2046087,NBS
chr15,Bn58500,10832194,92864673,82032479,RLK
chr15,Bn58501,53772007,99597520,45825513,TNL
chr15,Bn58502,18414193,55118001,36703808,RLK
chr15,Bn58503,6989653,43327247,36337594,CNL
chr15,Bn58504,26022610,32164987,6142377,TNL
chr15,Bn58505,50249714,97156092,46906378,TNL
chr15,Bn58506,65598456,72111642,6513186,TN
chr15,Bn58507,32718589,69687118,36968529,RLP
chr15,Bn58508,11715850,26479907,14764057,TNL
chr15,Bn58509,85385385,87866831,2481446,TN
chr15,Bn58510,9381538,19302874,9921336,CNL
chr15,Bn58511,98606977,99760342,1153365,RLK
chr15,Bn58512,1856503,63395680,61539177,NBS
chr15,Bn58513,36019319,42398378,6379059,RLK
chr15,Bn58514,63266565,99753959,36487394,TN
chr15,Bn58515,48536231,89255561,40719330,NBS
chr15,Bn58516,49374982,75612484,26237502,RLP
chr15,Bn58517,26049023,77405352,51356329,RLP
chr15,Bn58518,39294111,76459453,37165342,CN
chr15,Bn58519,82517499,95501400,12983901,TN
chr15,Bn58520,66687560,81468781,14781221,TN
chr15,Bn58521,93912659,98314742,4402083,NBS
chr15,Bn58522,13893555,55855874,41962319,TN
chr15,Bn58523,77370739,88409541,11038802,CN
chr15,Bn58524,45038714,57308224,12269510,CN
chr15,Bn58525,13529902,23494243,9964341,NBS
chr15,Bn58526,72873779,97448142,24574363,RLK
chr15,Bn58527,66476405,99444211,32967806,CNL
chr15,Bn58528,22425619,24321421,1895802,NBS
chr15,Bn58529,32745914,61126117,28380203,CN
chr15,Bn58530,39495800,98692732,59196932,TNL
chr15,Bn58531,10717149,87996596,77279447,NBS
chr15,Bn58532,2733900,60925209,58191309,TN
chr15,Bn58533,73815116,81326269,7511153,RLK
chr15,Bn58534,81821924,92293846,10471922,TNL
chr15,Bn58535,11924478,92261193,80336715,RLP
chr15,Bn58536,67802706,76759420,8956714,NBS
chr15,Bn58537,52807860,86017636,33209776,RLP
chr15,Bn58538,35476742,47735083,12258341,TN
chr15,Bn58539,15584715,17102324,1517609,NBS
chr15,Bn58540,5076830,40059933,34983103,RLK
chr15,Bn58541,83228159,97753191,14525032,TNL
chr15,Bn58542,38145985,66695040,28549055,NBS
chr15,Bn58543,40733197,92262916,51529719,RLK
chr15,Bn58544,87550981,94910513,7359532,TN
chr15,Bn58545,2320154,45370176,43050022,TNL
chr15,Bn58546,3131587,14417893,11286306,TNL
chr15,Bn58547,13312278,22295358,8983080,NBS
chr15,Bn58548,44278083,94749733,50471650,CNL
chr15,Bn58549,73356927,87181871,13824944,RLK
chr15,Bn58550,82588375,82942938,354563,RLP
chr15,Bn58551,58085231,83281881,25196650,TN
chr15,Bn58552,23874708,62022744,38148036,TNL
chr15,Bn58553,62395197,81268691,18873494,RLP
chr15,Bn58554,88750489,89305507,555018,NBS
chr15,Bn58555,66053259,88016353,21963094,TN
chr15,Bn58556,71733679,81983308,10249629,RLP
chr15,Bn58557,90094318,95697858,5603540,CN
chr15,Bn58558,36325617,71257684,34932067,CN
chr15,Bn58559,99720906,99740720,19814,TNL
chr15,Bn58560,24836834,73696575,48859741,RLP
chr15,Bn58561,29140813,37251395,8110582,RLK
chr15,Bn58562,51256598,51367366,110768,NBS
chr15,Bn58563,84824838,95273605,10448767,TNL
chr15,Bn58564,41137688,77006885,35869197,CNL
chr15,Bn58565,18150878,60126069,41975191,NBS
chr15,Bn58566,73862728,92950938,19088210,CNL
chr15,Bn58567,46005825,60996957,14991132,CN
chr15,Bn58568,57476137,68726405,11250268,RLP
chr15,Bn58569,67623456,94415998,26792542,CNL
chr15,Bn58570,87840692,90160494,2319802,RLK
chr15,Bn58571,42790522,43926490,1135968,RLK
chr15,Bn58572,4482385,78458289,73975904,TNL
chr15,Bn58573,4021159,82586950,78565791,RLP
chr15,Bn58574,54309780,73057414,18747634,CN
chr15,Bn58575,90108559,96241529,6132970,TNL
chr15,Bn58576,17605683,24986867,7381184,TNL
chr15,Bn58577,95544129,99212511,3668382,CN
chr15,Bn58578,52691856,54205248,1513392,RLK
chr15,Bn58579,84910730,98812433,13901703,CN
chr15,Bn58580,17651743,81794023,64142280,RLP
chr15,Bn58581,22179979,84457559,62277580,CN
chr15,Bn58582,7786376,95146540,87360164,CN
chr15,Bn58583,81338316,82225903,887587,RLP
chr15,Bn58584,77263500,84629842,7366342,TNL
chr15,Bn58585,2393074,14451336,12058262,TNL
chr15,Bn58586,56511875,63320976,6809101,CNL
chr15,Bn58587,29587014,54826532,25239518,CNL
chr15,Bn58588,2024442,53149072,51124630,TNL
chr15,Bn58589,53615000,89974769,36359769,RLK
chr15,Bn58590,17247878,58246086,40998208,CN
chr15,Bn58591,41620282,57919530,16299248,NBS
chr15,Bn58592,13388238,13889640,501402,NBS
chr15,Bn58593,1213792,83501168,82287376,NBS
chr15,Bn58594,62663340,74120503,11457163,CN
chr15,Bn58595,64623848,87291730,22667882,CNL
chr15,Bn58596,7959180,53106868,45147688,CN
chr15,Bn58597,32538387,81923087,49384700,NBS
chr15,Bn58598,72132827,92804869,20672042,NBS
chr15,Bn58599,22464930,29129276,6664346,CN
chr15,Bn58600,80908840,81632496,723656,CN
chr15,Bn58601,3332956,6911628,3578672,RLP
chr15,Bn58602,67479560,86158940,18679380,NBS
chr15,Bn58603,74171031,75572762,1401731,TNL
chr15,Bn58604,3685588,63363018,59677430,RLK
chr15,Bn58605,87595007,95493406,7898399,TNL
chr15,Bn58606,47890219,49678101,1787882,NBS
chr15,Bn58607,42855721,64581420,21725699,RLK
chr15,Bn58608,48668635,59497248,10828613,RLK
chr15,Bn58609,95773259,97538081,1764822,RLP
chr15,Bn58610,54374343,61948203,7573860,CNL
chr15,Bn58611,25076609,64243860,39167251,TNL
chr15,Bn58612,55763687,89804878,34041191,RLK
chr15,Bn58613,95502377,96471925,969548,RLK
chr15,Bn58614,91702789,91872347,169558,RLP
chr15,Bn58615,71222029,92427616,21205587,TN
chr15,Bn58616,71691843,95340214,23648371,CNL
chr15,Bn58617,94863818,99704968,4841150,CN
chr15,Bn58618,43312768,65790855,22478087,RLK
chr15,Bn58619,33026853,56683539,23656686,CN
chr15,Bn58620,22583498,23532664,949166,RLK
chr15,Bn58621,71576089,90674449,19098360,NBS
chr15,Bn58622,93298604,99218244,5919640,CNL
chr15,Bn58623,62395107,80600612,18205505,RLK
chr15,Bn58624,45869257,88381350,42512093,TN
chr15,Bn58625,60642721,68795388,8152667,TNL
chr15,Bn58626,54304547,64254318,9949771,RLK
chr15,Bn58627,64743767,99348172,34604405,RLP
chr15,Bn58628,98129486,98839576,710090,TNL
chr15,Bn58629,3834010,6284451,2450441,RLP
chr15,Bn58630,37476086,75933247,38457161,CN
chr15,Bn58631,20042668,33555433,13512765,RLP
chr15,Bn58632,32216793,66687849,34471056,RLP
chr15,Bn58633,4623997,15801444,11177447,TNL
chr15,Bn58634,83689087,87800797,4111710,RLP
chr15,Bn58635,35598547,91170459,55571912,CNL
chr15,Bn58636,4553687,24385474,19831787,NBS
chr15,Bn58637,57603088,73315084,15711996,RLK
chr15,Bn58638,49181076,94442112,45261036,NBS
chr15,Bn58639,72091070,75233814,3142744,TN
chr15,Bn58640,43497060,43695040,197980,RLP
chr15,Bn58641,23668974,62427072,38758098,TNL
chr15,Bn58642,3114732,89008058,85893326,NBS
chr15,Bn58643,35635374,66868953,31233579,CN
chr15,Bn58644,32524000,57243635,24719635,CNL
chr15,Bn58645,20397201,76944255,56547054,RLP
chr15,Bn58646,81073441,95516538,14443097,TN
chr15,Bn58647,36902552,74912483,38009931,TNL
chr15,Bn58648,44878803,81357702,36478899,TNL
chr15,Bn58649,61156877,73345152,12188275,RLP
chr15,Bn58650,5940170,72900343,66960173,TN
chr15,Bn58651,19913738,92672245,72758507,TNL
chr15,Bn58652,70573306,83615186,13041880,TN
chr15,Bn58653,68355512,79152070,10796558,TN
chr15,Bn58654,91001135,99966378,8965243,TNL
chr15,Bn58655,56543486,94919012,38375526,CN
chr15,Bn58656,81717268,94253241,12535973,TN
chr15,Bn58657,11757639,96370678,84613039,CN
chr15,Bn58658,94359278,94686776,327498,TNL
chr15,Bn58659,43609454,78209416,34599962,CN
chr15,Bn58660,12329948,40055449,27725501,RLK
chr15,Bn58661,92946791,94269155,1322364,RLP
chr15,Bn58662,97876834,98989861,1113027,TNL
chr15,Bn58663,19403252,65843454,46440202,TN
chr15,Bn58664,34157548,61986133,27828585,CNL
chr15,Bn58665,49756438,60620959,10864521,TN
chr15,Bn58666,19756013,31353546,11597533,RLP
chr15,Bn58667,97654979,98973229,1318250,CN
chr15,Bn58668,35466323,72044766,36578443,CNL
chr15,Bn58669,74058420,91787339,17728919,TN
chr15,Bn58670,6756378,36055492,29299114,TNL
chr15,Bn58671,32439137,56573529,24134392,RLK
chr15,Bn58672,71967313,98221235,26253922,CNL
chr15,Bn58673,72748502,88155103,15406601,RLP
chr15,Bn58674,40993721,68702497,27708776,TNL
chr15,Bn58675,44423615,94669100,50245485,RLP
chr15,Bn58676,82543281,88166388,5623107,CNL
chr15,Bn58677,23332830,63405750,40072920,RLK
chr15,Bn58678,30144473,79451147,49306674,RLK
chr15,Bn58679,11008756,65350036,54341280,CNL
chr15,Bn58680,76593919,96710103,20116184,RLK
chr15,Bn58681,92104870,93304109,1199239,NBS
chr15,Bn58682,30334021,44843678,14509657,TN
chr15,Bn58683,36589505,97671571,61082066,CN
chr15,Bn58684,74450725,77844861,3394136,NBS
chr15,Bn58685,71631390,98847686,27216296,CNL
chr15,Bn58686,3472582,40305026,36832444,NBS
chr15,Bn58687,54417497,95077406,40659909,RLP
chr15,Bn58688,35219299,83832384,48613085,CNL
chr15,Bn58689,73224697,95155180,21930483,RLK
chr15,Bn58690,23331169,97742396,74411227,CNL
chr15,Bn58691,8671261,19041533,10370272,RLK
chr15,Bn58692,61810242,80320708,18510466,RLK
chr15,Bn58693,15286107,65325690,50039583,TNL
chr15,Bn58694,44789355,92611659,47822304,TNL
chr15,Bn58695,88298090,91874155,3576065,TN
chr15,Bn58696,67878187,95352175,27473988,NBS
chr15,Bn58697,19228236,61063616,41835380,CNL
chr15,Bn58698,91825562,95180311,3354749,RLK
chr15,Bn58699,72746151,89406645,16660494,CN
chr15,Bn58700,65143809,96765894,31622085,CNL
chr15,Bn58701,50436169,89901893,39465724,CNL
chr15,Bn58702,6208176,27121525,20913349,CN
chr15,Bn58703,42733547,55099406,12365859,RLK
chr15,Bn58704,80477008,99116895,18639887,TN
chr15,Bn58705,39841449,98331237,58489788,TNL
chr15,Bn58706,38187179,45835136,7647957,CNL
chr15,Bn58707,89140912,96815318,7674406,RLP
chr15,Bn58708,95312524,96639974,1327450,TN
chr15,Bn58709,39980412,54709579,14729167,CNL
chr15,Bn58710,62804978,78338428,15533450,CN
chr15,Bn58711,9430543,79771002,70340459,CNL
chr15,Bn58712,3814657,91014155,87199498,TNL
chr15,Bn58713,93654455,98393446,4738991,RLP
chr15,Bn58714,76696927,85862271,9165344,RLK
chr15,Bn58715,91437188,98551676,7114488,CNL
chr15,Bn58716,19846143,63907248,44061105,CN
chr15,Bn58717,61327437,74288365,12960928,TN
chr15,Bn58718,33779491,36567939,2788448,RLP
chr15,Bn58719,64421871,82041185,17619314,TN
chr15,Bn58720,49765598,69728584,19962986,NBS
chr15,Bn58721,1881261,61929296,60048035,CNL
chr15,Bn58722,7313468,36277566,28964098,CNL
chr15,Bn58723,45141614,50029438,4887824,NBS
chr15,Bn58724,35590540,94956817,59366277,NBS
chr15,Bn58725,11165320,61142642,49977322,NBS
chr15,Bn58726,58414634,76867453,18452819,CNL
chr15,Bn58727,91915706,93690805,1775099,NBS
chr15,Bn58728,8252613,48655438,40402825,RLK
chr15,Bn58729,8573463,59379727,50806264,TN
chr15,Bn58730,80076622,80421664,345042,CN
chr15,Bn58731,13701701,59845994,46144293,NBS
chr15,Bn58732,64076905,91027259,26950354,CN
chr15,Bn58733,53657657,94486833,40829176,CNL
chr15,Bn58734,23703910,59393005,35689095,RLP
chr15,Bn58735,57308104,63662837,6354733,CNL
chr15,Bn58736,5774972,56094220,50319248,TN
chr15,Bn58737,57563604,96327790,38764186,TN
chr15,Bn58738,38846725,89992315,51145590,CN
chr15,Bn58739,53537995,67587147,14049152,TN
chr15,Bn58740,32501907,75755247,43253340,RLP
chr15,Bn58741,76062888,86820136,10757248,CN
chr15,Bn58742,99858228,99998608,140380,NBS
chr15,Bn58743,56430674,61600286,5169612,CNL
chr15,Bn58744,98420381,99507433,1087052,CNL
chr15,Bn58745,62825203,73144601,10319398,RLP
chr15,Bn58746,58315555,63982323,5666768,CNL
chr15,Bn58747,93454643,94372228,917585,TNL
chr15,Bn58748,26561984,60126709,33564725,TN
chr15,Bn58749,32693858,47924282,15230424,RLK
chr15,Bn58750,30335448,56099965,25764517,TNL
chr15,Bn58751,48962451,65460381,16497930,CNL
chr15,Bn58752,86903708,98024378,11120670,CN
chr15,Bn58753,22851735,42641301,19789566,CN
chr15,Bn58754,51768855,88078447,36309592,RLP
chr15,Bn58755,26321064,65686755,39365691,RLK
chr15,Bn58756,80944232,89237049,8292817,RLP
chr15,Bn58757,17011875,21225469,4213594,NBS
chr15,Bn58758,81718563,89305008,7586445,CNL
chr15,Bn58759,99562208,99715096,152888,NBS
chr15,Bn58760,15256674,16641258,1384584,TNL
chr15,Bn58761,76331507,81294075,4962568,NBS
chr15,Bn58762,86142809,86547028,404219,RLK
chr15,Bn58763,23099004,64252575,41153571,TN
chr15,Bn58764,88829687,90839105,2009418,CNL
chr15,Bn58765,15913763,41686627,25772864,TN
chr15,Bn58766,41087245,70386579,29299334,CN
chr15,Bn58767,27925436,41040177,13114741,TNL
chr15,Bn58768,24702200,86428778,61726578,CNL
chr15,Bn58769,89191701,91680761,2489060,RLP
chr15,Bn58770,93931321,96068437,2137116,RLK
chr15,Bn58771,83042101,88391987,5349886,CNL
chr15,Bn58772,36734093,93813044,57078951,NBS
chr15,Bn58773,59866080,78573257,18707177,CN
chr15,Bn58774,44285995,90793858,46507863,CN
chr15,Bn58775,12928514,58956642,46028128,RLP
chr15,Bn58776,3182578,99720349,96537771,TN
chr15,Bn58777,41395176,88462045,47066869,RLK
chr15,Bn58778,74499233,79589198,5089965,TNL
chr15,Bn58779,66831305,80981397,14150092,CN
chr15,Bn58780,55096356,75244096,20147740,TN
chr15,Bn58781,86810207,96632748,9822541,RLK
chr15,Bn58782,80580301,91874120,11293819,TNL
chr15,Bn58783,10982991,73249421,62266430,CN
chr15,Bn58784,91835552,97687256,5851704,TN
chr15,Bn58785,94421623,95639446,1217823,TNL
chr15,Bn58786,21793192,53008431,31215239,TNL
chr15,Bn58787,94332892,94520586,187694,TN
chr15,Bn58788,96927582,96983625,56043,RLP
chr15,Bn58789,67893494,87833189,19939695,TNL
chr15,Bn58790,38467803,83330335,44862532,TNL
chr15,Bn58791,93149846,95135917,1986071,CNL
chr15,Bn58792,85089338,94400555,9311217,CNL
chr15,Bn58793,93158659,96185743,3027084,RLP
chr15,Bn58794,89723340,96990148,7266808,RLK
chr15,Bn58795,53089086,79707163,26618077,RLK
chr15,Bn58796,9096989,76906670,67809681,NBS
chr15,Bn58797,17398468,43529322,26130854,RLK
chr15,Bn58798,57948489,78289595,20341106,RLK
chr15,Bn58799,61997855,94688626,32690771,CN
chr15,Bn58800,86947323,95350570,8403247,RLP
chr15,Bn58801,11981377,86227031,74245654,TN
chr15,Bn58802,14939906,52543942,37604036,NBS
chr15,Bn58803,71176954,80190886,9013932,CN
chr15,Bn58804,29301107,99750795,70449688,RLK
chr15,Bn58805,4562111,54635350,50073239,RLP
chr15,Bn58806,96602181,97496282,894101,TNL
chr15,Bn58807,67326864,79631769,12304905,TN
chr15,Bn58808,29125298,38953477,9828179,RLP
chr15,Bn58809,61756096,63444782,1688686,RLK
chr15,Bn58810,78437834,89215769,10777935,RLK
chr15,Bn58811,24847204,82084604,57237400,RLP
chr15,Bn58812,76963878,93086456,16122578,TNL
chr15,Bn58813,40756568,55946306,15189738,NBS
chr15,Bn58814,45261762,74332460,29070698,CNL
chr15,Bn58815,35131338,79010225,43878887,TN
chr15,Bn58816,51764176,83912027,32147851,RLK
chr15,Bn58817,33534982,61829396,28294414,TN
chr15,Bn58818,13848047,98783856,84935809,CN
chr15,Bn58819,33701254,72787465,39086211,RLK
chr15,Bn58820,18829510,52538470,33708960,RLK
chr15,Bn58821,69240085,96795092,27555007,TN
chr15,Bn58822,75175558,75464437,288879,NBS
chr15,Bn58823,70609591,86228833,15619242,RLK
chr15,Bn58824,73556519,97781931,24225412,CN
chr15,Bn58825,48952189,67182405,18230216,CNL
chr15,Bn58826,33782476,81475029,47692553,CNL
chr15,Bn58827,82308628,89032791,6724163,CNL
chr15,Bn58828,56761902,60831626,4069724,CN
chr15,Bn58829,19166151,48206942,29040791,RLK
chr15,Bn58830,61765887,92981526,31215639,CNL
chr15,Bn58831,63744978,76909869,13164891,TN
chr15,Bn58832,25952499,67236550,41284051,CNL
chr15,Bn58833,54567634,91048047,36480413,NBS
chr15,Bn58834,4194337,34324623,30130286,RLK
chr15,Bn58835,66962553,87653682,20691129,TN
chr15,Bn58836,93651134,97841253,4190119,RLP
chr15,Bn58837,72827296,87023469,14196173,CN
chr15,Bn58838,42193543,62504587,20311044,TNL
chr15,Bn58839,78551397,83104060,4552663,RLK
chr15,Bn58840,65551721,93870469,28318748,NBS
chr15,Bn58841,67298852,92210339,24911487,NBS
chr15,Bn58842,8999800,88076229,79076429,RLK
chr15,Bn58843,95697871,98132260,2434389,RLP
chr15,Bn58844,49908121,89541679,39633558,CN
chr15,Bn58845,77987526,86325796,8338270,RLP
chr15,Bn58846,81664266,96475704,14811438,RLK
chr15,Bn58847,67118848,84838666,17719818,CN
chr15,Bn58848,65733081,95752801,30019720,RLP
chr15,Bn58849,56717497,96206098,39488601,NBS
chr15,Bn58850,30724348,68672325,37947977,TNL
chr15,Bn58851,70284446,96412272,26127826,CNL
chr15,Bn58852,21404250,50180117,28775867,CN
chr15,Bn58853,74785498,89648118,14862620,CNL
chr15,Bn58854,24245269,95474899,71229630,CN
chr15,Bn58855,7698291,68816470,61118179,CNL
chr15,Bn58856,55317421,70898225,15580804,RLP
chr15,Bn58857,20546167,21538694,992527,RLK
chr15,Bn58858,67908432,68009980,101548,RLK
chr15,Bn58859,18808602,47316950,28508348,CNL
chr15,Bn58860,59447434,96546371,37098937,TN
chr15,Bn58861,93269429,94156130,886701,CN
chr15,Bn58862,69613308,98920444,29307136,RLK
chr15,Bn58863,4889759,37934976,33045217,TNL
chr15,Bn58864,48967517,87815799,38848282,TN
chr15,Bn58865,35388827,98996089,63607262,TNL
chr15,Bn58866,39473752,46835310,7361558,CNL
chr15,Bn58867,15234437,55468086,40233649,CN
chr15,Bn58868,63239371,70390628,7151257,CNL
chr15,Bn58869,1087722,94843753,93756031,TNL
chr15,Bn58870,71727867,75081638,3353771,RLP
chr15,Bn58871,94159873,95454840,1294967,TNL
chr15,Bn58872,45252868,91873509,46620641,CN
chr15,Bn58873,21297615,80440809,59143194,RLK
chr15,Bn58874,56455266,89689624,33234358,CN
chr15,Bn58875,22014041,37593280,15579239,CNL
chr15,Bn58876,93351117,95074544,1723427,RLP
chr15,Bn58877,26509524,96426527,69917003,NBS
chr15,Bn58878,39947843,83893189,43945346,CN
chr15,Bn58879,94563035,96372401,1809366,TN
chr15,Bn58880,56447116,94688295,38241179,CNL
chr15,Bn58881,48368033,56716817,8348784,TN
chr15,Bn58882,90235302,91457951,1222649,CN
chr15,Bn58883,73586254,78157011,4570757,RLK
chr15,Bn58884,2090972,93042960,90951988,TN
chr15,Bn58885,75973028,82515375,6542347,CNL
chr15,Bn58886,31428574,89092524,57663950,CN
chr15,Bn58887,79221148,98646216,19425068,NBS
chr15,Bn58888,89202522,91720820,2518298,TN
chr15,Bn58889,62610807,68163196,5552389,CN
chr15,Bn58890,62475677,78016668,15540991,TNL
chr15,Bn58891,16895576,63366409,46470833,NBS
chr15,Bn58892,34851001,98344153,63493152,RLK
chr15,Bn58893,42540576,77873759,35333183,RLP
chr15,Bn58894,36753211,91380648,54627437,RLK
chr15,Bn58895,9120636,76115538,66994902,CNL
chr15,Bn58896,39529703,65817552,26287849,TNL
chr15,Bn58897,8653014,85311673,76658659,CN
chr15,Bn58898,38322903,72746922,34424019,TNL
chr15,Bn58899,8030401,78699155,70668754,NBS
chr15,Bn58900,53113421,64054183,10940762,CN
chr15,Bn58901,1769760,57384873,55615113,RLK
chr15,Bn58902,38982625,60121921,21139296,CNL
chr15,Bn58903,39015992,85336466,46320474,TN
chr15,Bn58904,58759306,97429457,38670151,TN
chr15,Bn58905,84047168,92170853,8123685,RLP
chr15,Bn58906,38063232,69608372,31545140,TN
chr15,Bn58907,14949554,88769948,73820394,TNL
chr15,Bn58908,32193513,69983951,37790438,RLP
chr15,Bn58909,93037992,96080979,3042987,TN
chr15,Bn58910,13192801,57710044,44517243,RLK
chr15,Bn58911,21850244,35545769,13695525,RLK
chr15,Bn58912,51663789,58881326,7217537,RLK
chr15,Bn58913,52662979,93361149,40698170,TNL
chr15,Bn58914,72046157,79103936,7057779,RLP
chr15,Bn58915,49151392,71507924,22356532,RLP
chr15,Bn58916,63528117,94116157,30588040,RLK
chr15,Bn58917,31528599,70114110,38585511,RLP
chr15,Bn58918,37478674,90909985,53431311,RLK
chr15,Bn58919,96381098,97518122,1137024,RLP
chr15,Bn58920,61057592,67169106,6111514,CNL
chr15,Bn58921,66453037,68684189,2231152,RLP
chr15,Bn58922,66917411,68717468,1800057,TN
chr15,Bn58923,77289119,91965980,14676861,RLK
chr15,Bn58924,73498578,82944108,9445530,NBS
chr15,Bn58925,32316886,84062678,51745792,CNL
chr15,Bn58926,96103107,98111224,2008117,CNL
chr15,Bn58927,85254536,86718797,1464261,RLP
chr15,Bn58928,38833939,93615233,54781294,TNL
chr15,Bn58929,74374996,83946498,9571502,TNL
chr15,Bn58930,66280042,74603615,8323573,NBS
chr15,Bn58931,33075086,43151949,10076863,TNL
chr15,Bn58932,3302439,3775243,472804,TNL
chr15,Bn58933,72749758,91763851,19014093,CN
chr15,Bn58934,28805401,29322744,517343,RLP
chr15,Bn58935,11358798,87547848,76189050,RLP
chr15,Bn58936,26736101,45592913,18856812,NBS
chr15,Bn58937,49569155,64879735,15310580,CN
chr15,Bn58938,38246910,69311202,31064292,CN
chr15,Bn58939,14229995,30895240,16665245,TNL
chr15,Bn58940,72309278,88471946,16162668,CN
chr15,Bn58941,60427028,73719984,13292956,RLK
chr15,Bn58942,28030992,80309777,52278785,RLK
chr15,Bn58943,31384778,94131694,62746916,RLK
chr15,Bn58944,91921213,94578579,2657366,TNL
chr15,Bn58945,1409350,83079450,81670100,RLK
chr15,Bn58946,51066218,97925969,46859751,RLK
chr15,Bn58947,68279487,75517971,7238484,RLK
chr15,Bn58948,38756011,87349868,48593857,CNL
chr15,Bn58949,15226130,99090099,83863969,CN
chr15,Bn58950,44274909,81880064,37605155,CN
chr15,Bn58951,70121851,92974017,22852166,TNL
chr15,Bn58952,85935195,94173500,8238305,NBS
chr15,Bn58953,31040842,96229694,65188852,CN
chr15,Bn58954,42117126,60849351,18732225,NBS
chr15,Bn58955,18049007,45279583,27230576,CNL
chr15,Bn58956,69755396,79395480,9640084,CN
chr15,Bn58957,14691003,71228167,56537164,CNL
chr15,Bn58958,23343530,24850847,1507317,TN
chr15,Bn58959,76596393,95166494,18570101,RLK
chr15,Bn58960,56009849,81184969,25175120,CN
chr15,Bn58961,73533980,93761990,20228010,TNL
chr15,Bn58962,32104698,33073903,969205,CNL
chr15,Bn58963,51980540,80209068,28228528,TN
chr15,Bn58964,91288903,99642850,8353947,RLK
chr15,Bn58965,14110041,50107304,35997263,RLP
chr15,Bn58966,2289493,45989047,43699554,CN
chr15,Bn58967,7797450,9804007,2006557,CNL
chr15,Bn58968,58342945,86217710,27874765,RLP
chr15,Bn58969,94272997,99103494,4830497,TN
chr15,Bn58970,28834964,30549277,1714313,TNL
chr15,Bn58971,76328959,97824363,21495404,RLP
chr15,Bn58972,96843275,97919401,1076126,TNL
chr15,Bn58973,58491753,83536956,25045203,TNL
chr15,Bn58974,48156513,54787425,6630912,RLP
chr15,Bn58975,96960334,97935440,975106,CNL
chr15,Bn58976,49874058,78806718,28932660,TN
chr15,Bn58977,99812803,99838680,25877,CNL
chr15,Bn58978,50356957,65922541,15565584,CNL
chr15,Bn58979,95047232,97592935,2545703,NBS
chr15,Bn58980,11788376,74777459,62989083,RLK
chr15,Bn58981,33403858,55325193,21921335,NBS
chr15,Bn58982,99552515,99683812,131297,CN
chr15,Bn58983,3124556,48718854,45594298,RLK
chr15,Bn58984,33408132,47856740,14448608,CN
chr15,Bn58985,6611628,59789135,53177507,RLP
chr15,Bn58986,35554491,95411900,59857409,TNL
chr15,Bn58987,91593711,95991463,4397752,RLK
chr15,Bn58988,44062985,91122303,47059318,CN
chr15,Bn58989,92938280,95182592,2244312,CN
chr15,Bn58990,16216683,86755565,70538882,RLK
chr15,Bn58991,44644075,99920123,55276048,CN
chr15,Bn58992,13445971,52122341,38676370,TNL
chr15,Bn58993,40301864,41232567,930703,RLK
chr15,Bn58994,28302843,50446363,22143520,TNL
chr15,Bn58995,32858048,78976637,46118589,TNL
chr15,Bn58996,9951326,12081299,2129973,RLP
chr15,Bn58997,42729354,78417883,35688529,RLP
chr15,Bn58998,85998010,86248828,250818,RLK
chr15,Bn58999,93971597,97113430,3141833,RLK
chr15,Bn59000,39763005,58247144,18484139,TNL
chr15,Bn59001,79988961,86259706,6270745,RLP
chr15,Bn59002,69223734,88225816,19002082,RLP
chr15,Bn59003,76671384,86277569,9606185,CNL
chr15,Bn59004,19893231,29589162,9695931,RLK
chr15,Bn59005,61882311,67025259,5142948,RLP
chr15,Bn59006,4637951,11721313,7083362,RLP
chr15,Bn59007,29148197,61079666,31931469,CNL
chr15,Bn59008,74490358,81904493,7414135,NBS
chr15,Bn59009,49025544,92128362,43102818,CN
chr15,Bn59010,79986973,88494571,8507598,RLP
chr15,Bn59011,16331688,75443908,59112220,CNL
chr15,Bn59012,8833397,90875560,82042163,RLK
chr15,Bn59013,87846872,98316382,10469510,NBS
chr15,Bn59014,83065566,86164638,3099072,CNL
chr15,Bn59015,82548853,89604827,7055974,CNL
chr15,Bn59016,36480518,46988246,10507728,RLP
chr15,Bn59017,30916681,72275873,41359192,CNL
chr15,Bn59018,43689138,87040566,43351428,TN
chr15,Bn59019,21069460,56809403,35739943,NBS
chr15,Bn59020,53545816,76242256,22696440,CN
chr15,Bn59021,74903320,96291395,21388075,CN
chr15,Bn59022,34842610,82469938,47627328,CN
chr15,Bn59023,91870450,95491620,3621170,CN
chr15,Bn59024,19035411,79670363,60634952,CNL
chr15,Bn59025,94752385,99179581,4427196,CNL
chr15,Bn59026,42615278,58780391,16165113,CNL
chr15,Bn59027,64689843,65152859,463016,CN
chr15,Bn59028,1554883,29310849,27755966,CN
chr15,Bn59029,56017451,90266876,34249425,CNL
chr15,Bn59030,32986281,47548445,14562164,TNL
chr15,Bn59031,89695405,99495388,9799983,CN
chr15,Bn59032,1719196,33901170,32181974,CNL
chr15,Bn59033,6931207,8467618,1536411,NBS
chr15,Bn59034,2533609,95502838,92969229,RLK
chr15,Bn59035,90783305,92722417,1939112,RLP
chr15,Bn59036,6669556,43075413,36405857,CNL
chr15,Bn59037,59737453,73313494,13576041,RLK
chr15,Bn59038,78857905,91583294,12725389,RLK
chr15,Bn59039,91688491,99274025,7585534,CNL
chr15,Bn59040,89078673,96528829,7450156,CN
chr15,Bn59041,62648641,71336512,8687871,CN
chr15,Bn59042,52219512,71923939,19704427,CNL
chr15,Bn59043,2877583,40220554,37342971,RLK
chr15,Bn59044,86026435,86807637,781202,TNL
chr15,Bn59045,5937035,16720094,10783059,CNL
chr15,Bn59046,94475100,94967914,492814,RLP
chr15,Bn59047,82178266,87386889,5208623,RLP
chr15,Bn59048,65079825,77967398,12887573,CN
chr15,Bn59049,84992633,87733932,2741299,RLK
chr15,Bn59050,7293912,73029183,65735271,TN
chr15,Bn59051,95902513,96854337,951824,TNL
chr15,Bn59052,84914982,97303659,12388677,CN
chr15,Bn59053,88122352,90531508,2409156,CNL
chr15,Bn59054,78574532,87108363,8533831,TNL
chr15,Bn59055,25195863,52332359,27136496,RLP
chr15,Bn59056,14489130,39474178,24985048,RLP
chr15,Bn59057,36129589,53885718,17756129,RLP
chr15,Bn59058,52019799,91140635,39120836,CNL
chr15,Bn59059,26501005,77084847,50583842,TNL
chr15,Bn59060,42104121,82373463,40269342,CNL
chr15,Bn59061,36108747,48283828,12175081,RLK
chr15,Bn59062,71325384,83841695,12516311,NBS
chr15,Bn59063,14336829,91275636,76938807,TNL
chr15,Bn59064,82108655,95459797,13351142,RLK
chr15,Bn59065,57063656,81268834,24205178,TNL
chr15,Bn59066,8254227,69213678,60959451,CN
chr15,Bn59067,30440597,95137001,64696404,TNL
chr15,Bn59068,31175772,39683657,8507885,NBS
chr15,Bn59069,84196221,94703608,10507387,CN
chr15,Bn59070,14979219,92294599,77315380,TNL
chr15,Bn59071,53973666,87466182,33492516,TNL
chr15,Bn59072,30003374,67628486,37625112,RLK
chr15,Bn59073,12620343,54541745,41921402,CNL
chr15,Bn59074,15917717,79325905,63408188,RLK
chr15,Bn59075,8533773,95771768,87237995,CNL
chr15,Bn59076,9629579,66822948,57193369,TN
chr15,Bn59077,23880052,31194293,7314241,TN
chr15,Bn59078,81266299,83190698,1924399,CN
chr15,Bn59079,18314894,39531078,21216184,TNL
chr15,Bn59080,73983684,97048661,23064977,RLP
chr15,Bn59081,96707568,98723203,2015635,CNL
chr15,Bn59082,34171838,71239509,37067671,NBS
chr15,Bn59083,44827209,85166467,40339258,RLK
chr15,Bn59084,18067320,22846100,4778780,RLP
chr15,Bn59085,57945589,60584605,2639016,TN
chr15,Bn59086,50062590,99415319,49352729,RLP
chr15,Bn59087,85747026,89448013,3700987,RLK
chr15,Bn59088,74184570,97734142,23549572,TN
chr15,Bn59089,64322043,92897445,28575402,RLP
chr15,Bn59090,84328081,94509832,10181751,CNL
chr15,Bn59091,61962173,85679543,23717370,TN
chr15,Bn59092,4260977,52102184,47841207,CNL
chr15,Bn59093,87262066,99610133,12348067,CN
chr15,Bn59094,2992681,31528803,28536122,CN
chr15,Bn59095,22811922,52319300,29507378,CNL
chr15,Bn59096,34797560,78007337,43209777,RLP
chr15,Bn59097,91180407,94498169,3317762,CNL
chr15,Bn59098,71267771,86133827,14866056,CN
chr15,Bn59099,17148955,52536141,35387186,TNL
chr15,Bn59100,85344674,92913434,7568760,TNL
chr15,Bn59101,41702443,90287357,48584914,RLK
chr15,Bn59102,70940237,80278640,9338403,TN
chr15,Bn59103,34221512,88839984,54618472,CNL
chr15,Bn59104,50038436,87418695,37380259,CN
chr15,Bn59105,38068599,62790831,24722232,TNL
chr15,Bn59106,72773909,83761855,10987946,NBS
chr15,Bn59107,56681220,60942187,4260967,TNL
chr15,Bn59108,42466713,74987145,32520432,NBS
chr15,Bn59109,62388934,88652064,26263130,TNL
chr15,Bn59110,70146220,75428933,5282713,TNL
chr15,Bn59111,80447863,96552291,16104428,TNL
chr15,Bn59112,67343838,79643673,12299835,NBS
chr15,Bn59113,55942883,86982351,31039468,RLK
chr15,Bn59114,77127982,97847366,20719384,RLK
chr15,Bn59115,5531911,34114161,28582250,CNL
chr15,Bn59116,44527047,69946273,25419226,NBS
chr15,Bn59117,76357636,81720774,5363138,TNL
chr15,Bn59118,20960960,34284748,13323788,CN
chr15,Bn59119,23577977,69674296,46096319,RLK
chr15,Bn59120,56432461,67258320,10825859,TN
chr15,Bn59121,43847778,47461106,3613328,RLP
chr15,Bn59122,44731566,55122832,10391266,CNL
chr15,Bn59123,43411304,52510420,9099116,RLP
chr15,Bn59124,58611368,85141809,26530441,TNL
chr15,Bn59125,49978883,97411340,47432457,RLP
chr15,Bn59126,89277135,91143365,1866230,TN
chr15,Bn59127,60433934,75521657,15087723,CN
chr15,Bn59128,32081474,69164613,37083139,RLP
chr15,Bn59129,99759372,99793195,33823,CN
chr15,Bn59130,23500709,42882166,19381457,CNL
chr15,Bn59131,19118942,97366640,78247698,CNL
chr15,Bn59132,55707418,96784604,41077186,CNL
chr15,Bn59133,53810477,84166985,30356508,RLP
chr15,Bn59134,89093790,98632065,9538275,NBS
chr15,Bn59135,55730319,74794738,19064419,RLP
chr15,Bn59136,29834921,86922535,57087614,TNL
chr15,Bn59137,45356125,80490268,35134143,NBS
chr15,Bn59138,44756982,45053756,296774,RLP
chr15,Bn59139,44243759,58657019,14413260,CNL
chr15,Bn59140,35001395,86898505,51897110,RLP
chr15,Bn59141,89076888,92533113,3456225,TNL
chr15,Bn59142,18464095,33940160,15476065,RLP
chr15,Bn59143,4622304,35365485,30743181,RLK
chr15,Bn59144,82044085,83614913,1570828,TNL
chr15,Bn59145,68450073,91378274,22928201,TN
chr15,Bn59146,94960859,99076324,4115465,NBS
chr15,Bn59147,49231506,49377236,145730,CNL
chr15,Bn59148,42919943,94257259,51337316,RLK
chr15,Bn59149,29232069,70932415,41700346,CNL
chr15,Bn59150,87748408,94370787,6622379,CNL
chr15,Bn59151,91316405,96714686,5398281,RLK
chr15,Bn59152,90136119,96256719,6120600,TNL
chr15,Bn59153,74895327,76348338,1453011,RLK
chr15,Bn59154,84338461,90855637,6517176,TN
chr15,Bn59155,10299744,46140741,35840997,CNL
chr15,Bn59156,74458922,80253509,5794587,CNL
chr15,Bn59157,59400117,92704149,33304032,TN
chr15,Bn59158,94324509,96217809,1893300,RLK
chr15,Bn59159,51131261,65481881,14350620,RLP
chr15,Bn59160,12566004,55024071,42458067,RLK
chr15,Bn59161,84001933,98631076,14629143,TN
chr15,Bn59162,31370722,40423948,9053226,TNL
chr15,Bn59163,69179173,99817833,30638660,RLK
chr15,Bn59164,10800691,25517969,14717278,RLP
chr15,Bn59165,11065364,31496146,20430782,RLP
chr15,Bn59166,63931392,91351714,27420322,NBS
chr15,Bn59167,17833071,44891644,27058573,TN
chr15,Bn59168,68427524,84173335,15745811,RLK
chr15,Bn59169,67994285,80290426,12296141,RLP
chr15,Bn59170,28323032,32633739,4310707,TNL
chr15,Bn59171,45824622,71144991,25320369,TN
chr15,Bn59172,93910718,95974909,2064191,CN
chr15,Bn59173,99805124,99870154,65030,TN
chr15,Bn59174,6911660,82488263,75576603,CNL
chr15,Bn59175,97112136,97328867,216731,RLK
chr15,Bn59176,2144128,88200500,86056372,TNL
chr15,Bn59177,42721556,98720566,55999010,CNL
chr15,Bn59178,55167204,83424235,28257031,TNL
chr15,Bn59179,15661464,85845384,70183920,CN
chr15,Bn59180,79657840,84174586,4516746,TN
chr15,Bn59181,1488457,57933528,56445071,CN
chr15,Bn59182,78671100,84987693,6316593,TNL
chr15,Bn59183,56609521,83656094,27046573,RLK
chr15,Bn59184,53539796,57377787,3837991,RLK
chr15,Bn59185,57612913,68597732,10984819,TNL
chr15,Bn59186,21531720,59545818,38014098,TNL
chr15,Bn59187,16578995,94491936,77912941,NBS
chr15,Bn59188,47561361,96279769,48718408,CN
chr15,Bn59189,17220665,59158254,41937589,RLP
chr15,Bn59190,79417805,87962854,8545049,NBS
chr15,Bn59191,73287826,79170355,5882529,NBS
chr15,Bn59192,93251198,94351240,1100042,RLP
chr15,Bn59193,25170983,34359062,9188079,CN
chr15,Bn59194,69636673,69966210,329537,TNL
chr15,Bn59195,50990928,61309534,10318606,CN
chr15,Bn59196,8105765,26990071,18884306,NBS
chr15,Bn59197,61198238,71440652,10242414,CN
chr15,Bn59198,15168293,90628533,75460240,NBS
chr15,Bn59199,33978315,95473761,61495446,TNL
chr15,Bn59200,28704228,38976274,10272046,CNL
chr15,Bn59201,97348913,99903198,2554285,CNL
chr15,Bn59202,26063030,99373051,73310021,RLK
chr15,Bn59203,61391134,93721888,32330754,TN
chr15,Bn59204,4204674,5469943,1265269,CNL
chr15,Bn59205,92914890,98250746,5335856,RLK
chr15,Bn59206,22066506,54965608,32899102,NBS
chr15,Bn59207,37422476,55330459,17907983,CN
chr15,Bn59208,90018177,92425022,2406845,RLK
chr15,Bn59209,19580966,85293702,65712736,RLP
chr15,Bn59210,49718459,90676718,40958259,TN
chr15,Bn59211,5225890,41055042,35829152,TN
chr15,Bn59212,20846350,41046577,20200227,TNL
chr15,Bn59213,98598682,99063297,464615,TN
chr15,Bn59214,50634341,62529261,11894920,CN
chr15,Bn59215,75367580,75893852,526272,CNL
chr15,Bn59216,74989808,90200095,15210287,TNL
chr15,Bn59217,73313713,76171588,2857875,CN
chr15,Bn59218,80065861,98653185,18587324,NBS
chr15,Bn59219,39173530,90745979,51572449,CN
chr15,Bn59220,49742217,93191401,43449184,CNL
chr15,Bn59221,69798867,91791065,21992198,CNL
chr15,Bn59222,42373269,45564060,3190791,CN
chr15,Bn59223,98797447,99506066,708619,TN
chr15,Bn59224,98324336,99159510,835174,CNL
chr15,Bn59225,92994822,98845855,5851033,CN
chr15,Bn59226,24706849,96867176,72160327,TN
chr15,Bn59227,51950511,72001473,20050962,RLK
chr15,Bn59228,29648597,73474431,43825834,TN
chr15,Bn59229,12513300,40229199,27715899,TN
chr15,Bn59230,50016923,73631323,23614400,CN
chr15,Bn59231,61233284,77227063,15993779,TN
chr15,Bn59232,47960518,53817206,5856688,NBS
chr15,Bn59233,52035551,92046242,40010691,CN
chr15,Bn59234,61655905,65622036,3966131,RLK
chr15,Bn59235,25852554,42665092,16812538,TNL
chr15,Bn59236,36073977,76133123,40059146,NBS
chr15,Bn59237,37817499,42070656,4253157,RLP
chr15,Bn59238,90617348,94930526,4313178,NBS
chr15,Bn59239,58718107,63616680,4898573,NBS
chr15,Bn59240,92290476,97547465,5256989,NBS
chr15,Bn59241,32841358,98715632,65874274,TN
chr15,Bn59242,36579983,84023459,47443476,CN
chr15,Bn59243,44009388,93923540,49914152,CNL
chr15,Bn59244,87619253,92591790,4972537,RLP
chr15,Bn59245,20603661,98644381,78040720,CNL
chr15,Bn59246,71575231,89308363,17733132,RLP
chr15,Bn59247,4202779,10567053,6364274,NBS
chr15,Bn59248,13743931,35913543,22169612,NBS
chr15,Bn59249,61694198,79220943,17526745,CN
chr15,Bn59250,17212512,61872206,44659694,RLP
chr15,Bn59251,98076485,99433762,1357277,TN
chr15,Bn59252,87589939,91538150,3948211,RLP
chr15,Bn59253,47661240,90895814,43234574,CN
chr15,Bn59254,40646374,67836575,27190201,TNL
chr15,Bn59255,89271889,95831522,6559633,RLK
chr15,Bn59256,7125995,61832409,54706414,CNL
chr15,Bn59257,19929551,76715711,56786160,CNL
chr15,Bn59258,97292810,97587114,294304,CNL
chr15,Bn59259,18249411,23350492,5101081,TNL
chr15,Bn59260,13819429,93282205,79462776,CNL
chr15,Bn59261,7984491,86621056,78636565,TN
chr15,Bn59262,60603333,65905238,5301905,RLP
chr15,Bn59263,2121776,10529091,8407315,TN
chr15,Bn59264,43370614,84333677,40963063,NBS
chr15,Bn59265,4913485,33074648,28161163,RLK
chr15,Bn59266,45526796,47010197,1483401,RLK
chr15,Bn59267,85578240,87546490,1968250,RLP
chr15,Bn59268,57010978,86391615,29380637,RLP
chr15,Bn59269,1369877,48628779,47258902,TN
chr15,Bn59270,71853842,73909883,2056041,TNL
chr15,Bn59271,96986578,98734345,1747767,TNL
chr15,Bn59272,57187531,97322076,40134545,RLP
chr15,Bn59273,34064397,48461354,14396957,RLK
chr15,Bn59274,28862164,98447348,69585184,RLP
chr15,Bn59275,46242120,73729734,27487614,TNL
chr15,Bn59276,73723367,77735401,4012034,RLP
chr15,Bn59277,38232241,84848159,46615918,TN
chr15,Bn59278,1340242,48213454,46873212,RLP
chr15,Bn59279,42161283,71908799,29747516,CNL
chr15,Bn59280,49893006,86798669,36905663,TN
chr15,Bn59281,72874396,85241151,12366755,TN
chr15,Bn59282,69551387,71539275,1987888,NBS
chr15,Bn59283,99777517,99858442,80925,CN
chr15,Bn59284,27912078,61001604,33089526,RLP
chr15,Bn59285,22690879,62108773,39417894,TN
chr15,Bn59286,2816786,61734334,58917548,CN
chr15,Bn59287,26937354,39774486,12837132,TN
chr15,Bn59288,49504873,78393411,28888538,RLP
chr15,Bn59289,49308367,72536736,23228369,CNL
chr15,Bn59290,29861840,40761302,10899462,CNL
chr15,Bn59291,27085081,45885523,18800442,TNL
chr15,Bn59292,67624381,72892781,5268400,NBS
chr15,Bn59293,69664904,75207295,5542391,CNL
chr15,Bn59294,44942110,49875298,4933188,CNL
chr15,Bn59295,99690364,99883683,193319,CN
chr15,Bn59296,17321214,45428831,28107617,CNL
chr15,Bn59297,56266274,80558454,24292180,RLP
chr15,Bn59298,30094234,42096981,12002747,TNL
chr15,Bn59299,19632423,39299937,19667514,CN
chr15,Bn59300,96158913,98109377,1950464,CN
chr15,Bn59301,25958138,33378794,7420656,TNL
chr15,Bn59302,10936764,52032826,41096062,NBS
chr15,Bn59303,12437531,13788887,1351356,TN
chr15,Bn59304,71464407,77257711,5793304,CN
chr15,Bn59305,96421775,99993090,3571315,NBS
chr15,Bn59306,25461069,63812580,38351511,TNL
chr15,Bn59307,47746275,95609236,47862961,RLP
chr15,Bn59308,14394406,97336978,82942572,TNL
chr15,Bn59309,14973245,86334021,71360776,RLP
chr15,Bn59310,82727110,93497511,10770401,TN
chr15,Bn59311,62368669,71636328,9267659,CN
chr15,Bn59312,44042840,96205956,52163116,CNL
chr15,Bn59313,10895816,90277001,79381185,CNL
chr15,Bn59314,97290603,98751294,1460691,TNL
chr15,Bn59315,76727790,95514713,18786923,RLP
chr15,Bn59316,37975971,70105525,32129554,TN
chr15,Bn59317,30546541,76465840,45919299,TN
chr15,Bn59318,47586981,61110438,13523457,RLP
chr15,Bn59319,93664451,98851732,5187281,TNL
chr15,Bn59320,34817072,66207588,31390516,CNL
chr15,Bn59321,97430418,99615147,2184729,TN
chr15,Bn59322,23943659,61968581,38024922,RLK
chr15,Bn59323,33087966,72074808,38986842,RLP
chr15,Bn59324,60318173,68073159,7754986,NBS
chr15,Bn59325,24818686,25627638,808952,CN
chr15,Bn59326,92708359,95804064,3095705,RLP
chr15,Bn59327,67238019,77785905,10547886,CN
chr15,Bn59328,59503571,87768527,28264956,RLK
chr15,Bn59329,68243758,73217668,4973910,NBS
chr15,Bn59330,91016389,96464419,5448030,TNL
chr15,Bn59331,54263460,72365574,18102114,CNL
chr15,Bn59332,62177722,90251995,28074273,TN
chr15,Bn59333,90934433,96723285,5788852,TN
chr15,Bn59334,80980466,89679721,8699255,TNL
chr15,Bn59335,99973847,99980435,6588,TN
chr15,Bn59336,28024490,98628426,70603936,NBS
chr15,Bn59337,1366822,84893731,83526909,CNL
chr15,Bn59338,32343424,54453316,22109892,CNL
chr15,Bn59339,76715386,76786432,71046,RLP
chr15,Bn59340,72180114,82356383,10176269,RLK
chr15,Bn59341,6984611,29466101,22481490,TNL
chr15,Bn59342,58988720,77181310,18192590,CNL
chr15,Bn59343,4218794,27837262,23618468,NBS
chr15,Bn59344,88791860,95703440,6911580,TN
chr15,Bn59345,27140213,66347568,39207355,TN
chr15,Bn59346,38543262,57098407,18555145,CN
chr15,Bn59347,12007845,50937921,38930076,CNL
chr15,Bn59348,22799896,28735581,5935685,CN
chr15,Bn59349,69259841,73998767,4738926,RLK
chr15,Bn59350,33818267,99013447,65195180,NBS
chr15,Bn59351,39454889,75958055,36503166,TNL
chr15,Bn59352,45146217,78590631,33444414,RLP
chr15,Bn59353,20367156,57110967,36743811,TNL
chr15,Bn59354,21339485,95312983,73973498,CN
chr15,Bn59355,65763732,92455484,26691752,TNL
chr15,Bn59356,31867161,53851689,21984528,TNL
chr15,Bn59357,2670709,6821069,4150360,TNL
chr15,Bn59358,41639478,72149088,30509610,CNL
chr15,Bn59359,53305005,97735411,44430406,NBS
chr15,Bn59360,16997632,32825998,15828366,NBS
chr15,Bn59361,87745780,88930603,1184823,CNL
chr15,Bn59362,44725308,72881176,28155868,NBS
chr15,Bn59363,60482062,76607855,16125793,RLP
chr15,Bn59364,96937462,98928290,1990828,CNL
chr15,Bn59365,46410658,81986137,35575479,RLK
chr15,Bn59366,44967886,63660059,18692173,TNL
chr15,Bn59367,43462424,45617057,2154633,RLK
chr15,Bn59368,5966609,84471140,78504531,TNL
chr15,Bn59369,28705217,76891847,48186630,RLK
chr15,Bn59370,56873401,58870259,1996858,RLP
chr15,Bn59371,74263694,85992802,11729108,RLK
chr15,Bn59372,52063564,74377042,22313478,RLK
chr15,Bn59373,53934036,71795296,17861260,RLP
chr15,Bn59374,8799922,87649062,78849140,CNL
chr15,Bn59375,86323321,89580334,3257013,TNL
chr15,Bn59376,72658203,99652938,26994735,TNL
chr15,Bn59377,70081159,84824631,14743472,NBS
chr15,Bn59378,53521248,95565556,42044308,TNL
chr15,Bn59379,93711075,93763466,52391,TN
chr15,Bn59380,48479714,82680916,34201202,CN
chr15,Bn59381,95822008,98264894,2442886,RLP
chr15,Bn59382,79128705,95930827,16802122,CN
chr15,Bn59383,23939999,31394226,7454227,CNL
chr15,Bn59384,24817227,95315430,70498203,RLP
chr15,Bn59385,71613014,84498346,12885332,RLP
chr15,Bn59386,74749182,75975291,1226109,TN
chr15,Bn59387,56830817,68600270,11769453,RLK
chr15,Bn59388,49619702,58309867,8690165,NBS
chr15,Bn59389,75027428,91754212,16726784,NBS
chr15,Bn59390,80708644,91223034,10514390,NBS
chr15,Bn59391,9939990,67820076,57880086,TNL
chr15,Bn59392,9476888,13403628,3926740,RLP
chr15,Bn59393,83982650,89757593,5774943,TNL
chr15,Bn59394,24365729,25949531,1583802,NBS
chr15,Bn59395,1115069,64835587,63720518,NBS
chr15,Bn59396,13634926,60436601,46801675,RLK
chr15,Bn59397,47573866,82219344,34645478,RLK
chr15,Bn59398,21015095,91873972,70858877,TN
chr15,Bn59399,15948551,17766820,1818269,RLP
chr15,Bn59400,13289984,73696538,60406554,RLK
chr15,Bn59401,8764768,50185627,41420859,CN
chr15,Bn59402,81000012,94318074,13318062,TN
chr15,Bn59403,88238400,90704889,2466489,RLP
chr15,Bn59404,99259693,99979354,719661,RLK
chr15,Bn59405,7561902,43670179,36108277,RLK
chr15,Bn59406,95780600,96430703,650103,TN
chr15,Bn59407,40212292,66220442,26008150,TNL
chr15,Bn59408,91438564,98859820,7421256,CNL
chr15,Bn59409,71220255,84037627,12817372,TN
chr15,Bn59410,96663961,97801508,1137547,TN
chr15,Bn59411,50700522,55617002,4916480,TN
chr15,Bn59412,27129911,82282083,55152172,RLK
chr15,Bn59413,4987138,36127904,31140766,RLK
chr15,Bn59414,59584732,91631604,32046872,RLK
chr15,Bn59415,98897445,99758574,861129,RLP
chr15,Bn59416,99084390,99962278,877888,NBS
chr15,Bn59417,93838220,94507661,669441,RLK
chr15,Bn59418,49173005,94462820,45289815,RLK
chr15,Bn59419,20202897,58963141,38760244,NBS
chr15,Bn59420,40828117,99522301,58694184,RLP
chr15,Bn59421,78695461,85865389,7169928,TNL
chr15,Bn59422,14244818,94121083,79876265,NBS
chr15,Bn59423,20912998,74178779,53265781,CN
chr15,Bn59424,88034662,92665549,4630887,RLK
chr15,Bn59425,96442189,99806740,3364551,CN
chr15,Bn59426,17997671,53006804,35009133,NBS
chr15,Bn59427,1859514,52330207,50470693,TN
chr15,Bn59428,27168283,47367277,20198994,RLK
chr15,Bn59429,41241600,56999803,15758203,TNL
chr15,Bn59430,51703127,61272887,9569760,CNL
chr15,Bn59431,59275784,98765496,39489712,RLP
chr15,Bn59432,14893639,33800388,18906749,CN
chr15,Bn59433,18103572,84046867,65943295,CNL
chr15,Bn59434,92650179,95127036,2476857,NBS
chr15,Bn59435,78074375,80444422,2370047,TNL
chr15,Bn59436,77002568,96942412,19939844,RLP
chr15,Bn59437,50816250,88489083,37672833,RLK
chr15,Bn59438,54123321,70387057,16263736,CNL
chr15,Bn59439,61543521,96294964,34751443,NBS
chr15,Bn59440,26786126,97876360,71090234,CN
chr15,Bn59441,2364063,24923020,22558957,CNL
chr15,Bn59442,67626054,80007116,12381062,NBS
chr15,Bn59443,60835759,81712852,20877093,TNL
chr15,Bn59444,18822181,78386860,59564679,CN
chr15,Bn59445,73862525,91309047,17446522,RLK
chr15,Bn59446,36812144,41918126,5105982,CNL
chr15,Bn59447,63817029,75862262,12045233,CNL
chr15,Bn59448,38398564,83832667,45434103,TNL
chr15,Bn59449,59562608,66092428,6529820,CN
chr15,Bn59450,22591508,89704764,67113256,CN
chr15,Bn59451,22716102,39242277,16526175,RLP
chr15,Bn59452,4597951,91203106,86605155,RLP
chr15,Bn59453,21772267,90943868,69171601,TN
chr15,Bn59454,7564213,88651812,81087599,NBS
chr15,Bn59455,6233674,71616268,65382594,TNL
chr15,Bn59456,63196647,85557077,22360430,TNL
chr15,Bn59457,16321350,25725827,9404477,RLK
chr15,Bn59458,37573004,55096039,17523035,TN
chr15,Bn59459,41611130,65431750,23820620,TNL
chr15,Bn59460,2047855,55867462,53819607,NBS
chr15,Bn59461,64725495,86759602,22034107,TNL
chr15,Bn59462,86341463,95784375,9442912,RLK
chr15,Bn59463,68455769,69888462,1432693,CNL
chr15,Bn59464,64718017,92786480,28068463,TNL
chr15,Bn59465,17897585,70017366,52119781,TN
chr15,Bn59466,6089586,28423124,22333538,RLP
chr15,Bn59467,59949047,65240736,5291689,TN
chr15,Bn59468,34970708,85069266,50098558,CNL
chr15,Bn59469,11865617,16448363,4582746,CN
chr15,Bn59470,17574721,92536606,74961885,TNL
chr15,Bn59471,77253901,85261577,8007676,CN
chr15,Bn59472,15069707,37045473,21975766,TNL
chr15,Bn59473,73124811,79925164,6800353,TN
chr15,Bn59474,81906636,85890372,3983736,RLP
chr15,Bn59475,43953733,60816030,16862297,TNL
chr15,Bn59476,24725356,32906483,8181127,TN
chr15,Bn59477,36205633,46796357,10590724,RLK
chr15,Bn59478,68843808,98196040,29352232,NBS
chr15,Bn59479,6891462,69043768,62152306,NBS
chr15,Bn59480,33172746,94086296,60913550,TNL
chr15,Bn59481,4142627,50115400,45972773,RLK
chr15,Bn59482,30227859,73181299,42953440,CN
chr15,Bn59483,65817372,66162997,345625,TNL
chr15,Bn59484,62151093,80079996,17928903,CN
chr15,Bn59485,66281191,67770463,1489272,TN
chr15,Bn59486,95713455,96671102,957647,TNL
chr15,Bn59487,11015564,86285103,75269539,TN
chr15,Bn59488,18716120,79225248,60509128,TNL
chr15,Bn59489,18600511,46693323,28092812,RLP
chr15,Bn59490,9726146,40444701,30718555,RLK
chr15,Bn59491,87726787,91045134,3318347,CNL
chr15,Bn59492,88228922,96503457,8274535,RLK
chr15,Bn59493,1154586,31729437,30574851,CN
chr15,Bn59494,24125973,88909150,64783177,TN
chr15,Bn59495,87250707,98652444,11401737,RLK
chr15,Bn59496,94071104,94602188,531084,TN
chr15,Bn59497,99674740,99818532,143792,TNL
chr15,Bn59498,75771607,76899063,1127456,CN
chr15,Bn59499,86134941,96039419,9904478,NBS
chr15,Bn59500,50430433,66393686,15963253,NBS
chr15,Bn59501,48953569,69692529,20738960,RLP
chr15,Bn59502,28863606,38499129,9635523,RLK
chr15,Bn59503,96473377,99409544,2936167,RLK
chr15,Bn59504,46675098,72662910,25987812,TNL
chr15,Bn59505,82541655,91566054,9024399,RLP
chr15,Bn59506,79640593,83325789,3685196,CN
chr15,Bn59507,7046642,44853105,37806463,TN
chr15,Bn59508,4025079,65266021,61240942,RLK
chr15,Bn59509,91273451,91686733,413282,TN
chr15,Bn59510,13083463,34707927,21624464,CN
chr15,Bn59511,9438510,70647218,61208708,CN
chr15,Bn59512,82895147,88146209,5251062,RLP
chr15,Bn59513,86652588,98273407,11620819,TNL
chr15,Bn59514,69387896,88074320,18686424,TN
chr15,Bn59515,39647574,93019655,53372081,RLK
chr15,Bn59516,62032844,92003184,29970340,CN
chr15,Bn59517,33381534,54561828,21180294,TNL
chr15,Bn59518,31818413,37319804,5501391,RLP
chr15,Bn59519,23906872,68815974,44909102,TNL
chr15,Bn59520,15639165,75169504,59530339,CNL
chr15,Bn59521,29404160,82698086,53293926,NBS
chr15,Bn59522,57707787,79494896,21787109,CN
chr15,Bn59523,8909328,87382298,78472970,TNL
chr15,Bn59524,34613544,51095258,16481714,NBS
chr15,Bn59525,30826571,87583471,56756900,CNL
chr15,Bn59526,59510499,85632235,26121736,NBS
chr15,Bn59527,64255434,65851997,1596563,RLP
chr15,Bn59528,42047444,92691591,50644147,CN
chr15,Bn59529,86990160,87271052,280892,CN
chr15,Bn59530,37399756,40851550,3451794,RLP
chr15,Bn59531,96512729,98911674,2398945,CN
chr15,Bn59532,51939958,89929459,37989501,RLP
chr15,Bn59533,70217279,88556025,18338746,NBS
chr15,Bn59534,33714523,38088226,4373703,TNL
chr15,Bn59535,77104472,92842077,15737605,RLK
chr15,Bn59536,3717102,10305468,6588366,RLK
chr15,Bn59537,56798134,94277895,37479761,CN
chr15,Bn59538,99771198,99870604,99406,TN
chr15,Bn59539,29273712,76447211,47173499,TNL
chr15,Bn59540,57410262,74444250,17033988,TNL
chr15,Bn59541,12434844,16916184,4481340,NBS
chr15,Bn59542,42086707,45309373,3222666,TNL
chr15,Bn59543,6348460,59210576,52862116,RLP
chr15,Bn59544,2551398,86855272,84303874,TNL
chr15,Bn59545,92904514,96956265,4051751,CN
chr15,Bn59546,7887483,38331357,30443874,CNL
chr15,Bn59547,37173350,96106049,58932699,TN
chr15,Bn59548,7898038,70774644,62876606,CN
chr15,Bn59549,32854338,61739073,28884735,NBS
chr15,Bn59550,59483394,91292969,31809575,NBS
chr15,Bn59551,11689671,93488504,81798833,RLP
chr15,Bn59552,61443109,83479480,22036371,RLP
chr15,Bn59553,33115586,91369984,58254398,CNL
chr15,Bn59554,18629816,99729867,81100051,CN
chr15,Bn59555,66160604,93185499,27024895,TNL
chr15,Bn59556,54925273,96052909,41127636,TN
chr15,Bn59557,49377291,84050746,34673455,TN
chr15,Bn59558,11934791,62124825,50190034,CNL
chr15,Bn59559,24899996,94728040,69828044,RLK
chr15,Bn59560,62791638,78673442,15881804,CNL
chr15,Bn59561,55650091,82683918,27033827,RLK
chr15,Bn59562,64651873,73307430,8655557,RLK
chr15,Bn59563,61269589,68776759,7507170,RLP
chr15,Bn59564,62589549,85035762,22446213,TNL
chr15,Bn59565,9446229,72752030,63305801,TN
chr15,Bn59566,81346207,97187680,15841473,TN
chr15,Bn59567,18566643,87986150,69419507,CN
chr15,Bn59568,86946175,96960036,10013861,TN
chr15,Bn59569,10265900,22119187,11853287,TNL
chr15,Bn59570,26377123,42965306,16588183,NBS
chr15,Bn59571,36195251,92318153,56122902,CNL
chr15,Bn59572,97580283,99450291,1870008,TN
chr15,Bn59573,37513793,92406715,54892922,TNL
chr15,Bn59574,97797864,98891354,1093490,NBS
chr15,Bn59575,82171133,93641029,11469896,CN
chr15,Bn59576,49685603,60102902,10417299,NBS
chr15,Bn59577,99699314,99858688,159374,NBS
chr15,Bn59578,84662699,96906354,12243655,TNL
chr15,Bn59579,24500141,82902716,58402575,TN
chr15,Bn59580,71438133,96188890,24750757,RLK
chr15,Bn59581,42350825,60976843,18626018,RLK
chr15,Bn59582,89588439,90474228,885789,RLP
chr15,Bn59583,90281778,94146628,3864850,RLP
chr15,Bn59584,53520970,74742873,21221903,RLK
chr15,Bn59585,10043505,12632318,2588813,RLP
chr15,Bn59586,17604259,43172028,25567769,TNL
chr15,Bn59587,50536875,96804309,46267434,RLK
chr15,Bn59588,22599981,23207937,607956,TN
chr15,Bn59589,25233762,65329683,40095921,RLP
chr15,Bn59590,6950512,16955904,10005392,NBS
chr15,Bn59591,34257427,48065747,13808320,CN
chr15,Bn59592,9559528,42645084,33085556,CN
chr15,Bn59593,60132552,87420594,27288042,CNL
chr15,Bn59594,96703109,98622359,1919250,TNL
chr15,Bn59595,66160999,90142961,23981962,CNL
chr15,Bn59596,78851248,84111428,5260180,NBS
chr15,Bn59597,20405321,57341723,36936402,RLK
chr15,Bn59598,91853494,94409748,2556254,RLP
chr15,Bn59599,13498610,91067226,77568616,NBS
chr15,Bn59600,97502466,99706243,2203777,TNL
chr15,Bn59601,39845333,45469725,5624392,TNL
chr15,Bn59602,18282423,85471209,67188786,RLP
chr15,Bn59603,42017095,66824386,24807291,RLK
chr15,Bn59604,80752407,85021865,4269458,TNL
chr15,Bn59605,80352088,85906712,5554624,CNL
chr15,Bn59606,66711158,68521243,1810085,CNL
chr15,Bn59607,36455171,54666305,18211134,RLK
chr15,Bn59608,88391163,98977306,10586143,TN
chr15,Bn59609,33365513,75108105,41742592,RLK
chr15,Bn59610,35441748,50048275,14606527,TNL
chr15,Bn59611,8769295,35151310,26382015,RLK
chr15,Bn59612,20125988,45129757,25003769,TNL
chr15,Bn59613,52211319,63616445,11405126,RLK
chr15,Bn59614,9313605,66334355,57020750,RLK
chr15,Bn59615,99161485,99234328,72843,TN
chr15,Bn59616,89681752,92473676,2791924,NBS
chr15,Bn59617,62303472,66940123,4636651,TNL
chr15,Bn59618,84197322,93278513,9081191,CN
chr15,Bn59619,48757833,88856650,40098817,RLP
chr15,Bn59620,71889662,99498884,27609222,CN
chr15,Bn59621,20431226,54519082,34087856,RLK
chr15,Bn59622,91623683,97105728,5482045,RLP
chr15,Bn59623,33168233,96557452,63389219,NBS
chr15,Bn59624,83993997,98747730,14753733,CN
chr15,Bn59625,73037662,75907846,2870184,TNL
chr15,Bn59626,56194840,59070722,2875882,RLK
chr15,Bn59627,92748394,94201976,1453582,TN
chr15,Bn59628,13099734,42679804,29580070,CN
chr15,Bn59629,23214754,24591883,1377129,TN
chr15,Bn59630,96482698,98284610,1801912,NBS
chr15,Bn59631,19702655,87784771,68082116,CN
chr15,Bn59632,14420258,80485440,66065182,TN
chr15,Bn59633,66316196,95859383,29543187,TN
chr15,Bn59634,65921672,90698847,24777175,RLP
chr15,Bn59635,57232801,68286759,11053958,TN
chr15,Bn59636,81928470,93273012,11344542,RLP
chr15,Bn59637,63580658,72474752,8894094,TN
chr15,Bn59638,81166621,89443775,8277154,CN
chr15,Bn59639,65357541,73693491,8335950,TNL
chr15,Bn59640,53058528,68686256,15627728,NBS
chr15,Bn59641,91440027,94149815,2709788,TN
chr15,Bn59642,68409831,69482846,1073015,NBS
chr15,Bn59643,61773894,71740050,9966156,TN
chr15,Bn59644,44181939,92747866,48565927,CN
chr15,Bn59645,10902545,85732473,74829928,TN
chr15,Bn59646,85231275,98783026,13551751,RLK
chr15,Bn59647,78185354,94439840,16254486,RLP
chr15,Bn59648,51665478,75131788,23466310,RLK
chr15,Bn59649,98338618,99966991,1628373,TNL
chr15,Bn59650,50767550,99622723,48855173,TN
chr15,Bn59651,89906887,93694236,3787349,RLK
chr15,Bn59652,63820309,74541236,10720927,RLK
chr15,Bn59653,43683110,53057803,9374693,TN
chr15,Bn59654,11526290,71173148,59646858,TNL
chr15,Bn59655,97795207,98821646,1026439,TNL
chr15,Bn59656,85909724,87830031,1920307,CNL
chr15,Bn59657,72200091,73737523,1537432,CNL
chr15,Bn59658,40568310,79562529,38994219,TN
chr15,Bn59659,37801191,83436114,45634923,RLK
chr15,Bn59660,52765599,99652865,46887266,CN
chr15,Bn59661,50247138,81999087,31751949,RLK
chr15,Bn59662,65240775,73590412,8349637,TN
chr15,Bn59663,21629974,83151155,61521181,TNL
chr15,Bn59664,77923979,79097948,1173969,RLK
chr15,Bn59665,40113548,58568027,18454479,RLK
chr15,Bn59666,40392349,70146048,29753699,CN
chr15,Bn59667,33400522,38648198,5247676,RLP
chr15,Bn59668,85672239,93498037,7825798,CNL
chr15,Bn59669,46205652,68453649,22247997,TN
chr15,Bn59670,54290328,82790145,28499817,RLK
chr15,Bn59671,30417624,47218876,16801252,RLP
chr15,Bn59672,81713939,84430089,2716150,RLP
chr15,Bn59673,68878874,90439010,21560136,NBS
chr15,Bn59674,27535741,69415472,41879731,RLP
chr15,Bn59675,5104168,7099239,1995071,TN
chr15,Bn59676,89444381,92230940,2786559,TN
chr15,Bn59677,93096807,93443757,346950,CNL
chr15,Bn59678,81803030,82810791,1007761,CN
chr15,Bn59679,76776853,86473563,9696710,CNL
chr15,Bn59680,37602209,77024423,39422214,RLK
chr15,Bn59681,54285107,69602697,15317590,RLP
chr15,Bn59682,47826935,84426667,36599732,RLK
chr15,Bn59683,18779041,83873849,65094808,RLP
chr15,Bn59684,42636065,82417427,39781362,RLK
chr15,Bn59685,16698140,90934827,74236687,NBS
chr15,Bn59686,80828247,93214363,12386116,NBS
chr15,Bn59687,68468714,74809466,6340752,TNL
chr15,Bn59688,42950417,60915601,17965184,CN
chr15,Bn59689,66504486,95524235,29019749,RLP
chr15,Bn59690,41252997,58897282,17644285,CN
chr15,Bn59691,1315512,6680691,5365179,TN
chr15,Bn59692,18335615,46970365,28634750,TN
chr15,Bn59693,22001692,80070831,58069139,CNL
chr15,Bn59694,42297788,52275196,9977408,CN
chr15,Bn59695,34058622,76232285,42173663,TNL
chr15,Bn59696,13483417,69078931,55595514,TNL
chr15,Bn59697,13132398,14647973,1515575,RLK
chr15,Bn59698,37160019,41230747,4070728,CNL
chr15,Bn59699,4463863,20129627,15665764,TNL
chr15,Bn59700,54547959,68824361,14276402,NBS
chr15,Bn59701,13596816,84565342,70968526,TN
chr15,Bn59702,40180172,63181731,23001559,TN
chr15,Bn59703,33999658,38925317,4925659,CNL
chr15,Bn59704,67046162,70859518,3813356,CN
chr15,Bn59705,37163041,91030121,53867080,CNL
chr15,Bn59706,32584780,41121994,8537214,NBS
chr15,Bn59707,67306931,76899731,9592800,CN
chr15,Bn59708,99103542,99378352,274810,RLP
chr15,Bn59709,8397175,40060881,31663706,RLP
chr15,Bn59710,1399009,53292676,51893667,CN
chr15,Bn59711,26499221,96333076,69833855,RLK
chr15,Bn59712,11117118,37373993,26256875,RLK
chr15,Bn59713,74119286,98639912,24520626,RLP
chr15,Bn59714,56710180,98411364,41701184,CNL
chr15,Bn59715,16572055,97065265,80493210,RLP
chr15,Bn59716,13136525,29335931,16199406,TN
chr15,Bn59717,81730062,91058737,9328675,RLP
chr15,Bn59718,6646654,13764865,7118211,CNL
chr15,Bn59719,63123160,95036202,31913042,NBS
chr15,Bn59720,38289086,40746626,2457540,TN
chr15,Bn59721,83693270,90318156,6624886,RLK
chr15,Bn59722,21541108,28764981,7223873,TN
chr15,Bn59723,72087727,99611772,27524045,NBS
chr15,Bn59724,73561689,97609593,24047904,TN
chr15,Bn59725,90055834,96165611,6109777,TNL
chr15,Bn59726,16876620,62056984,45180364,CNL
chr15,Bn59727,69803173,85668998,15865825,NBS
chr15,Bn59728,43561862,98321887,54760025,TNL
chr15,Bn59729,6440734,83105401,76664667,CN
chr15,Bn59730,39520170,45475658,5955488,RLK
chr15,Bn59731,72519642,77379694,4860052,RLP
chr15,Bn59732,10355260,84587305,74232045,RLK
chr15,Bn59733,69870448,89205714,19335266,CNL
chr15,Bn59734,45868904,88880563,43011659,RLK
chr15,Bn59735,39127751,94298435,55170684,RLP
chr15,Bn59736,22213249,45528149,23314900,TN
chr15,Bn59737,81241232,89812653,8571421,RLK
chr15,Bn59738,70984969,86272590,15287621,RLP
chr15,Bn59739,97566437,98450328,883891,RLP
chr15,Bn59740,40890026,90872166,49982140,CNL
chr15,Bn59741,48007107,84982749,36975642,CN
chr15,Bn59742,66997414,67981926,984512,NBS
chr15,Bn59743,10591657,67461199,56869542,CN
chr15,Bn59744,93858473,99857115,5998642,CN
chr15,Bn59745,72498252,80260242,7761990,TN
chr15,Bn59746,21360076,66606542,45246466,CNL
chr15,Bn59747,98943443,99706611,763168,RLP
chr15,Bn59748,12165094,60002346,47837252,CNL
chr15,Bn59749,86527694,91006035,4478341,TN
chr15,Bn59750,48813839,74487760,25673921,TN
chr15,Bn59751,22581196,38551669,15970473,CN
chr15,Bn59752,68513936,94751969,26238033,CN
chr15,Bn59753,59688679,84924793,25236114,RLK
chr15,Bn59754,82569820,89600793,7030973,CNL
chr15,Bn59755,43285768,81179290,37893522,TNL
chr15,Bn59756,97866293,98821617,955324,NBS
chr15,Bn59757,96093695,98621960,2528265,TNL
chr15,Bn59758,80679914,93733493,13053579,CN
chr15,Bn59759,67871059,96484331,28613272,RLP
chr15,Bn59760,83135878,85063088,1927210,TNL
chr15,Bn59761,79097779,81470725,2372946,TN
chr15,Bn59762,78362680,90277455,11914775,TN
chr15,Bn59763,62212984,82373019,20160035,NBS
chr15,Bn59764,61065675,70884332,9818657,TNL
chr15,Bn59765,4717175,91462812,86745637,NBS
chr15,Bn59766,71027784,94919798,23892014,RLP
chr15,Bn59767,64427379,92409747,27982368,RLK
chr15,Bn59768,30464851,55993406,25528555,RLP
chr15,Bn59769,9321707,11221864,1900157,RLP
chr15,Bn59770,51722982,94556505,42833523,RLK
chr15,Bn59771,7454878,26168724,18713846,TNL
chr15,Bn59772,88855692,90708467,1852775,TN
chr15,Bn59773,90211097,99095351,8884254,CNL
chr15,Bn59774,76814783,92183166,15368383,RLP
chr15,Bn59775,63282706,78513423,15230717,TN
chr15,Bn59776,35713998,80708950,44994952,TN
chr15,Bn59777,49423048,90260682,40837634,CNL
chr15,Bn59778,5132405,42331719,37199314,NBS
chr15,Bn59779,13871671,63686314,49814643,CNL
chr15,Bn59780,4591996,55242229,50650233,NBS
chr15,Bn59781,56352220,97513465,41161245,RLK
chr15,Bn59782,51118429,72710169,21591740,RLP
chr15,Bn59783,36689507,44387633,7698126,CNL
chr15,Bn59784,33608336,83620978,50012642,CNL
chr15,Bn59785,69030421,92359590,23329169,NBS
chr15,Bn59786,33856393,44080018,10223625,NBS
chr15,Bn59787,87127521,99652338,12524817,TN
chr15,Bn59788,52189643,73619252,21429609,CNL
chr15,Bn59789,75106345,83857232,8750887,NBS
chr15,Bn59790,25456520,44840688,19384168,RLK
chr15,Bn59791,17287408,76075205,58787797,CN
chr15,Bn59792,85768785,99925278,14156493,NBS
chr15,Bn59793,1350177,57666538,56316361,RLK
chr15,Bn59794,12922340,79303566,66381226,NBS
chr15,Bn59795,90320843,96679951,6359108,TNL
chr15,Bn59796,46036494,56382478,10345984,TNL
chr15,Bn59797,16687589,46260678,29573089,TNL
chr15,Bn59798,39626942,40210300,583358,NBS
chr15,Bn59799,86519986,95393992,8874006,CNL
chr15,Bn59800,56925791,69725460,12799669,TNL
chr15,Bn59801,32579693,87076640,54496947,RLK
chr15,Bn59802,92445482,98641233,6195751,RLP
chr15,Bn59803,32442065,56269670,23827605,CN
chr15,Bn59804,14173111,87428520,73255409,RLP
chr15,Bn59805,98772210,99417398,645188,RLP
chr15,Bn59806,26040002,90673112,64633110,CN
chr15,Bn59807,22740913,74101173,51360260,CNL
chr15,Bn59808,7590594,15055812,7465218,CNL
chr15,Bn59809,16912508,38313041,21400533,TN
chr15,Bn59810,82654053,88700813,6046760,CNL
chr15,Bn59811,84056670,89927747,5871077,CNL
chr15,Bn59812,74995514,78560833,3565319,NBS
chr15,Bn59813,14955881,65868789,50912908,CNL
chr15,Bn59814,73737265,99570581,25833316,TN
chr15,Bn59815,18895678,77189298,58293620,CNL
chr15,Bn59816,21915026,67590101,45675075,RLK
chr15,Bn59817,79190662,91501127,12310465,RLK
chr15,Bn59818,31141607,48482722,17341115,CN
chr15,Bn59819,28407371,74687994,46280623,TNL
chr15,Bn59820,36352496,85815234,49462738,CNL
chr15,Bn59821,44376486,91122634,46746148,NBS
chr15,Bn59822,36046728,88058690,52011962,RLK
chr15,Bn59823,84196340,89783209,5586869,NBS
chr15,Bn59824,62117667,72332661,10214994,TN
chr15,Bn59825,68795932,90745868,21949936,TNL
chr15,Bn59826,25830456,77370184,51539728,CN
chr15,Bn59827,35332221,61258979,25926758,TNL
chr15,Bn59828,84033492,90946069,6912577,CNL
chr15,Bn59829,39563891,41828398,2264507,NBS
chr15,Bn59830,70669836,99803410,29133574,TNL
chr15,Bn59831,58502726,98153901,39651175,TNL
chr15,Bn59832,94457650,96619374,2161724,RLP
chr15,Bn59833,85943035,95031759,9088724,RLP
chr15,Bn59834,13425594,33399165,19973571,TNL
chr15,Bn59835,17256802,84631242,67374440,RLP
chr15,Bn59836,8221838,98181273,89959435,RLP
chr15,Bn59837,8032097,88109075,80076978,CN
chr15,Bn59838,18828179,55707532,36879353,NBS
chr15,Bn59839,19677618,54477244,34799626,CN
chr15,Bn59840,23850262,35983194,12132932,NBS
chr15,Bn59841,12107415,93165016,81057601,RLK
chr15,Bn59842,35324365,77853816,42529451,CNL
chr15,Bn59843,68502089,74684562,6182473,NBS
chr15,Bn59844,75919171,79146609,3227438,CNL
chr15,Bn59845,85076454,99593566,14517112,CNL
chr15,Bn59846,73183071,90076370,16893299,NBS
chr15,Bn59847,2700393,44562764,41862371,CN
chr15,Bn59848,11834365,33033994,21199629,NBS
chr15,Bn59849,69101242,98533236,29431994,RLK
chr15,Bn59850,37530748,56368032,18837284,TNL
chr15,Bn59851,53047656,55410162,2362506,RLK
chr15,Bn59852,24070187,73396886,49326699,NBS
chr15,Bn59853,40776130,67373341,26597211,CNL
chr15,Bn59854,99380877,99802636,421759,RLP
chr15,Bn59855,99254787,99971960,717173,TN
chr15,Bn59856,91374011,95853914,4479903,TN
chr15,Bn59857,99482976,99557890,74914,NBS
chr15,Bn59858,82455649,97972111,15516462,RLK
chr15,Bn59859,54799138,94524221,39725083,TN
chr15,Bn59860,52009283,83293411,31284128,RLK
chr15,Bn59861,39736600,47888563,8151963,NBS
chr15,Bn59862,37388771,92721662,55332891,NBS
chr15,Bn59863,11854413,24929943,13075530,RLK
chr15,Bn59864,41988871,43001481,1012610,RLP
chr15,Bn59865,26917792,39299189,12381397,CNL
chr15,Bn59866,66469705,67683815,1214110,NBS
chr15,Bn59867,39240892,99488884,60247992,NBS
chr15,Bn59868,39164482,98378785,59214303,RLK
chr15,Bn59869,20054698,78573475,58518777,RLK
chr15,Bn59870,63839197,90911191,27071994,CNL
chr15,Bn59871,69165644,71105598,1939954,CNL
chr15,Bn59872,15673121,51087436,35414315,CN
chr15,Bn59873,59118912,74652983,15534071,RLK
chr15,Bn59874,23836151,30637858,6801707,TNL
chr15,Bn59875,41434674,57178824,15744150,CNL
chr15,Bn59876,97156107,99673572,2517465,TNL
chr15,Bn59877,39447206,64180726,24733520,RLK
chr15,Bn59878,41577110,52086628,10509518,RLK
chr15,Bn59879,64748192,84294079,19545887,NBS
chr15,Bn59880,47974513,95173266,47198753,CN
chr15,Bn59881,51946360,98689314,46742954,CN
chr15,Bn59882,87299635,89444671,2145036,CNL
chr15,Bn59883,19687587,28821146,9133559,RLP
chr15,Bn59884,72253238,98386690,26133452,CN
chr15,Bn59885,28490566,44857561,16366995,CN
chr15,Bn59886,63577133,99454642,35877509,CNL
chr15,Bn59887,92277748,99467836,7190088,RLK
chr15,Bn59888,43242091,71083890,27841799,CNL
chr15,Bn59889,37720113,91328272,53608159,RLP
chr15,Bn59890,93778137,93949889,171752,RLK
chr15,Bn59891,40655476,68842802,28187326,RLK
chr15,Bn59892,70642389,76914657,6272268,RLP
chr15,Bn59893,80109713,83140850,3031137,RLK
chr15,Bn59894,59679039,90150754,30471715,CNL
chr15,Bn59895,43402173,81080994,37678821,RLK
chr15,Bn59896,83090618,86378353,3287735,TNL
chr15,Bn59897,95854819,98784578,2929759,RLP
chr15,Bn59898,85611233,90385593,4774360,RLK
chr15,Bn59899,53642572,61861993,8219421,TNL
chr15,Bn59900,20535393,55244329,34708936,NBS
chr15,Bn59901,18426226,52408892,33982666,RLP
chr15,Bn59902,50332034,68645089,18313055,TNL
chr15,Bn59903,29775774,70899951,41124177,TNL
chr15,Bn59904,2026133,97500003,95473870,TNL
chr15,Bn59905,42180969,83925837,41744868,CN
chr15,Bn59906,82234442,90327176,8092734,RLP
chr15,Bn59907,22323693,57871565,35547872,CN
chr15,Bn59908,51519378,57028650,5509272,CN
chr15,Bn59909,47155111,67983290,20828179,NBS
chr15,Bn59910,13366771,16132716,2765945,RLP
chr15,Bn59911,51270160,98141883,46871723,TNL
chr15,Bn59912,15511410,66892992,51381582,TNL
chr15,Bn59913,87633070,98820747,11187677,RLK
chr15,Bn59914,35617777,84936343,49318566,RLK
chr15,Bn59915,88498233,99111552,10613319,NBS
chr15,Bn59916,69569126,94941630,25372504,NBS
chr15,Bn59917,57924532,85600789,27676257,RLK
chr15,Bn59918,85292495,98266495,12974000,CNL
chr15,Bn59919,25702678,46033842,20331164,CN
chr15,Bn59920,84017674,85592583,1574909,RLP
chr15,Bn59921,27215355,38745134,11529779,TN
chr15,Bn59922,54223958,99001598,44777640,TN
chr15,Bn59923,72479492,85888630,13409138,TNL
chr15,Bn59924,29827727,98790331,68962604,RLK
chr15,Bn59925,90745339,92113070,1367731,NBS
chr15,Bn59926,71365700,72419437,1053737,TN
chr15,Bn59927,61509801,93626624,32116823,TN
chr15,Bn59928,93125397,95278700,2153303,TN
chr15,Bn59929,60318045,95193519,34875474,TNL
chr15,Bn59930,17994071,75597827,57603756,RLK
chr15,Bn59931,87238654,88381221,1142567,CN
chr15,Bn59932,39089658,73742442,34652784,TN
chr15,Bn59933,42716214,97120428,54404214,TNL
chr15,Bn59934,13922781,96066659,82143878,TNL
chr15,Bn59935,34130898,60285381,26154483,RLP
chr15,Bn59936,45630842,49627009,3996167,CN
chr15,Bn59937,66048845,93943700,27894855,CNL
chr15,Bn59938,53589766,66831763,13241997,CN
chr15,Bn59939,87502909,94051783,6548874,RLP
chr15,Bn59940,89947266,91063967,1116701,TN
chr15,Bn59941,48180817,52093962,3913145,CNL
chr15,Bn59942,81238599,83143394,1904795,CNL
chr15,Bn59943,41952551,57225478,15272927,RLK
chr15,Bn59944,39431299,90170407,50739108,CN
chr15,Bn59945,26163425,83497080,57333655,TN
chr15,Bn59946,74438938,75849534,1410596,CNL
chr15,Bn59947,63427467,79807321,16379854,CN
chr15,Bn59948,11476041,88802246,77326205,CNL
chr15,Bn59949,20489374,80191826,59702452,TN
chr15,Bn59950,72834333,83056058,10221725,TNL
chr15,Bn59951,49144501,53419085,4274584,TNL
chr15,Bn59952,94422783,94659059,236276,TN
chr15,Bn59953,49895444,59337717,9442273,RLK
chr15,Bn59954,44068080,60037031,15968951,TN
chr15,Bn59955,68134947,79165971,11031024,TN
chr15,Bn59956,50336945,85258502,34921557,TN
chr15,Bn59957,96402701,97167904,765203,CNL
chr15,Bn59958,66661238,82118112,15456874,RLP
chr15,Bn59959,92333241,98066848,5733607,CNL
chr15,Bn59960,66964976,88177502,21212526,RLP
chr15,Bn59961,33331968,64209983,30878015,CNL
chr15,Bn59962,76389414,90544101,14154687,CN
chr15,Bn59963,53891179,97588820,43697641,TNL
chr15,Bn59964,48413269,85829382,37416113,CNL
chr15,Bn59965,35900579,82484519,46583940,RLP
chr15,Bn59966,57051654,65453809,8402155,RLK
chr15,Bn59967,32207410,35213258,3005848,CNL
chr15,Bn59968,57379980,95914147,38534167,CN
chr15,Bn59969,69093089,78636811,9543722,TN
chr15,Bn59970,4956731,82011798,77055067,RLK
chr15,Bn59971,62888263,66793050,3904787,RLP
chr15,Bn59972,9041846,82047739,73005893,RLK
chr15,Bn59973,23126909,68753678,45626769,RLP
chr15,Bn59974,42102996,45540345,3437349,RLK
chr15,Bn59975,12615674,31620441,19004767,CNL
chr15,Bn59976,33621080,69771129,36150049,RLK
chr15,Bn59977,38416444,93163570,54747126,RLK
chr15,Bn59978,36940027,52393020,15452993,NBS
chr15,Bn59979,12747647,53118679,40371032,TN
chr15,Bn59980,61335250,77289881,15954631,CN
chr15,Bn59981,86159284,99043904,12884620,CNL
chr15,Bn59982,65857301,92593518,26736217,CNL
chr15,Bn59983,51320573,98316820,46996247,CN
chr15,Bn59984,24782213,75290828,50508615,RLK
chr15,Bn59985,13704141,94154459,80450318,RLK
chr15,Bn59986,30267653,80822895,50555242,RLK
chr15,Bn59987,45129728,78852775,33723047,CNL
chr15,Bn59988,36847389,91055341,54207952,NBS
chr15,Bn59989,29480969,66250999,36770030,CNL
chr15,Bn59990,53378721,56015242,2636521,RLP
chr15,Bn59991,9760600,40560746,30800146,RLP
chr15,Bn59992,83829675,92496916,8667241,RLP
chr15,Bn59993,8882595,87588273,78705678,RLK
chr15,Bn59994,49172711,73799502,24626791,RLP
chr15,Bn59995,4838277,47954425,43116148,RLK
chr15,Bn59996,2286042,55429699,53143657,TNL
chr15,Bn59997,24074454,80347381,56272927,TNL
chr15,Bn59998,7821493,98209784,90388291,TNL
chr15,Bn59999,79797152,85521038,5723886,TNL
chr15,Bn60000,84427036,87243237,2816201,NBS
chr15,Bn60001,71388995,89017587,17628592,NBS
chr15,Bn60002,49329470,99501514,50172044,CNL
chr15,Bn60003,48631470,87232389,38600919,NBS
chr15,Bn60004,35940075,65396545,29456470,TNL
chr15,Bn60005,7539530,22713300,15173770,CN
chr15,Bn60006,96514693,98669748,2155055,TNL
chr15,Bn60007,84575887,90523151,5947264,RLP
chr15,Bn60008,39183440,56722703,17539263,TN
chr15,Bn60009,58924829,74806589,15881760,RLK
chr15,Bn60010,28730055,78706161,49976106,RLK
chr15,Bn60011,94763100,97266861,2503761,CNL
chr15,Bn60012,85492968,88775780,3282812,TNL
chr15,Bn60013,98627569,99607540,979971,NBS
chr15,Bn60014,80631010,80689408,58398,RLK
chr15,Bn60015,38404383,89037575,50633192,RLP
chr15,Bn60016,84150417,91198386,7047969,TN
chr15,Bn60017,9211778,22207195,12995417,TNL
chr15,Bn60018,80321721,86009549,5687828,CNL
chr15,Bn60019,82201140,94252144,12051004,CNL
chr15,Bn60020,1751695,27815110,26063415,RLP
chr15,Bn60021,54214242,89087359,34873117,TN
chr15,Bn60022,30235712,51970595,21734883,RLP
chr15,Bn60023,79520768,96204311,16683543,CN
chr15,Bn60024,40918905,59810713,18891808,CNL
chr15,Bn60025,59337645,99396969,40059324,RLK
chr15,Bn60026,2431761,16130286,13698525,CN
chr15,Bn60027,2702140,57152197,54450057,RLP
chr15,Bn60028,94488412,98851846,4363434,NBS
chr15,Bn60029,59971265,63574335,3603070,RLP
chr15,Bn60030,16175019,94756468,78581449,RLK
chr15,Bn60031,25033603,52462410,27428807,RLK
chr15,Bn60032,45168739,93620793,48452054,CN
chr15,Bn60033,14069224,22139892,8070668,RLP
chr15,Bn60034,67857468,96992798,29135330,NBS
chr15,Bn60035,68519238,70797012,2277774,CNL
chr15,Bn60036,96312085,99781211,3469126,RLK
chr15,Bn60037,15382519,76754751,61372232,RLP
chr15,Bn60038,47094760,72911501,25816741,CN
chr15,Bn60039,39621261,45250498,5629237,RLK
chr15,Bn60040,78806504,91041298,12234794,RLK
chr15,Bn60041,14674239,46584819,31910580,CN
chr15,Bn60042,62553696,95488684,32934988,CNL
chr15,Bn60043,87906183,94086612,6180429,CN
chr15,Bn60044,29138853,34114764,4975911,RLK
chr15,Bn60045,91409386,98484058,7074672,CN
chr15,Bn60046,64142514,95709272,31566758,CN
chr15,Bn60047,78982602,87132866,8150264,CN
chr15,Bn60048,59314210,76677452,17363242,NBS
chr15,Bn60049,15812171,99303017,83490846,NBS
chr15,Bn60050,99985962,99986493,531,CNL
chr15,Bn60051,70229023,95822354,25593331,TNL
chr15,Bn60052,79875964,81277629,1401665,RLK
chr15,Bn60053,38902464,41850081,2947617,CN
chr15,Bn60054,34590420,49389354,14798934,RLP
chr15,Bn60055,46039820,57875987,11836167,NBS
chr15,Bn60056,84351353,93138417,8787064,NBS
chr15,Bn60057,34805903,76512665,41706762,CN
chr15,Bn60058,57474276,57652975,178699,CNL
chr15,Bn60059,22254819,47038941,24784122,CN
chr15,Bn60060,87865304,91550461,3685157,CNL
chr15,Bn60061,54053852,67941172,13887320,RLP
chr15,Bn60062,59946799,80095358,20148559,RLK
chr15,Bn60063,82992414,88529329,5536915,RLP
chr15,Bn60064,26682403,80754884,54072481,CNL
chr15,Bn60065,80967976,98020241,17052265,RLP
chr15,Bn60066,81434905,94407645,12972740,CN
chr15,Bn60067,73867530,77867208,3999678,CNL
chr15,Bn60068,48755721,69870951,21115230,CN
chr15,Bn60069,98010832,99421630,1410798,CN
chr15,Bn60070,83293345,97654658,14361313,CN
chr15,Bn60071,28792054,97826514,69034460,TNL
chr15,Bn60072,9798112,74082350,64284238,TNL
chr15,Bn60073,24305274,59598341,35293067,NBS
chr15,Bn60074,45312381,73159706,27847325,RLK
chr15,Bn60075,88244320,88983526,739206,RLP
chr15,Bn60076,70889602,78944244,8054642,RLP
chr15,Bn60077,77311372,80133868,2822496,TNL
chr15,Bn60078,30402952,35527462,5124510,CNL
chr15,Bn60079,3771104,98505869,94734765,TNL
chr15,Bn60080,35998603,67730650,31732047,CN
chr15,Bn60081,7365624,28024429,20658805,NBS
chr15,Bn60082,6393061,8755688,2362627,RLK
chr15,Bn60083,86999765,99953592,12953827,NBS
chr15,Bn60084,84796114,85926947,1130833,CN
chr15,Bn60085,90226855,94598966,4372111,TNL
chr15,Bn60086,52646845,58592267,5945422,CNL
chr15,Bn60087,96333167,97760861,1427694,NBS
chr15,Bn60088,8428270,19853685,11425415,NBS
chr15,Bn60089,83618323,84774419,1156096,RLP
chr15,Bn60090,85245584,91835933,6590349,RLP
chr15,Bn60091,5980244,85843163,79862919,TN
chr15,Bn60092,87832536,93661667,5829131,NBS
chr15,Bn60093,74286558,99440044,25153486,RLP
chr15,Bn60094,42098411,54488670,12390259,RLP
chr15,Bn60095,83785299,98136052,14350753,NBS
chr15,Bn60096,60768236,98227407,37459171,TN
chr15,Bn60097,71866449,79762320,7895871,CN
chr15,Bn60098,93112909,95732031,2619122,RLK
chr15,Bn60099,54992100,89151222,34159122,NBS
chr15,Bn60100,53716688,94252714,40536026,NBS
chr15,Bn60101,81329240,99407592,18078352,RLK
chr15,Bn60102,99707548,99920833,213285,CNL
chr15,Bn60103,69386123,82046574,12660451,RLP
chr15,Bn60104,41486518,86912108,45425590,TNL
chr15,Bn60105,66861271,82548267,15686996,CNL
chr15,Bn60106,51595916,64144977,12549061,TNL
chr15,Bn60107,39677305,96095274,56417969,RLK
chr15,Bn60108,95946773,99034803,3088030,RLP
chr15,Bn60109,36615256,87806670,51191414,TN
chr15,Bn60110,62925180,99735136,36809956,TNL
chr15,Bn60111,69215480,76283224,7067744,RLP
chr15,Bn60112,9155029,38188951,29033922,CNL
chr15,Bn60113,30705820,82631778,51925958,TNL
chr15,Bn60114,5030039,51540712,46510673,RLK
chr15,Bn60115,82786062,97956309,15170247,RLK
chr15,Bn60116,12448922,34001820,21552898,TNL
chr15,Bn60117,65528131,76426034,10897903,TNL
chr15,Bn60118,21538894,91766506,70227612,RLP
chr15,Bn60119,93581268,94368125,786857,RLP
chr15,Bn60120,22027945,88535988,66508043,RLP
chr15,Bn60121,13167957,71297152,58129195,CN
chr15,Bn60122,93071464,95800552,2729088,TNL
chr15,Bn60123,44112849,54629446,10516597,TN
chr15,Bn60124,72939099,82796331,9857232,CNL
chr15,Bn60125,12465405,26613584,14148179,NBS
chr15,Bn60126,29459862,74943149,45483287,TNL
chr15,Bn60127,57680971,80555729,22874758,CN
chr15,Bn60128,4947752,94230436,89282684,NBS
chr15,Bn60129,90627502,97802206,7174704,CNL
chr15,Bn60130,11151396,27321565,16170169,RLP
chr15,Bn60131,13960734,27324507,13363773,NBS
chr15,Bn60132,38047731,90830856,52783125,CN
chr15,Bn60133,41372136,91597179,50225043,RLK
chr15,Bn60134,42554425,86364421,43809996,TNL
chr15,Bn60135,57694665,64643163,6948498,CN
chr15,Bn60136,55306076,73696059,18389983,NBS
chr15,Bn60137,83366694,96800719,13434025,TNL
chr15,Bn60138,16681167,76609309,59928142,CNL
chr15,Bn60139,57493682,61644065,4150383,CN
chr15,Bn60140,6345575,83243889,76898314,CNL
chr15,Bn60141,48555913,75268276,26712363,TN
chr15,Bn60142,22179379,68034118,45854739,RLP
chr15,Bn60143,53948700,67028473,13079773,NBS
chr15,Bn60144,11980022,41097429,29117407,RLP
chr15,Bn60145,99508188,99555594,47406,CNL
chr15,Bn60146,75278018,93945615,18667597,TN
chr15,Bn60147,24613516,68470494,43856978,NBS
chr15,Bn60148,40748314,56902848,16154534,RLK
chr15,Bn60149,85343493,97312199,11968706,NBS
chr15,Bn60150,58952651,68515832,9563181,CN
chr15,Bn60151,84967487,95349874,10382387,TN
chr15,Bn60152,24641004,81548367,56907363,RLK
chr15,Bn60153,85403607,86936767,1533160,CNL
chr15,Bn60154,30582771,84545207,53962436,RLP
chr15,Bn60155,54284948,92284963,38000015,TNL
chr15,Bn60156,93947074,97874464,3927390,RLK
chr15,Bn60157,86891800,91667217,4775417,RLP
chr15,Bn60158,81863805,88048396,6184591,TNL
chr15,Bn60159,62854159,99893967,37039808,RLK
chr15,Bn60160,7730287,71059485,63329198,NBS
chr15,Bn60161,68095799,78441672,10345873,TN
chr15,Bn60162,88011247,92333871,4322624,RLK
chr15,Bn60163,3063205,39001927,35938722,CNL
chr15,Bn60164,63683983,99947450,36263467,RLK
chr15,Bn60165,39892103,94765374,54873271,TNL
chr15,Bn60166,45831381,91369440,45538059,CNL
chr15,Bn60167,29963468,73222066,43258598,TNL
chr15,Bn60168,63805127,92166669,28361542,TNL
chr15,Bn60169,19568506,65359010,45790504,RLK
chr15,Bn60170,51602649,65456469,13853820,TNL
chr15,Bn60171,55153937,63979691,8825754,CN
chr15,Bn60172,10365040,88481077,78116037,RLK
chr15,Bn60173,15353643,56103592,40749949,CNL
chr15,Bn60174,35005556,46248105,11242549,TNL
chr15,Bn60175,82722695,87704410,4981715,TN
chr15,Bn60176,79199372,83615243,4415871,CNL
chr15,Bn60177,80289588,89761654,9472066,NBS
chr15,Bn60178,86542848,93669837,7126989,CN
chr15,Bn60179,86890590,88950092,2059502,CNL
chr15,Bn60180,4760353,29211966,24451613,CNL
chr15,Bn60181,7067079,90094502,83027423,RLK
chr15,Bn60182,31631396,51243972,19612576,NBS
chr15,Bn60183,96579500,96751259,171759,RLK
chr15,Bn60184,86940103,90413632,3473529,TNL
chr15,Bn60185,45827626,53822173,7994547,CNL
chr15,Bn60186,40863270,78283823,37420553,NBS
chr15,Bn60187,92950629,98780739,5830110,CNL
chr15,Bn60188,50041097,65476144,15435047,TNL
chr15,Bn60189,58705229,89791140,31085911,CN
chr15,Bn60190,60001559,91212349,31210790,CN
chr15,Bn60191,95522302,97540387,2018085,RLP
chr15,Bn60192,72791194,95079469,22288275,RLP
chr15,Bn60193,78602504,87843209,9240705,NBS
chr15,Bn60194,59595101,77176866,17581765,CN
chr15,Bn60195,38588366,97651445,59063079,TNL
chr15,Bn60196,2654935,98939806,96284871,NBS
chr15,Bn60197,46925958,61498106,14572148,TN
chr15,Bn60198,75455103,97460248,22005145,CNL
chr15,Bn60199,48538841,65008152,16469311,RLP
chr15,Bn60200,56542778,75982219,19439441,CN
chr15,Bn60201,29943781,94823185,64879404,CN
chr15,Bn60202,84589829,88164133,3574304,TN
chr15,Bn60203,11118614,56437867,45319253,RLP
chr15,Bn60204,30040991,45336935,15295944,TN
chr15,Bn60205,54712151,83069548,28357397,CN
chr15,Bn60206,22859584,51976190,29116606,RLP
chr15,Bn60207,28199759,91773283,63573524,NBS
chr15,Bn60208,61297331,81197718,19900387,CNL
chr15,Bn60209,89403750,91208293,1804543,CNL
chr15,Bn60210,6015563,21608664,15593101,RLP
chr15,Bn60211,20417747,99116411,78698664,RLK
chr15,Bn60212,4498121,10011482,5513361,CNL
chr15,Bn60213,7135353,28821422,21686069,TN
chr15,Bn60214,54814932,90391326,35576394,RLK
chr15,Bn60215,52209681,64713341,12503660,TN
chr15,Bn60216,31191363,49683323,18491960,RLP
chr15,Bn60217,77119896,91669370,14549474,RLK
chr15,Bn60218,71270950,87337831,16066881,RLK
chr15,Bn60219,61493203,84096091,22602888,TN
chr15,Bn60220,76744901,81260958,4516057,NBS
chr15,Bn60221,31042669,92514748,61472079,RLP
chr15,Bn60222,69455575,82615820,13160245,RLK
chr15,Bn60223,63312913,93281689,29968776,NBS
chr15,Bn60224,18262432,97556023,79293591,RLK
chr15,Bn60225,51222752,84234535,33011783,CN
chr15,Bn60226,18350655,53916618,35565963,RLK
chr15,Bn60227,7851451,24465111,16613660,NBS
chr15,Bn60228,23830562,23955214,124652,RLK
chr15,Bn60229,51014724,59587855,8573131,RLP
chr15,Bn60230,46005049,79319865,33314816,NBS
chr15,Bn60231,72010174,86686152,14675978,CNL
chr15,Bn60232,79806739,83959219,4152480,TNL
chr15,Bn60233,43693756,45205580,1511824,TN
chr15,Bn60234,36451298,47426644,10975346,TN
chr15,Bn60235,51296178,61278155,9981977,RLP
chr15,Bn60236,74473393,94441405,19968012,TN
chr15,Bn60237,60785304,88404521,27619217,TN
chr15,Bn60238,52841473,64384224,11542751,CNL
chr15,Bn60239,99345993,99908413,562420,TNL
chr15,Bn60240,33843301,65465027,31621726,TN
chr15,Bn60241,64527210,88877619,24350409,RLP
chr15,Bn60242,64951557,66464664,1513107,TNL
chr15,Bn60243,10634226,66209908,55575682,CNL
chr15,Bn60244,67190043,80592779,13402736,CN
chr15,Bn60245,51405639,60576163,9170524,CN
chr15,Bn60246,54042859,81651792,27608933,RLP
chr15,Bn60247,24381561,62656534,38274973,RLP
chr15,Bn60248,79991342,80890345,899003,CNL
chr15,Bn60249,60237687,83476329,23238642,TN
chr15,Bn60250,76548200,90975316,14427116,CN
chr15,Bn60251,78397295,80676308,2279013,RLP
chr15,Bn60252,5879789,46027608,40147819,NBS
chr15,Bn60253,7855573,52125674,44270101,NBS
chr15,Bn60254,4713475,50082641,45369166,NBS
chr15,Bn60255,62404658,80733770,18329112,RLK
chr15,Bn60256,98211747,98423814,212067,NBS
chr15,Bn60257,91859501,94345974,2486473,TN
chr15,Bn60258,91596978,95688272,4091294,TNL
chr15,Bn60259,12490051,87618067,75128016,CNL
chr15,Bn60260,6480716,97873887,91393171,CNL
chr15,Bn60261,94499914,97655020,3155106,TN
chr15,Bn60262,32849365,93263392,60414027,RLK
chr15,Bn60263,58761153,93471355,34710202,NBS
chr15,Bn60264,46783689,47731616,947927,NBS
chr15,Bn60265,96624395,98209367,1584972,RLK
chr15,Bn60266,64664049,75085024,10420975,RLK
chr15,Bn60267,52345239,94390596,42045357,TN
chr15,Bn60268,58117067,68083270,9966203,RLP
chr15,Bn60269,78299991,91805070,13505079,CNL
chr15,Bn60270,8145150,72710088,64564938,NBS
chr15,Bn60271,38382790,58262762,19879972,TNL
chr15,Bn60272,50759175,73371995,22612820,NBS
chr15,Bn60273,36810121,87432407,50622286,RLP
chr15,Bn60274,25324948,58405788,33080840,CN
chr15,Bn60275,51240520,87709597,36469077,CN
chr15,Bn60276,84996762,88161780,3165018,RLP
chr15,Bn60277,19231866,71539941,52308075,CNL
chr15,Bn60278,79868504,83126982,3258478,NBS
chr15,Bn60279,24912423,87833430,62921007,RLK
chr15,Bn60280,67251379,83260925,16009546,CNL
chr15,Bn60281,16940156,33769932,16829776,TNL
chr15,Bn60282,2956671,61317383,58360712,RLK
chr15,Bn60283,91012602,99955444,8942842,TN
chr15,Bn60284,55122167,71317306,16195139,CNL
chr15,Bn60285,82362594,82387309,24715,CNL
chr15,Bn60286,22815041,36550264,13735223,NBS
chr15,Bn60287,77635917,86585080,8949163,CN
chr15,Bn60288,68813078,92088977,23275899,TNL
chr15,Bn60289,58060253,65744808,7684555,RLP
chr15,Bn60290,67288640,84714778,17426138,RLK
chr15,Bn60291,81039031,94585643,13546612,TN
chr15,Bn60292,92875896,94611830,1735934,NBS
chr15,Bn60293,5579969,23453334,17873365,RLP
chr15,Bn60294,55991682,80835854,24844172,CN
chr15,Bn60295,39864184,61291231,21427047,RLP
chr15,Bn60296,13053137,94382751,81329614,TN
chr15,Bn60297,34869111,84096257,49227146,CN
chr15,Bn60298,59440042,67172658,7732616,RLK
chr15,Bn60299,47911794,49812907,1901113,NBS
chr15,Bn60300,28199707,64199109,35999402,RLK
chr15,Bn60301,84556278,88482828,3926550,CN
chr15,Bn60302,96491839,98583317,2091478,TN
chr15,Bn60303,83648595,90242264,6593669,CN
chr15,Bn60304,5150571,38718332,33567761,NBS
chr15,Bn60305,61619679,65250260,3630581,CNL
chr15,Bn60306,56623482,82214165,25590683,TN
chr15,Bn60307,8033519,34746998,26713479,RLP
chr15,Bn60308,68621159,76309235,7688076,CN
chr15,Bn60309,3838078,67876296,64038218,RLK
chr15,Bn60310,19837040,88290913,68453873,RLP
chr15,Bn60311,57703202,71276571,13573369,TN
chr15,Bn60312,83398369,99854575,16456206,CNL
chr15,Bn60313,23975498,85210688,61235190,TNL
chr15,Bn60314,48880756,74718365,25837609,TNL
chr15,Bn60315,70380209,98937022,28556813,CNL
chr15,Bn60316,59934289,68407883,8473594,CN
chr15,Bn60317,30538504,82137485,51598981,RLK
chr15,Bn60318,9390774,35795205,26404431,NBS
chr15,Bn60319,37691061,68721072,31030011,CNL
chr15,Bn60320,34720492,39190264,4469772,RLK
chr15,Bn60321,23480784,54624647,31143863,CNL
chr15,Bn60322,75166060,77979955,2813895,TN
chr15,Bn60323,93509908,99245708,5735800,NBS
chr15,Bn60324,32958780,35380368,2421588,NBS
chr15,Bn60325,15301726,50334268,35032542,NBS
chr15,Bn60326,32999433,69063565,36064132,TN
chr15,Bn60327,98741025,99945961,1204936,CNL
chr15,Bn60328,38894784,93515962,54621178,NBS
chr15,Bn60329,78901266,83176693,4275427,RLP
chr15,Bn60330,28120272,52498527,24378255,TNL
chr15,Bn60331,60965116,69258247,8293131,TNL
chr15,Bn60332,43873517,89654408,45780891,CNL
chr15,Bn60333,84596894,90325787,5728893,RLP
chr15,Bn60334,80138711,80900891,762180,TNL
chr15,Bn60335,79658637,86394057,6735420,TN
chr15,Bn60336,93541321,97521388,3980067,RLK
chr15,Bn60337,98005746,99160749,1155003,CN
chr15,Bn60338,41759604,80171510,38411906,NBS
chr15,Bn60339,88009885,88997125,987240,CN
chr15,Bn60340,15788527,90660155,74871628,TNL
chr15,Bn60341,22958895,53036303,30077408,TN
chr15,Bn60342,32871933,88647522,55775589,RLK
chr15,Bn60343,27897259,28983614,1086355,NBS
chr15,Bn60344,63853876,75307022,11453146,CNL
chr15,Bn60345,34612778,84076768,49463990,RLP
chr15,Bn60346,81406908,86215756,4808848,TN
chr15,Bn60347,40839351,74806670,33967319,RLK
chr15,Bn60348,47704206,92139456,44435250,RLK
chr15,Bn60349,94884949,97277306,2392357,RLP
chr15,Bn60350,22240390,37758243,15517853,CNL
chr15,Bn60351,37497891,57617571,20119680,RLP
chr15,Bn60352,89600982,94511945,4910963,TN
chr15,Bn60353,33870598,77684410,43813812,NBS
chr15,Bn60354,10526973,94129900,83602927,RLK
chr15,Bn60355,69168890,84154599,14985709,TN
chr15,Bn60356,49586027,61799042,12213015,RLP
chr15,Bn60357,39046945,99077010,60030065,TN
chr15,Bn60358,18540380,40643781,22103401,RLK
chr15,Bn60359,49817248,68306678,18489430,RLP
chr15,Bn60360,35216306,69928447,34712141,CN
chr15,Bn60361,94773930,96503840,1729910,NBS
chr15,Bn60362,58404652,59139235,734583,NBS
chr15,Bn60363,41667631,77936761,36269130,TNL
chr15,Bn60364,88332407,95941752,7609345,CN
chr15,Bn60365,10869722,31239115,20369393,RLP
chr15,Bn60366,34591847,48085126,13493279,TN
chr15,Bn60367,77979969,96128009,18148040,TNL
chr15,Bn60368,65624449,78986659,13362210,CNL
chr15,Bn60369,46773954,64539810,17765856,NBS
chr15,Bn60370,71454280,71662436,208156,CNL
chr15,Bn60371,20603153,54972039,34368886,CN
chr15,Bn60372,18662265,39188769,20526504,RLK
chr15,Bn60373,42434493,90332509,47898016,RLP
chr15,Bn60374,13470169,69924408,56454239,CNL
chr15,Bn60375,82801785,91156259,8354474,CNL
chr15,Bn60376,56233779,87029614,30795835,RLP
chr15,Bn60377,99956958,99998217,41259,NBS
chr15,Bn60378,11367960,16592671,5224711,TN
chr15,Bn60379,25816565,70487568,44671003,CN
chr15,Bn60380,96733154,97965076,1231922,CNL
chr15,Bn60381,93057191,94878282,1821091,NBS
chr15,Bn60382,86830899,92752141,5921242,NBS
chr15,Bn60383,37718540,62504834,24786294,NBS
chr15,Bn60384,15184159,35390023,20205864,TN
chr15,Bn60385,19655631,93427690,73772059,CN
chr15,Bn60386,68318873,70303255,1984382,TNL
chr15,Bn60387,45789336,93146172,47356836,RLP
chr15,Bn60388,53636335,69175443,15539108,TNL
chr15,Bn60389,3186844,92365203,89178359,RLK
chr15,Bn60390,40855044,55427688,14572644,RLP
chr15,Bn60391,16783347,98318250,81534903,NBS
chr15,Bn60392,72786785,98320589,25533804,RLK
chr15,Bn60393,34401473,48834871,14433398,RLP
chr15,Bn60394,10577777,99658974,89081197,RLP
chr15,Bn60395,10761377,49155624,38394247,RLP
chr15,Bn60396,17222954,21469637,4246683,RLP
chr15,Bn60397,55180779,82191378,27010599,TN
chr15,Bn60398,55707867,79611855,23903988,TNL
chr15,Bn60399,51560182,64953515,13393333,RLK
chr15,Bn60400,49711949,61472553,11760604,RLP
chr15,Bn60401,19242872,90679938,71437066,TN
chr15,Bn60402,88079265,98391772,10312507,RLK
chr15,Bn60403,19922015,69653207,49731192,CNL
chr15,Bn60404,67065686,92847582,25781896,RLP
chr15,Bn60405,14973705,69180259,54206554,TNL
chr15,Bn60406,81775473,94512000,12736527,CN
chr15,Bn60407,75916099,76819659,903560,TNL
chr15,Bn60408,94517943,98055762,3537819,RLP
chr15,Bn60409,41975135,79907213,37932078,RLK
chr15,Bn60410,81865276,85231238,3365962,NBS
chr15,Bn60411,19484237,59507506,40023269,RLP
chr15,Bn60412,53636236,56325302,2689066,CN
chr15,Bn60413,91793510,98977121,7183611,RLK
chr15,Bn60414,28244209,63521497,35277288,NBS
chr15,Bn60415,18000315,87005264,69004949,RLK
chr15,Bn60416,98952939,99035235,82296,CNL
chr15,Bn60417,47190753,53436050,6245297,CN
chr15,Bn60418,39947419,53374122,13426703,RLP
chr15,Bn60419,39158189,71704022,32545833,TN
chr15,Bn60420,51087704,54985927,3898223,RLK
chr15,Bn60421,31330383,91691821,60361438,CN
chr15,Bn60422,2352959,12899129,10546170,TNL
chr15,Bn60423,95882954,95963106,80152,CNL
chr15,Bn60424,39632585,83184915,43552330,CN
chr15,Bn60425,4581392,88713513,84132121,RLP
chr15,Bn60426,83852299,99277997,15425698,TN
chr15,Bn60427,11984403,51832585,39848182,NBS
chr15,Bn60428,95525417,98304547,2779130,NBS
chr15,Bn60429,21222632,52669080,31446448,RLP
chr15,Bn60430,41267479,52557835,11290356,CN
chr15,Bn60431,60963606,85935366,24971760,RLK
chr15,Bn60432,7710471,81085662,73375191,TN
chr15,Bn60433,37528327,52058646,14530319,RLP
chr15,Bn60434,45388664,98771692,53383028,CNL
chr15,Bn60435,47278860,83468231,36189371,RLK
chr15,Bn60436,31457086,42958481,11501395,TNL
chr15,Bn60437,43864965,60025217,16160252,CN
chr15,Bn60438,39711290,50633723,10922433,RLP
chr15,Bn60439,23068746,64086910,41018164,RLK
chr15,Bn60440,62102061,94121341,32019280,TN
chr15,Bn60441,99445869,99998375,552506,NBS
chr15,Bn60442,83483759,86789271,3305512,RLK
chr15,Bn60443,98630052,99193735,563683,NBS
chr15,Bn60444,88935099,89064693,129594,RLK
chr15,Bn60445,41505801,98060622,56554821,CNL
chr15,Bn60446,91890142,98712659,6822517,RLP
chr15,Bn60447,28926600,65728006,36801406,CNL
chr15,Bn60448,17006043,36662903,19656860,TN
chr15,Bn60449,47310116,61124620,13814504,TNL
chr15,Bn60450,20955306,24986732,4031426,RLP
chr15,Bn60451,67989065,74099733,6110668,CN
chr15,Bn60452,3725874,95956019,92230145,NBS
chr15,Bn60453,86930235,95674299,8744064,RLK
chr15,Bn60454,22161662,38731176,16569514,CN
chr15,Bn60455,78398464,89657074,11258610,CNL
chr15,Bn60456,91518711,99818537,8299826,RLP
chr15,Bn60457,24199655,31769062,7569407,NBS
chr15,Bn60458,87422364,90227430,2805066,RLK
chr15,Bn60459,42158018,42995060,837042,CN
chr15,Bn60460,33876519,89257382,55380863,RLK
chr15,Bn60461,72015843,81341269,9325426,CN
chr15,Bn60462,59719141,83273059,23553918,CN
chr15,Bn60463,84460235,99226781,14766546,CN
chr15,Bn60464,69386090,73758710,4372620,RLP
chr15,Bn60465,68719814,94100550,25380736,TNL
chr15,Bn60466,58339980,61010011,2670031,CN
chr15,Bn60467,55008267,98361119,43352852,NBS
chr15,Bn60468,86769958,98291300,11521342,NBS
chr15,Bn60469,14311562,89989407,75677845,CNL
chr15,Bn60470,26034998,91104073,65069075,NBS
chr15,Bn60471,32131018,51655905,19524887,TNL
chr15,Bn60472,19895474,76761280,56865806,RLK
chr15,Bn60473,65989596,74082442,8092846,TN
chr15,Bn60474,31304382,83307673,52003291,NBS
chr15,Bn60475,18916854,48763547,29846693,CN
chr15,Bn60476,8283600,34616409,26332809,RLK
chr15,Bn60477,15444067,73106093,57662026,CN
chr15,Bn60478,99626179,99853882,227703,CNL
chr15,Bn60479,30239218,97848326,67609108,TNL
chr15,Bn60480,52767190,68711885,15944695,CNL
chr15,Bn60481,33922070,88842676,54920606,NBS
chr15,Bn60482,10824097,27497878,16673781,TN
chr15,Bn60483,84637209,85534466,897257,CN
chr15,Bn60484,55132575,58239986,3107411,TN
chr15,Bn60485,21820646,23541832,1721186,RLP
chr15,Bn60486,42911708,66854037,23942329,CN
chr15,Bn60487,72775867,98954468,26178601,RLP
chr15,Bn60488,73497974,96195869,22697895,RLK
chr15,Bn60489,3333677,25501234,22167557,TNL
chr15,Bn60490,49693916,90306047,40612131,TN
chr15,Bn60491,48750435,85265968,36515533,CNL
chr15,Bn60492,27062296,46461133,19398837,CNL
chr15,Bn60493,66493933,83534243,17040310,TNL
chr15,Bn60494,9715537,56500010,46784473,TN
chr15,Bn60495,15683223,99837123,84153900,TN
chr15,Bn60496,84713707,95700111,10986404,TN
chr15,Bn60497,58740902,61782773,3041871,RLP
chr15,Bn60498,98370366,99704308,1333942,RLP
chr15,Bn60499,29827649,92480850,62653201,TN
chr15,Bn60500,8496903,41480679,32983776,RLK
chr15,Bn60501,6549058,57469494,50920436,TNL
chr15,Bn60502,79449828,81631510,2181682,CNL
chr15,Bn60503,76718925,97850031,21131106,RLK
chr15,Bn60504,33265099,76740169,43475070,RLK
chr15,Bn60505,59250854,92076851,32825997,TN
chr15,Bn60506,70004731,84746522,14741791,TN
chr15,Bn60507,58851849,72713778,13861929,RLP
chr15,Bn60508,63308113,90971283,27663170,RLK
chr15,Bn60509,73718051,94181264,20463213,TNL
chr15,Bn60510,90093233,93640333,3547100,NBS
chr15,Bn60511,60042299,90527356,30485057,CNL
chr15,Bn60512,55706491,86802449,31095958,RLK
chr15,Bn60513,53529846,83808880,30279034,CNL
chr15,Bn60514,44520076,83482297,38962221,RLP
chr15,Bn60515,17491737,19922517,2430780,TNL
chr15,Bn60516,24774323,72080556,47306233,TN
chr15,Bn60517,22113803,29421362,7307559,RLP
chr15,Bn60518,70352811,76751693,6398882,TNL
chr15,Bn60519,16117805,30461871,14344066,CNL
chr15,Bn60520,94989795,99178656,4188861,RLP
chr15,Bn60521,56543571,69127979,12584408,RLP
chr15,Bn60522,87653934,89910422,2256488,TN
chr15,Bn60523,63574040,81289028,17714988,TN
chr15,Bn60524,46198227,57677346,11479119,CNL
chr15,Bn60525,37556516,64092178,26535662,NBS
chr15,Bn60526,23304490,63928145,40623655,NBS
chr15,Bn60527,69627048,90239890,20612842,CN
chr15,Bn60528,50286133,63981855,13695722,NBS
chr15,Bn60529,63405793,79817915,16412122,CN
chr15,Bn60530,53790975,77832101,24041126,RLP
chr15,Bn60531,28121207,41827603,13706396,RLK
chr15,Bn60532,30106456,66013212,35906756,TNL
chr15,Bn60533,44665932,60662359,15996427,NBS
chr15,Bn60534,20156268,74678091,54521823,RLK
chr15,Bn60535,79159780,95125133,15965353,TN
chr15,Bn60536,3198256,73916494,70718238,TNL
chr15,Bn60537,20889995,73650217,52760222,RLK
chr15,Bn60538,39612019,86970525,47358506,CNL
chr15,Bn60539,89777099,91006300,1229201,TN
chr15,Bn60540,81535350,89774653,8239303,CN
chr15,Bn60541,68422973,86299442,17876469,RLP
chr15,Bn60542,98056911,99961708,1904797,TN
chr15,Bn60543,11548127,18481373,6933246,RLP
chr15,Bn60544,51303563,85593211,34289648,CNL
chr15,Bn60545,51629604,95428207,43798603,CNL
chr15,Bn60546,40272396,59242365,18969969,CN
chr15,Bn60547,10482406,87620579,77138173,NBS
chr15,Bn60548,65867082,80910886,15043804,CNL
chr15,Bn60549,21093656,38999832,17906176,CN
chr15,Bn60550,17445834,54486721,37040887,TN
chr15,Bn60551,37584424,57868601,20284177,TN
chr15,Bn60552,7781363,55425868,47644505,RLP
chr15,Bn60553,55072319,92846620,37774301,TN
chr15,Bn60554,53097450,63136628,10039178,RLK
chr15,Bn60555,14510901,58128250,43617349,CN
chr15,Bn60556,46641629,76059844,29418215,RLP
chr15,Bn60557,96753278,97257422,504144,RLK
chr15,Bn60558,68655256,75610752,6955496,RLK
chr15,Bn60559,44463528,49425935,4962407,CNL
chr15,Bn60560,59078071,77190549,18112478,CN
chr15,Bn60561,86636121,93945812,7309691,RLP
chr15,Bn60562,50336901,80520041,30183140,RLP
chr15,Bn60563,48144373,50278374,2134001,TNL
chr15,Bn60564,16223456,32827113,16603657,CN
chr15,Bn60565,17408647,93240308,75831661,TNL
chr15,Bn60566,39715550,48596417,8880867,RLP
chr15,Bn60567,92665079,98578247,5913168,RLP
chr15,Bn60568,27499243,83699647,56200404,RLK
chr15,Bn60569,42963347,77295317,34331970,RLP
chr15,Bn60570,48080038,49829879,1749841,RLK
chr15,Bn60571,74042779,85816957,11774178,CN
chr15,Bn60572,73553930,86791842,13237912,CNL
chr15,Bn60573,6745460,22529579,15784119,CN
chr15,Bn60574,48710550,60854099,12143549,RLK
chr15,Bn60575,36096741,55680933,19584192,RLK
chr15,Bn60576,49946719,64477814,14531095,RLK
chr15,Bn60577,31913484,80827567,48914083,RLP
chr15,Bn60578,95303170,99201947,3898777,NBS
chr15,Bn60579,8780905,36298383,27517478,CNL
chr15,Bn60580,64408368,86688467,22280099,CN
chr15,Bn60581,32231147,57222049,24990902,TNL
chr15,Bn60582,12482326,39656820,27174494,RLP
chr15,Bn60583,37950005,71321921,33371916,CN
chr15,Bn60584,8724551,60513241,51788690,CNL
chr15,Bn60585,63294867,93736659,30441792,CN
chr15,Bn60586,35598498,51069435,15470937,TN
chr15,Bn60587,2416340,42280203,39863863,TNL
chr15,Bn60588,23519866,64638724,41118858,RLP
chr15,Bn60589,98466529,98858361,391832,RLK
chr15,Bn60590,61480333,83756459,22276126,RLP
chr15,Bn60591,50594954,92853917,42258963,RLP
chr15,Bn60592,27425964,51398285,23972321,CN
chr15,Bn60593,72194471,92017815,19823344,NBS
chr15,Bn60594,51895073,98652562,46757489,NBS
chr15,Bn60595,41668699,45907004,4238305,CN
chr15,Bn60596,27844788,69846649,42001861,NBS
chr15,Bn60597,88259394,92647073,4387679,TN
chr15,Bn60598,42458022,95202265,52744243,CNL
chr15,Bn60599,97358639,97558438,199799,RLK
chr15,Bn60600,76235758,95536834,19301076,RLK
chr15,Bn60601,50348916,99541903,49192987,TNL
chr15,Bn60602,52520871,70992711,18471840,RLK
chr15,Bn60603,18714438,32473200,13758762,CN
chr15,Bn60604,51547963,86663713,35115750,NBS
chr15,Bn60605,17358733,66430307,49071574,RLK
chr15,Bn60606,70062021,71726070,1664049,CNL
chr15,Bn60607,20946277,61118209,40171932,RLP
chr15,Bn60608,10177435,97931318,87753883,CN
chr15,Bn60609,15553753,33299916,17746163,NBS
chr15,Bn60610,45373116,84966451,39593335,CN
chr15,Bn60611,32904618,85411345,52506727,TN
chr15,Bn60612,37224273,41760191,4535918,RLK
chr15,Bn60613,32167227,74797304,42630077,TNL
chr15,Bn60614,23518365,74867586,51349221,TN
chr15,Bn60615,25975265,36958305,10983040,TN
chr15,Bn60616,61044850,90320489,29275639,TNL
chr15,Bn60617,72815370,90324970,17509600,RLP
chr15,Bn60618,27071117,95030412,67959295,RLK
chr15,Bn60619,67199426,99326535,32127109,RLP
chr15,Bn60620,18880443,42962105,24081662,RLK
chr15,Bn60621,38061153,70980120,32918967,NBS
chr15,Bn60622,63455601,81098781,17643180,NBS
chr15,Bn60623,4919277,51754727,46835450,CN
chr15,Bn60624,58275864,78967440,20691576,RLK
chr15,Bn60625,43544914,52998664,9453750,TNL
chr15,Bn60626,5523848,10123764,4599916,RLP
chr15,Bn60627,55509088,78486835,22977747,RLP
chr15,Bn60628,8906269,49052217,40145948,RLP
chr15,Bn60629,82091156,86498026,4406870,RLP
chr15,Bn60630,2966903,24150526,21183623,CN
chr15,Bn60631,42679579,72895763,30216184,NBS
chr15,Bn60632,38694458,61439450,22744992,NBS
chr15,Bn60633,86189086,97075637,10886551,RLK
chr15,Bn60634,74839032,76511178,1672146,TNL
chr15,Bn60635,58373757,66172510,7798753,CN
chr15,Bn60636,57864529,91981721,34117192,RLP
chr15,Bn60637,15520544,40701650,25181106,RLK
chr15,Bn60638,99512463,99859122,346659,TNL
chr15,Bn60639,16432471,47236643,30804172,NBS
chr15,Bn60640,84431047,99629597,15198550,TNL
chr15,Bn60641,31039865,78385158,47345293,RLK
chr15,Bn60642,91227739,91884037,656298,CN
chr15,Bn60643,37391665,74119160,36727495,RLK
chr15,Bn60644,43372911,94695542,51322631,TN
chr15,Bn60645,88519467,96605587,8086120,RLP
chr15,Bn60646,36670002,99473884,62803882,NBS
chr15,Bn60647,64482033,73784581,9302548,RLK
chr15,Bn60648,39856550,80514380,40657830,CNL
chr15,Bn60649,96785730,97771008,985278,NBS
chr15,Bn60650,21218030,65563796,44345766,RLK
chr15,Bn60651,73955695,97089729,23134034,RLP
chr15,Bn60652,91004056,97641465,6637409,RLK
chr15,Bn60653,99257700,99802478,544778,TN
chr15,Bn60654,22641750,24150590,1508840,RLK
chr15,Bn60655,63404194,98097817,34693623,RLK
chr15,Bn60656,36423476,64164427,27740951,CNL
chr15,Bn60657,18012414,62078428,44066014,TN
chr15,Bn60658,75275377,84051539,8776162,RLP
chr15,Bn60659,71159538,92110987,20951449,RLP
chr15,Bn60660,89144242,93535443,4391201,TN
chr15,Bn60661,62318054,77659254,15341200,RLK
chr15,Bn60662,39224140,78475815,39251675,CN
chr15,Bn60663,95679027,95958751,279724,NBS
chr15,Bn60664,7903484,38685468,30781984,CNL
chr15,Bn60665,58527367,81473284,22945917,TN
chr15,Bn60666,16646703,62476778,45830075,TN
chr15,Bn60667,38749726,53664183,14914457,TNL
chr15,Bn60668,52074885,62620418,10545533,RLP
chr15,Bn60669,71080379,80948992,9868613,CN
chr15,Bn60670,25867315,87166849,61299534,CN
chr15,Bn60671,3058679,93874429,90815750,TNL
chr15,Bn60672,87600324,99767705,12167381,RLK
chr15,Bn60673,84043039,90496151,6453112,TNL
chr15,Bn60674,77767026,94878102,17111076,TNL
chr15,Bn60675,92857484,93202653,345169,TN
chr15,Bn60676,39986345,40713020,726675,TN
chr15,Bn60677,4726469,11366777,6640308,CN
chr15,Bn60678,61492582,63487482,1994900,CNL
chr15,Bn60679,28840558,99277063,70436505,RLP
chr15,Bn60680,16816833,33611354,16794521,RLP
chr15,Bn60681,80518354,91587431,11069077,TNL
chr15,Bn60682,48199012,84870660,36671648,RLK
chr15,Bn60683,12074011,25053238,12979227,TN
chr15,Bn60684,78221996,89229177,11007181,CNL
chr15,Bn60685,27400367,64499604,37099237,RLK
chr15,Bn60686,98791087,99578332,787245,RLK
chr15,Bn60687,95550959,97444553,1893594,TNL
chr15,Bn60688,13229533,85448233,72218700,CN
chr15,Bn60689,22919128,98495922,75576794,CN
chr15,Bn60690,72128600,82225805,10097205,RLP
chr15,Bn60691,5525018,71148968,65623950,NBS
chr15,Bn60692,36941174,73332059,36390885,CNL
chr15,Bn60693,84163666,92526808,8363142,NBS
chr15,Bn60694,9750654,44909053,35158399,CNL
chr15,Bn60695,36231736,83750474,47518738,RLK
chr15,Bn60696,62036218,81805038,19768820,CNL
chr15,Bn60697,47143303,58680364,11537061,RLP
chr15,Bn60698,57104059,92618554,35514495,RLK
chr15,Bn60699,45416578,71510220,26093642,CNL
chr15,Bn60700,89975096,98555986,8580890,TNL
chr15,Bn60701,94711476,98572067,3860591,NBS
chr15,Bn60702,63840125,84479325,20639200,CNL
chr15,Bn60703,82098837,98689182,16590345,RLP
chr15,Bn60704,16323471,80772603,64449132,RLK
chr15,Bn60705,54596888,68016625,13419737,TN
chr15,Bn60706,29968895,59327016,29358121,RLK
chr15,Bn60707,26558580,40629919,14071339,CN
chr15,Bn60708,96536955,99248594,2711639,TNL
chr15,Bn60709,83489114,88414966,4925852,RLP
chr15,Bn60710,42331239,60783933,18452694,NBS
chr15,Bn60711,59267137,70566953,11299816,TN
chr15,Bn60712,70927703,81277522,10349819,TNL
chr15,Bn60713,90735983,91288903,552920,CN
chr15,Bn60714,12082414,45509074,33426660,RLK
chr15,Bn60715,82364673,84771975,2407302,TNL
chr15,Bn60716,66126168,88062659,21936491,RLK
chr15,Bn60717,91868212,98536839,6668627,RLK
chr15,Bn60718,74223224,98730574,24507350,TNL
chr15,Bn60719,71877535,92626354,20748819,NBS
chr15,Bn60720,53473886,73152923,19679037,CN
chr15,Bn60721,95870209,99993743,4123534,RLP
chr15,Bn60722,33423722,75944550,42520828,NBS
chr15,Bn60723,77399961,80237760,2837799,RLP
chr15,Bn60724,85851268,98953154,13101886,CN
chr15,Bn60725,33076206,84448047,51371841,NBS
chr15,Bn60726,24920655,59499935,34579280,NBS
chr15,Bn60727,44992647,98301346,53308699,TNL
chr15,Bn60728,61288493,75699503,14411010,RLP
chr15,Bn60729,6219581,40369804,34150223,RLP
chr15,Bn60730,14589783,27318156,12728373,NBS
chr15,Bn60731,79225351,86731652,7506301,RLP
chr15,Bn60732,63611663,66426373,2814710,TNL
chr15,Bn60733,70069100,94607458,24538358,RLP
chr15,Bn60734,29015175,86709528,57694353,TN
chr15,Bn60735,84190906,98585637,14394731,TN
chr15,Bn60736,8629782,25440758,16810976,TN
chr15,Bn60737,55578398,83550332,27971934,TN
chr15,Bn60738,75275360,76353705,1078345,TNL
chr15,Bn60739,36555357,51534674,14979317,RLP
chr15,Bn60740,28085303,64192528,36107225,TNL
chr15,Bn60741,63227706,64199576,971870,RLP
chr15,Bn60742,48548152,52939603,4391451,CN
chr15,Bn60743,61571557,65743210,4171653,TNL
chr15,Bn60744,59279180,64223573,4944393,TNL
chr15,Bn60745,96352251,98980251,2628000,CNL
chr15,Bn60746,75261797,87312485,12050688,TN
chr15,Bn60747,78208636,94084240,15875604,CN
chr15,Bn60748,79864903,82938177,3073274,TNL
chr15,Bn60749,2266754,98097810,95831056,TNL
chr15,Bn60750,14776912,46443349,31666437,TNL
chr15,Bn60751,88684399,96387074,7702675,CN
chr15,Bn60752,96135616,98812607,2676991,TNL
chr15,Bn60753,45227421,49745544,4518123,TNL
chr15,Bn60754,98680494,99271475,590981,NBS
chr15,Bn60755,8735558,56662792,47927234,TN
chr15,Bn60756,58887437,72752260,13864823,CN
chr15,Bn60757,60258337,98629688,38371351,RLK
chr15,Bn60758,67077392,81425534,14348142,CN
chr15,Bn60759,26900550,78665570,51765020,CNL
chr15,Bn60760,96263079,96657788,394709,RLP
chr15,Bn60761,63221021,64797685,1576664,CN
chr15,Bn60762,41251045,75764799,34513754,TN
chr15,Bn60763,9695340,50357318,40661978,NBS
chr15,Bn60764,69717809,93685715,23967906,TNL
chr15,Bn60765,69399501,71932847,2533346,TNL
chr15,Bn60766,72948593,85031669,12083076,TN
chr15,Bn60767,66108734,66145843,37109,TNL
chr15,Bn60768,3303888,7341192,4037304,CN
chr15,Bn60769,45179766,86529097,41349331,RLP
chr15,Bn60770,45494725,70709680,25214955,CNL
chr15,Bn60771,10107902,65958437,55850535,RLP
chr15,Bn60772,5290541,87545156,82254615,CNL
chr15,Bn60773,22203793,55987076,33783283,CNL
chr15,Bn60774,71736964,93934484,22197520,RLK
chr15,Bn60775,66953461,81691061,14737600,TNL
chr15,Bn60776,57183596,89740456,32556860,TN
chr15,Bn60777,42910987,90274135,47363148,CNL
chr15,Bn60778,23923171,27483547,3560376,RLP
chr15,Bn60779,5301045,44747395,39446350,TNL
chr15,Bn60780,87868493,96362029,8493536,TNL
chr15,Bn60781,92549757,99126185,6576428,RLP
chr15,Bn60782,81944267,93260152,11315885,RLK
chr15,Bn60783,40732542,72216853,31484311,NBS
chr15,Bn60784,47713484,62655255,14941771,TN
chr15,Bn60785,52476974,63854503,11377529,RLP
chr15,Bn60786,31512095,41866644,10354549,RLP
chr15,Bn60787,79576057,96099941,16523884,CNL
chr15,Bn60788,31917311,82576582,50659271,NBS
chr15,Bn60789,76258403,84184755,7926352,RLP
chr15,Bn60790,64319590,65162633,843043,RLK
chr15,Bn60791,70106665,78137698,8031033,TN
chr15,Bn60792,49656609,86102507,36445898,NBS
chr15,Bn60793,2802944,12769594,9966650,NBS
chr15,Bn60794,1825091,77006500,75181409,CN
chr15,Bn60795,26564245,91213682,64649437,TN
chr15,Bn60796,77257256,98424849,21167593,NBS
chr15,Bn60797,18598334,35379475,16781141,TN
chr15,Bn60798,45221158,95074416,49853258,TNL
chr15,Bn60799,67192151,97164530,29972379,TNL
chr15,Bn60800,29496035,78926672,49430637,CN
chr15,Bn60801,92625982,95973855,3347873,RLP
chr15,Bn60802,62090318,83917013,21826695,NBS
chr15,Bn60803,93121488,97044856,3923368,TN
chr15,Bn60804,36048332,90283163,54234831,RLP
chr15,Bn60805,91272241,97033987,5761746,TNL
chr15,Bn60806,41287644,51319249,10031605,NBS
chr15,Bn60807,72578789,74194042,1615253,RLP
chr15,Bn60808,79845470,96615649,16770179,RLP
chr15,Bn60809,15698562,96092468,80393906,TNL
chr15,Bn60810,88665033,99991684,11326651,TNL
chr15,Bn60811,20698046,77504045,56805999,NBS
chr15,Bn60812,81569089,88958494,7389405,RLK
chr15,Bn60813,88780146,97089200,8309054,CN
chr15,Bn60814,64413233,77882874,13469641,RLK
chr15,Bn60815,64703380,97749129,33045749,TNL
chr15,Bn60816,76143733,77296168,1152435,CNL
chr15,Bn60817,62984748,72731985,9747237,NBS
chr15,Bn60818,83366797,98499895,15133098,TN
chr15,Bn60819,55018937,72789498,17770561,TNL
chr15,Bn60820,41139929,77553424,36413495,CN
chr15,Bn60821,98961481,98986992,25511,NBS
chr15,Bn60822,69848257,76518456,6670199,TNL
chr15,Bn60823,70941238,84496263,13555025,NBS
chr15,Bn60824,4425946,10939460,6513514,CNL
chr15,Bn60825,72639593,88655023,16015430,CN
chr15,Bn60826,29541078,54822383,25281305,NBS
chr15,Bn60827,77514128,84639110,7124982,TNL
chr15,Bn60828,4387600,70672705,66285105,TN
chr15,Bn60829,95007135,95814385,807250,RLP
chr15,Bn60830,21443158,97760904,76317746,NBS
chr15,Bn60831,37978048,82627878,44649830,RLP
chr15,Bn60832,99737557,99993845,256288,TNL
chr15,Bn60833,93986321,94407369,421048,RLK
chr15,Bn60834,68999279,92053225,23053946,RLK
chr15,Bn60835,60550386,62631280,2080894,TNL
chr15,Bn60836,83138826,86577661,3438835,RLP
chr15,Bn60837,51037786,61778307,10740521,TNL
chr15,Bn60838,34777682,50253228,15475546,CN
chr15,Bn60839,67150871,81213544,14062673,RLP
chr15,Bn60840,42428278,78329337,35901059,RLP
chr15,Bn60841,46994305,47247511,253206,RLP
chr15,Bn60842,70572756,78830395,8257639,TN
chr15,Bn60843,93331778,99205728,5873950,RLP
chr15,Bn60844,58073818,82906052,24832234,TN
chr15,Bn60845,19095454,53697504,34602050,TNL
chr15,Bn60846,63285738,98493672,35207934,TN
chr15,Bn60847,82381864,96600249,14218385,TNL
chr15,Bn60848,83350396,91814231,8463835,RLP
chr15,Bn60849,67539764,68277527,737763,NBS
chr15,Bn60850,30867264,61222911,30355647,CNL
chr15,Bn60851,1861489,85649604,83788115,TN
chr15,Bn60852,57731064,89323930,31592866,TNL
chr15,Bn60853,78570229,79460554,890325,RLK
chr15,Bn60854,29804850,57391347,27586497,TNL
chr15,Bn60855,55966102,85670869,29704767,NBS
chr15,Bn60856,15576996,33411855,17834859,TNL
chr15,Bn60857,23605641,47204405,23598764,CNL
chr15,Bn60858,39720302,71525378,31805076,TNL
chr15,Bn60859,60445149,71007685,10562536,NBS
chr15,Bn60860,9686432,57690776,48004344,CN
chr15,Bn60861,5484194,78914318,73430124,NBS
chr15,Bn60862,4894027,40377525,35483498,CN
chr15,Bn60863,79827132,98712991,18885859,TN
chr15,Bn60864,4358217,46115065,41756848,TNL
chr15,Bn60865,76718025,89383200,12665175,CNL
chr15,Bn60866,40367657,54122329,13754672,RLP
chr15,Bn60867,76941210,78960600,2019390,CNL
chr15,Bn60868,43950383,55743790,11793407,RLK
chr15,Bn60869,68356257,81443077,13086820,NBS
chr15,Bn60870,79421813,93420172,13998359,TNL
chr15,Bn60871,9666766,30161599,20494833,NBS
chr15,Bn60872,85685907,85805865,119958,RLP
chr15,Bn60873,91409621,97519632,6110011,CNL
chr15,Bn60874,18245134,91132500,72887366,RLP
chr15,Bn60875,75223515,90892763,15669248,TN
chr15,Bn60876,20513533,43975714,23462181,NBS
chr15,Bn60877,18553723,66999889,48446166,TN
chr15,Bn60878,11597265,60204852,48607587,NBS
chr15,Bn60879,33215323,84637602,51422279,TN
chr15,Bn60880,97099687,97522955,423268,RLP
chr15,Bn60881,52281199,56263469,3982270,CNL
chr15,Bn60882,50174834,87592023,37417189,RLK
chr15,Bn60883,28094816,98434424,70339608,RLP
chr15,Bn60884,79399797,88840850,9441053,CN
chr15,Bn60885,53325408,61547419,8222011,NBS
chr15,Bn60886,94921681,95367994,446313,TN
chr15,Bn60887,49245910,93503917,44258007,CNL
chr15,Bn60888,12269154,30431691,18162537,TN
chr15,Bn60889,89845438,99998690,10153252,CNL
chr15,Bn60890,8148255,73597395,65449140,TNL
chr15,Bn60891,65159278,97252086,32092808,TNL
chr15,Bn60892,32149301,63803299,31653998,RLP
chr15,Bn60893,13788001,55301037,41513036,TNL
chr15,Bn60894,8189563,82971657,74782094,RLK
chr15,Bn60895,42881604,98390011,55508407,CN
chr15,Bn60896,69121291,88078320,18957029,RLP
chr15,Bn60897,3247213,47412321,44165108,CNL
chr15,Bn60898,88508887,93333595,4824708,CNL
chr15,Bn60899,81361288,91882598,10521310,RLP
chr15,Bn60900,87809877,89901582,2091705,RLK
chr15,Bn60901,71452522,97002238,25549716,TNL
chr15,Bn60902,31540220,74336731,42796511,RLP
chr15,Bn60903,24061310,31463993,7402683,CNL
chr15,Bn60904,49483047,96139139,46656092,NBS
chr15,Bn60905,65612237,66371775,759538,TN
chr15,Bn60906,6520219,82852319,76332100,RLK
chr15,Bn60907,40894556,47583063,6688507,CNL
chr15,Bn60908,14630396,30219780,15589384,CN
chr15,Bn60909,52803175,94575803,41772628,CNL
chr15,Bn60910,24451195,50226031,25774836,TNL
chr15,Bn60911,97950937,98889794,938857,RLP
chr15,Bn60912,40713626,75134251,34420625,NBS
chr15,Bn60913,68494816,68757680,262864,RLP
chr15,Bn60914,69595179,88500748,18905569,RLP
chr15,Bn60915,33439059,78906924,45467865,CN
chr15,Bn60916,33217159,87355693,54138534,RLP
chr15,Bn60917,65703807,89108809,23405002,RLK
chr15,Bn60918,56299785,69083388,12783603,RLP
chr15,Bn60919,76373207,92652839,16279632,CN
chr15,Bn60920,26435992,61917505,35481513,TNL
chr15,Bn60921,25846190,84611122,58764932,RLK
chr15,Bn60922,33365542,67467757,34102215,NBS
chr15,Bn60923,78587853,95162015,16574162,RLP
chr15,Bn60924,4267396,47613483,43346087,CN
chr15,Bn60925,3385832,87373431,83987599,RLP
chr15,Bn60926,32790204,43439783,10649579,CN
chr15,Bn60927,6365226,66175095,59809869,RLK
chr15,Bn60928,13263476,80492459,67228983,TN
chr15,Bn60929,63847344,83036789,19189445,CNL
chr15,Bn60930,34415525,56058791,21643266,CNL
chr15,Bn60931,1234806,83367852,82133046,NBS
chr15,Bn60932,6747326,25944789,19197463,NBS
chr15,Bn60933,66475672,73639883,7164211,CN
chr15,Bn60934,15787733,69526273,53738540,RLP
chr15,Bn60935,94447331,98011967,3564636,CN
chr15,Bn60936,8389084,11159088,2770004,RLK
chr15,Bn60937,29258129,34044169,4786040,RLK
chr15,Bn60938,79728965,81495067,1766102,CNL
chr15,Bn60939,16314184,29393932,13079748,TN
chr15,Bn60940,62448407,91104388,28655981,CN
chr15,Bn60941,97256097,97767738,511641,TN
chr15,Bn60942,50037572,79331623,29294051,TNL
chr15,Bn60943,71986235,82882922,10896687,CN
chr15,Bn60944,37274808,65133270,27858462,CN
chr15,Bn60945,20313945,30072817,9758872,CN
chr15,Bn60946,45326167,72903257,27577090,CN
chr15,Bn60947,64551190,76938868,12387678,CN
chr15,Bn60948,18043142,65081413,47038271,TN
chr15,Bn60949,33197447,80854482,47657035,NBS
chr15,Bn60950,80310627,82883802,2573175,TNL
chr15,Bn60951,71056315,75438758,4382443,RLP
chr15,Bn60952,18437792,80585180,62147388,NBS
chr15,Bn60953,19642244,57803391,38161147,RLK
chr15,Bn60954,8774736,61422564,52647828,CN
chr15,Bn60955,37529698,60572829,23043131,CN
chr15,Bn60956,24204897,74433641,50228744,TNL
chr15,Bn60957,19111304,92160904,73049600,TN
chr15,Bn60958,76822277,93005056,16182779,RLK
chr15,Bn60959,15180003,57121815,41941812,CNL
chr15,Bn60960,76041500,92862056,16820556,RLP
chr15,Bn60961,78696180,94048552,15352372,TNL
chr15,Bn60962,49105107,53291261,4186154,CN
chr15,Bn60963,19701660,98837714,79136054,NBS
chr15,Bn60964,33648047,93972800,60324753,TN
chr15,Bn60965,47427447,95487999,48060552,TNL
chr15,Bn60966,30853699,33877437,3023738,RLK
chr15,Bn60967,86784529,97658150,10873621,TNL
chr15,Bn60968,23227489,23833700,606211,RLP
chr15,Bn60969,69876840,88984371,19107531,RLK
chr15,Bn60970,87766200,99452376,11686176,RLK
chr15,Bn60971,84319161,89213857,4894696,TNL
chr15,Bn60972,48054772,73560621,25505849,TN
chr15,Bn60973,87345678,91037418,3691740,NBS
chr15,Bn60974,48859222,90545680,41686458,CNL
chr15,Bn60975,79902108,89750297,9848189,RLK
chr15,Bn60976,80728202,85281306,4553104,CNL
chr15,Bn60977,89528753,98493162,8964409,RLP
chr15,Bn60978,28007049,44592390,16585341,RLP
chr15,Bn60979,19843663,72961872,53118209,CNL
chr15,Bn60980,29257044,65800457,36543413,TNL
chr15,Bn60981,75482441,97998698,22516257,RLK
chr15,Bn60982,57830341,66880319,9049978,RLK
chr15,Bn60983,13843252,74637848,60794596,CN
chr15,Bn60984,41221946,53187658,11965712,CNL
chr15,Bn60985,73091604,93455586,20363982,CN
chr15,Bn60986,87446117,94573582,7127465,NBS
chr15,Bn60987,62593883,95497308,32903425,NBS
chr15,Bn60988,95957835,99328462,3370627,TNL
chr15,Bn60989,63448633,81505853,18057220,NBS
chr15,Bn60990,7748614,46544518,38795904,CNL
chr15,Bn60991,88441759,92423053,3981294,TN
chr15,Bn60992,31280516,90436096,59155580,RLP
chr15,Bn60993,60633973,81119437,20485464,RLP
chr15,Bn60994,6027648,28669641,22641993,TN
chr15,Bn60995,9061057,30704332,21643275,RLP
chr15,Bn60996,85566939,86534656,967717,RLP
chr15,Bn60997,46299455,79679394,33379939,CNL
chr15,Bn60998,25372971,52638521,27265550,TNL
chr15,Bn60999,17417353,73191856,55774503,CNL
chr15,Bn61000,91465030,93258365,1793335,TNL
chr15,Bn61001,94123710,98308000,4184290,CNL
chr15,Bn61002,40559887,71139752,30579865,TN
chr15,Bn61003,41035548,84785979,43750431,RLP
chr15,Bn61004,55621419,71362670,15741251,RLP
chr15,Bn61005,24527221,41826090,17298869,CN
chr15,Bn61006,76118021,91645878,15527857,TN
chr15,Bn61007,21886652,85704283,63817631,CN
chr15,Bn61008,59328396,93633969,34305573,TNL
chr15,Bn61009,58481795,93108798,34627003,RLK
chr15,Bn61010,31062726,60423441,29360715,RLP
chr15,Bn61011,52481245,85938449,33457204,NBS
chr15,Bn61012,37965483,59169899,21204416,TNL
chr15,Bn61013,45369101,91626109,46257008,CN
chr15,Bn61014,88547495,93127173,4579678,RLK
chr15,Bn61015,25959341,45780499,19821158,TNL
chr15,Bn61016,57784057,77132896,19348839,RLK
chr15,Bn61017,67540197,84302336,16762139,RLP
chr15,Bn61018,72043343,76028514,3985171,CN
chr15,Bn61019,33512205,66914893,33402688,CNL
chr15,Bn61020,41919273,96564078,54644805,NBS
chr15,Bn61021,72037125,80939577,8902452,CNL
chr15,Bn61022,10162688,28465645,18302957,RLP
chr15,Bn61023,24768741,49525834,24757093,RLP
chr15,Bn61024,26794961,36514374,9719413,CNL
chr15,Bn61025,16609866,27077906,10468040,RLK
chr15,Bn61026,4469837,40373869,35904032,RLK
chr15,Bn61027,9821082,28523705,18702623,RLP
chr15,Bn61028,5166760,56688477,51521717,CN
chr15,Bn61029,47779043,94764695,46985652,CN
chr15,Bn61030,90144397,92252703,2108306,CN
chr15,Bn61031,86256415,94436634,8180219,TNL
chr15,Bn61032,43973471,70272626,26299155,TNL
chr15,Bn61033,19114465,79219082,60104617,CNL
chr15,Bn61034,23730574,23926250,195676,TN
chr15,Bn61035,44711841,92953382,48241541,RLK
chr15,Bn61036,43891475,48650477,4759002,NBS
chr15,Bn61037,77974916,81798245,3823329,RLP
chr15,Bn61038,84196521,87737692,3541171,CNL
chr15,Bn61039,11693369,50991607,39298238,CN
chr15,Bn61040,20172608,29307747,9135139,RLP
chr15,Bn61041,53827800,87585666,33757866,TN
chr15,Bn61042,23435855,32384059,8948204,TN
chr15,Bn61043,26697268,37735216,11037948,CN
chr15,Bn61044,88203921,98292711,10088790,NBS
chr15,Bn61045,4736898,52525191,47788293,CNL
chr15,Bn61046,3823906,58077010,54253104,RLP
chr15,Bn61047,20037116,68898526,48861410,RLK
chr15,Bn61048,96181211,96841954,660743,CNL
chr15,Bn61049,15006718,45393419,30386701,CNL
chr15,Bn61050,37500146,39862888,2362742,CN
chr15,Bn61051,41329873,83650801,42320928,NBS
chr15,Bn61052,21165524,23660778,2495254,CN
chr15,Bn61053,60109131,82200461,22091330,CNL
chr15,Bn61054,77777730,91900313,14122583,NBS
chr15,Bn61055,92684355,99931068,7246713,TN
chr15,Bn61056,40589051,50020565,9431514,TNL
chr15,Bn61057,20036967,73858901,53821934,RLK
chr15,Bn61058,16670254,49772833,33102579,TNL
chr15,Bn61059,11541192,24043350,12502158,RLK
chr15,Bn61060,67479966,83246362,15766396,CNL
chr15,Bn61061,38979892,69272474,30292582,RLK
chr15,Bn61062,25220309,32719835,7499526,RLP
chr15,Bn61063,33362062,64576070,31214008,RLP
chr15,Bn61064,90866843,95055080,4188237,TNL
chr15,Bn61065,17771179,78279231,60508052,NBS
chr15,Bn61066,98332921,99783261,1450340,TNL
chr15,Bn61067,2074043,83956814,81882771,TNL
chr15,Bn61068,98778884,99999799,1220915,NBS
chr15,Bn61069,78245955,99144294,20898339,TN
chr15,Bn61070,35966805,56994702,21027897,TNL
chr15,Bn61071,59171800,64518751,5346951,CN
chr15,Bn61072,88777157,99222116,10444959,RLP
chr15,Bn61073,62162889,97609526,35446637,RLK
chr15,Bn61074,41716995,74369967,32652972,RLK
chr15,Bn61075,62173716,83903190,21729474,CN
chr15,Bn61076,77850986,90954897,13103911,RLK
chr15,Bn61077,56809382,67236428,10427046,TNL
chr15,Bn61078,90059979,99458274,9398295,CNL
chr15,Bn61079,82254932,94889712,12634780,CN
chr15,Bn61080,67757118,68124106,366988,TNL
chr15,Bn61081,94003245,98114120,4110875,TNL
chr15,Bn61082,66166651,68113395,1946744,TNL
chr15,Bn61083,55308669,59957495,4648826,RLK
chr15,Bn61084,88893252,95912303,7019051,RLP
chr15,Bn61085,8361038,95020392,86659354,NBS
chr15,Bn61086,34626664,38778072,4151408,RLP
chr15,Bn61087,32902951,36494712,3591761,TNL
chr15,Bn61088,61621536,96906881,35285345,RLK
chr15,Bn61089,61544300,93201855,31657555,TN
chr15,Bn61090,67902032,73726393,5824361,CN
chr15,Bn61091,79831890,85579222,5747332,CN
chr15,Bn61092,97073196,97465828,392632,NBS
chr15,Bn61093,96133960,98344049,2210089,NBS
chr15,Bn61094,73126698,78930232,5803534,CN
chr15,Bn61095,48682709,90420607,41737898,TN
chr15,Bn61096,4374021,64318171,59944150,RLK
chr15,Bn61097,51279741,62009837,10730096,RLK
chr15,Bn61098,69298043,82249284,12951241,NBS
chr15,Bn61099,59865828,63819330,3953502,CNL
chr15,Bn61100,53870689,86823696,32953007,TNL
chr15,Bn61101,15448962,58646504,43197542,CNL
chr15,Bn61102,98801836,99238154,436318,TNL
chr15,Bn61103,78083115,92093635,14010520,TNL
chr15,Bn61104,50699940,73833144,23133204,RLP
chr15,Bn61105,63478543,69278814,5800271,RLK
chr15,Bn61106,30814961,74831726,44016765,RLK
chr15,Bn61107,99712372,99822760,110388,TN
chr15,Bn61108,84733741,90112019,5378278,NBS
chr15,Bn61109,86405669,97200927,10795258,RLP
chr15,Bn61110,53093951,64029323,10935372,TNL
chr15,Bn61111,39011409,41596352,2584943,CNL
chr15,Bn61112,12779507,35609097,22829590,TN
chr15,Bn61113,79853484,87977295,8123811,TN
chr15,Bn61114,70623044,91738112,21115068,NBS
chr15,Bn61115,18841224,93685550,74844326,CN
chr15,Bn61116,29856041,67407355,37551314,CN
chr15,Bn61117,32676456,60507817,27831361,TN
chr15,Bn61118,33519119,51366071,17846952,CN
chr15,Bn61119,46069502,78711450,32641948,CNL
chr15,Bn61120,86290028,88131671,1841643,TNL
chr15,Bn61121,81591846,88288301,6696455,RLP
chr15,Bn61122,97065490,99585325,2519835,TNL
chr15,Bn61123,53386783,60234638,6847855,RLP
chr15,Bn61124,66304405,90476708,24172303,NBS
chr15,Bn61125,84064332,84974921,910589,CN
chr15,Bn61126,81726867,98619294,16892427,CN
chr15,Bn61127,68795212,75743593,6948381,NBS
chr15,Bn61128,8970238,11287898,2317660,RLK
chr15,Bn61129,87060992,90839930,3778938,CN
chr15,Bn61130,95584586,96174109,589523,CNL
chr15,Bn61131,57448943,96348463,38899520,RLP
chr15,Bn61132,34540390,77694340,43153950,CN
chr15,Bn61133,30332245,81233436,50901191,TN
chr15,Bn61134,19504294,83398506,63894212,CNL
chr15,Bn61135,21437728,92418983,70981255,CNL
chr15,Bn61136,70802433,76415727,5613294,TN
chr15,Bn61137,86087382,89389606,3302224,TN
chr15,Bn61138,84948746,87994955,3046209,CNL
chr15,Bn61139,89916553,97085745,7169192,NBS
chr15,Bn61140,73380970,78260086,4879116,TN
chr15,Bn61141,89262354,93253655,3991301,RLP
chr15,Bn61142,20460806,42636648,22175842,NBS
chr15,Bn61143,93390341,99500647,6110306,RLK
chr15,Bn61144,77749087,81220727,3471640,TN
chr15,Bn61145,57441956,76661686,19219730,CNL
chr15,Bn61146,48287976,63254482,14966506,RLP
chr15,Bn61147,16880700,87435234,70554534,NBS
chr15,Bn61148,71428806,80561333,9132527,NBS
chr15,Bn61149,15820897,99774337,83953440,TNL
chr15,Bn61150,69904177,87563653,17659476,CN
chr15,Bn61151,21962777,39520919,17558142,TN
chr15,Bn61152,83146493,91744430,8597937,TNL
chr15,Bn61153,23890125,78780400,54890275,TNL
chr15,Bn61154,52736506,99031858,46295352,TNL
chr15,Bn61155,98506209,99526448,1020239,CN
chr15,Bn61156,22308250,33277827,10969577,TN
chr15,Bn61157,50421874,57553953,7132079,RLK
chr15,Bn61158,60085891,97745582,37659691,RLP
chr15,Bn61159,43019625,50356892,7337267,CNL
chr15,Bn61160,82226266,93606603,11380337,RLK
chr15,Bn61161,28537159,79971123,51433964,TNL
chr15,Bn61162,4718410,18263350,13544940,CNL
chr15,Bn61163,3529154,65518606,61989452,RLP
chr15,Bn61164,9302349,62395846,53093497,TNL
chr15,Bn61165,79025223,94446291,15421068,RLK
chr15,Bn61166,13980819,40942917,26962098,TN
chr15,Bn61167,43991245,97751589,53760344,CN
chr15,Bn61168,16895432,29379002,12483570,RLP
chr15,Bn61169,38679612,80367056,41687444,TNL
chr15,Bn61170,77842436,85536723,7694287,TNL
chr15,Bn61171,34654453,35247027,592574,TN
chr15,Bn61172,1438392,27672397,26234005,TN
chr15,Bn61173,10572225,54077821,43505596,TN
chr15,Bn61174,60417706,84225691,23807985,CNL
chr15,Bn61175,88523806,93260840,4737034,TNL
chr15,Bn61176,91068184,99388644,8320460,CNL
chr15,Bn61177,47558554,94943037,47384483,NBS
chr15,Bn61178,13870571,24743889,10873318,TN
chr15,Bn61179,20082632,48194529,28111897,CNL
chr15,Bn61180,8991981,69555866,60563885,TN
chr15,Bn61181,82671371,93031667,10360296,RLP
chr15,Bn61182,9711254,61938241,52226987,RLK
chr15,Bn61183,21308380,86563261,65254881,CNL
chr15,Bn61184,98052482,99924704,1872222,TN
chr15,Bn61185,95279834,99280784,4000950,NBS
chr15,Bn61186,14940847,71933518,56992671,RLP
chr15,Bn61187,67799929,74560609,6760680,TN
chr15,Bn61188,9207835,20538354,11330519,CNL
chr15,Bn61189,18756915,97120459,78363544,NBS
chr15,Bn61190,5246059,30398325,25152266,RLK
chr15,Bn61191,2763527,72274636,69511109,TNL
chr15,Bn61192,93237900,97643240,4405340,CNL
chr15,Bn61193,96994046,99477131,2483085,TN
chr15,Bn61194,87868143,90367394,2499251,RLK
chr15,Bn61195,23952078,33616358,9664280,TNL
chr15,Bn61196,61952840,84450321,22497481,TN
chr15,Bn61197,72146473,83208254,11061781,CN
chr15,Bn61198,12331586,68786273,56454687,TNL
chr15,Bn61199,40666889,81025469,40358580,CNL
chr15,Bn61200,32389098,73964532,41575434,RLK
chr15,Bn61201,70152994,95394917,25241923,TN
chr15,Bn61202,31306025,50575696,19269671,TN
chr15,Bn61203,53308843,79145494,25836651,TNL
chr15,Bn61204,94485115,95215548,730433,NBS
chr15,Bn61205,46722154,95449106,48726952,TN
chr15,Bn61206,8158843,74210477,66051634,RLP
chr15,Bn61207,95724351,96092141,367790,CN
chr15,Bn61208,34678553,83293269,48614716,TNL
chr15,Bn61209,15268829,45758823,30489994,TNL
chr15,Bn61210,24315477,56771057,32455580,RLP
chr15,Bn61211,34403657,53381887,18978230,CNL
chr15,Bn61212,86527095,89818070,3290975,RLP
chr15,Bn61213,47290036,85915680,38625644,TNL
chr15,Bn61214,11977353,55528138,43550785,RLK
chr15,Bn61215,67453392,84391632,16938240,RLK
chr15,Bn61216,10394271,92438189,82043918,TN
chr15,Bn61217,43279981,49168857,5888876,TN
chr15,Bn61218,20219559,49508996,29289437,NBS
chr15,Bn61219,62953417,83340462,20387045,TN
chr15,Bn61220,51759159,70252020,18492861,TN
chr15,Bn61221,9331746,23094024,13762278,CN
chr15,Bn61222,77792639,81582620,3789981,NBS
chr15,Bn61223,8561787,53864537,45302750,NBS
chr15,Bn61224,15331101,89551445,74220344,RLP
chr15,Bn61225,57555313,91982736,34427423,TN
chr15,Bn61226,7425574,72659741,65234167,TN
chr15,Bn61227,46061501,51257410,5195909,RLK
chr15,Bn61228,80752836,85657806,4904970,CNL
chr15,Bn61229,52603372,83631029,31027657,CNL
chr15,Bn61230,32553096,94565821,62012725,RLK
chr15,Bn61231,36355345,99367332,63011987,NBS
chr15,Bn61232,44220812,56930102,12709290,CNL
chr15,Bn61233,67776479,74746184,6969705,TNL
chr15,Bn61234,39007913,67930342,28922429,RLK
chr15,Bn61235,82106890,83134739,1027849,RLK
chr15,Bn61236,47340439,80963319,33622880,TN
chr15,Bn61237,41763492,82818207,41054715,TN
chr15,Bn61238,74082055,80307494,6225439,TNL
chr15,Bn61239,20775099,48395641,27620542,CNL
chr15,Bn61240,32074248,75357333,43283085,RLP
chr15,Bn61241,37190417,91136339,53945922,CN
chr15,Bn61242,35224823,41446748,6221925,RLK
chr15,Bn61243,71210153,83978739,12768586,TNL
chr15,Bn61244,36466971,44042926,7575955,TN
chr15,Bn61245,93774235,97807784,4033549,CN
chr15,Bn61246,79017781,84607353,5589572,TNL
chr15,Bn61247,82123873,89906049,7782176,RLP
chr15,Bn61248,47106379,71715048,24608669,RLP
chr15,Bn61249,88039550,94528594,6489044,TNL
chr15,Bn61250,12429638,25619792,13190154,CNL
chr15,Bn61251,48785509,89708136,40922627,TNL
chr15,Bn61252,20325775,81377934,61052159,RLP
chr15,Bn61253,91609215,97228424,5619209,TN
chr15,Bn61254,74403805,93335324,18931519,NBS
chr15,Bn61255,97766938,98579884,812946,CNL
chr15,Bn61256,23900183,55140311,31240128,TN
chr15,Bn61257,83375905,91906224,8530319,TN
chr15,Bn61258,96138512,98926187,2787675,RLP
chr15,Bn61259,24355384,72324011,47968627,NBS
chr15,Bn61260,6429832,97344878,90915046,CNL
chr15,Bn61261,22538542,96173378,73634836,TNL
chr15,Bn61262,14369022,75484465,61115443,CNL
chr15,Bn61263,98121801,99753713,1631912,CNL
chr15,Bn61264,11104453,92269957,81165504,TNL
chr15,Bn61265,20688390,87990842,67302452,TNL
chr15,Bn61266,19435435,79460956,60025521,TN
chr15,Bn61267,50272281,71563593,21291312,NBS
chr15,Bn61268,66949355,81359833,14410478,TN
chr15,Bn61269,94995560,95547917,552357,NBS
chr15,Bn61270,96985993,98695706,1709713,RLP
chr15,Bn61271,15966299,45184428,29218129,CN
chr15,Bn61272,86126333,95315563,9189230,RLP
chr15,Bn61273,94057858,96641776,2583918,TN
chr15,Bn61274,97245493,98573710,1328217,TN
chr15,Bn61275,12312861,17660503,5347642,CNL
chr15,Bn61276,71689745,94106163,22416418,NBS
chr15,Bn61277,21951506,84024243,62072737,TN
chr15,Bn61278,64432605,87142237,22709632,TN
chr15,Bn61279,63282098,66963828,3681730,TNL
chr15,Bn61280,64077961,64653152,575191,CNL
chr15,Bn61281,97543328,98194817,651489,NBS
chr15,Bn61282,94025059,97917537,3892478,RLP
chr15,Bn61283,74316184,94271236,19955052,TN
chr15,Bn61284,77008801,81951062,4942261,RLP
chr15,Bn61285,85815801,97389747,11573946,NBS
chr15,Bn61286,99733580,99900321,166741,TN
chr15,Bn61287,27950014,92348810,64398796,NBS
chr15,Bn61288,1775800,86861070,85085270,CNL
chr15,Bn61289,39435650,71360979,31925329,RLP
chr15,Bn61290,29802389,35325834,5523445,CN
chr15,Bn61291,58062386,87579755,29517369,TN
chr15,Bn61292,78089830,98021496,19931666,TN
chr15,Bn61293,68719508,86125913,17406405,NBS
chr15,Bn61294,34429302,63681593,29252291,RLK
chr15,Bn61295,13853351,27982474,14129123,NBS
chr15,Bn61296,91489062,93749202,2260140,RLP
chr15,Bn61297,34299664,36642228,2342564,TNL
chr15,Bn61298,54674668,62341616,7666948,TNL
chr15,Bn61299,47197826,79566450,32368624,TN
chr15,Bn61300,71290100,87943562,16653462,RLK
chr15,Bn61301,60962879,83987778,23024899,CN
chr15,Bn61302,18464296,94628537,76164241,TN
chr15,Bn61303,13253635,97226611,83972976,RLK
chr15,Bn61304,39393182,58848574,19455392,RLP
chr15,Bn61305,11643129,45185648,33542519,RLK
chr15,Bn61306,58176994,66450781,8273787,RLK
chr15,Bn61307,93429264,95406953,1977689,NBS
chr15,Bn61308,57277262,98842677,41565415,TN
chr15,Bn61309,11087885,97420593,86332708,CNL
chr15,Bn61310,68604375,74186973,5582598,CNL
chr15,Bn61311,38051842,99570379,61518537,TN
chr15,Bn61312,17601976,72687349,55085373,CNL
chr15,Bn61313,96376112,97671507,1295395,CN
chr15,Bn61314,98830088,99671541,841453,CN
chr15,Bn61315,75979442,99615099,23635657,RLP
chr15,Bn61316,54817590,90514850,35697260,CNL
chr15,Bn61317,92958103,93962333,1004230,RLP
chr15,Bn61318,78831400,85709982,6878582,RLK
chr15,Bn61319,70916601,83216102,12299501,NBS
chr15,Bn61320,24657288,25820120,1162832,CN
chr15,Bn61321,13793067,32459907,18666840,RLK
chr15,Bn61322,96744178,97675430,931252,CNL
chr15,Bn61323,60524819,99304413,38779594,CNL
chr15,Bn61324,41704430,57540284,15835854,CN
chr15,Bn61325,76195208,82390899,6195691,CNL
chr15,Bn61326,14168721,89858432,75689711,NBS
chr15,Bn61327,98069734,98409332,339598,TNL
chr15,Bn61328,19525367,64244773,44719406,RLK
chr15,Bn61329,12225561,59112956,46887395,CN
chr15,Bn61330,59207753,80960327,21752574,RLK
chr15,Bn61331,14425951,16521127,2095176,TNL
chr15,Bn61332,56575068,97219206,40644138,CNL
chr15,Bn61333,60664033,70776262,10112229,RLK
chr15,Bn61334,98080645,99839649,1759004,CNL
chr15,Bn61335,56021944,88144881,32122937,RLP
chr15,Bn61336,80203792,86943104,6739312,CN
chr15,Bn61337,65408835,81872417,16463582,TNL
chr15,Bn61338,58512413,61726254,3213841,CN
chr15,Bn61339,69923165,84211505,14288340,TNL
chr15,Bn61340,50028553,64406776,14378223,CNL
chr15,Bn61341,82294094,88379251,6085157,RLP
chr15,Bn61342,84944121,90788084,5843963,RLP
chr15,Bn61343,22698969,96846689,74147720,TN
chr15,Bn61344,83003809,87715673,4711864,TNL
chr15,Bn61345,97753016,98716480,963464,RLP
chr15,Bn61346,83969908,87588238,3618330,CNL
chr15,Bn61347,95283381,96237816,954435,NBS
chr15,Bn61348,85342015,98777500,13435485,RLP
chr15,Bn61349,53055625,98484145,45428520,RLP
chr15,Bn61350,96676558,99380508,2703950,RLP
chr15,Bn61351,92743334,98490120,5746786,RLP
chr15,Bn61352,95195966,99438986,4243020,CNL
chr15,Bn61353,24906575,90290567,65383992,TN
chr15,Bn61354,64281265,80360634,16079369,TN
chr15,Bn61355,56546446,82802389,26255943,TN
chr15,Bn61356,20364393,42100525,21736132,CNL
chr15,Bn61357,18332416,91826973,73494557,CN
chr15,Bn61358,26381253,49311944,22930691,TNL
chr15,Bn61359,37049832,64389731,27339899,CN
chr15,Bn61360,17234298,29110937,11876639,CNL
chr15,Bn61361,55753720,99293178,43539458,RLP
chr15,Bn61362,37692913,89400020,51707107,RLK
chr15,Bn61363,36420923,54246377,17825454,CNL
chr15,Bn61364,2396245,39793101,37396856,TN
chr15,Bn61365,98079194,98804634,725440,CN
chr15,Bn61366,57567741,91093628,33525887,CNL
chr15,Bn61367,72534891,80687725,8152834,TN
chr15,Bn61368,31529880,61590711,30060831,TNL
chr15,Bn61369,63869761,72882996,9013235,RLP
chr15,Bn61370,17906486,33897865,15991379,RLK
chr15,Bn61371,38722925,93922557,55199632,TN
chr15,Bn61372,59665885,73528755,13862870,NBS
chr15,Bn61373,1239004,7553262,6314258,RLK
chr15,Bn61374,56795631,98699991,41904360,TNL
chr15,Bn61375,3750449,5557798,1807349,TN
chr15,Bn61376,77462562,89544264,12081702,RLK
chr15,Bn61377,69012279,83677552,14665273,TNL
chr15,Bn61378,5944971,19093320,13148349,TN
chr15,Bn61379,72939409,87857661,14918252,TNL
chr15,Bn61380,41554755,66548571,24993816,TN
chr15,Bn61381,18735648,33253875,14518227,TN
chr15,Bn61382,98811544,99441179,629635,CNL
chr15,Bn61383,41901670,42614318,712648,TNL
chr15,Bn61384,44663232,88581198,43917966,CN
chr15,Bn61385,90177599,90601203,423604,RLP
chr15,Bn61386,93131574,95457769,2326195,CN
chr15,Bn61387,61397302,85509235,24111933,NBS
chr15,Bn61388,52348911,92539458,40190547,TNL
chr15,Bn61389,83803390,86603467,2800077,NBS
chr15,Bn61390,79996187,86093558,6097371,CNL
chr15,Bn61391,31720258,65639915,33919657,RLK
chr15,Bn61392,19611054,71537138,51926084,TNL
chr15,Bn61393,34284200,62731322,28447122,NBS
chr15,Bn61394,75971791,87717005,11745214,TNL
chr15,Bn61395,21621096,49582487,27961391,TN
chr15,Bn61396,75421912,80785448,5363536,CN
chr15,Bn61397,79680144,93377208,13697064,RLK
chr15,Bn61398,40070355,52995335,12924980,CN
chr15,Bn61399,89372350,97478036,8105686,CN
chr15,Bn61400,62336267,70158844,7822577,TNL
chr15,Bn61401,57115212,70465290,13350078,NBS
chr15,Bn61402,88145619,99544617,11398998,RLK
chr15,Bn61403,93720759,98002308,4281549,CNL
chr15,Bn61404,97436611,97498263,61652,CN
chr15,Bn61405,60478088,80615449,20137361,TNL
chr15,Bn61406,5642287,49165474,43523187,CN
chr15,Bn61407,40174313,50938446,10764133,CN
chr15,Bn61408,30493877,51419344,20925467,RLP
chr15,Bn61409,59767837,81677445,21909608,NBS
chr15,Bn61410,53797860,92445194,38647334,CN
chr15,Bn61411,7634269,60700355,53066086,CNL
chr15,Bn61412,30149596,69505458,39355862,NBS
chr15,Bn61413,49497572,83906119,34408547,CN
chr15,Bn61414,65161243,80121429,14960186,RLK
chr15,Bn61415,20492841,36889894,16397053,TNL
chr15,Bn61416,43756304,72588430,28832126,CN
chr15,Bn61417,86360478,89482905,3122427,NBS
chr15,Bn61418,29982500,59458423,29475923,CNL
chr15,Bn61419,39121193,60809888,21688695,CNL
chr15,Bn61420,10713805,65617132,54903327,RLK
chr15,Bn61421,15373745,21490077,6116332,TNL
chr15,Bn61422,73462598,96289685,22827087,RLP
chr15,Bn61423,2917150,11182127,8264977,CN
chr15,Bn61424,17975900,45621482,27645582,NBS
chr15,Bn61425,78460149,94541878,16081729,CNL
chr15,Bn61426,56296292,64163626,7867334,NBS
chr15,Bn61427,87702258,92751230,5048972,NBS
chr15,Bn61428,11058712,68368474,57309762,CNL
chr15,Bn61429,68245575,90276994,22031419,TN
chr15,Bn61430,98738355,99618099,879744,CN
chr15,Bn61431,28159058,45907305,17748247,TNL
chr15,Bn61432,34270988,34344077,73089,TN
chr15,Bn61433,39255132,57706709,18451577,CNL
chr15,Bn61434,68558676,91471199,22912523,RLK
chr15,Bn61435,58021043,70390671,12369628,CNL
chr15,Bn61436,16515385,74983337,58467952,CN
chr15,Bn61437,83930341,96552493,12622152,TNL
chr15,Bn61438,43841343,89741101,45899758,TNL
chr15,Bn61439,61760533,78199089,16438556,TN
chr15,Bn61440,99853265,99914189,60924,NBS
chr15,Bn61441,42591123,44716297,2125174,NBS
chr15,Bn61442,7097403,38251884,31154481,RLK
chr15,Bn61443,15275836,96391610,81115774,TN
chr15,Bn61444,69111288,85160388,16049100,TN
chr15,Bn61445,96302419,96917066,614647,NBS
chr15,Bn61446,70230730,86910702,16679972,NBS
chr15,Bn61447,47998244,75150003,27151759,CNL
chr15,Bn61448,2057781,82066531,80008750,CNL
chr15,Bn61449,11067459,39864539,28797080,NBS
chr15,Bn61450,90510475,97414151,6903676,RLP
chr15,Bn61451,52721851,76598933,23877082,CNL
chr15,Bn61452,90348540,93499769,3151229,TNL
chr15,Bn61453,90598453,96244553,5646100,TNL
chr15,Bn61454,37048677,61911723,24863046,RLP
chr15,Bn61455,42367035,69376861,27009826,RLK
chr15,Bn61456,71463065,87950509,16487444,CN
chr15,Bn61457,57202122,86494207,29292085,NBS
chr15,Bn61458,10773994,79300767,68526773,NBS
chr15,Bn61459,94672549,98708243,4035694,RLP
chr15,Bn61460,58544755,97616003,39071248,CNL
chr15,Bn61461,99972958,99985039,12081,CN
chr15,Bn61462,51872079,64514767,12642688,RLP
chr15,Bn61463,23991445,70869103,46877658,RLK
chr15,Bn61464,96206732,96435224,228492,TNL
chr15,Bn61465,62711367,96436494,33725127,TNL
chr15,Bn61466,34690785,97716132,63025347,CN
chr15,Bn61467,93480581,96546383,3065802,CN
chr15,Bn61468,44803032,88470254,43667222,CN
chr15,Bn61469,63567268,93431101,29863833,TNL
chr15,Bn61470,85595828,97457338,11861510,NBS
chr15,Bn61471,51125805,58755516,7629711,CN
chr15,Bn61472,13628369,17031833,3403464,TNL
chr15,Bn61473,69189809,88473267,19283458,RLP
chr15,Bn61474,83131123,98024085,14892962,CNL
chr15,Bn61475,70569490,82537583,11968093,RLK
chr15,Bn61476,85784307,89503671,3719364,CNL
chr15,Bn61477,73269416,81864418,8595002,CN
chr15,Bn61478,84446434,98626452,14180018,RLK
chr15,Bn61479,8065552,70770286,62704734,NBS
chr15,Bn61480,1816499,90389267,88572768,NBS
chr15,Bn61481,43773179,43815661,42482,TNL
chr15,Bn61482,23621459,34623503,11002044,TN
chr15,Bn61483,58127470,80896367,22768897,TNL
chr15,Bn61484,71047689,82955428,11907739,TN
chr15,Bn61485,98737966,98921051,183085,TN
chr15,Bn61486,61900232,97032455,35132223,TNL
chr15,Bn61487,17518419,96146054,78627635,TN
chr15,Bn61488,1340430,30091682,28751252,RLP
chr15,Bn61489,97923622,99708567,1784945,TNL
chr15,Bn61490,75693383,95009112,19315729,RLK
chr15,Bn61491,79605812,90061156,10455344,CN
chr15,Bn61492,1739689,68992234,67252545,TNL
chr15,Bn61493,52049207,85229167,33179960,TNL
chr15,Bn61494,8980316,70449477,61469161,NBS
chr15,Bn61495,62869351,74271471,11402120,NBS
chr15,Bn61496,18582038,40319945,21737907,CN
chr15,Bn61497,73198301,96875351,23677050,CN
chr15,Bn61498,97220036,98011878,791842,NBS
chr15,Bn61499,87108117,99109895,12001778,RLK
chr15,Bn61500,48884631,64289979,15405348,RLP
chr15,Bn61501,2190513,92669670,90479157,CN
chr15,Bn61502,87528568,91651333,4122765,RLP
chr15,Bn61503,19032414,44717715,25685301,TNL
chr15,Bn61504,46621069,63855444,17234375,CNL
chr15,Bn61505,32994933,97244500,64249567,TNL
chr15,Bn61506,16589016,82173539,65584523,TNL
chr15,Bn61507,34333582,96978717,62645135,CNL
chr15,Bn61508,98693010,99107939,414929,TN
chr15,Bn61509,54082169,55064837,982668,RLK
chr15,Bn61510,38841995,76275524,37433529,RLP
chr15,Bn61511,24643370,52861599,28218229,CN
chr15,Bn61512,98636684,99227712,591028,TN
chr15,Bn61513,13141438,74920341,61778903,RLP
chr15,Bn61514,46507892,49589014,3081122,RLP
chr15,Bn61515,53187883,66780663,13592780,RLK
chr15,Bn61516,93113903,97529566,4415663,RLP
chr15,Bn61517,23019773,94404163,71384390,NBS
chr15,Bn61518,86400397,96897174,10496777,TN
chr15,Bn61519,23117806,77404154,54286348,TN
chr15,Bn61520,95194630,98508706,3314076,NBS
chr15,Bn61521,76887447,82364357,5476910,TN
chr15,Bn61522,10628214,20472223,9844009,RLP
chr15,Bn61523,59816922,86927922,27111000,CN
chr15,Bn61524,6320905,42484683,36163778,TN
chr15,Bn61525,54997451,85440749,30443298,RLP
chr15,Bn61526,40927645,69190316,28262671,RLP
chr15,Bn61527,51977824,64932579,12954755,NBS
chr15,Bn61528,18767249,86990032,68222783,CNL
chr15,Bn61529,21127918,68462656,47334738,RLP
chr15,Bn61530,56542727,81361345,24818618,TNL
chr15,Bn61531,78201471,81789782,3588311,TN
chr15,Bn61532,27929341,34594203,6664862,RLK
chr15,Bn61533,98195112,99194012,998900,CNL
chr15,Bn61534,60337314,79254312,18916998,TNL
chr15,Bn61535,69895946,77029828,7133882,RLP
chr15,Bn61536,65780754,89550305,23769551,RLP
chr15,Bn61537,13224301,15289781,2065480,TNL
chr15,Bn61538,43786571,62975677,19189106,CN
chr15,Bn61539,13854857,34114540,20259683,TNL
chr15,Bn61540,38266178,84176748,45910570,RLK
chr15,Bn61541,17811291,40424596,22613305,NBS
chr15,Bn61542,86170097,94311445,8141348,TN
chr15,Bn61543,25374155,42724379,17350224,NBS
chr15,Bn61544,55647906,56491554,843648,TN
chr15,Bn61545,55708398,85991472,30283074,RLP
chr15,Bn61546,41008055,84123157,43115102,RLK
chr15,Bn61547,39205617,96616607,57410990,RLP
chr15,Bn61548,61574920,62753088,1178168,RLP
chr15,Bn61549,44931639,94956689,50025050,RLK
chr15,Bn61550,8710616,68288543,59577927,RLP
chr15,Bn61551,77389059,86625540,9236481,CN
chr15,Bn61552,14794599,25013369,10218770,TNL
chr15,Bn61553,87258979,95676302,8417323,TN
chr15,Bn61554,4958342,79041737,74083395,RLP
chr15,Bn61555,53184383,61633289,8448906,RLK
chr15,Bn61556,42830290,51339405,8509115,RLK
chr15,Bn61557,51408357,65952018,14543661,TN
chr15,Bn61558,74440681,92550256,18109575,TN
chr15,Bn61559,13658072,55564956,41906884,RLK
chr15,Bn61560,31364979,55795183,24430204,NBS
chr15,Bn61561,69925337,85658281,15732944,CN
chr15,Bn61562,78774797,99162671,20387874,RLP
chr15,Bn61563,3553646,48824245,45270599,TNL
chr15,Bn61564,22239574,79646559,57406985,RLP
chr15,Bn61565,33864273,89841480,55977207,TN
chr15,Bn61566,9433421,11638131,2204710,TN
chr15,Bn61567,26526512,43058641,16532129,NBS
chr15,Bn61568,22627038,85678524,63051486,CNL
chr15,Bn61569,83342771,91208589,7865818,CN
chr15,Bn61570,56374463,84221628,27847165,RLK
chr15,Bn61571,61097053,97159278,36062225,TNL
chr15,Bn61572,12361528,67584944,55223416,TN
chr15,Bn61573,36833968,50923401,14089433,RLK
chr15,Bn61574,9907092,15736835,5829743,RLP
chr15,Bn61575,28787264,94075307,65288043,CNL
chr15,Bn61576,19221585,21676943,2455358,TN
chr15,Bn61577,9371470,47646096,38274626,CNL
chr15,Bn61578,27124932,60240061,33115129,CNL
chr15,Bn61579,7971452,12026785,4055333,TN
chr15,Bn61580,58540559,88472753,29932194,CN
chr15,Bn61581,44051412,96541217,52489805,RLP
chr15,Bn61582,57943519,62706213,4762694,CN
chr15,Bn61583,34153243,80421343,46268100,TNL
chr15,Bn61584,18526695,50246852,31720157,CN
chr15,Bn61585,44901900,88010116,43108216,TN
chr15,Bn61586,21787092,67419361,45632269,CN
chr15,Bn61587,93712129,99603679,5891550,NBS
chr15,Bn61588,14472392,43327306,28854914,TN
chr15,Bn61589,51788378,58921066,7132688,NBS
chr15,Bn61590,83546576,87315984,3769408,NBS
chr15,Bn61591,18267463,31227815,12960352,CNL
chr15,Bn61592,59670945,61628102,1957157,TNL
chr15,Bn61593,31958514,63590905,31632391,CNL
chr15,Bn61594,28738902,54646435,25907533,RLP
chr15,Bn61595,9837802,50348288,40510486,TNL
chr15,Bn61596,54731903,84768076,30036173,TNL
chr15,Bn61597,89813221,94550534,4737313,TN
chr15,Bn61598,3375283,27795776,24420493,TN
chr15,Bn61599,12565017,43149572,30584555,CNL
chr15,Bn61600,78018044,82041652,4023608,TN
chr15,Bn61601,25824745,62025951,36201206,TNL
chr15,Bn61602,32307707,33839916,1532209,TN
chr15,Bn61603,44905954,69133845,24227891,CN
chr15,Bn61604,93750780,97353499,3602719,RLP
chr15,Bn61605,11857152,54896310,43039158,TNL
chr15,Bn61606,67847386,85518687,17671301,TNL
chr15,Bn61607,88905679,90410476,1504797,RLK
chr15,Bn61608,21544861,84564615,63019754,RLK
chr15,Bn61609,95705503,96343655,638152,TN
chr15,Bn61610,29737626,42512953,12775327,NBS
chr15,Bn61611,76492308,78822619,2330311,TNL
chr15,Bn61612,48028355,96996027,48967672,NBS
chr15,Bn61613,21770611,70492493,48721882,CNL
chr15,Bn61614,42570618,42773381,202763,RLP
chr15,Bn61615,2238243,79583964,77345721,NBS
chr15,Bn61616,80687172,94253615,13566443,CNL
chr15,Bn61617,55610670,57964417,2353747,RLP
chr15,Bn61618,97335513,99816029,2480516,TN
chr15,Bn61619,54845825,99774545,44928720,NBS
chr15,Bn61620,14857447,93232646,78375199,RLK
chr15,Bn61621,86341740,98836965,12495225,CN
chr15,Bn61622,78939958,91092540,12152582,CN
chr15,Bn61623,79470584,85367502,5896918,RLK
chr15,Bn61624,71256755,95539586,24282831,TNL
chr15,Bn61625,85571349,91566819,5995470,CN
chr15,Bn61626,90230462,97538020,7307558,CNL
chr15,Bn61627,68503647,95747879,27244232,CNL
chr15,Bn61628,70050722,91795448,21744726,CN
chr15,Bn61629,44313468,70223703,25910235,RLP
chr15,Bn61630,89057777,89495537,437760,CN
chr15,Bn61631,72488766,74682387,2193621,CNL
chr15,Bn61632,61683916,87132704,25448788,NBS
chr15,Bn61633,26039948,71167415,45127467,RLK
chr15,Bn61634,76431582,80764237,4332655,RLP
chr15,Bn61635,20567952,80180592,59612640,NBS
chr15,Bn61636,98314688,99816897,1502209,NBS
chr15,Bn61637,93069231,93417182,347951,TN
chr15,Bn61638,74425745,90672998,16247253,TN
chr15,Bn61639,10645500,65159057,54513557,RLP
chr15,Bn61640,58711450,59112167,400717,TN
chr15,Bn61641,44692705,51225960,6533255,CN
chr15,Bn61642,18870910,70183812,51312902,RLK
chr15,Bn61643,63764799,84951115,21186316,RLK
chr15,Bn61644,48198781,64916070,16717289,TNL
chr15,Bn61645,29866248,86688723,56822475,RLP
chr15,Bn61646,88376770,98154588,9777818,TN
chr15,Bn61647,34505846,78351773,43845927,RLK
chr15,Bn61648,23973094,34521586,10548492,CNL
chr15,Bn61649,68202713,74738070,6535357,RLK
chr15,Bn61650,14245092,15147463,902371,NBS
chr15,Bn61651,97159095,99840727,2681632,CNL
chr15,Bn61652,60943325,99795096,38851771,CNL
chr15,Bn61653,47133079,56971120,9838041,RLK
chr15,Bn61654,2593172,66389693,63796521,TNL
chr15,Bn61655,35927304,50032897,14105593,NBS
chr15,Bn61656,32519694,56319238,23799544,RLK
chr15,Bn61657,94763926,98637792,3873866,CN
chr15,Bn61658,52417231,99280501,46863270,RLP
chr15,Bn61659,37681073,91460248,53779175,CN
chr15,Bn61660,17659144,97534383,79875239,CNL
chr15,Bn61661,90498589,92132965,1634376,RLK
chr15,Bn61662,27840686,34070758,6230072,TN
chr15,Bn61663,45347675,86727544,41379869,TN
chr15,Bn61664,45278242,82981025,37702783,RLK
chr15,Bn61665,41496115,84124020,42627905,CNL
chr15,Bn61666,46616745,93462131,46845386,RLP
chr15,Bn61667,6398771,10195806,3797035,TNL
chr15,Bn61668,64784194,74674946,9890752,CNL
chr15,Bn61669,64176893,87684605,23507712,TNL
chr15,Bn61670,76954229,91735801,14781572,TN
chr15,Bn61671,82549039,97495574,14946535,CNL
chr15,Bn61672,89727656,93645805,3918149,TNL
chr15,Bn61673,87523975,88308638,784663,TN
chr15,Bn61674,87664631,92687024,5022393,CNL
chr15,Bn61675,38800155,96551421,57751266,RLK
chr15,Bn61676,49160188,82956087,33795899,RLK
chr15,Bn61677,52386327,71024376,18638049,TNL
chr15,Bn61678,27781229,79615103,51833874,CNL
chr15,Bn61679,16955154,46784917,29829763,RLP
chr15,Bn61680,55165343,55892192,726849,NBS
chr15,Bn61681,59165879,68772361,9606482,TNL
chr15,Bn61682,20615848,61055512,40439664,CNL
chr15,Bn61683,55498320,61379990,5881670,RLK
chr15,Bn61684,87451830,91439465,3987635,RLK
chr15,Bn61685,7380423,48491510,41111087,CNL
chr15,Bn61686,56435500,58637855,2202355,RLK
chr15,Bn61687,41988441,55852328,13863887,RLP
chr15,Bn61688,83399982,95508914,12108932,RLK
chr15,Bn61689,18349838,40095798,21745960,CNL
chr15,Bn61690,30968352,48634125,17665773,RLP
chr15,Bn61691,92341557,94704913,2363356,RLP
chr15,Bn61692,42901323,55763006,12861683,CN
chr15,Bn61693,33396936,45959889,12562953,NBS
chr15,Bn61694,1220870,76659585,75438715,NBS
chr15,Bn61695,36496016,85274636,48778620,NBS
chr15,Bn61696,64849169,91214743,26365574,NBS
chr15,Bn61697,18559695,66332649,47772954,TN
chr15,Bn61698,64563519,98378868,33815349,NBS
chr15,Bn61699,92728961,97381688,4652727,RLP
chr15,Bn61700,17065876,27748035,10682159,TNL
chr15,Bn61701,12041212,57144680,45103468,NBS
chr15,Bn61702,14150586,19088560,4937974,RLK
chr15,Bn61703,41243486,72242627,30999141,TNL
chr15,Bn61704,9272366,93313105,84040739,TN
chr15,Bn61705,49045562,59977647,10932085,NBS
chr15,Bn61706,52170326,87961615,35791289,NBS
chr15,Bn61707,1940571,49292966,47352395,RLK
chr15,Bn61708,6680538,96699334,90018796,TNL
chr15,Bn61709,91132956,93104332,1971376,TNL
chr15,Bn61710,48719053,70181068,21462015,CN
chr15,Bn61711,54967386,61256572,6289186,CNL
chr15,Bn61712,88612906,93843344,5230438,TN
chr15,Bn61713,97185470,99868154,2682684,CN
chr15,Bn61714,85706986,96349944,10642958,TNL
chr15,Bn61715,49660648,58972525,9311877,RLK
chr15,Bn61716,37315492,72513172,35197680,TN
chr15,Bn61717,67306774,98357283,31050509,TN
chr15,Bn61718,53721501,85241620,31520119,RLK
chr15,Bn61719,52061939,53310910,1248971,NBS
chr15,Bn61720,84323908,91192219,6868311,TN
chr15,Bn61721,79024942,98573899,19548957,TNL
chr15,Bn61722,27028767,86471311,59442544,CN
chr15,Bn61723,48158732,54436148,6277416,NBS
chr15,Bn61724,50021945,94634454,44612509,NBS
chr15,Bn61725,82631013,89110262,6479249,CNL
chr15,Bn61726,99130297,99959903,829606,CN
chr15,Bn61727,81208478,94304886,13096408,CNL
chr15,Bn61728,19897900,86341411,66443511,TN
chr15,Bn61729,46820270,78299532,31479262,RLK
chr15,Bn61730,32311000,47388047,15077047,CNL
chr15,Bn61731,27370706,41343904,13973198,NBS
chr15,Bn61732,54187740,89669742,35482002,CNL
chr15,Bn61733,93418251,97406832,3988581,RLK
chr15,Bn61734,69514910,85914546,16399636,CN
chr15,Bn61735,84502219,98747352,14245133,TN
chr15,Bn61736,56606713,63673928,7067215,CNL
chr15,Bn61737,71326575,96146547,24819972,NBS
chr15,Bn61738,63090799,94414284,31323485,CNL
chr15,Bn61739,58099057,78578658,20479601,NBS
chr15,Bn61740,43233763,90583459,47349696,CNL
chr15,Bn61741,16368047,22739347,6371300,NBS
chr15,Bn61742,6711553,18080294,11368741,CN
chr15,Bn61743,90704684,99295494,8590810,CN
chr15,Bn61744,15917668,47885906,31968238,NBS
chr15,Bn61745,56398574,72390710,15992136,RLK
chr15,Bn61746,93318486,93319092,606,TN
chr15,Bn61747,67404681,76494856,9090175,RLP
chr15,Bn61748,96685407,99273645,2588238,NBS
chr15,Bn61749,52765319,74123201,21357882,RLP
chr15,Bn61750,44588894,78763693,34174799,RLK
chr15,Bn61751,64581096,94096913,29515817,CNL
chr15,Bn61752,86820234,87262984,442750,CN
chr15,Bn61753,38687694,64399568,25711874,CNL
chr15,Bn61754,65601938,74548155,8946217,RLP
chr15,Bn61755,88262295,88373584,111289,NBS
chr15,Bn61756,71955867,98298075,26342208,NBS
chr15,Bn61757,12145514,16086117,3940603,RLP
chr15,Bn61758,13791971,43698411,29906440,RLK
chr15,Bn61759,64983734,83102194,18118460,RLP
chr15,Bn61760,81636912,92454546,10817634,NBS
chr15,Bn61761,68851818,86140233,17288415,CNL
chr15,Bn61762,61278493,93129293,31850800,TNL
chr15,Bn61763,63434743,70764927,7330184,TN
chr15,Bn61764,30637495,48464845,17827350,TN
chr15,Bn61765,87352842,91184415,3831573,CN
chr15,Bn61766,39553183,70183675,30630492,CN
chr15,Bn61767,77147091,82302411,5155320,CNL
chr15,Bn61768,72920320,97084618,24164298,RLP
chr15,Bn61769,1736838,71933430,70196592,TNL
chr15,Bn61770,75155081,98998900,23843819,RLP
chr15,Bn61771,94262698,97582324,3319626,RLK
chr15,Bn61772,39758804,96561925,56803121,RLP
chr15,Bn61773,85838445,96030408,10191963,RLP
chr15,Bn61774,90775831,95622491,4846660,NBS
chr15,Bn61775,64673487,94616551,29943064,RLP
chr15,Bn61776,40150942,68160423,28009481,RLK
chr15,Bn61777,3848027,28273542,24425515,NBS
chr15,Bn61778,42827229,67056658,24229429,NBS
chr15,Bn61779,5106134,11531711,6425577,RLP
chr15,Bn61780,85164377,85355483,191106,TN
chr15,Bn61781,53075298,64457285,11381987,NBS
chr15,Bn61782,23672037,89858134,66186097,RLP
chr15,Bn61783,72852361,96968110,24115749,TNL
chr15,Bn61784,46137244,97753054,51615810,TN
chr15,Bn61785,23121239,95223799,72102560,RLP
chr15,Bn61786,64662462,84771072,20108610,NBS
chr15,Bn61787,14238529,22276969,8038440,TN
chr15,Bn61788,3975536,91471051,87495515,TNL
chr15,Bn61789,11927167,31036046,19108879,RLP
chr15,Bn61790,85501830,86901404,1399574,TN
chr15,Bn61791,3742186,33692782,29950596,TN
chr15,Bn61792,24679355,37504299,12824944,NBS
chr15,Bn61793,34990109,73750242,38760133,CN
chr15,Bn61794,57619907,98877489,41257582,RLK
chr15,Bn61795,43603725,80846314,37242589,TNL
chr15,Bn61796,28208240,90198368,61990128,RLP
chr15,Bn61797,74783569,99460940,24677371,RLK
chr15,Bn61798,37990509,45705108,7714599,NBS
chr15,Bn61799,44639345,75092785,30453440,CN
chr15,Bn61800,7757499,51877124,44119625,NBS
chr15,Bn61801,81333503,85600866,4267363,CN
chr15,Bn61802,46872185,71882406,25010221,CN
chr15,Bn61803,37517374,64045896,26528522,RLP
chr15,Bn61804,20154672,34890978,14736306,TNL
chr15,Bn61805,32593202,92353494,59760292,CNL
chr15,Bn61806,13515889,86425299,72909410,TN
chr15,Bn61807,5300985,11313853,6012868,CN
chr15,Bn61808,37620935,94277958,56657023,RLP
chr15,Bn61809,19923535,31520334,11596799,CN
chr15,Bn61810,78928684,84784544,5855860,TN
chr15,Bn61811,48589198,96864037,48274839,CN
chr15,Bn61812,28618130,31985387,3367257,TNL
chr15,Bn61813,21793969,96896230,75102261,CNL
chr15,Bn61814,43193081,68157026,24963945,TN
chr15,Bn61815,41275479,57035150,15759671,CNL
chr15,Bn61816,58260188,83988649,25728461,TN
chr15,Bn61817,79619364,98255193,18635829,TNL
chr15,Bn61818,12846554,48462745,35616191,TNL
chr15,Bn61819,56596990,95653486,39056496,TN
chr15,Bn61820,23172208,36512445,13340237,RLK
chr15,Bn61821,38128707,50370810,12242103,RLP
chr15,Bn61822,73014452,88219765,15205313,RLP
chr15,Bn61823,63150735,77336018,14185283,TN
chr15,Bn61824,20906308,80045151,59138843,CN
chr15,Bn61825,47685486,48458619,773133,CN
chr15,Bn61826,87439881,91867461,4427580,CNL
chr15,Bn61827,30978529,74809886,43831357,CN
chr15,Bn61828,75783406,95890140,20106734,TNL
chr15,Bn61829,9330039,56935136,47605097,RLK
chr15,Bn61830,20565313,37567961,17002648,TN
chr15,Bn61831,97153803,98394989,1241186,TNL
chr15,Bn61832,57673774,88247523,30573749,TN
chr15,Bn61833,56165635,85129802,28964167,TN
chr15,Bn61834,11471610,73569610,62098000,TNL
chr15,Bn61835,41780176,60514506,18734330,TN
chr15,Bn61836,72992540,89721936,16729396,NBS
chr15,Bn61837,96456018,98219812,1763794,CN
chr15,Bn61838,97705655,98959867,1254212,CNL
chr15,Bn61839,48243122,53199404,4956282,CNL
chr15,Bn61840,53751165,73268597,19517432,TN
chr15,Bn61841,65024959,99087383,34062424,TNL
chr15,Bn61842,17260470,20070777,2810307,CNL
chr15,Bn61843,50229445,94405004,44175559,TNL
chr15,Bn61844,13640288,83112729,69472441,TN
chr15,Bn61845,35265530,96257862,60992332,NBS
chr15,Bn61846,87008628,98826752,11818124,TN
chr15,Bn61847,70732865,77995908,7263043,TNL
chr15,Bn61848,65598952,99529956,33931004,TN
chr15,Bn61849,13591423,68721616,55130193,CNL
chr15,Bn61850,37623094,86747248,49124154,CNL
chr15,Bn61851,39905071,95384339,55479268,CNL
chr15,Bn61852,86706236,95002806,8296570,CN
chr15,Bn61853,12568548,30614448,18045900,CNL
chr15,Bn61854,72454985,79821894,7366909,RLK
chr15,Bn61855,70810535,88568197,17757662,NBS
chr15,Bn61856,31982624,95866959,63884335,TN
chr15,Bn61857,20420836,62021971,41601135,CNL
chr15,Bn61858,39228694,97597241,58368547,RLP
chr15,Bn61859,7430614,30252585,22821971,CNL
chr15,Bn61860,30234665,63254463,33019798,TN
chr15,Bn61861,6055520,20603784,14548264,RLP
chr15,Bn61862,75985473,80480763,4495290,TNL
chr15,Bn61863,58366790,74901427,16534637,NBS
chr15,Bn61864,24374786,35516029,11141243,CNL
chr15,Bn61865,86159356,96915343,10755987,TN
chr15,Bn61866,43533875,77582475,34048600,RLK
chr15,Bn61867,54719679,95632548,40912869,CNL
chr15,Bn61868,10377682,56412434,46034752,CN
chr15,Bn61869,31058576,47545555,16486979,TNL
chr15,Bn61870,65902314,68570105,2667791,TNL
chr15,Bn61871,50581005,64372143,13791138,NBS
chr15,Bn61872,5381255,75273064,69891809,TNL
chr15,Bn61873,47859775,60603226,12743451,TNL
chr15,Bn61874,35196330,89217823,54021493,RLK
chr15,Bn61875,65693991,94180636,28486645,CN
chr15,Bn61876,46198034,56698667,10500633,RLP
chr15,Bn61877,77689770,90542321,12852551,RLK
chr15,Bn61878,63457475,87903614,24446139,RLP
chr15,Bn61879,82332221,82487730,155509,RLP
chr15,Bn61880,34374225,61075412,26701187,CN
chr15,Bn61881,85752964,96530349,10777385,NBS
chr15,Bn61882,2774299,36979252,34204953,RLK
chr15,Bn61883,72877593,85091546,12213953,CNL
chr15,Bn61884,19710969,49343226,29632257,RLP
chr15,Bn61885,65035473,83397709,18362236,NBS
chr15,Bn61886,94544412,96038208,1493796,CNL
chr15,Bn61887,37944523,83823928,45879405,CN
chr15,Bn61888,52315973,56877764,4561791,CNL
chr15,Bn61889,31834625,78249865,46415240,NBS
chr15,Bn61890,96748565,97142825,394260,RLP
chr15,Bn61891,49218252,69381132,20162880,CNL
chr15,Bn61892,4914994,60876481,55961487,RLP
chr15,Bn61893,42443602,90781585,48337983,RLP
chr15,Bn61894,20576378,45475235,24898857,RLK
chr15,Bn61895,35691450,85559020,49867570,TN
chr15,Bn61896,53606412,68253031,14646619,RLK
chr15,Bn61897,60993338,64877178,3883840,CN
chr15,Bn61898,88302768,98958212,10655444,CNL
chr15,Bn61899,14827951,56499138,41671187,CN
chr15,Bn61900,87828930,89390814,1561884,RLK
chr15,Bn61901,15349321,26032387,10683066,RLP
chr15,Bn61902,5569196,78360961,72791765,TN
chr15,Bn61903,96809420,97768036,958616,CNL
chr15,Bn61904,82558623,83398681,840058,RLK
chr15,Bn61905,16274847,52641789,36366942,TN
chr15,Bn61906,47268918,73356632,26087714,CNL
chr15,Bn61907,75005018,91416603,16411585,CN
chr15,Bn61908,2009124,34837373,32828249,NBS
chr15,Bn61909,23400740,57835537,34434797,RLP
chr15,Bn61910,11913747,50436730,38522983,CNL
chr15,Bn61911,52185535,59274571,7089036,RLK
chr15,Bn61912,76695812,82738023,6042211,RLK
chr15,Bn61913,46842411,83413241,36570830,TNL
chr15,Bn61914,96442106,99938334,3496228,TNL
chr15,Bn61915,18243835,40382403,22138568,NBS
chr15,Bn61916,54149873,99464573,45314700,CNL
chr15,Bn61917,3071134,72821410,69750276,TN
chr15,Bn61918,51616170,75574815,23958645,CN
chr15,Bn61919,70958030,73537973,2579943,NBS
chr15,Bn61920,57897927,68445847,10547920,TNL
chr15,Bn61921,85548816,96683672,11134856,TN
chr15,Bn61922,15234479,26400319,11165840,TN
chr15,Bn61923,91679024,93152642,1473618,RLK
chr15,Bn61924,9176607,40050738,30874131,NBS
chr15,Bn61925,2136472,91619699,89483227,TNL
chr15,Bn61926,87806470,97608860,9802390,RLP
chr15,Bn61927,17541094,30460486,12919392,NBS
chr15,Bn61928,68343585,92866532,24522947,CNL
chr15,Bn61929,75891071,77289693,1398622,RLK
chr15,Bn61930,76605210,93182904,16577694,RLK
chr15,Bn61931,77357322,92096197,14738875,RLP
chr15,Bn61932,95397761,98947847,3550086,CNL
chr15,Bn61933,47964661,76905522,28940861,RLP
chr15,Bn61934,89987714,94947367,4959653,CNL
chr15,Bn61935,28851316,78886365,50035049,TNL
chr15,Bn61936,24920334,79503369,54583035,TNL
chr15,Bn61937,89936304,98590766,8654462,RLK
chr15,Bn61938,60236408,73008284,12771876,NBS
chr15,Bn61939,8287795,12731032,4443237,CNL
chr15,Bn61940,94138784,94737331,598547,NBS
chr15,Bn61941,41950271,49348645,7398374,NBS
chr15,Bn61942,61949850,94834865,32885015,RLP
chr15,Bn61943,59504639,80567393,21062754,TN
chr15,Bn61944,10859607,56995422,46135815,RLP
chr15,Bn61945,22195959,92947854,70751895,CN
chr15,Bn61946,41327054,72887718,31560664,NBS
chr15,Bn61947,46886126,77049003,30162877,TNL
chr15,Bn61948,94002244,94249513,247269,NBS
chr15,Bn61949,5193930,27502997,22309067,NBS
chr15,Bn61950,64270784,97949866,33679082,RLK
chr15,Bn61951,84128811,95383780,11254969,TN
chr15,Bn61952,11823477,89687238,77863761,CNL
chr15,Bn61953,62051288,69238787,7187499,NBS
chr15,Bn61954,57923224,70634125,12710901,TN
chr15,Bn61955,74383883,87873080,13489197,TNL
chr15,Bn61956,98041604,99235435,1193831,CN
chr15,Bn61957,30176600,62773175,32596575,NBS
chr15,Bn61958,98869097,99168990,299893,CNL
chr15,Bn61959,15708154,36753479,21045325,CN
chr15,Bn61960,43796410,73264964,29468554,TN
chr15,Bn61961,73068612,77469371,4400759,NBS
chr15,Bn61962,81833779,98290147,16456368,NBS
chr15,Bn61963,85961051,91106271,5145220,NBS
chr15,Bn61964,87798775,93330704,5531929,CNL
chr15,Bn61965,30976940,44040629,13063689,CNL
chr15,Bn61966,16502850,69651322,53148472,CNL
chr15,Bn61967,96279307,97139068,859761,TNL
chr15,Bn61968,57552552,97347450,39794898,CNL
chr15,Bn61969,60843576,80101851,19258275,RLK
chr15,Bn61970,56358717,63296534,6937817,CNL
chr15,Bn61971,49291011,99576602,50285591,NBS
chr15,Bn61972,28881649,47257167,18375518,RLK
chr15,Bn61973,72183281,83274049,11090768,RLK
chr15,Bn61974,2228837,42890515,40661678,RLK
chr15,Bn61975,38635900,97982854,59346954,TNL
chr15,Bn61976,43728593,87131572,43402979,RLP
chr15,Bn61977,83669531,94887422,11217891,RLP
chr15,Bn61978,23899718,98271855,74372137,NBS
chr15,Bn61979,95582733,99715005,4132272,RLP
chr15,Bn61980,68111951,83447928,15335977,TNL
chr15,Bn61981,37449650,78277965,40828315,RLP
chr15,Bn61982,59062439,77911487,18849048,TNL
chr15,Bn61983,24844957,68185337,43340380,CNL
chr15,Bn61984,30048866,65657764,35608898,CNL
chr15,Bn61985,51929086,63422926,11493840,TN
chr15,Bn61986,29884673,37750573,7865900,RLK
chr15,Bn61987,50420632,95264728,44844096,TNL
chr15,Bn61988,63037375,93718171,30680796,NBS
chr15,Bn61989,78173015,97374398,19201383,NBS
chr15,Bn61990,5105082,29099901,23994819,CNL
chr15,Bn61991,13466791,32283459,18816668,TNL
chr15,Bn61992,1424282,69359454,67935172,NBS
chr15,Bn61993,76816115,86031685,9215570,TN
chr15,Bn61994,3545231,9730354,6185123,CN
chr15,Bn61995,77206215,82254678,5048463,CN
chr15,Bn61996,83613654,91537138,7923484,CNL
chr15,Bn61997,65126321,82992950,17866629,TN
chr15,Bn61998,23554274,93319603,69765329,CNL
chr15,Bn61999,52953574,85693506,32739932,NBS
chr15,Bn62000,55648150,87429726,31781576,RLP
chr15,Bn62001,77347576,84297084,6949508,NBS
chr15,Bn62002,51942309,87669683,35727374,TN
chr15,Bn62003,30789507,45697489,14907982,TN
chr15,Bn62004,53365731,55396799,2031068,TNL
chr15,Bn62005,39613147,52250257,12637110,CNL
chr15,Bn62006,52566003,92705251,40139248,CN
chr15,Bn62007,1943145,24403537,22460392,RLP
chr15,Bn62008,53036353,95766444,42730091,RLK
chr15,Bn62009,25133939,68733362,43599423,CN
chr15,Bn62010,56784689,90759058,33974369,RLP
chr15,Bn62011,91949395,96794603,4845208,CN
chr15,Bn62012,17229485,25818870,8589385,CNL
chr15,Bn62013,98042466,99886902,1844436,RLP
chr15,Bn62014,25158528,90275134,65116606,NBS
chr15,Bn62015,5964478,70937986,64973508,NBS
chr15,Bn62016,42995520,89845963,46850443,CNL
chr15,Bn62017,45790733,74656786,28866053,TNL
chr15,Bn62018,6549820,61115789,54565969,CNL
chr15,Bn62019,54337482,56164994,1827512,CNL
chr15,Bn62020,82618128,99844862,17226734,NBS
chr15,Bn62021,62277715,75280426,13002711,CN
chr15,Bn62022,75839217,92139618,16300401,CN
chr15,Bn62023,93469317,99337124,5867807,RLP
chr15,Bn62024,66206871,73832762,7625891,CN
chr15,Bn62025,45911595,74500551,28588956,RLK
chr15,Bn62026,47087558,88081564,40994006,TNL
chr15,Bn62027,99920787,99948612,27825,CNL
chr15,Bn62028,59669577,67011820,7342243,CN
chr15,Bn62029,66544623,67245137,700514,RLP
chr15,Bn62030,94613477,94853089,239612,RLK
chr15,Bn62031,59602495,75099666,15497171,CN
chr15,Bn62032,40352209,54010849,13658640,CNL
chr15,Bn62033,37347874,65784907,28437033,TN
chr15,Bn62034,10452204,14890481,4438277,TN
chr15,Bn62035,83627499,88463185,4835686,RLP
chr15,Bn62036,89137920,90179531,1041611,TNL
chr15,Bn62037,70917653,85628541,14710888,TN
chr15,Bn62038,64252135,86621898,22369763,RLK
chr15,Bn62039,31083189,72151021,41067832,RLK
chr15,Bn62040,41654494,98423623,56769129,CN
chr15,Bn62041,89922168,97933861,8011693,TNL
chr15,Bn62042,60833173,93585821,32752648,RLP
chr15,Bn62043,69933216,85530281,15597065,RLP
chr15,Bn62044,13164547,38649702,25485155,CN
chr15,Bn62045,62048472,69701060,7652588,RLP
chr15,Bn62046,76252442,88732515,12480073,TNL
chr15,Bn62047,29509140,65484818,35975678,RLP
chr15,Bn62048,28239004,71963463,43724459,TN
chr15,Bn62049,40458821,98163831,57705010,RLP
chr15,Bn62050,67477121,93887414,26410293,RLK
chr15,Bn62051,2784535,76567498,73782963,RLK
chr15,Bn62052,88379539,97255304,8875765,TN
chr15,Bn62053,44219188,77530716,33311528,NBS
chr15,Bn62054,62545304,97064647,34519343,RLP
chr15,Bn62055,85582205,92072506,6490301,RLP
chr15,Bn62056,61759212,88703757,26944545,TNL
chr15,Bn62057,18070410,31705963,13635553,CNL
chr15,Bn62058,16239959,91751406,75511447,CN
chr15,Bn62059,28004006,47470428,19466422,RLK
chr15,Bn62060,82183819,86973201,4789382,RLP
chr15,Bn62061,89175834,92143816,2967982,CNL
chr15,Bn62062,83977104,95080759,11103655,CNL
chr15,Bn62063,42713518,93754118,51040600,CNL
chr15,Bn62064,43618510,62227317,18608807,NBS
chr15,Bn62065,33426082,55005138,21579056,RLP
chr15,Bn62066,35745520,52296462,16550942,RLK
chr15,Bn62067,29287911,30464275,1176364,TNL
chr15,Bn62068,1459917,78070507,76610590,RLK
chr15,Bn62069,53464823,86912305,33447482,TNL
chr15,Bn62070,87724443,90587384,2862941,RLP
chr15,Bn62071,94564849,95496777,931928,TN
chr15,Bn62072,61273869,71720961,10447092,CN
chr15,Bn62073,84098004,84212481,114477,TN
chr15,Bn62074,65173813,76969246,11795433,RLP
chr15,Bn62075,13236992,90341048,77104056,RLP
chr15,Bn62076,46378777,99002917,52624140,NBS
chr15,Bn62077,97088548,97935267,846719,RLK
chr15,Bn62078,55911876,99262189,43350313,CNL
chr15,Bn62079,95387742,97950957,2563215,RLK
chr15,Bn62080,45317977,70898572,25580595,RLK
chr15,Bn62081,59614613,78329572,18714959,CN
chr15,Bn62082,24513066,96034396,71521330,CN
chr15,Bn62083,1631204,79566023,77934819,RLP
chr15,Bn62084,26507216,28033852,1526636,RLP
chr15,Bn62085,80067962,91601964,11534002,CN
chr15,Bn62086,99668679,99769021,100342,NBS
chr15,Bn62087,37623494,96280870,58657376,CNL
chr15,Bn62088,56155809,60708996,4553187,CNL
chr15,Bn62089,60343005,67443093,7100088,RLK
chr15,Bn62090,83511650,96892054,13380404,RLP
chr15,Bn62091,93224502,94866974,1642472,RLK
chr15,Bn62092,48185590,83171444,34985854,TN
chr15,Bn62093,47889125,91511386,43622261,RLP
chr15,Bn62094,76952322,88424254,11471932,NBS
chr15,Bn62095,66016139,76348371,10332232,TN
chr15,Bn62096,86582774,93440788,6858014,TNL
chr15,Bn62097,70222586,76352693,6130107,CN
chr15,Bn62098,57197175,62749917,5552742,CNL
chr15,Bn62099,83297930,84284478,986548,NBS
chr15,Bn62100,37097865,43113176,6015311,NBS
chr15,Bn62101,79784752,88193659,8408907,RLK
chr15,Bn62102,6869781,41685210,34815429,TNL
chr15,Bn62103,6102787,47461529,41358742,TNL
chr15,Bn62104,36018365,40218120,4199755,NBS
chr15,Bn62105,72854165,86678763,13824598,TNL
chr15,Bn62106,62632417,85997114,23364697,TN
chr15,Bn62107,34997820,37052981,2055161,TNL
chr15,Bn62108,85391061,86877977,1486916,RLP
chr15,Bn62109,18021592,61090320,43068728,TN
chr15,Bn62110,9542676,71193335,61650659,CNL
chr15,Bn62111,30226456,37585707,7359251,CNL
chr15,Bn62112,28266900,78547610,50280710,CN
chr15,Bn62113,77067678,81909847,4842169,CNL
chr15,Bn62114,27666114,51210072,23543958,TNL
chr15,Bn62115,83449964,85201227,1751263,NBS
chr15,Bn62116,18659612,81769206,63109594,CN
chr15,Bn62117,98988817,99495567,506750,RLP
chr15,Bn62118,20044138,99869012,79824874,CN
chr15,Bn62119,78127958,81774960,3647002,RLP
chr15,Bn62120,92260984,94835145,2574161,CNL
chr15,Bn62121,78812259,81160979,2348720,CN
chr15,Bn62122,35324138,83356861,48032723,RLK
chr15,Bn62123,57120394,91758062,34637668,RLK
chr15,Bn62124,68188954,68729296,540342,CNL
chr15,Bn62125,85017084,93451288,8434204,TN
chr15,Bn62126,46660531,81204342,34543811,CNL
chr15,Bn62127,7291390,87761332,80469942,CN
chr15,Bn62128,78907661,98223384,19315723,CNL
chr15,Bn62129,31301503,84352540,53051037,NBS
chr15,Bn62130,50511575,88683462,38171887,CNL
chr15,Bn62131,2804445,88494009,85689564,CNL
chr15,Bn62132,45624896,82988928,37364032,CN
chr15,Bn62133,21556294,89295653,67739359,RLK
chr15,Bn62134,49500527,82786489,33285962,TNL
chr15,Bn62135,93939365,99727870,5788505,CN
chr15,Bn62136,53147349,65934513,12787164,CNL
chr15,Bn62137,75945658,90111393,14165735,CNL
chr15,Bn62138,93830932,97243609,3412677,TNL
chr15,Bn62139,13531118,76120913,62589795,RLK
chr15,Bn62140,18886884,41620911,22734027,CN
chr15,Bn62141,13048249,98840199,85791950,NBS
chr15,Bn62142,74211851,95863918,21652067,RLP
chr15,Bn62143,38629152,81295661,42666509,NBS
chr15,Bn62144,49360079,78644734,29284655,NBS
chr15,Bn62145,33153947,65494211,32340264,CN
chr15,Bn62146,89432708,93758089,4325381,TN
chr15,Bn62147,81590361,86762435,5172074,CN
chr15,Bn62148,20686191,85381211,64695020,CNL
chr15,Bn62149,11956168,16986483,5030315,RLK
chr15,Bn62150,67504814,72787620,5282806,RLK
chr15,Bn62151,68010850,68835197,824347,RLK
chr15,Bn62152,61651405,71518301,9866896,CN
chr15,Bn62153,45230927,70789144,25558217,RLK
chr15,Bn62154,6714170,61442707,54728537,CN
chr15,Bn62155,4423563,16288145,11864582,RLK
chr15,Bn62156,82459836,84788311,2328475,CNL
chr15,Bn62157,60890581,80617659,19727078,RLP
chr15,Bn62158,2876387,40204493,37328106,TN
chr15,Bn62159,39508254,57263334,17755080,NBS
chr15,Bn62160,92729139,98100603,5371464,TN
chr15,Bn62161,1266670,90187526,88920856,TN
chr15,Bn62162,7470626,91559137,84088511,TN
chr15,Bn62163,31959271,53949078,21989807,RLK
chr15,Bn62164,61271307,75086517,13815210,NBS
chr15,Bn62165,27418692,53105116,25686424,CNL
chr15,Bn62166,21552806,33384965,11832159,CNL
chr15,Bn62167,37777848,50797797,13019949,RLP
chr15,Bn62168,38186784,76245629,38058845,NBS
chr15,Bn62169,56982975,96427690,39444715,RLP
chr15,Bn62170,34572883,76910972,42338089,RLK
chr15,Bn62171,91249669,97862949,6613280,CN
chr15,Bn62172,62080139,93848209,31768070,TNL
chr15,Bn62173,38314525,87776253,49461728,RLK
chr15,Bn62174,7371731,55860339,48488608,NBS
chr15,Bn62175,89281485,99682853,10401368,NBS
chr15,Bn62176,86878658,99577540,12698882,CNL
chr15,Bn62177,84676827,91047695,6370868,TNL
chr15,Bn62178,93441649,95068318,1626669,CN
chr15,Bn62179,34827936,56471809,21643873,CNL
chr15,Bn62180,34477771,92942677,58464906,NBS
chr15,Bn62181,42040138,58857908,16817770,RLP
chr15,Bn62182,8242470,28138742,19896272,CN
chr15,Bn62183,36758954,76011184,39252230,TNL
chr15,Bn62184,53546997,87374460,33827463,RLP
chr15,Bn62185,11756763,73629364,61872601,TNL
chr15,Bn62186,50544250,68881770,18337520,CN
chr15,Bn62187,34890169,71583220,36693051,CN
chr15,Bn62188,72604271,96847039,24242768,TNL
chr15,Bn62189,47285799,71220713,23934914,TN
chr15,Bn62190,59858739,94243395,34384656,CN
chr15,Bn62191,10976338,40792808,29816470,RLP
chr15,Bn62192,80965061,81286328,321267,CN
chr15,Bn62193,6574576,75162162,68587586,RLK
chr15,Bn62194,40534044,52885035,12350991,RLP
chr15,Bn62195,56878654,82937870,26059216,TN
chr15,Bn62196,82632572,89763001,7130429,CNL
chr15,Bn62197,26459129,59966359,33507230,CN
chr15,Bn62198,99990972,99999976,9004,CNL
chr15,Bn62199,36989663,81612796,44623133,CN
chr15,Bn62200,40503852,96279341,55775489,TN
chr15,Bn62201,27116747,33698611,6581864,TN
chr15,Bn62202,53154463,85679144,32524681,RLK
chr15,Bn62203,25805170,62685037,36879867,TNL
chr15,Bn62204,8447769,32990935,24543166,TN
chr15,Bn62205,47309326,52227147,4917821,CNL
chr15,Bn62206,67155418,83879752,16724334,TN
chr15,Bn62207,93476998,96089153,2612155,RLK
chr15,Bn62208,2558731,96741825,94183094,CN
chr15,Bn62209,77717734,93641431,15923697,NBS
chr15,Bn62210,77105677,94963496,17857819,RLP
chr15,Bn62211,52165571,76772427,24606856,RLK
chr15,Bn62212,75524644,83701129,8176485,CNL
chr15,Bn62213,44209387,64725579,20516192,CN
chr15,Bn62214,49583797,93837627,44253830,TN
chr15,Bn62215,6300441,47321360,41020919,TNL
chr15,Bn62216,32576735,72369584,39792849,CN
chr15,Bn62217,85266961,90153674,4886713,RLP
chr15,Bn62218,86848485,99237662,12389177,TN
chr15,Bn62219,37363746,99638075,62274329,CN
chr15,Bn62220,70989843,71261575,271732,CNL
chr15,Bn62221,15318424,77448028,62129604,CN
chr15,Bn62222,47675417,83283859,35608442,CN
chr15,Bn62223,69988920,90661619,20672699,TN
chr15,Bn62224,66718260,91316699,24598439,TN
chr15,Bn62225,97206165,98279592,1073427,TN
chr15,Bn62226,48332544,53131547,4799003,TNL
chr15,Bn62227,23024476,82064976,59040500,CN
chr15,Bn62228,10884124,57409069,46524945,RLP
chr15,Bn62229,21864226,63424243,41560017,RLP
chr15,Bn62230,47321997,48612213,1290216,CN
chr15,Bn62231,23303418,93489537,70186119,CNL
chr15,Bn62232,40237845,61328176,21090331,TNL
chr15,Bn62233,34013101,76607382,42594281,NBS
chr15,Bn62234,27971803,65438487,37466684,TN
chr15,Bn62235,32711601,62071929,29360328,RLP
chr15,Bn62236,51551584,56740914,5189330,CN
chr15,Bn62237,42551727,59394024,16842297,TNL
chr15,Bn62238,62103380,64743162,2639782,RLP
chr15,Bn62239,33444127,73009720,39565593,RLK
chr15,Bn62240,14044326,38343049,24298723,CN
chr15,Bn62241,4934410,29944509,25010099,CN
chr15,Bn62242,38479615,46670179,8190564,CN
chr15,Bn62243,11545411,99088483,87543072,RLK
chr15,Bn62244,37988689,67824740,29836051,RLP
chr15,Bn62245,12686560,53738492,41051932,RLP
chr15,Bn62246,33158132,53809676,20651544,RLK
chr15,Bn62247,45559700,68505727,22946027,CNL
chr15,Bn62248,74450886,78368473,3917587,TNL
chr15,Bn62249,9260292,56403570,47143278,RLP
chr15,Bn62250,27762114,39122147,11360033,RLP
chr15,Bn62251,72893301,86216156,13322855,TN
chr15,Bn62252,49191511,53307757,4116246,RLK
chr15,Bn62253,90378601,97541091,7162490,TNL
chr15,Bn62254,48360345,74119671,25759326,TNL
chr15,Bn62255,92543475,98648131,6104656,RLK
chr15,Bn62256,67004945,99460216,32455271,NBS
chr15,Bn62257,75004899,90677151,15672252,TN
chr15,Bn62258,34902524,56200944,21298420,RLP
chr15,Bn62259,68796232,93463292,24667060,NBS
chr15,Bn62260,67223060,71713776,4490716,TNL
chr15,Bn62261,12635972,31653915,19017943,NBS
chr15,Bn62262,5223857,81689305,76465448,TNL
chr15,Bn62263,89186950,90762398,1575448,CNL
chr15,Bn62264,71667117,87023504,15356387,TNL
chr15,Bn62265,44133121,91580129,47447008,TN
chr15,Bn62266,40794390,68894863,28100473,TNL
chr15,Bn62267,22073019,94440926,72367907,CNL
chr15,Bn62268,62973454,74920128,11946674,NBS
chr15,Bn62269,63564293,75717026,12152733,CNL
chr15,Bn62270,55076976,94834032,39757056,CNL
chr15,Bn62271,99571557,99935410,363853,TN
chr15,Bn62272,70548671,83355458,12806787,RLP
chr15,Bn62273,7593532,11753314,4159782,TN
chr15,Bn62274,85036666,98644981,13608315,CNL
chr15,Bn62275,27453708,70624122,43170414,CNL
chr15,Bn62276,23986880,41967771,17980891,RLP
chr15,Bn62277,17444674,41607979,24163305,CN
chr15,Bn62278,51396360,92773779,41377419,TNL
chr15,Bn62279,17066067,20129753,3063686,RLK
chr15,Bn62280,87041526,97626990,10585464,CNL
chr15,Bn62281,30257116,72689513,42432397,TN
chr15,Bn62282,27607365,27937322,329957,RLK
chr15,Bn62283,76009869,94738511,18728642,RLK
chr15,Bn62284,87038824,89716153,2677329,CNL
chr15,Bn62285,7394341,85491538,78097197,TNL
chr15,Bn62286,87177072,91341439,4164367,TN
chr15,Bn62287,61576213,64447410,2871197,TNL
chr15,Bn62288,72663287,88937763,16274476,RLP
chr15,Bn62289,57836203,70283261,12447058,RLP
chr15,Bn62290,91557643,93216776,1659133,RLK
chr15,Bn62291,37934417,45329313,7394896,CN
chr15,Bn62292,27975805,30678686,2702881,RLP
chr15,Bn62293,89657755,93932938,4275183,CN
chr15,Bn62294,97540196,97891779,351583,TN
chr15,Bn62295,72219502,95016283,22796781,TN
chr15,Bn62296,79506393,80719259,1212866,TNL
chr15,Bn62297,82580181,83928416,1348235,CNL
chr15,Bn62298,18056158,54992399,36936241,NBS
chr15,Bn62299,46697742,86412765,39715023,RLP
chr15,Bn62300,7019710,85354033,78334323,TN
chr15,Bn62301,48927193,54053354,5126161,TNL
chr15,Bn62302,60423646,94542335,34118689,TNL
chr15,Bn62303,76226627,97442208,21215581,NBS
chr15,Bn62304,36072421,82703682,46631261,CN
chr15,Bn62305,50217338,51871740,1654402,NBS
chr15,Bn62306,9275550,43833725,34558175,NBS
chr15,Bn62307,63229746,69595562,6365816,TN
chr15,Bn62308,69818606,80818347,10999741,RLK
chr15,Bn62309,74348314,75275598,927284,CNL
chr15,Bn62310,10068295,60019032,49950737,CN
chr15,Bn62311,10919360,57462111,46542751,NBS
chr15,Bn62312,16124871,83308244,67183373,CN
chr15,Bn62313,81224508,82505245,1280737,TNL
chr15,Bn62314,4957534,15848346,10890812,TN
chr15,Bn62315,44835890,50062832,5226942,RLK
chr15,Bn62316,59320596,64015270,4694674,RLP
chr15,Bn62317,98012572,98366723,354151,TN
chr15,Bn62318,49741123,60189147,10448024,RLP
chr15,Bn62319,51179450,70472652,19293202,TN
chr15,Bn62320,91922307,96775065,4852758,CNL
chr15,Bn62321,39344245,67697398,28353153,TNL
chr15,Bn62322,14709702,87018567,72308865,RLK
chr15,Bn62323,34288480,61943875,27655395,CNL
chr15,Bn62324,73837110,88575828,14738718,TN
chr15,Bn62325,72761003,81811789,9050786,CNL
chr15,Bn62326,27421874,29448098,2026224,CNL
chr15,Bn62327,7686209,37752785,30066576,RLK
chr15,Bn62328,63043345,97435416,34392071,RLK
chr15,Bn62329,55100143,99307270,44207127,NBS
chr15,Bn62330,79638459,99837878,20199419,RLK
chr15,Bn62331,38437876,72726716,34288840,RLP
chr15,Bn62332,36029222,76940325,40911103,RLP
chr15,Bn62333,45065318,54046631,8981313,CN
chr15,Bn62334,39868380,92612893,52744513,RLP
chr15,Bn62335,40949391,88529227,47579836,CNL
chr15,Bn62336,57573199,96654497,39081298,TNL
chr15,Bn62337,71240689,80120969,8880280,TN
chr15,Bn62338,55991984,86901765,30909781,RLK
chr15,Bn62339,63757593,94777999,31020406,TN
chr15,Bn62340,49010095,57002178,7992083,RLP
chr15,Bn62341,15568105,98057490,82489385,NBS
chr15,Bn62342,98292489,98905599,613110,TN
chr15,Bn62343,63290135,83955196,20665061,NBS
chr15,Bn62344,37568673,96408163,58839490,NBS
chr15,Bn62345,97640934,98079648,438714,CN
chr15,Bn62346,83259870,91762521,8502651,RLK
chr15,Bn62347,58099668,96812077,38712409,NBS
chr15,Bn62348,86293823,97211271,10917448,TNL
chr15,Bn62349,85470899,88515331,3044432,CN
chr15,Bn62350,10610859,15954707,5343848,NBS
chr15,Bn62351,79320357,79927487,607130,CNL
chr15,Bn62352,55460599,99975751,44515152,NBS
chr15,Bn62353,66105509,90599205,24493696,RLP
chr15,Bn62354,40094341,82329209,42234868,TN
chr15,Bn62355,79676154,99970414,20294260,RLK
chr15,Bn62356,37850982,40498196,2647214,RLP
chr15,Bn62357,76595669,99436669,22841000,TNL
chr15,Bn62358,89769845,90711090,941245,TN
chr15,Bn62359,60436115,99885717,39449602,TNL
chr15,Bn62360,38338474,96526974,58188500,CNL
chr15,Bn62361,69338731,97528595,28189864,RLK
chr15,Bn62362,6862164,96572785,89710621,CNL
chr15,Bn62363,17082130,70273803,53191673,CNL
chr15,Bn62364,38168649,96029928,57861279,TNL
chr15,Bn62365,12930349,83243672,70313323,CNL
chr15,Bn62366,54055286,71424616,17369330,TN
chr15,Bn62367,85902274,94719229,8816955,CNL
chr15,Bn62368,9694351,48418064,38723713,TN
chr15,Bn62369,21422979,45261142,23838163,RLK
chr15,Bn62370,15167021,85743061,70576040,TN
chr15,Bn62371,66671880,69997814,3325934,TNL
chr15,Bn62372,78674615,82998091,4323476,RLK
chr15,Bn62373,74283164,90451277,16168113,TNL
chr15,Bn62374,29011312,84310494,55299182,CNL
chr15,Bn62375,7509651,16215038,8705387,CN
chr15,Bn62376,28631297,92252246,63620949,TNL
chr15,Bn62377,46673940,61467525,14793585,TNL
chr15,Bn62378,56406887,75012545,18605658,TN
chr15,Bn62379,13366471,67002270,53635799,RLK
chr15,Bn62380,59328385,81851437,22523052,TN
chr15,Bn62381,12166163,67029766,54863603,TNL
chr15,Bn62382,5645746,48513503,42867757,RLP
chr15,Bn62383,4057152,95250584,91193432,TN
chr15,Bn62384,84972824,96531317,11558493,CNL
chr15,Bn62385,4598432,70166198,65567766,CNL
chr15,Bn62386,83183344,85501803,2318459,RLK
chr15,Bn62387,37771241,96474770,58703529,CN
chr15,Bn62388,60975274,66088271,5112997,CNL
chr15,Bn62389,24529982,28002206,3472224,RLP
chr15,Bn62390,66948996,96356233,29407237,CN
chr15,Bn62391,53086466,61446003,8359537,NBS
chr15,Bn62392,79186389,98264148,19077759,CN
chr15,Bn62393,76282783,94772619,18489836,CN
chr15,Bn62394,27529899,42022656,14492757,NBS
chr15,Bn62395,7004881,55434752,48429871,NBS
chr15,Bn62396,5155493,64646157,59490664,NBS
chr15,Bn62397,3281697,72154185,68872488,TN
chr15,Bn62398,54644550,72164939,17520389,RLK
chr15,Bn62399,49132181,83528875,34396694,RLK
chr15,Bn62400,86725641,96559616,9833975,TN
chr15,Bn62401,52480506,63190097,10709591,NBS
chr15,Bn62402,89577454,92435140,2857686,TNL
chr15,Bn62403,27793172,68406209,40613037,TNL
chr15,Bn62404,11705545,23531574,11826029,RLK
chr15,Bn62405,83079691,86484906,3405215,RLP
chr15,Bn62406,29359536,57938815,28579279,TNL
chr15,Bn62407,27395296,94704819,67309523,RLP
chr15,Bn62408,10892103,90140817,79248714,NBS
chr15,Bn62409,74076703,96796750,22720047,TN
chr15,Bn62410,45430841,60619447,15188606,NBS
chr15,Bn62411,76635555,88253366,11617811,TNL
chr15,Bn62412,17535269,20443101,2907832,TNL
chr15,Bn62413,72151928,76055460,3903532,CNL
chr15,Bn62414,10307866,47405345,37097479,TN
chr15,Bn62415,86655410,97442067,10786657,NBS
chr15,Bn62416,12623229,80549646,67926417,NBS
chr15,Bn62417,94017365,99739601,5722236,NBS
chr15,Bn62418,71143596,79365637,8222041,TNL
chr15,Bn62419,46332425,87352454,41020029,RLK
chr15,Bn62420,25685041,67337029,41651988,RLK
chr15,Bn62421,34592821,93582897,58990076,RLK
chr15,Bn62422,32129218,33301869,1172651,TNL
chr15,Bn62423,97774402,99280326,1505924,RLK
chr15,Bn62424,4867750,65485160,60617410,RLP
chr15,Bn62425,55306962,63576095,8269133,CNL
chr15,Bn62426,93704736,95744586,2039850,RLP
chr15,Bn62427,21993347,82196917,60203570,RLP
chr15,Bn62428,2790854,71063280,68272426,RLP
chr15,Bn62429,27553519,57793995,30240476,CNL
chr15,Bn62430,66748013,93210897,26462884,TNL
chr15,Bn62431,58093508,69652944,11559436,CNL
chr15,Bn62432,94249117,95754087,1504970,CNL
chr15,Bn62433,59605663,99998345,40392682,RLK
chr15,Bn62434,50128299,81661130,31532831,NBS
chr15,Bn62435,51527247,79874667,28347420,RLP
chr15,Bn62436,53397857,57645884,4248027,NBS
chr15,Bn62437,77330506,84601385,7270879,RLP
chr15,Bn62438,38606104,40991030,2384926,CNL
chr15,Bn62439,36247857,69268555,33020698,CN
chr15,Bn62440,42285356,54506114,12220758,TN
chr15,Bn62441,47479349,98588080,51108731,CNL
chr15,Bn62442,36000340,95210856,59210516,TN
chr15,Bn62443,62468709,77333758,14865049,CNL
chr15,Bn62444,74006267,91739110,17732843,RLP
chr15,Bn62445,61729449,78159528,16430079,RLP
chr15,Bn62446,25231883,65636201,40404318,NBS
chr15,Bn62447,58395601,96095154,37699553,TN
chr15,Bn62448,22302269,90073440,67771171,CNL
chr15,Bn62449,38030053,88099394,50069341,TNL
chr15,Bn62450,21362977,27796704,6433727,NBS
chr15,Bn62451,21017645,49604946,28587301,NBS
chr15,Bn62452,72277112,89033817,16756705,CN
chr15,Bn62453,78266099,88285564,10019465,RLP
chr15,Bn62454,71425180,95168551,23743371,CN
chr15,Bn62455,50216053,56784589,6568536,TNL
chr15,Bn62456,42433744,82550053,40116309,RLK
chr15,Bn62457,71479248,84114378,12635130,TN
chr15,Bn62458,9540952,74640354,65099402,TN
chr15,Bn62459,47701131,74126686,26425555,NBS
chr15,Bn62460,25959525,99331088,73371563,RLK
chr15,Bn62461,58556795,85011254,26454459,RLK
chr15,Bn62462,39748713,77775999,38027286,NBS
chr15,Bn62463,74180677,97871942,23691265,RLK
chr15,Bn62464,76192209,97819108,21626899,NBS
chr15,Bn62465,13282641,70540426,57257785,TNL
chr15,Bn62466,73474913,89653617,16178704,RLK
chr15,Bn62467,16264867,75521560,59256693,NBS
chr15,Bn62468,55086307,90567217,35480910,CN
chr15,Bn62469,17883220,27107794,9224574,RLK
chr15,Bn62470,17417906,46254231,28836325,TN
chr15,Bn62471,39849978,70949655,31099677,TN
chr15,Bn62472,56383999,90362643,33978644,CNL
chr15,Bn62473,33926630,37961764,4035134,NBS
chr15,Bn62474,35356389,63663956,28307567,TNL
chr15,Bn62475,60083334,80734904,20651570,NBS
chr15,Bn62476,8137038,25088779,16951741,RLP
chr15,Bn62477,54534502,94175017,39640515,CN
chr15,Bn62478,33890046,84361222,50471176,CNL
chr15,Bn62479,55370666,86797346,31426680,RLK
chr15,Bn62480,21963225,48414091,26450866,TNL
chr15,Bn62481,23423264,76057351,52634087,RLP
chr15,Bn62482,5118841,9175085,4056244,CN
chr15,Bn62483,38138152,83361047,45222895,TNL
chr15,Bn62484,12866220,22344167,9477947,TNL
chr15,Bn62485,43194573,65330813,22136240,TN
chr15,Bn62486,5444113,11498204,6054091,TN
chr15,Bn62487,97093875,97813428,719553,NBS
chr15,Bn62488,30933197,41732180,10798983,RLP
chr15,Bn62489,86389953,90489175,4099222,RLP
chr15,Bn62490,20568433,95796872,75228439,NBS
chr15,Bn62491,24114742,87159337,63044595,TNL
chr15,Bn62492,33336359,50712390,17376031,RLK
chr15,Bn62493,52597262,57076757,4479495,TN
chr15,Bn62494,45447851,87640196,42192345,RLK
chr15,Bn62495,13392282,76899492,63507210,NBS
chr15,Bn62496,57699859,60225332,2525473,NBS
chr15,Bn62497,7524998,26153580,18628582,TNL
chr15,Bn62498,27281122,32037228,4756106,TNL
chr15,Bn62499,27098116,30573552,3475436,NBS
chr15,Bn62500,14182034,34386598,20204564,CNL
chr15,Bn62501,73117309,90123234,17005925,RLK
chr15,Bn62502,84725611,95638450,10912839,TN
chr15,Bn62503,97622988,99900308,2277320,CNL
chr15,Bn62504,4206440,9415337,5208897,RLK
chr15,Bn62505,42707776,56254365,13546589,CN
chr15,Bn62506,24433183,37484702,13051519,RLP
chr15,Bn62507,6819569,74573267,67753698,NBS
chr15,Bn62508,35020776,75375975,40355199,TN
chr15,Bn62509,24379716,99254248,74874532,RLK
chr15,Bn62510,73706709,87518095,13811386,CN
chr15,Bn62511,19558758,74090668,54531910,CN
chr15,Bn62512,31363906,92890482,61526576,TNL
chr15,Bn62513,31409365,83831736,52422371,CN
chr15,Bn62514,81601789,81660159,58370,RLP
chr15,Bn62515,76971254,85778696,8807442,CNL
chr15,Bn62516,69325112,86783446,17458334,CNL
chr15,Bn62517,70899684,91681864,20782180,TNL
chr15,Bn62518,20103554,61287560,41184006,RLP
chr15,Bn62519,60172370,96988474,36816104,TN
chr15,Bn62520,58351322,76715770,18364448,CN
chr15,Bn62521,61422521,91326029,29903508,NBS
chr15,Bn62522,44196161,90428114,46231953,RLK
chr15,Bn62523,45230172,88145990,42915818,TNL
chr15,Bn62524,46819233,83164370,36345137,CN
chr15,Bn62525,55562106,73841426,18279320,TN
chr15,Bn62526,42988259,47835465,4847206,TN
chr15,Bn62527,57437008,97773202,40336194,RLP
chr15,Bn62528,25891378,26577401,686023,CNL
chr15,Bn62529,17615720,28024259,10408539,CN
chr15,Bn62530,61305041,78044050,16739009,RLK
chr15,Bn62531,52576838,91061731,38484893,NBS
chr15,Bn62532,28192578,56029411,27836833,RLK
chr15,Bn62533,43939321,64564282,20624961,CN
chr15,Bn62534,47809824,83837107,36027283,NBS
chr15,Bn62535,65014615,85222252,20207637,RLK
chr15,Bn62536,43471731,70002103,26530372,TNL
chr15,Bn62537,50641080,59185800,8544720,RLK
chr15,Bn62538,18610438,74400623,55790185,RLK
chr15,Bn62539,30735020,38668885,7933865,TN
chr15,Bn62540,67963518,97469014,29505496,CN
chr15,Bn62541,9352354,19041007,9688653,CNL
chr15,Bn62542,40051828,49596559,9544731,TNL
chr15,Bn62543,3061815,65285014,62223199,RLP
chr15,Bn62544,49277658,55737380,6459722,CNL
chr15,Bn62545,83045899,88779638,5733739,TN
chr15,Bn62546,44888158,63683558,18795400,TN
chr15,Bn62547,1629720,11260469,9630749,CNL
chr15,Bn62548,54421000,87546226,33125226,CNL
chr15,Bn62549,9599818,96572568,86972750,RLK
chr15,Bn62550,21043708,53860825,32817117,TN
chr15,Bn62551,70874475,95245454,24370979,NBS
chr15,Bn62552,89516795,97051247,7534452,CNL
chr15,Bn62553,60326438,78991386,18664948,RLK
chr15,Bn62554,44760871,69858558,25097687,NBS
chr15,Bn62555,11108766,34226858,23118092,CNL
chr15,Bn62556,91771709,94125760,2354051,NBS
chr15,Bn62557,85661695,92671280,7009585,TNL
chr15,Bn62558,94616520,97578322,2961802,RLK
chr15,Bn62559,35820868,87601708,51780840,NBS
chr15,Bn62560,2121187,10194022,8072835,RLP
chr15,Bn62561,70409259,89983841,19574582,NBS
chr15,Bn62562,76099050,81130787,5031737,CNL
chr15,Bn62563,60222357,81731283,21508926,RLK
chr15,Bn62564,44919831,95980305,51060474,CNL
chr15,Bn62565,83572535,90059230,6486695,CN
chr15,Bn62566,56332536,68665089,12332553,TN
chr15,Bn62567,54080831,96678684,42597853,CNL
chr15,Bn62568,95041296,95957740,916444,CNL
chr15,Bn62569,55637516,93553625,37916109,CNL
chr15,Bn62570,1354106,66032003,64677897,NBS
chr15,Bn62571,95946217,96827097,880880,CNL
chr15,Bn62572,59502589,90727379,31224790,TNL
chr15,Bn62573,82652952,85030574,2377622,RLP
chr15,Bn62574,13191616,79692767,66501151,RLP
chr15,Bn62575,67245018,87696998,20451980,TN
chr15,Bn62576,81004972,91202015,10197043,TNL
chr15,Bn62577,87463819,99686261,12222442,CNL
chr15,Bn62578,46870723,79590070,32719347,TN
chr15,Bn62579,81206684,93436322,12229638,RLP
chr15,Bn62580,53172218,59338748,6166530,CNL
chr15,Bn62581,44985271,71437203,26451932,RLK
chr15,Bn62582,74657629,85145375,10487746,TNL
chr15,Bn62583,56381882,85412533,29030651,RLK
chr15,Bn62584,87190330,96710102,9519772,TN
chr15,Bn62585,22890207,96087721,73197514,TN
chr15,Bn62586,18258222,86439061,68180839,NBS
chr15,Bn62587,71769049,74057963,2288914,CNL
chr15,Bn62588,93151347,94869875,1718528,RLK
chr15,Bn62589,10707396,88074473,77367077,RLP
chr15,Bn62590,22323030,90549694,68226664,NBS
chr15,Bn62591,65035636,70492657,5457021,TN
chr15,Bn62592,52513278,78541680,26028402,CNL
chr15,Bn62593,62168560,87077145,24908585,TNL
chr15,Bn62594,87305265,88104147,798882,RLP
chr15,Bn62595,43346092,64255603,20909511,NBS
chr15,Bn62596,70503940,73854394,3350454,NBS
chr15,Bn62597,87923769,97972100,10048331,TNL
chr15,Bn62598,69455640,95141201,25685561,RLP
chr15,Bn62599,38219378,98553153,60333775,CNL
chr15,Bn62600,38712788,89613395,50900607,TNL
chr15,Bn62601,68133018,85831197,17698179,RLK
chr15,Bn62602,87031484,98186847,11155363,NBS
chr15,Bn62603,63604156,72683448,9079292,CNL
chr15,Bn62604,67764038,98048170,30284132,RLP
chr15,Bn62605,27416233,52463793,25047560,TN
chr15,Bn62606,72049386,96333849,24284463,TN
chr15,Bn62607,53278861,81289001,28010140,CNL
chr15,Bn62608,23815842,77639997,53824155,CNL
chr15,Bn62609,95423495,97401717,1978222,RLK
chr15,Bn62610,52923880,66437816,13513936,RLP
chr15,Bn62611,41236623,61818889,20582266,RLK
chr15,Bn62612,82078503,82676689,598186,CNL
chr15,Bn62613,26158034,69700428,43542394,CN
chr15,Bn62614,64247857,88782350,24534493,CN
chr15,Bn62615,75978694,81228936,5250242,RLK
chr15,Bn62616,53435323,54883628,1448305,CNL
chr15,Bn62617,14408876,46509422,32100546,TN
chr15,Bn62618,44177693,55106336,10928643,CNL
chr15,Bn62619,9725545,43290685,33565140,TN
chr15,Bn62620,11073269,92756816,81683547,RLP
chr15,Bn62621,85258230,96097899,10839669,RLP
chr15,Bn62622,73434799,77694378,4259579,TN
chr15,Bn62623,68580428,68741345,160917,CNL
chr15,Bn62624,72068829,78684526,6615697,RLP
chr15,Bn62625,89249598,93095110,3845512,CNL
chr15,Bn62626,71114673,77580144,6465471,RLK
chr15,Bn62627,9376564,79354095,69977531,CN
chr15,Bn62628,97116425,97948608,832183,RLK
chr15,Bn62629,77508404,92639287,15130883,TN
chr15,Bn62630,8895016,22192486,13297470,TN
chr15,Bn62631,19513515,64874887,45361372,TN
chr15,Bn62632,55233639,63231522,7997883,RLK
chr15,Bn62633,91344981,95832764,4487783,RLP
chr15,Bn62634,6348587,95983600,89635013,NBS
chr15,Bn62635,6188573,86649533,80460960,RLP
chr15,Bn62636,2042288,63523428,61481140,RLK
chr15,Bn62637,83456303,96983688,13527385,TNL
chr15,Bn62638,87480355,96634090,9153735,NBS
chr15,Bn62639,37013486,61006641,23993155,NBS
chr15,Bn62640,22391068,42191254,19800186,NBS
chr15,Bn62641,2141564,77418549,75276985,CN
chr15,Bn62642,1699725,79334724,77634999,TN
chr15,Bn62643,8155015,59947764,51792749,RLK
chr15,Bn62644,24768296,72847956,48079660,CN
chr15,Bn62645,78033796,84512340,6478544,TN
chr15,Bn62646,33650265,71856695,38206430,TN
chr15,Bn62647,28468999,79371330,50902331,CN
chr15,Bn62648,49685669,88031664,38345995,RLP
chr15,Bn62649,64825338,93378092,28552754,RLP
chr15,Bn62650,87183740,87530267,346527,RLK
chr15,Bn62651,80033566,86344070,6310504,RLP
chr15,Bn62652,55480474,99744247,44263773,TNL
chr15,Bn62653,52530086,93424240,40894154,TNL
chr15,Bn62654,60967501,65324274,4356773,CN
chr15,Bn62655,62453349,71024291,8570942,CNL
chr15,Bn62656,61944585,93219099,31274514,TNL
chr15,Bn62657,1328830,15336636,14007806,TN
chr15,Bn62658,53758814,97999467,44240653,CN
chr15,Bn62659,54231394,73916198,19684804,CN
chr15,Bn62660,19234374,98112998,78878624,NBS
chr15,Bn62661,26800991,53182417,26381426,TNL
chr15,Bn62662,67943429,85450395,17506966,RLK
chr15,Bn62663,48511227,56508775,7997548,TN
chr15,Bn62664,45957596,47992397,2034801,RLP
chr15,Bn62665,69863837,97032723,27168886,CNL
chr15,Bn62666,83376437,93278048,9901611,CN
chr15,Bn62667,31779555,37719687,5940132,TNL
chr15,Bn62668,98012858,99229341,1216483,RLK
chr15,Bn62669,18873918,94437082,75563164,CN
chr15,Bn62670,85776210,96609819,10833609,CN
chr15,Bn62671,60033356,94619108,34585752,RLK
chr15,Bn62672,63070226,85616496,22546270,CN
chr15,Bn62673,98982565,99707789,725224,NBS
chr15,Bn62674,48091848,62772087,14680239,TN
chr15,Bn62675,73730872,90727173,16996301,CNL
chr15,Bn62676,31322148,42749649,11427501,TNL
chr15,Bn62677,80822808,81465887,643079,CNL
chr15,Bn62678,35770700,75204742,39434042,CNL
chr15,Bn62679,73328204,79144772,5816568,CNL
chr15,Bn62680,91168963,99155561,7986598,TN
chr15,Bn62681,19769547,58527125,38757578,NBS
chr15,Bn62682,11607067,80907996,69300929,TN
chr15,Bn62683,5937508,41477534,35540026,CNL
chr15,Bn62684,58684293,87976925,29292632,TNL
chr15,Bn62685,6497465,60932254,54434789,TN
chr15,Bn62686,23753512,59866050,36112538,TN
chr15,Bn62687,42275977,57382431,15106454,RLP
chr15,Bn62688,83712222,96003734,12291512,RLK
chr15,Bn62689,29601360,39003653,9402293,TNL
chr15,Bn62690,89118911,95323211,6204300,CNL
chr15,Bn62691,31352673,87041175,55688502,CNL
chr15,Bn62692,29359335,55036077,25676742,CNL
chr15,Bn62693,9148899,21166657,12017758,CN
chr15,Bn62694,88052281,96054003,8001722,RLP
chr15,Bn62695,33790727,39856519,6065792,NBS
chr15,Bn62696,84763237,96476480,11713243,TNL
chr15,Bn62697,67693691,85917090,18223399,NBS
chr15,Bn62698,72019875,95295065,23275190,TNL
chr15,Bn62699,17343677,98762503,81418826,TNL
chr15,Bn62700,9509492,65443411,55933919,CNL
chr15,Bn62701,20769537,74564493,53794956,CNL
chr15,Bn62702,61059787,98269379,37209592,RLP
chr15,Bn62703,34582678,40171687,5589009,CN
chr15,Bn62704,19937597,30855400,10917803,CN
chr15,Bn62705,68272781,75390308,7117527,CNL
chr15,Bn62706,24088242,66230718,42142476,TN
chr15,Bn62707,57106034,81552628,24446594,TN
chr15,Bn62708,45870346,84454878,38584532,RLP
chr15,Bn62709,12475966,87547529,75071563,TNL
chr15,Bn62710,61510305,88304051,26793746,RLK
chr15,Bn62711,56932560,98128726,41196166,RLP
chr15,Bn62712,35906388,83478301,47571913,RLP
chr15,Bn62713,25668316,61969184,36300868,RLK
chr15,Bn62714,18946139,24080383,5134244,RLK
chr15,Bn62715,26429670,60016673,33587003,RLP
chr15,Bn62716,39190750,41982649,2791899,RLP
chr15,Bn62717,86780011,87929342,1149331,CNL
chr15,Bn62718,21800456,64569598,42769142,TNL
chr15,Bn62719,75347556,89088690,13741134,CN
chr15,Bn62720,3628113,26116673,22488560,CN
chr15,Bn62721,40427689,99086744,58659055,TNL
chr15,Bn62722,7644952,51741507,44096555,RLK
chr15,Bn62723,25695199,70454725,44759526,TN
chr15,Bn62724,72332334,99752042,27419708,NBS
chr15,Bn62725,28259012,84466453,56207441,NBS
chr15,Bn62726,56136501,73323917,17187416,CNL
chr15,Bn62727,82829947,83123490,293543,CN
chr15,Bn62728,91371769,95091193,3719424,CN
chr15,Bn62729,68495771,76610613,8114842,RLP
chr15,Bn62730,38498523,55069051,16570528,RLK
chr15,Bn62731,77291092,86278371,8987279,CN
chr15,Bn62732,46099320,56860622,10761302,CNL
chr15,Bn62733,75990472,98599552,22609080,NBS
chr15,Bn62734,89854310,99680558,9826248,TNL
chr15,Bn62735,71006472,90903486,19897014,CN
chr15,Bn62736,45035806,80903601,35867795,TN
chr15,Bn62737,62904634,95388805,32484171,TNL
chr15,Bn62738,20781105,80292346,59511241,TNL
chr15,Bn62739,35829352,41580061,5750709,TNL
chr15,Bn62740,6037403,92788168,86750765,NBS
chr15,Bn62741,88655323,94509882,5854559,TNL
chr15,Bn62742,41708963,94839981,53131018,RLK
chr15,Bn62743,74998232,89439449,14441217,NBS
chr15,Bn62744,45566341,85113728,39547387,RLK
chr15,Bn62745,13449586,46867184,33417598,CN
chr15,Bn62746,81107886,95646675,14538789,CN
chr15,Bn62747,59087302,82276669,23189367,TN
chr15,Bn62748,89112799,98161435,9048636,TN
chr15,Bn62749,56848617,93128827,36280210,TNL
chr15,Bn62750,29015663,96465391,67449728,TNL
chr15,Bn62751,62415032,63548419,1133387,TN
chr15,Bn62752,19173465,36716944,17543479,CN
chr15,Bn62753,39003736,97070866,58067130,RLK
chr15,Bn62754,65282403,90919079,25636676,TNL
chr15,Bn62755,91429174,94217514,2788340,TNL
chr15,Bn62756,23965339,33364373,9399034,RLP
chr15,Bn62757,14764114,97517993,82753879,RLK
chr15,Bn62758,33451551,88053312,54601761,CN
chr15,Bn62759,93782061,96336712,2554651,CN
chr15,Bn62760,30582796,62936048,32353252,RLK
chr15,Bn62761,97335041,99663792,2328751,RLK
chr15,Bn62762,28316639,37296341,8979702,NBS
chr15,Bn62763,31425702,65304633,33878931,RLP
chr15,Bn62764,17228567,55139287,37910720,TNL
chr15,Bn62765,81760126,93211952,11451826,RLK
chr15,Bn62766,37173761,51963920,14790159,NBS
chr15,Bn62767,92285308,96048460,3763152,CN
chr15,Bn62768,66622324,68677858,2055534,CNL
chr15,Bn62769,84241129,98058063,13816934,CN
chr15,Bn62770,83728917,85659944,1931027,RLP
chr15,Bn62771,67002442,77016670,10014228,CNL
chr15,Bn62772,75784141,83743158,7959017,RLP
chr15,Bn62773,16573849,73567728,56993879,CN
chr15,Bn62774,63739704,95975565,32235861,RLP
chr15,Bn62775,32611927,40212804,7600877,TNL
chr15,Bn62776,38627425,88818658,50191233,RLK
chr15,Bn62777,60552168,86034275,25482107,RLP
chr15,Bn62778,51883876,57387506,5503630,TNL
chr15,Bn62779,57634394,67035841,9401447,TN
chr15,Bn62780,82112258,96762053,14649795,CNL
chr15,Bn62781,76041563,92449643,16408080,RLP
chr15,Bn62782,66291614,69494783,3203169,RLP
chr15,Bn62783,67970966,75607515,7636549,RLP
chr15,Bn62784,44275509,53800143,9524634,CNL
chr15,Bn62785,83965743,89465399,5499656,CN
chr15,Bn62786,5288291,18607294,13319003,RLP
chr15,Bn62787,83205631,97186881,13981250,TN
chr15,Bn62788,99074179,99086858,12679,NBS
chr15,Bn62789,95376753,98716270,3339517,NBS
chr15,Bn62790,37204785,83062518,45857733,CNL
chr15,Bn62791,77573998,95632630,18058632,TNL
chr15,Bn62792,82358876,90935404,8576528,RLP
chr15,Bn62793,71161456,84209496,13048040,RLP
chr15,Bn62794,27882498,81719297,53836799,RLK
chr15,Bn62795,68651999,80058084,11406085,TNL
chr15,Bn62796,6295962,83264923,76968961,RLK
chr15,Bn62797,72976769,74468749,1491980,TN
chr15,Bn62798,21419504,56519326,35099822,CN
chr15,Bn62799,7668442,18386152,10717710,CN
chr15,Bn62800,55982800,58706176,2723376,RLK
chr15,Bn62801,65011473,90222387,25210914,RLK
chr15,Bn62802,12915751,29201966,16286215,TNL
chr15,Bn62803,78861866,82033527,3171661,RLK
chr15,Bn62804,71938384,74305684,2367300,CNL
chr15,Bn62805,2525748,82550225,80024477,TNL
chr15,Bn62806,42817835,75596413,32778578,RLK
chr15,Bn62807,48148486,89850314,41701828,TN
chr15,Bn62808,39322071,82683945,43361874,TN
chr15,Bn62809,88561845,94566593,6004748,TNL
chr15,Bn62810,15210997,24037641,8826644,NBS
chr15,Bn62811,69525829,94590313,25064484,NBS
chr15,Bn62812,11635268,84630727,72995459,RLK
chr15,Bn62813,88738109,98900955,10162846,RLP
chr15,Bn62814,77255694,84749061,7493367,TN
chr15,Bn62815,16477776,28761906,12284130,RLP
chr15,Bn62816,26237394,95717500,69480106,RLP
chr15,Bn62817,28817447,81544001,52726554,RLK
chr15,Bn62818,25988014,60873767,34885753,RLK
chr15,Bn62819,74952375,78184355,3231980,RLK
chr15,Bn62820,24928733,97546718,72617985,CN
chr15,Bn62821,88217370,90291901,2074531,RLK
chr15,Bn62822,21317550,61579630,40262080,RLK
chr15,Bn62823,55306471,86240550,30934079,TN
chr15,Bn62824,48314549,56521851,8207302,CNL
chr15,Bn62825,48013795,97337783,49323988,CN
chr15,Bn62826,30812943,39961325,9148382,CNL
chr15,Bn62827,29664836,39586761,9921925,TN
chr15,Bn62828,2028122,90036148,88008026,NBS
chr15,Bn62829,2624387,11201193,8576806,TN
chr15,Bn62830,94028992,97713329,3684337,CN
chr15,Bn62831,91381596,92089379,707783,TN
chr15,Bn62832,93947072,97322416,3375344,RLP
chr15,Bn62833,86463972,93582982,7119010,RLK
chr15,Bn62834,3472451,48705458,45233007,CN
chr15,Bn62835,1775167,78619041,76843874,CNL
chr15,Bn62836,14325828,87696841,73371013,RLP
chr15,Bn62837,74994385,92473866,17479481,CNL
chr15,Bn62838,9638068,23988162,14350094,NBS
chr15,Bn62839,16517022,18097197,1580175,CN
chr15,Bn62840,57224039,95359427,38135388,NBS
chr15,Bn62841,84057714,98132441,14074727,RLK
chr15,Bn62842,6334951,46802747,40467796,TN
chr15,Bn62843,68797378,91211341,22413963,RLP
chr15,Bn62844,20915666,46621689,25706023,TNL
chr15,Bn62845,5194083,65915595,60721512,TN
chr15,Bn62846,48460009,79383057,30923048,TNL
chr15,Bn62847,98814403,99979775,1165372,TN
chr15,Bn62848,94823086,95658549,835463,RLK
chr15,Bn62849,65420654,95355606,29934952,CNL
chr15,Bn62850,36623322,80059052,43435730,CNL
chr15,Bn62851,1949065,70744480,68795415,CN
chr15,Bn62852,11665424,61024897,49359473,NBS
chr15,Bn62853,33148181,99061976,65913795,TN
chr15,Bn62854,51819677,76368575,24548898,TN
chr15,Bn62855,31073525,59290587,28217062,RLK
chr15,Bn62856,31264218,39693148,8428930,NBS
chr15,Bn62857,2771574,38887403,36115829,NBS
chr15,Bn62858,62375076,78442307,16067231,CNL
chr15,Bn62859,48074375,71393644,23319269,CNL
chr15,Bn62860,72002045,84184250,12182205,RLP
chr15,Bn62861,33072936,89445315,56372379,CN
chr15,Bn62862,32643371,44165604,11522233,TN
chr15,Bn62863,17044060,31077863,14033803,TN
chr15,Bn62864,99925914,99953879,27965,TN
chr15,Bn62865,40869598,98478089,57608491,TNL
chr15,Bn62866,77458893,93114751,15655858,RLK
chr15,Bn62867,11843759,64248409,52404650,CN
chr15,Bn62868,7495200,37978859,30483659,RLK
chr15,Bn62869,24320299,34795001,10474702,TN
chr15,Bn62870,13391803,54221168,40829365,NBS
chr15,Bn62871,60356655,76751356,16394701,RLP
chr15,Bn62872,36946512,60294102,23347590,RLK
chr15,Bn62873,31426884,87756229,56329345,NBS
chr15,Bn62874,16176297,23370544,7194247,CN
chr15,Bn62875,41944353,42722448,778095,TNL
chr15,Bn62876,53270049,60341119,7071070,RLK
chr15,Bn62877,28753593,30354956,1601363,CN
chr15,Bn62878,69769434,99504399,29734965,CNL
chr15,Bn62879,83067471,99343256,16275785,CNL
chr15,Bn62880,52782075,62720750,9938675,TNL
chr15,Bn62881,89442407,98339315,8896908,CNL
chr15,Bn62882,46445846,86450660,40004814,TNL
chr15,Bn62883,82230738,93154193,10923455,CN
chr15,Bn62884,48732290,49359871,627581,TNL
chr15,Bn62885,23739194,89557972,65818778,TN
chr15,Bn62886,11023072,21031342,10008270,RLK
chr15,Bn62887,31955144,44740853,12785709,TNL
chr15,Bn62888,86952365,91961541,5009176,RLK
chr15,Bn62889,55173746,94922834,39749088,RLP
chr15,Bn62890,80607317,94566361,13959044,CNL
chr15,Bn62891,8769609,89919408,81149799,RLP
chr15,Bn62892,5087423,83050256,77962833,NBS
chr15,Bn62893,78903963,85572146,6668183,RLK
chr15,Bn62894,69781719,70756936,975217,RLK
chr15,Bn62895,95784033,98229819,2445786,CN
chr15,Bn62896,78822612,94843600,16020988,NBS
chr15,Bn62897,61522136,71301610,9779474,TN
chr15,Bn62898,55276841,60703626,5426785,CN
chr15,Bn62899,87274928,91027607,3752679,CN
chr15,Bn62900,79154908,99055198,19900290,TNL
chr15,Bn62901,1281142,33403769,32122627,RLK
chr15,Bn62902,36420179,87680400,51260221,NBS
chr15,Bn62903,14039293,64307074,50267781,TNL
chr15,Bn62904,66939082,78767172,11828090,TNL
chr15,Bn62905,7313309,42057965,34744656,RLP
chr15,Bn62906,78216380,83512605,5296225,RLP
chr15,Bn62907,15112756,36109191,20996435,CN
chr15,Bn62908,68104703,77606771,9502068,RLK
chr15,Bn62909,31143863,76234629,45090766,CN
chr15,Bn62910,88146388,99278846,11132458,TN
chr15,Bn62911,48829392,50062716,1233324,CN
chr15,Bn62912,32405996,97930588,65524592,RLK
chr15,Bn62913,66750901,67102540,351639,TNL
chr15,Bn62914,41328939,96300011,54971072,RLP
chr15,Bn62915,76730424,93470018,16739594,CNL
chr15,Bn62916,65435780,91813005,26377225,RLK
chr15,Bn62917,85698341,92768597,7070256,CN
chr15,Bn62918,67026012,91863423,24837411,CN
chr15,Bn62919,93149363,98588437,5439074,RLK
chr15,Bn62920,3777850,59833393,56055543,RLP
chr15,Bn62921,73997794,93715931,19718137,CNL
chr15,Bn62922,52464958,89490224,37025266,RLP
chr15,Bn62923,64635470,73916337,9280867,CNL
chr15,Bn62924,69653744,75006004,5352260,TN
chr15,Bn62925,11251048,79918435,68667387,RLP
chr15,Bn62926,88363097,88724852,361755,NBS
chr15,Bn62927,78555290,93802398,15247108,CN
chr15,Bn62928,23319189,42857458,19538269,TN
chr15,Bn62929,94439838,99403253,4963415,RLP
chr15,Bn62930,49531231,60502055,10970824,CNL
chr15,Bn62931,13051866,58973950,45922084,NBS
chr15,Bn62932,98495425,99066308,570883,TNL
chr15,Bn62933,8730296,77517982,68787686,NBS
chr15,Bn62934,81320544,91205102,9884558,RLP
chr15,Bn62935,23483462,47183506,23700044,TNL
chr15,Bn62936,31005125,82012798,51007673,TN
chr15,Bn62937,7892946,53114463,45221517,CN
chr15,Bn62938,90862169,91252490,390321,TN
chr15,Bn62939,11853661,14062892,2209231,NBS
chr15,Bn62940,10486816,22733090,12246274,CN
chr15,Bn62941,30393450,32548973,2155523,CN
chr15,Bn62942,30492539,97345781,66853242,NBS
chr15,Bn62943,53033391,67234568,14201177,RLP
chr15,Bn62944,53399607,72631655,19232048,RLK
chr15,Bn62945,57634391,66796655,9162264,TNL
chr15,Bn62946,19594136,86831201,67237065,NBS
chr15,Bn62947,10487803,37802378,27314575,RLK
chr15,Bn62948,41319418,74257713,32938295,CN
chr15,Bn62949,55425080,74548934,19123854,TN
chr15,Bn62950,41822689,49989831,8167142,CN
chr15,Bn62951,46257241,53986864,7729623,RLP
chr15,Bn62952,20965822,79031354,58065532,NBS
chr15,Bn62953,87317454,97894662,10577208,RLK
chr15,Bn62954,75875639,96699092,20823453,TNL
chr15,Bn62955,78012644,88405005,10392361,TNL
chr15,Bn62956,79509959,97151267,17641308,RLP
chr15,Bn62957,32918755,81917312,48998557,CNL
chr15,Bn62958,72169974,81456989,9287015,TNL
chr15,Bn62959,11174179,13378493,2204314,NBS
chr15,Bn62960,29436558,84675289,55238731,TN
chr15,Bn62961,91086440,92070974,984534,NBS
chr15,Bn62962,88810977,98914436,10103459,RLK
chr15,Bn62963,51646413,74641094,22994681,CNL
chr15,Bn62964,36774187,50578631,13804444,CNL
chr15,Bn62965,73779244,96183879,22404635,CN
chr15,Bn62966,53135511,63946542,10811031,CNL
chr15,Bn62967,9802731,66890740,57088009,TN
chr15,Bn62968,23392818,59342035,35949217,TN
chr15,Bn62969,25778714,88953027,63174313,RLK
chr15,Bn62970,10988403,87213503,76225100,CNL
chr15,Bn62971,75583265,88372651,12789386,CNL
chr15,Bn62972,38884713,49722732,10838019,TN
chr15,Bn62973,9549982,72357989,62808007,RLP
chr15,Bn62974,3859886,52143509,48283623,TNL
chr15,Bn62975,52364019,94767926,42403907,CNL
chr15,Bn62976,21026619,37709406,16682787,RLK
chr15,Bn62977,70212693,89269698,19057005,TNL
chr15,Bn62978,3695665,29606711,25911046,CN
chr15,Bn62979,72607911,93945360,21337449,RLP
chr15,Bn62980,4247993,42221374,37973381,TNL
chr15,Bn62981,54577541,93288612,38711071,CN
chr15,Bn62982,18025532,46122489,28096957,TN
chr15,Bn62983,71092358,96323730,25231372,TNL
chr15,Bn62984,8017912,10699967,2682055,TNL
chr15,Bn62985,96028537,96110222,81685,CNL
chr15,Bn62986,37133673,72993647,35859974,CN
chr15,Bn62987,93057694,94862955,1805261,TN
chr15,Bn62988,95347532,97850622,2503090,RLP
chr15,Bn62989,33202419,74911153,41708734,CN
chr15,Bn62990,86308532,89755212,3446680,RLK
chr15,Bn62991,60408906,66032193,5623287,NBS
chr15,Bn62992,38176350,85988327,47811977,TNL
chr15,Bn62993,97558296,98309820,751524,NBS
chr15,Bn62994,4873840,21170078,16296238,RLP
chr15,Bn62995,70217626,96640142,26422516,CNL
chr15,Bn62996,97668369,99769210,2100841,RLP
chr15,Bn62997,14565718,14853242,287524,TN
chr15,Bn62998,74274032,81263066,6989034,NBS
chr15,Bn62999,8899120,44295697,35396577,CNL
chr15,Bn63000,46198054,87428937,41230883,CN
chr15,Bn63001,12837853,64519310,51681457,TNL
chr15,Bn63002,40297364,70166882,29869518,CNL
chr15,Bn63003,74616245,76893981,2277736,TNL
chr15,Bn63004,95003197,95082550,79353,CN
chr15,Bn63005,95953707,99371160,3417453,NBS
chr15,Bn63006,24629111,92030805,67401694,RLK
chr15,Bn63007,91186814,96445528,5258714,RLK
chr15,Bn63008,22689667,23786814,1097147,CN
chr15,Bn63009,94668496,98470308,3801812,NBS
chr15,Bn63010,52011151,57745244,5734093,RLK
chr15,Bn63011,87742664,93915339,6172675,RLK
chr15,Bn63012,52349172,73355867,21006695,CNL
chr15,Bn63013,71561470,97347647,25786177,CNL
chr15,Bn63014,44595531,51233835,6638304,TNL
chr15,Bn63015,9690863,99466321,89775458,NBS
chr15,Bn63016,97762514,97771559,9045,CN
chr15,Bn63017,50261765,83840322,33578557,CNL
chr15,Bn63018,73450968,79628387,6177419,CNL
chr15,Bn63019,93088317,99444277,6355960,CNL
chr15,Bn63020,99713821,99993598,279777,CN
chr15,Bn63021,82208729,82838750,630021,NBS
chr15,Bn63022,58802006,79025485,20223479,NBS
chr15,Bn63023,65661329,80774897,15113568,RLP
chr15,Bn63024,17063447,44868494,27805047,TN
chr15,Bn63025,70824972,71382675,557703,TNL
chr15,Bn63026,66334754,91602491,25267737,RLK
chr15,Bn63027,85504273,94850900,9346627,RLP
chr15,Bn63028,8463511,37826806,29363295,CN
chr15,Bn63029,51039007,79287219,28248212,RLK
chr15,Bn63030,48292933,95104216,46811283,TN
chr15,Bn63031,96200566,96913164,712598,TN
chr15,Bn63032,43014813,55218074,12203261,RLP
chr15,Bn63033,4710989,13376751,8665762,NBS
chr15,Bn63034,81558297,83733269,2174972,TNL
chr15,Bn63035,96647398,97924722,1277324,RLK
chr15,Bn63036,1856785,93881840,92025055,NBS
chr15,Bn63037,13468477,85700061,72231584,CNL
chr15,Bn63038,15601556,55741290,40139734,TN
chr15,Bn63039,6724959,90456331,83731372,CNL
chr15,Bn63040,22611196,72814876,50203680,TN
chr15,Bn63041,24971967,74647504,49675537,RLK
chr15,Bn63042,16171764,93124559,76952795,NBS
chr15,Bn63043,24832275,88931399,64099124,CNL
chr15,Bn63044,39476919,90687501,51210582,CN
chr15,Bn63045,47007278,96208042,49200764,TNL
chr15,Bn63046,31429785,81715233,50285448,CNL
chr15,Bn63047,80997938,98540593,17542655,TN
chr15,Bn63048,76482137,81607366,5125229,CNL
chr15,Bn63049,11441740,29488747,18047007,RLP
chr15,Bn63050,36860706,45976269,9115563,TNL
chr15,Bn63051,4755243,48426139,43670896,CN
chr15,Bn63052,48487241,51679843,3192602,RLK
chr15,Bn63053,12245016,75185267,62940251,NBS
chr15,Bn63054,88120112,95566311,7446199,TNL
chr15,Bn63055,51572784,64672873,13100089,RLK
chr15,Bn63056,96404881,99233493,2828612,CNL
chr15,Bn63057,78264387,82591831,4327444,TNL
chr15,Bn63058,83186342,94771528,11585186,CNL
chr15,Bn63059,73663520,95796209,22132689,TNL
chr15,Bn63060,32517559,72397273,39879714,CN
chr15,Bn63061,37055328,98562364,61507036,CN
chr15,Bn63062,3088786,34734755,31645969,CNL
chr15,Bn63063,32304468,81542984,49238516,TN
chr15,Bn63064,76213435,85506963,9293528,TN
chr15,Bn63065,58500844,90224581,31723737,NBS
chr15,Bn63066,78544439,90031019,11486580,TN
chr15,Bn63067,28211360,63609713,35398353,CNL
chr15,Bn63068,23955359,55455469,31500110,CNL
chr15,Bn63069,18381000,58281910,39900910,NBS
chr15,Bn63070,39840630,87900114,48059484,RLP
chr15,Bn63071,71412824,98516559,27103735,RLK
chr15,Bn63072,23118096,31007585,7889489,CN
chr15,Bn63073,67669514,76968151,9298637,CNL
chr15,Bn63074,47290333,82863302,35572969,RLK
chr15,Bn63075,23867298,52274286,28406988,CN
chr15,Bn63076,52826850,61325850,8499000,RLK
chr15,Bn63077,72461570,82095432,9633862,CN
chr15,Bn63078,13968838,65991731,52022893,CNL
chr15,Bn63079,84879390,97952748,13073358,TNL
chr15,Bn63080,73757017,78767256,5010239,RLP
chr15,Bn63081,81102055,88928847,7826792,NBS
chr15,Bn63082,61663689,68133084,6469395,RLK
chr15,Bn63083,25369543,82097118,56727575,NBS
chr15,Bn63084,43355484,67741461,24385977,TNL
chr15,Bn63085,4853879,45673647,40819768,NBS
chr15,Bn63086,41955909,98017751,56061842,NBS
chr15,Bn63087,6509717,54443206,47933489,CNL
chr15,Bn63088,69267394,79437070,10169676,CNL
chr15,Bn63089,83099253,87687082,4587829,RLK
chr15,Bn63090,95209554,99580456,4370902,RLP
chr15,Bn63091,24384092,99215473,74831381,RLK
chr15,Bn63092,90960007,94147891,3187884,TNL
chr15,Bn63093,44656437,72929908,28273471,RLK
chr15,Bn63094,11326306,48181581,36855275,NBS
chr15,Bn63095,50322778,76971426,26648648,RLK
chr15,Bn63096,69336575,69542415,205840,NBS
chr15,Bn63097,61193710,89154194,27960484,TNL
chr15,Bn63098,94535100,96785583,2250483,NBS
chr15,Bn63099,4615246,91128252,86513006,RLP
chr15,Bn63100,69645304,86148111,16502807,CNL
chr15,Bn63101,33348375,78801756,45453381,TN
chr15,Bn63102,82266770,84033504,1766734,NBS
chr15,Bn63103,92415092,93562493,1147401,RLP
chr15,Bn63104,20473683,89914958,69441275,RLK
chr15,Bn63105,57940904,94086846,36145942,TNL
chr15,Bn63106,69545003,84944743,15399740,CNL
chr15,Bn63107,2567443,25769871,23202428,TNL
chr15,Bn63108,70840039,78076135,7236096,TNL
chr15,Bn63109,18481362,57062437,38581075,TNL
chr15,Bn63110,31836619,48210102,16373483,CN
chr15,Bn63111,68984861,69910194,925333,RLK
chr15,Bn63112,20454436,43682079,23227643,TN
chr15,Bn63113,78343565,80439586,2096021,RLK
chr15,Bn63114,45981192,70871299,24890107,CN
chr15,Bn63115,92129694,99097308,6967614,TNL
chr15,Bn63116,38779948,43844149,5064201,CN
chr15,Bn63117,37297812,88535688,51237876,TN
chr15,Bn63118,65941650,78316871,12375221,CN
chr15,Bn63119,47411308,88236607,40825299,TN
chr15,Bn63120,74781673,97996214,23214541,CNL
chr15,Bn63121,72281428,97609110,25327682,NBS
chr15,Bn63122,71081454,78739382,7657928,RLK
chr15,Bn63123,13028293,37125653,24097360,NBS
chr15,Bn63124,24308491,83489957,59181466,TNL
chr15,Bn63125,74241275,99980063,25738788,NBS
chr15,Bn63126,87338619,99352639,12014020,TNL
chr15,Bn63127,34401854,57682521,23280667,CNL
chr15,Bn63128,61076807,74969750,13892943,CN
chr15,Bn63129,96167665,96200917,33252,CN
chr15,Bn63130,46006132,88513730,42507598,RLK
chr15,Bn63131,81071165,92852303,11781138,TN
chr15,Bn63132,37590674,45565167,7974493,TN
chr15,Bn63133,77298438,95938082,18639644,TN
chr15,Bn63134,78600446,89884479,11284033,CN
chr15,Bn63135,64466223,95147462,30681239,CNL
chr15,Bn63136,34408440,59379603,24971163,RLP
chr15,Bn63137,70599042,82728391,12129349,TNL
chr15,Bn63138,46515457,78994683,32479226,TNL
chr15,Bn63139,90914078,95617943,4703865,RLP
chr15,Bn63140,31269326,48705817,17436491,RLK
chr15,Bn63141,64787335,90242000,25454665,CN
chr15,Bn63142,16414048,41103529,24689481,CN
chr15,Bn63143,25658379,31811700,6153321,TN
chr15,Bn63144,14908959,55094721,40185762,TNL
chr15,Bn63145,13369135,38360720,24991585,RLK
chr15,Bn63146,69682394,80148930,10466536,RLP
chr15,Bn63147,94664586,96615362,1950776,TN
chr15,Bn63148,4235145,88538533,84303388,RLP
chr15,Bn63149,20455592,78043779,57588187,RLP
chr15,Bn63150,55514981,64547361,9032380,RLP
chr15,Bn63151,46532640,55355224,8822584,NBS
chr15,Bn63152,42962869,52297201,9334332,NBS
chr15,Bn63153,53962570,81915803,27953233,RLK
chr15,Bn63154,80623178,96901601,16278423,TN
chr15,Bn63155,24447442,96781442,72334000,TNL
chr15,Bn63156,31770190,33323147,1552957,NBS
chr15,Bn63157,86311128,89262772,2951644,CN
chr15,Bn63158,65027263,68833926,3806663,NBS
chr15,Bn63159,39485967,71579739,32093772,RLP
chr15,Bn63160,11491204,40747472,29256268,RLP
chr15,Bn63161,41939391,98982908,57043517,TN
chr15,Bn63162,29686964,79373271,49686307,RLP
chr15,Bn63163,22327895,53342523,31014628,RLK
chr15,Bn63164,2753983,77821432,75067449,RLP
chr15,Bn63165,60469784,97308203,36838419,NBS
chr15,Bn63166,38027058,67548833,29521775,RLP
chr15,Bn63167,33392780,52657602,19264822,RLP
chr15,Bn63168,45336266,48564958,3228692,CNL
chr15,Bn63169,26475022,63034065,36559043,CN
chr15,Bn63170,10735646,32123916,21388270,RLP
chr15,Bn63171,13064095,68941306,55877211,NBS
chr15,Bn63172,98861168,99652004,790836,CNL
chr15,Bn63173,82060460,92001039,9940579,RLP
chr15,Bn63174,98540343,98566258,25915,CNL
chr15,Bn63175,35004104,61148541,26144437,NBS
chr15,Bn63176,53383591,53980295,596704,CNL
chr15,Bn63177,63910186,76855973,12945787,CNL
chr15,Bn63178,47305077,77841245,30536168,TNL
chr15,Bn63179,53880118,56730999,2850881,RLP
chr15,Bn63180,57141465,81364711,24223246,TNL
chr15,Bn63181,89783358,90864602,1081244,TNL
chr15,Bn63182,48049324,71220880,23171556,TNL
chr15,Bn63183,37737788,50286263,12548475,TNL
chr15,Bn63184,19516469,96426180,76909711,NBS
chr15,Bn63185,43989066,99696490,55707424,TN
chr15,Bn63186,73636443,93403066,19766623,RLK
chr15,Bn63187,81719735,88942029,7222294,CNL
chr15,Bn63188,59667987,93807138,34139151,CNL
chr15,Bn63189,50016935,60045553,10028618,NBS
chr15,Bn63190,32873709,48307320,15433611,RLP
chr15,Bn63191,92863092,96216251,3353159,RLK
chr15,Bn63192,59193352,71997936,12804584,NBS
chr15,Bn63193,90219713,98853057,8633344,NBS
chr15,Bn63194,88758170,94358653,5600483,CN
chr15,Bn63195,36990907,50016468,13025561,TNL
chr15,Bn63196,73729491,74105996,376505,RLK
chr15,Bn63197,6629451,38864135,32234684,RLK
chr15,Bn63198,41436983,79099426,37662443,TNL
chr15,Bn63199,70842004,80078231,9236227,TN
chr15,Bn63200,2970728,58286674,55315946,RLK
chr15,Bn63201,18519475,73006383,54486908,TNL
chr15,Bn63202,58510348,60376020,1865672,RLP
chr15,Bn63203,25504685,79861923,54357238,CN
chr15,Bn63204,4001178,47158064,43156886,TN
chr15,Bn63205,23896302,64575739,40679437,CNL
chr15,Bn63206,45298906,47628363,2329457,RLP
chr15,Bn63207,42277090,99210421,56933331,NBS
chr15,Bn63208,43073748,77373625,34299877,CN
chr15,Bn63209,14345309,71342438,56997129,TNL
chr15,Bn63210,11970871,40894784,28923913,TN
chr15,Bn63211,86125943,92706384,6580441,NBS
chr15,Bn63212,51678626,67634564,15955938,NBS
chr15,Bn63213,46989095,49609303,2620208,TN
chr15,Bn63214,85952025,86388696,436671,RLP
chr15,Bn63215,67554684,89836011,22281327,CNL
chr15,Bn63216,96178722,98805787,2627065,CN
chr15,Bn63217,57845827,61788651,3942824,CNL
chr15,Bn63218,50900376,53949264,3048888,TN
chr15,Bn63219,86209966,91560322,5350356,CN
chr15,Bn63220,11999271,66422578,54423307,TNL
chr15,Bn63221,98493725,99998105,1504380,RLK
chr15,Bn63222,26412885,96361738,69948853,RLP
chr15,Bn63223,32128935,50267744,18138809,TNL
chr15,Bn63224,56138699,79098355,22959656,CNL
chr15,Bn63225,79914597,86658667,6744070,TN
chr15,Bn63226,72830943,91947289,19116346,RLK
chr15,Bn63227,24518079,25562838,1044759,RLK
chr15,Bn63228,79824561,99893475,20068914,RLP
chr15,Bn63229,98832348,99856776,1024428,CNL
chr15,Bn63230,63205399,80290983,17085584,TN
chr15,Bn63231,78713058,94677275,15964217,NBS
chr15,Bn63232,79352923,97409528,18056605,CNL
chr15,Bn63233,10917031,41799865,30882834,RLK
chr15,Bn63234,26272229,66298951,40026722,TN
chr15,Bn63235,5326719,15096227,9769508,TN
chr15,Bn63236,82862254,90015601,7153347,TNL
chr15,Bn63237,35731661,95775355,60043694,TNL
chr15,Bn63238,38292168,48109749,9817581,NBS
chr15,Bn63239,25340349,96580023,71239674,CNL
chr15,Bn63240,65646947,78857193,13210246,RLK
chr15,Bn63241,82665954,94439498,11773544,CN
chr15,Bn63242,3312423,26658666,23346243,CN
chr15,Bn63243,28149162,88827309,60678147,RLK
chr15,Bn63244,89526213,96941841,7415628,NBS
chr15,Bn63245,24067082,72336180,48269098,NBS
chr15,Bn63246,56672509,88172635,31500126,TN
chr15,Bn63247,23183539,28144358,4960819,NBS
chr15,Bn63248,16844051,69237922,52393871,TNL
chr15,Bn63249,18138902,72681789,54542887,RLK
chr15,Bn63250,35209403,98649738,63440335,CN
chr15,Bn63251,35545269,39930012,4384743,TN
chr15,Bn63252,39074426,48708675,9634249,RLP
chr15,Bn63253,57782070,70845309,13063239,NBS
chr15,Bn63254,64151692,79264799,15113107,TN
chr15,Bn63255,62776252,98462188,35685936,CNL
chr15,Bn63256,5669845,16935542,11265697,NBS
chr15,Bn63257,47312509,56748569,9436060,TN
chr15,Bn63258,48774841,75247398,26472557,TNL
chr15,Bn63259,6839914,41281885,34441971,TNL
chr15,Bn63260,20164677,87153381,66988704,CNL
chr15,Bn63261,6705404,88317258,81611854,RLP
chr15,Bn63262,77210848,97382821,20171973,NBS
chr15,Bn63263,15272959,99053552,83780593,TNL
chr15,Bn63264,69925345,84415329,14489984,TNL
chr15,Bn63265,99258557,99863964,605407,CNL
chr15,Bn63266,4756306,83050705,78294399,NBS
chr15,Bn63267,66908443,68703330,1794887,TNL
chr15,Bn63268,58202973,95877944,37674971,NBS
chr15,Bn63269,37409152,67518054,30108902,TN
chr15,Bn63270,53830650,89998307,36167657,RLK
chr15,Bn63271,62368253,65223107,2854854,RLK
chr15,Bn63272,17631550,22175153,4543603,CNL
chr15,Bn63273,78907349,87829867,8922518,CNL
chr15,Bn63274,13858634,76602288,62743654,TNL
chr15,Bn63275,90789932,93003493,2213561,RLP
chr15,Bn63276,23735364,42708213,18972849,CN
chr15,Bn63277,95691530,96801349,1109819,RLP
chr15,Bn63278,34235947,49619418,15383471,RLP
chr15,Bn63279,17708444,99023161,81314717,CNL
chr15,Bn63280,20464071,96541698,76077627,RLP
chr15,Bn63281,73793250,84505281,10712031,NBS
chr15,Bn63282,12715747,33988817,21273070,RLP
chr15,Bn63283,24279592,56343894,32064302,CN
chr15,Bn63284,39700077,78849538,39149461,TN
chr15,Bn63285,26264743,82608282,56343539,RLP
chr15,Bn63286,66746667,96464143,29717476,CN
chr15,Bn63287,17625021,38003314,20378293,RLP
chr15,Bn63288,32929009,90233516,57304507,CNL
chr15,Bn63289,12784962,94844611,82059649,RLK
chr15,Bn63290,20459657,82583281,62123624,CNL
chr15,Bn63291,60443779,76927737,16483958,RLK
chr15,Bn63292,57937043,70093707,12156664,RLP
chr15,Bn63293,85884880,86548268,663388,CNL
chr15,Bn63294,81777395,91528633,9751238,RLK
chr15,Bn63295,4833550,70664389,65830839,CNL
chr15,Bn63296,89825018,94896552,5071534,RLP
chr15,Bn63297,34980052,55914866,20934814,RLK
chr15,Bn63298,27947732,59199207,31251475,NBS
chr15,Bn63299,36265740,57948682,21682942,RLK
chr15,Bn63300,43015749,77266214,34250465,CNL
chr15,Bn63301,4048402,14892780,10844378,TNL
chr15,Bn63302,7902703,96161839,88259136,TNL
chr15,Bn63303,66533146,79516007,12982861,RLP
chr15,Bn63304,93442430,99918706,6476276,CNL
chr15,Bn63305,69780669,84749271,14968602,TNL
chr15,Bn63306,12881759,13117114,235355,RLP
chr15,Bn63307,69526142,75143882,5617740,TNL
chr15,Bn63308,44934901,93362782,48427881,CNL
chr15,Bn63309,21053882,87948275,66894393,TN
chr15,Bn63310,32572749,83671811,51099062,TNL
chr15,Bn63311,43658615,55598797,11940182,CNL
chr15,Bn63312,88006075,98100188,10094113,TNL
chr15,Bn63313,34027957,93339572,59311615,TNL
chr15,Bn63314,69244202,96965061,27720859,NBS
chr15,Bn63315,66375047,85002319,18627272,TNL
chr15,Bn63316,37005149,62811988,25806839,RLP
chr15,Bn63317,1496086,83119287,81623201,NBS
chr15,Bn63318,38147210,65043080,26895870,RLP
chr15,Bn63319,72928781,91056145,18127364,CN
chr15,Bn63320,68146789,81325563,13178774,TN
chr15,Bn63321,41806191,75416343,33610152,CNL
chr15,Bn63322,54649680,58294514,3644834,CNL
chr15,Bn63323,6328675,64474929,58146254,CN
chr15,Bn63324,39888242,57985714,18097472,CN
chr15,Bn63325,14057077,24031200,9974123,RLK
chr15,Bn63326,29244408,41678778,12434370,CN
chr15,Bn63327,76822588,98675831,21853243,NBS
chr15,Bn63328,46309691,54692372,8382681,TNL
chr15,Bn63329,25564410,97260680,71696270,NBS
chr15,Bn63330,29940694,87253203,57312509,CNL
chr15,Bn63331,46496932,96265447,49768515,TN
chr15,Bn63332,53433039,69484754,16051715,CN
chr15,Bn63333,49287223,85439540,36152317,RLK
chr15,Bn63334,87455376,97428881,9973505,CNL
chr15,Bn63335,88703854,92475384,3771530,CN
chr15,Bn63336,11520910,28208870,16687960,RLP
chr15,Bn63337,27239368,75465516,48226148,TN
chr15,Bn63338,82938252,94617446,11679194,TNL
chr15,Bn63339,64334766,89373446,25038680,CN
chr15,Bn63340,57320674,75457086,18136412,NBS
chr15,Bn63341,37360914,81875924,44515010,RLK
chr15,Bn63342,70999260,78354963,7355703,NBS
chr15,Bn63343,78130735,88482935,10352200,RLK
chr15,Bn63344,18852640,41455190,22602550,TN
chr15,Bn63345,19122634,47153841,28031207,CNL
chr15,Bn63346,50455868,69788247,19332379,RLK
chr15,Bn63347,9886763,78900816,69014053,CN
chr15,Bn63348,62735215,77213772,14478557,NBS
chr15,Bn63349,90472826,93633061,3160235,CN
chr15,Bn63350,89112280,90570559,1458279,TNL
chr15,Bn63351,77244816,85498641,8253825,CN
chr15,Bn63352,38235937,74897174,36661237,RLP
chr15,Bn63353,28689740,48793279,20103539,CNL
chr15,Bn63354,9050104,66904580,57854476,TNL
chr15,Bn63355,96992822,99204450,2211628,RLK
chr15,Bn63356,43381854,98625776,55243922,RLK
chr15,Bn63357,56943652,58458356,1514704,RLP
chr15,Bn63358,16018814,61003937,44985123,TN
chr15,Bn63359,73324851,79204125,5879274,CN
chr15,Bn63360,56186960,89004812,32817852,CNL
chr15,Bn63361,7797553,25923837,18126284,CN
chr15,Bn63362,4212436,30605983,26393547,TNL
chr15,Bn63363,47792735,50824945,3032210,CN
chr15,Bn63364,85482745,96102422,10619677,RLP
chr15,Bn63365,77650909,91436202,13785293,RLK
chr15,Bn63366,41089973,70886738,29796765,CNL
chr15,Bn63367,83349230,86648063,3298833,RLK
chr15,Bn63368,60297971,65824574,5526603,TNL
chr15,Bn63369,40615679,48196265,7580586,RLP
chr15,Bn63370,61796907,86097861,24300954,NBS
chr15,Bn63371,3871254,93108798,89237544,RLK
chr15,Bn63372,2011426,88817451,86806025,NBS
chr15,Bn63373,62549175,77340790,14791615,RLK
chr15,Bn63374,77848239,80942352,3094113,RLK
chr15,Bn63375,5930376,24609326,18678950,RLK
chr15,Bn63376,13701090,20762842,7061752,RLK
chr15,Bn63377,89273596,99839022,10565426,RLK
chr15,Bn63378,17461109,95493266,78032157,TNL
chr15,Bn63379,13763157,29404005,15640848,NBS
chr15,Bn63380,49565655,49650333,84678,TN
chr15,Bn63381,14153058,93718212,79565154,TNL
chr15,Bn63382,88813156,93622015,4808859,CN
chr15,Bn63383,28305096,84080490,55775394,RLK
chr15,Bn63384,33721195,49237340,15516145,NBS
chr15,Bn63385,75879939,91881026,16001087,TN
chr15,Bn63386,54677494,58890338,4212844,RLK
chr15,Bn63387,75479110,87500126,12021016,NBS
chr15,Bn63388,3499601,90464620,86965019,CN
chr15,Bn63389,52165136,95996861,43831725,CNL
chr15,Bn63390,94841787,99830658,4988871,TNL
chr15,Bn63391,20200800,56987594,36786794,CN
chr15,Bn63392,77482646,94710275,17227629,NBS
chr15,Bn63393,59994062,97984864,37990802,CNL
chr15,Bn63394,5441859,63247709,57805850,NBS
chr15,Bn63395,76747655,86083875,9336220,RLP
chr15,Bn63396,42152782,69849702,27696920,RLK
chr15,Bn63397,82643038,94492797,11849759,CN
chr15,Bn63398,74630944,78515243,3884299,TN
chr15,Bn63399,85833891,96572025,10738134,NBS
chr15,Bn63400,45672338,60272261,14599923,TN
chr15,Bn63401,95892886,97717990,1825104,TN
chr15,Bn63402,34487362,49227265,14739903,TN
chr15,Bn63403,22162886,25217184,3054298,CNL
chr15,Bn63404,72998207,83382103,10383896,TNL
chr15,Bn63405,49056240,49954616,898376,CNL
chr15,Bn63406,69833833,75310254,5476421,TN
chr15,Bn63407,67383306,87861834,20478528,TNL
chr15,Bn63408,1693314,5631026,3937712,TNL
chr15,Bn63409,44918036,62060849,17142813,TNL
chr15,Bn63410,76344397,77973478,1629081,RLP
chr15,Bn63411,24074084,77730662,53656578,CNL
chr15,Bn63412,33998864,96623483,62624619,RLK
chr15,Bn63413,46485341,73981171,27495830,CN
chr15,Bn63414,58798715,70183227,11384512,TN
chr15,Bn63415,5982262,61128393,55146131,CNL
chr15,Bn63416,71497628,76065720,4568092,CN
chr15,Bn63417,45004347,96959701,51955354,CNL
chr15,Bn63418,66626409,75195878,8569469,NBS
chr15,Bn63419,10124813,38364342,28239529,TNL
chr15,Bn63420,29418656,55642783,26224127,CN
chr15,Bn63421,51783358,68341348,16557990,RLK
chr15,Bn63422,57595718,84244570,26648852,TN
chr15,Bn63423,75647754,84407057,8759303,RLK
chr15,Bn63424,17436260,52155993,34719733,NBS
chr15,Bn63425,31862781,60588445,28725664,RLP
chr15,Bn63426,47762847,81106288,33343441,RLP
chr15,Bn63427,23854892,86245764,62390872,TNL
chr15,Bn63428,5621038,66058847,60437809,CN
chr15,Bn63429,43447465,65502431,22054966,TN
chr15,Bn63430,72745445,93339151,20593706,CNL
chr15,Bn63431,61208863,65730340,4521477,TN
chr15,Bn63432,88720507,97248778,8528271,TNL
chr15,Bn63433,4661822,96041769,91379947,CNL
chr15,Bn63434,12655542,48179824,35524282,TNL
chr15,Bn63435,98339976,99345616,1005640,TNL
chr15,Bn63436,35998954,85587681,49588727,TNL
chr15,Bn63437,46356027,56093302,9737275,RLK
chr15,Bn63438,63640488,66786091,3145603,CNL
chr15,Bn63439,56326779,81661757,25334978,RLK
chr15,Bn63440,58720811,95710017,36989206,TN
chr15,Bn63441,37144074,72660306,35516232,RLP
chr15,Bn63442,23811295,85474057,61662762,CNL
chr15,Bn63443,64122217,87972295,23850078,TN
chr15,Bn63444,28872905,87972305,59099400,CN
chr15,Bn63445,52308546,53597545,1288999,TN
chr15,Bn63446,91839125,99843857,8004732,CN
chr15,Bn63447,90435279,94608717,4173438,CNL
chr15,Bn63448,71178159,74055191,2877032,CN
chr15,Bn63449,86838601,90364320,3525719,TN
chr15,Bn63450,92419695,95532509,3112814,CN
chr15,Bn63451,85980467,96960174,10979707,RLP
chr15,Bn63452,83215662,90774452,7558790,RLK
chr15,Bn63453,8815787,85610499,76794712,TNL
chr15,Bn63454,58435790,82897950,24462160,RLK
chr15,Bn63455,80539403,91139916,10600513,TN
chr15,Bn63456,58290585,61958933,3668348,CNL
chr15,Bn63457,13814968,87488570,73673602,RLK
chr15,Bn63458,30178743,57338912,27160169,CN
chr15,Bn63459,17293002,75107150,57814148,RLP
chr15,Bn63460,77895409,93167462,15272053,TN
chr15,Bn63461,40723530,78410600,37687070,TN
chr15,Bn63462,10471979,98033537,87561558,RLK
chr15,Bn63463,17648301,32924196,15275895,NBS
chr15,Bn63464,21217837,26755814,5537977,RLK
chr15,Bn63465,33498090,52645790,19147700,NBS
chr15,Bn63466,65272496,75092464,9819968,CN
chr15,Bn63467,23249617,33989278,10739661,TNL
chr15,Bn63468,56551666,66395896,9844230,RLP
chr15,Bn63469,31049697,67930165,36880468,TN
chr15,Bn63470,87241842,96660800,9418958,CNL
chr15,Bn63471,12171475,26017100,13845625,RLK
chr15,Bn63472,39118702,48645098,9526396,TNL
chr15,Bn63473,35758356,44327765,8569409,CN
chr15,Bn63474,93554986,93895089,340103,RLK
chr15,Bn63475,49664321,52822171,3157850,CNL
chr15,Bn63476,31700042,43443606,11743564,CNL
chr15,Bn63477,13295495,31001859,17706364,RLK
chr15,Bn63478,9495983,49697364,40201381,TN
chr15,Bn63479,69290269,69793552,503283,RLP
chr15,Bn63480,30884236,40192874,9308638,CNL
chr15,Bn63481,25996837,48545477,22548640,NBS
chr15,Bn63482,84717511,91765551,7048040,TN
chr15,Bn63483,18957768,87203168,68245400,NBS
chr15,Bn63484,61065939,85393720,24327781,NBS
chr15,Bn63485,54669931,66302812,11632881,CNL
chr15,Bn63486,47661401,82610766,34949365,TN
chr15,Bn63487,15035926,40085895,25049969,NBS
chr15,Bn63488,60931212,73070211,12138999,TNL
chr15,Bn63489,54773686,94643217,39869531,TNL
chr15,Bn63490,46089585,92820229,46730644,CN
chr15,Bn63491,74425873,88927079,14501206,RLK
chr15,Bn63492,25975000,37651477,11676477,NBS
chr15,Bn63493,59065311,86750961,27685650,TNL
chr15,Bn63494,21410554,80829396,59418842,RLP
chr15,Bn63495,24054709,85911353,61856644,CNL
chr15,Bn63496,16061113,65700369,49639256,TN
chr15,Bn63497,81260239,85683965,4423726,TN
chr15,Bn63498,92342666,95893114,3550448,TN
chr15,Bn63499,34598808,85622887,51024079,CNL
chr15,Bn63500,61722599,66287812,4565213,RLK
chr15,Bn63501,8380381,84495799,76115418,TN
chr15,Bn63502,35467572,80793783,45326211,RLK
chr15,Bn63503,80884596,89453447,8568851,CNL
chr15,Bn63504,19176715,53311862,34135147,RLK
chr15,Bn63505,28644785,28900758,255973,CN
chr15,Bn63506,5164435,57061178,51896743,CNL
chr15,Bn63507,76242857,77912314,1669457,CN
chr15,Bn63508,66116382,83039978,16923596,TN
chr15,Bn63509,14216883,60488041,46271158,TNL
chr15,Bn63510,86601719,89627492,3025773,TNL
chr15,Bn63511,86308493,91253066,4944573,NBS
chr15,Bn63512,50723597,80771425,30047828,RLP
chr15,Bn63513,54817800,64312952,9495152,TN
chr15,Bn63514,22843201,33944936,11101735,CNL
chr15,Bn63515,16289141,26536682,10247541,TN
chr15,Bn63516,88238918,95052303,6813385,CNL
chr15,Bn63517,33023729,34411143,1387414,CN
chr15,Bn63518,73251822,88455116,15203294,RLK
chr15,Bn63519,37493477,81539758,44046281,RLK
chr15,Bn63520,15160342,16834175,1673833,RLP
chr15,Bn63521,55672298,79424873,23752575,CNL
chr15,Bn63522,57006422,77265219,20258797,NBS
chr15,Bn63523,19713580,20799136,1085556,TNL
chr15,Bn63524,75132850,75879422,746572,RLP
chr15,Bn63525,43328245,82408612,39080367,RLP
chr15,Bn63526,79825478,90418589,10593111,TNL
chr15,Bn63527,73777626,89204042,15426416,CNL
chr15,Bn63528,62692288,68095391,5403103,CN
chr15,Bn63529,54113318,99790251,45676933,RLK
chr15,Bn63530,16887711,26856468,9968757,CNL
chr15,Bn63531,48469434,72564987,24095553,TN
chr15,Bn63532,82927096,99188910,16261814,RLP
chr15,Bn63533,92183897,99616984,7433087,CN
chr15,Bn63534,83071524,86866872,3795348,RLK
chr15,Bn63535,18814703,19504168,689465,RLP
chr15,Bn63536,58007262,65335390,7328128,TN
chr15,Bn63537,11790766,19643428,7852662,CNL
chr15,Bn63538,7180872,66884576,59703704,CN
chr15,Bn63539,89919578,98297804,8378226,NBS
chr15,Bn63540,29239810,64717747,35477937,CNL
chr15,Bn63541,16107307,77544228,61436921,CNL
chr15,Bn63542,19992952,35736888,15743936,RLP
chr15,Bn63543,3171822,97851830,94680008,TN
chr15,Bn63544,67835419,69967157,2131738,RLK
chr15,Bn63545,45581710,74915439,29333729,TN
chr15,Bn63546,37221834,37524585,302751,TN
chr15,Bn63547,41036418,60381352,19344934,CN
chr15,Bn63548,78399690,87550681,9150991,CNL
chr15,Bn63549,3125409,45328434,42203025,NBS
chr15,Bn63550,3875303,58295196,54419893,TNL
chr15,Bn63551,86836149,90728789,3892640,TN
chr15,Bn63552,31006813,34591385,3584572,TN
chr15,Bn63553,93966176,97679413,3713237,TNL
chr15,Bn63554,2790646,3825640,1034994,NBS
chr15,Bn63555,16213177,32729273,16516096,RLP
chr15,Bn63556,79854699,87546196,7691497,TNL
chr15,Bn63557,78001466,80425542,2424076,TN
chr15,Bn63558,92596734,96093751,3497017,RLP
chr15,Bn63559,97191886,97313282,121396,TNL
chr15,Bn63560,32393397,40098390,7704993,TNL
chr15,Bn63561,7891791,76196876,68305085,RLP
chr15,Bn63562,18307579,22494583,4187004,CN
chr15,Bn63563,16783155,64225156,47442001,TN
chr15,Bn63564,88079992,93353826,5273834,CN
chr15,Bn63565,79291375,90358150,11066775,RLP
chr15,Bn63566,7472014,79654924,72182910,TN
chr15,Bn63567,87784848,88602274,817426,CN
chr15,Bn63568,96019460,98139691,2120231,CNL
chr15,Bn63569,7582275,81445112,73862837,TN
chr15,Bn63570,67828551,93052784,25224233,RLK
chr15,Bn63571,59709871,69209868,9499997,TNL
chr15,Bn63572,62317934,87491898,25173964,CNL
chr15,Bn63573,34101527,39342472,5240945,RLK
chr15,Bn63574,13083594,90091942,77008348,CNL
chr15,Bn63575,73336101,82399168,9063067,NBS
chr15,Bn63576,1472455,80967267,79494812,TNL
chr15,Bn63577,35750657,77097997,41347340,RLP
chr15,Bn63578,69482065,99422801,29940736,TNL
chr15,Bn63579,92881230,93343265,462035,RLK
chr15,Bn63580,20356303,54019862,33663559,RLP
chr15,Bn63581,88244312,96420971,8176659,RLK
chr15,Bn63582,44380559,98928243,54547684,RLK
chr15,Bn63583,54475832,89526131,35050299,RLK
chr15,Bn63584,90626990,98789515,8162525,TN
chr15,Bn63585,29131146,29875653,744507,RLK
chr15,Bn63586,58550434,93004988,34454554,TNL
chr15,Bn63587,96569088,98441260,1872172,RLP
chr15,Bn63588,14116354,17464671,3348317,CN
chr15,Bn63589,17436625,83104353,65667728,CN
chr15,Bn63590,15147384,49678806,34531422,TNL
chr15,Bn63591,9384443,34599051,25214608,NBS
chr15,Bn63592,48759993,91436136,42676143,NBS
chr15,Bn63593,27297215,58287755,30990540,TN
chr15,Bn63594,73852701,89090218,15237517,TN
chr15,Bn63595,35024926,35123557,98631,CN
chr15,Bn63596,90495454,93918715,3423261,CNL
chr15,Bn63597,94046986,94538545,491559,RLK
chr15,Bn63598,10362888,90342770,79979882,CNL
chr15,Bn63599,94978036,99489605,4511569,TN
chr15,Bn63600,84217421,98741354,14523933,TNL
chr15,Bn63601,44741631,55162852,10421221,CNL
chr15,Bn63602,95661656,97362793,1701137,CNL
chr15,Bn63603,70487303,70696546,209243,TN
chr15,Bn63604,96263312,98399784,2136472,RLP
chr15,Bn63605,9202748,56490379,47287631,TN
chr15,Bn63606,87055736,87855063,799327,CN
chr15,Bn63607,92186343,99228390,7042047,NBS
chr15,Bn63608,18730656,91435820,72705164,CNL
chr15,Bn63609,17591541,48447907,30856366,TN
chr15,Bn63610,16689443,73269357,56579914,RLK
chr15,Bn63611,76113208,93627006,17513798,TNL
chr15,Bn63612,70739026,88924164,18185138,RLP
chr15,Bn63613,42802663,85458000,42655337,RLP
chr15,Bn63614,24414790,56419552,32004762,CNL
chr15,Bn63615,43945769,81933087,37987318,RLK
chr15,Bn63616,49292845,57182162,7889317,CNL
chr15,Bn63617,25890086,43616904,17726818,CN
chr15,Bn63618,36264561,41366236,5101675,CNL
chr15,Bn63619,38485937,94761733,56275796,RLP
chr15,Bn63620,86824880,87396136,571256,CN
chr15,Bn63621,53518502,68421275,14902773,RLP
chr15,Bn63622,76338835,95456788,19117953,CNL
chr15,Bn63623,62874047,92541715,29667668,TN
chr15,Bn63624,67606277,71458353,3852076,RLK
chr15,Bn63625,49434331,63224195,13789864,TN
chr15,Bn63626,97627047,98808327,1181280,RLP
chr15,Bn63627,66273133,91725680,25452547,CNL
chr15,Bn63628,61229187,87177394,25948207,CN
chr15,Bn63629,43584525,87259081,43674556,CNL
chr15,Bn63630,19994123,80160668,60166545,RLK
chr15,Bn63631,62332438,69806056,7473618,NBS
chr15,Bn63632,51938972,99311314,47372342,CN
chr15,Bn63633,50297301,69989846,19692545,TNL
chr15,Bn63634,27230260,41709068,14478808,TNL
chr15,Bn63635,26309987,65979300,39669313,CN
chr15,Bn63636,62647404,79717495,17070091,CN
chr15,Bn63637,47667607,73517349,25849742,CN
chr15,Bn63638,4595611,7238319,2642708,RLK
chr15,Bn63639,86634529,89085398,2450869,NBS
chr15,Bn63640,4583834,50306667,45722833,TNL
chr15,Bn63641,89721163,93866513,4145350,TN
chr15,Bn63642,95460955,98278321,2817366,RLP
chr15,Bn63643,65642840,71541084,5898244,TN
chr15,Bn63644,79278848,94074828,14795980,CN
chr15,Bn63645,59608800,74901393,15292593,RLP
chr15,Bn63646,51431919,88526804,37094885,RLP
chr15,Bn63647,80962760,81709165,746405,RLK
chr15,Bn63648,28946572,97674868,68728296,NBS
chr15,Bn63649,42725843,73590346,30864503,TN
chr15,Bn63650,43048146,54859732,11811586,RLP
chr15,Bn63651,65719006,77415863,11696857,CN
chr15,Bn63652,82512542,98919261,16406719,RLK
chr15,Bn63653,52730651,99811732,47081081,CN
chr15,Bn63654,85604762,93954774,8350012,CN
chr15,Bn63655,65151420,97251686,32100266,CNL
chr15,Bn63656,1866055,19145732,17279677,CN
chr15,Bn63657,25008622,95677944,70669322,CNL
chr15,Bn63658,18490644,82158949,63668305,RLP
chr15,Bn63659,45774434,92287363,46512929,TNL
chr15,Bn63660,92215464,92337656,122192,TNL
chr15,Bn63661,7361966,39316828,31954862,CN
chr15,Bn63662,63619240,85202028,21582788,RLP
chr15,Bn63663,33552976,69535565,35982589,CN
chr15,Bn63664,32527707,36574948,4047241,RLP
chr15,Bn63665,9284928,37223254,27938326,TN
chr15,Bn63666,41053213,53850773,12797560,TNL
chr15,Bn63667,51686091,60995792,9309701,RLP
chr15,Bn63668,46176700,65890935,19714235,CN
chr15,Bn63669,26175032,87660092,61485060,CN
chr15,Bn63670,36705012,80338546,43633534,TNL
chr15,Bn63671,17582888,74309800,56726912,RLP
chr15,Bn63672,78204640,84020160,5815520,RLP
chr15,Bn63673,7071572,42984089,35912517,TNL
chr15,Bn63674,53439376,81714565,28275189,CN
chr15,Bn63675,19293759,81797242,62503483,CN
chr15,Bn63676,13546758,93321831,79775073,RLP
chr15,Bn63677,50378274,89153386,38775112,TNL
chr15,Bn63678,39967151,50814357,10847206,TNL
chr15,Bn63679,16753415,22943842,6190427,CNL
chr15,Bn63680,15799747,62261027,46461280,RLP
chr15,Bn63681,84521346,91285766,6764420,CN
chr15,Bn63682,52998105,68098394,15100289,TNL
chr15,Bn63683,37913056,78376170,40463114,RLK
chr15,Bn63684,50392443,71754520,21362077,CN
chr15,Bn63685,21549091,60353209,38804118,CNL
chr15,Bn63686,92777231,94277637,1500406,CN
chr15,Bn63687,98266565,99437660,1171095,RLP
chr15,Bn63688,96620014,98099285,1479271,RLP
chr15,Bn63689,22058080,83299662,61241582,TN
chr15,Bn63690,9072978,97045311,87972333,TN
chr15,Bn63691,3431172,91890575,88459403,RLK
chr15,Bn63692,37349005,87154569,49805564,CN
chr15,Bn63693,88109533,88731276,621743,TNL
chr15,Bn63694,18403400,57380800,38977400,RLP
chr15,Bn63695,24288323,25061291,772968,CN
chr15,Bn63696,87571516,90615738,3044222,TN
chr15,Bn63697,82124610,88058995,5934385,TN
chr15,Bn63698,4127639,17639181,13511542,TNL
chr15,Bn63699,28526225,80011729,51485504,TN
chr15,Bn63700,93844150,99500759,5656609,CNL
chr15,Bn63701,50909062,87187371,36278309,TN
chr15,Bn63702,69628182,87384089,17755907,TNL
chr15,Bn63703,87389384,89993849,2604465,CN
chr15,Bn63704,23700296,59244619,35544323,TN
chr15,Bn63705,50175665,85953490,35777825,TNL
chr15,Bn63706,42155099,91693407,49538308,RLK
chr15,Bn63707,89441879,96506598,7064719,NBS
chr15,Bn63708,75155360,80738008,5582648,TNL
chr15,Bn63709,35311175,54202208,18891033,CNL
chr15,Bn63710,80496098,81917710,1421612,TN
chr15,Bn63711,67251151,67487793,236642,NBS
chr15,Bn63712,82228540,96088244,13859704,NBS
chr15,Bn63713,26058783,42243305,16184522,NBS
chr15,Bn63714,13096435,20247806,7151371,TN
chr15,Bn63715,1582941,56002399,54419458,TNL
chr15,Bn63716,41825324,79111719,37286395,TN
chr15,Bn63717,15528113,64276982,48748869,NBS
chr15,Bn63718,93126104,95243010,2116906,TN
chr15,Bn63719,81263516,97345954,16082438,CNL
chr15,Bn63720,41150808,61843072,20692264,RLP
chr15,Bn63721,67475448,99532861,32057413,CNL
chr15,Bn63722,88475754,99324474,10848720,NBS
chr15,Bn63723,43825022,46406802,2581780,RLP
chr15,Bn63724,46030905,67521390,21490485,CN
chr15,Bn63725,36757009,95244570,58487561,TNL
chr15,Bn63726,22571105,33983196,11412091,RLP
chr15,Bn63727,94401914,97547076,3145162,CN
chr15,Bn63728,88501167,95543652,7042485,RLP
chr15,Bn63729,69185572,87969406,18783834,CNL
chr15,Bn63730,96224161,97588815,1364654,CN
chr15,Bn63731,61424941,87277148,25852207,TN
chr15,Bn63732,7104518,47229900,40125382,TNL
chr15,Bn63733,13473700,93393373,79919673,NBS
chr15,Bn63734,79103107,95374144,16271037,RLK
chr15,Bn63735,58914284,73060899,14146615,CNL
chr15,Bn63736,64254381,88648133,24393752,TNL
chr15,Bn63737,22715096,73451008,50735912,RLP
chr15,Bn63738,67969691,77645574,9675883,TN
chr15,Bn63739,70428032,77117266,6689234,CNL
chr15,Bn63740,29480351,64167149,34686798,TNL
chr15,Bn63741,47535025,96423715,48888690,TNL
chr15,Bn63742,45131971,66972524,21840553,CNL
chr15,Bn63743,98204404,99702154,1497750,CN
chr15,Bn63744,76845559,83147429,6301870,NBS
chr15,Bn63745,14407937,18606023,4198086,CNL
chr15,Bn63746,35910471,86211904,50301433,RLP
chr15,Bn63747,27246375,81095074,53848699,TN
chr15,Bn63748,79576164,86114673,6538509,CNL
chr15,Bn63749,11053321,37645432,26592111,CNL
chr15,Bn63750,12034847,47051145,35016298,RLK
chr15,Bn63751,84811745,92358031,7546286,TNL
chr15,Bn63752,99798279,99938721,140442,RLK
chr15,Bn63753,34907936,72107990,37200054,NBS
chr15,Bn63754,8568253,65525574,56957321,RLP
chr15,Bn63755,44644488,80571984,35927496,RLP
chr15,Bn63756,2404113,99480409,97076296,RLP
chr15,Bn63757,4133242,22277380,18144138,RLP
chr15,Bn63758,76073487,95142130,19068643,TNL
chr15,Bn63759,7708487,35644164,27935677,RLK
chr15,Bn63760,51635525,56480296,4844771,CN
chr15,Bn63761,31887842,49204284,17316442,TN
chr15,Bn63762,81572233,93787366,12215133,TNL
chr15,Bn63763,31911463,39496363,7584900,CNL
chr15,Bn63764,8428284,36818316,28390032,NBS
chr15,Bn63765,57363298,99660967,42297669,RLP
chr15,Bn63766,44598822,75973608,31374786,TN
chr15,Bn63767,17125034,90529429,73404395,RLP
chr15,Bn63768,47326294,71384984,24058690,NBS
chr15,Bn63769,17028166,54029999,37001833,TN
chr15,Bn63770,21159028,90639026,69479998,TNL
chr15,Bn63771,46735918,95285795,48549877,CNL
chr15,Bn63772,96721684,96729026,7342,RLK
chr15,Bn63773,10903922,10967272,63350,RLK
chr15,Bn63774,87918454,94400844,6482390,TN
chr15,Bn63775,99261264,99843387,582123,RLP
chr15,Bn63776,43137683,77093448,33955765,RLK
chr15,Bn63777,77226092,99171183,21945091,TNL
chr15,Bn63778,74141985,81098684,6956699,NBS
chr15,Bn63779,41170837,75325140,34154303,RLK
chr15,Bn63780,70420813,70810493,389680,CNL
chr15,Bn63781,61476930,76112302,14635372,NBS
chr15,Bn63782,18687402,75351425,56664023,NBS
chr15,Bn63783,46785958,61269606,14483648,CNL
chr15,Bn63784,44176425,98257318,54080893,TN
chr15,Bn63785,44621215,63255684,18634469,RLK
chr15,Bn63786,36061391,79112778,43051387,RLK
chr15,Bn63787,41312364,48790494,7478130,TN
chr15,Bn63788,88150741,98439636,10288895,TN
chr15,Bn63789,15310155,16668859,1358704,TN
chr15,Bn63790,10730141,54514757,43784616,CNL
chr15,Bn63791,92682738,97567305,4884567,TN
chr15,Bn63792,27194993,71044793,43849800,CNL
chr15,Bn63793,17015029,31064444,14049415,RLK
chr15,Bn63794,56264909,96122593,39857684,TNL
chr15,Bn63795,35371257,95331383,59960126,TNL
chr15,Bn63796,6172064,30476715,24304651,TN
chr15,Bn63797,81365467,86820689,5455222,RLP
chr15,Bn63798,21964166,49202375,27238209,CNL
chr15,Bn63799,89525355,96638549,7113194,RLK
chr15,Bn63800,3458703,60913640,57454937,RLP
chr15,Bn63801,80686046,82570555,1884509,TNL
chr15,Bn63802,72726340,94271189,21544849,TN
chr15,Bn63803,81297275,95587397,14290122,NBS
chr15,Bn63804,88264832,94606244,6341412,TN
chr15,Bn63805,59466513,69626260,10159747,CN
chr15,Bn63806,57216580,70936639,13720059,TN
chr15,Bn63807,39016438,92638740,53622302,NBS
chr15,Bn63808,45067080,76696471,31629391,CNL
chr15,Bn63809,72308731,83941218,11632487,CNL
chr15,Bn63810,83573880,99947110,16373230,CNL
chr15,Bn63811,72647272,81859902,9212630,TN
chr15,Bn63812,58519382,86857710,28338328,TNL
chr15,Bn63813,38512656,65981860,27469204,RLK
chr15,Bn63814,23405212,78086988,54681776,TN
chr15,Bn63815,3877558,61201102,57323544,CN
chr15,Bn63816,62620433,66910504,4290071,RLP
chr15,Bn63817,77757852,90139363,12381511,RLK
chr15,Bn63818,52054342,53066703,1012361,NBS
chr15,Bn63819,82125919,90313493,8187574,TN
chr15,Bn63820,73812668,91233318,17420650,NBS
chr15,Bn63821,96283939,97656750,1372811,RLP
chr15,Bn63822,98537453,98810760,273307,CN
chr15,Bn63823,19319728,31165919,11846191,CN
chr15,Bn63824,43496139,77074566,33578427,CN
chr15,Bn63825,39910131,82284981,42374850,TNL
chr15,Bn63826,48924581,62106050,13181469,TN
chr15,Bn63827,99329072,99764757,435685,RLP
chr15,Bn63828,57690081,99304864,41614783,TNL
chr15,Bn63829,95992157,98180543,2188386,CNL
chr15,Bn63830,83766611,96549628,12783017,RLK
chr15,Bn63831,41956667,57415974,15459307,CNL
chr15,Bn63832,51618980,83758246,32139266,TNL
chr15,Bn63833,85442267,98858033,13415766,CN
chr15,Bn63834,58314193,91672932,33358739,TNL
chr15,Bn63835,83462204,84088522,626318,RLK
chr15,Bn63836,41359423,91684397,50324974,CNL
chr15,Bn63837,60166670,74804859,14638189,RLP
chr15,Bn63838,57161097,63324721,6163624,CN
chr15,Bn63839,19267403,92653658,73386255,CNL
chr15,Bn63840,80695979,90748552,10052573,CNL
chr15,Bn63841,30899445,40317983,9418538,RLK
chr15,Bn63842,62703918,84687178,21983260,TN
chr15,Bn63843,49426620,61631827,12205207,RLP
chr15,Bn63844,88010164,96363143,8352979,CNL
chr15,Bn63845,58639346,66504677,7865331,CN
chr15,Bn63846,12624813,98669553,86044740,CNL
chr15,Bn63847,27814960,81700763,53885803,RLK
chr15,Bn63848,97309962,97326885,16923,RLK
chr15,Bn63849,20553004,69049943,48496939,CNL
chr15,Bn63850,46392938,75446838,29053900,TNL
chr15,Bn63851,42381083,45051498,2670415,TN
chr15,Bn63852,9714039,59263664,49549625,CN
chr15,Bn63853,2237102,94371926,92134824,NBS
chr15,Bn63854,85515844,92397805,6881961,RLK
chr15,Bn63855,90879318,93244245,2364927,CN
chr15,Bn63856,91524179,96638089,5113910,RLK
chr15,Bn63857,30572338,33883346,3311008,CNL
chr15,Bn63858,3356046,66337433,62981387,TN
chr15,Bn63859,12060586,53913165,41852579,TN
chr15,Bn63860,86005753,98130982,12125229,TN
chr15,Bn63861,94156995,95260316,1103321,TN
chr15,Bn63862,95555914,99968993,4413079,TNL
chr15,Bn63863,16651367,50880959,34229592,CN
chr15,Bn63864,51156692,59463926,8307234,RLK
chr15,Bn63865,82225315,96307081,14081766,RLP
chr15,Bn63866,58761310,74468426,15707116,TN
chr15,Bn63867,82137236,88763651,6626415,CN
chr15,Bn63868,84181479,98392522,14211043,RLP
chr15,Bn63869,52438465,87600186,35161721,RLP
chr15,Bn63870,93859710,94542619,682909,CN
chr15,Bn63871,25226567,74324171,49097604,TN
chr15,Bn63872,45294113,49743234,4449121,CN
chr15,Bn63873,62490016,94632593,32142577,CN
chr15,Bn63874,96464201,96669656,205455,TNL
chr15,Bn63875,90499248,97921792,7422544,TN
chr15,Bn63876,64080577,91401368,27320791,RLP
chr15,Bn63877,11399953,67973981,56574028,RLP
chr15,Bn63878,78295549,93432671,15137122,CNL
chr15,Bn63879,37807301,68269039,30461738,RLK
chr15,Bn63880,77644641,96245712,18601071,NBS
chr15,Bn63881,55637964,74192046,18554082,CNL
chr15,Bn63882,64768706,94299455,29530749,TNL
chr15,Bn63883,79131090,98839445,19708355,TNL
chr15,Bn63884,34012174,37169207,3157033,RLP
chr15,Bn63885,49862307,61220961,11358654,RLK
chr15,Bn63886,76989245,83745383,6756138,CN
chr15,Bn63887,15235042,81510142,66275100,TNL
chr15,Bn63888,88022212,92510417,4488205,NBS
chr15,Bn63889,34813647,36439748,1626101,NBS
chr15,Bn63890,16869412,25591997,8722585,RLP
chr15,Bn63891,28351733,68430661,40078928,TN
chr15,Bn63892,16987104,93272287,76285183,CNL
chr15,Bn63893,70900196,94576294,23676098,RLP
chr15,Bn63894,32451320,93464109,61012789,NBS
chr15,Bn63895,21488699,97641841,76153142,CN
chr15,Bn63896,62581224,99133927,36552703,RLP
chr15,Bn63897,4325542,41636754,37311212,NBS
chr15,Bn63898,36117770,67415206,31297436,CNL
chr15,Bn63899,20284813,42118581,21833768,CNL
chr15,Bn63900,52661075,60322328,7661253,CNL
chr15,Bn63901,63880747,71046726,7165979,RLP
chr15,Bn63902,7590991,50543633,42952642,CN
chr15,Bn63903,61809525,87695224,25885699,CNL
chr15,Bn63904,4988515,14371560,9383045,TNL
chr15,Bn63905,51633223,85448953,33815730,NBS
chr15,Bn63906,84369278,96074740,11705462,TNL
chr15,Bn63907,76855523,91462635,14607112,TNL
chr15,Bn63908,97886911,98651320,764409,CNL
chr15,Bn63909,17527797,80272130,62744333,TN
chr15,Bn63910,15484243,95211035,79726792,TNL
chr15,Bn63911,14410455,24444002,10033547,CN
chr15,Bn63912,9629110,40068147,30439037,NBS
chr15,Bn63913,95576022,96001759,425737,CN
chr15,Bn63914,82892757,84181248,1288491,TN
chr15,Bn63915,2265218,83538780,81273562,CNL
chr15,Bn63916,5353376,36831649,31478273,RLK
chr15,Bn63917,89252831,99338478,10085647,NBS
chr15,Bn63918,56092513,63513384,7420871,NBS
chr15,Bn63919,54705584,85387449,30681865,NBS
chr15,Bn63920,3142464,30126706,26984242,NBS
chr15,Bn63921,44441658,56628477,12186819,CN
chr15,Bn63922,58441156,74219823,15778667,RLP
chr15,Bn63923,7260207,20771593,13511386,RLP
chr15,Bn63924,57579922,80203408,22623486,RLK
chr15,Bn63925,73457576,77562884,4105308,TN
chr15,Bn63926,44072371,57130955,13058584,CNL
chr15,Bn63927,96490879,97885618,1394739,RLK
chr15,Bn63928,31983240,33199323,1216083,NBS
chr15,Bn63929,67518095,70188602,2670507,TNL
chr15,Bn63930,92596925,93602848,1005923,RLP
chr15,Bn63931,71793022,89712429,17919407,RLP
chr15,Bn63932,11729596,36566932,24837336,TN
chr15,Bn63933,99636263,99977972,341709,NBS
chr15,Bn63934,79236047,91694347,12458300,RLK
chr15,Bn63935,62398560,80249304,17850744,RLK
chr15,Bn63936,68407772,69533424,1125652,RLK
chr15,Bn63937,9790667,78152435,68361768,CN
chr15,Bn63938,53444803,68587712,15142909,RLK
chr15,Bn63939,68833599,71219739,2386140,TN
chr15,Bn63940,71120317,77722940,6602623,CN
chr15,Bn63941,24595905,73215847,48619942,CNL
chr15,Bn63942,2097958,41331249,39233291,NBS
chr15,Bn63943,27835536,80316701,52481165,NBS
chr15,Bn63944,79784242,99407823,19623581,RLK
chr15,Bn63945,84985948,86884828,1898880,TN
chr15,Bn63946,46814005,54749474,7935469,TNL
chr15,Bn63947,15006718,53223629,38216911,TN
chr15,Bn63948,77823565,95229084,17405519,RLP
chr15,Bn63949,76763710,83941216,7177506,CNL
chr15,Bn63950,36130252,89378824,53248572,CNL
chr15,Bn63951,74961546,82288757,7327211,NBS
chr15,Bn63952,45424522,80489373,35064851,TNL
chr15,Bn63953,8643209,20616801,11973592,TN
chr15,Bn63954,71546323,79882058,8335735,RLP
chr15,Bn63955,78110031,93919079,15809048,RLK
chr15,Bn63956,87958287,91597750,3639463,CNL
chr15,Bn63957,97762366,99173766,1411400,RLK
chr15,Bn63958,10031686,23795653,13763967,CNL
chr15,Bn63959,95187777,95497840,310063,CN
chr15,Bn63960,17758898,33943973,16185075,RLP
chr15,Bn63961,83093907,96006038,12912131,RLK
chr15,Bn63962,71145625,87859716,16714091,TN
chr15,Bn63963,59286484,69311904,10025420,NBS
chr15,Bn63964,53535904,76116420,22580516,TN
chr15,Bn63965,23659855,31781945,8122090,RLP
chr15,Bn63966,76055647,91607309,15551662,CNL
chr15,Bn63967,20757293,50297806,29540513,TN
chr15,Bn63968,37881632,95363175,57481543,TN
chr15,Bn63969,8756950,22774077,14017127,RLK
chr15,Bn63970,47996669,95979010,47982341,TN
chr15,Bn63971,98221871,99391142,1169271,CNL
chr15,Bn63972,66708844,78773668,12064824,NBS
chr15,Bn63973,85958756,99244928,13286172,NBS
chr15,Bn63974,39546729,75395521,35848792,NBS
chr15,Bn63975,74470563,74724846,254283,RLK
chr15,Bn63976,34195060,61759978,27564918,RLK
chr15,Bn63977,6321875,34422980,28101105,RLK
chr15,Bn63978,74536914,91147102,16610188,NBS
chr15,Bn63979,35699640,72913430,37213790,RLK
chr15,Bn63980,66095456,93579791,27484335,RLK
chr15,Bn63981,41304006,90155249,48851243,RLP
chr15,Bn63982,97631585,97809163,177578,RLP
chr15,Bn63983,67713184,78130797,10417613,TNL
chr15,Bn63984,49732026,77715120,27983094,RLP
chr15,Bn63985,96144150,98470707,2326557,NBS
chr15,Bn63986,29613357,68419545,38806188,NBS
chr15,Bn63987,75693070,93034623,17341553,NBS
chr15,Bn63988,44646674,69082290,24435616,RLK
chr15,Bn63989,53432920,90867329,37434409,RLP
chr15,Bn63990,26548203,69131933,42583730,TN
chr15,Bn63991,77391886,80823365,3431479,TNL
chr15,Bn63992,38223644,76377309,38153665,CNL
chr15,Bn63993,30032739,94451641,64418902,RLP
chr15,Bn63994,17009143,96511679,79502536,CNL
chr15,Bn63995,95627154,96314174,687020,TN
chr15,Bn63996,47100866,66290400,19189534,RLK
chr15,Bn63997,84518263,97290193,12771930,TN
chr15,Bn63998,9184740,56974054,47789314,TNL
chr15,Bn63999,87078883,93244930,6166047,NBS
chr15,Bn64000,55117046,99360080,44243034,CNL
chr15,Bn64001,77542554,88260129,10717575,RLP
chr15,Bn64002,22303537,47111601,24808064,TNL
chr15,Bn64003,25369098,85711491,60342393,RLK
chr15,Bn64004,24598311,94960314,70362003,NBS
chr15,Bn64005,12680464,27286636,14606172,CNL
chr15,Bn64006,79065122,94623180,15558058,NBS
chr15,Bn64007,20105709,83116212,63010503,TNL
chr15,Bn64008,6175859,79299032,73123173,CN
chr15,Bn64009,80303315,99941580,19638265,CNL
chr15,Bn64010,2957266,25495018,22537752,RLP
chr15,Bn64011,35249646,44151155,8901509,TN
chr15,Bn64012,54051375,90971899,36920524,CNL
chr15,Bn64013,74048233,95078936,21030703,TN
chr15,Bn64014,95495517,96673716,1178199,CNL
chr15,Bn64015,52625461,68866925,16241464,CNL
chr15,Bn64016,53558490,67773709,14215219,CN
chr15,Bn64017,42833133,84641928,41808795,CN
chr15,Bn64018,26604496,65000995,38396499,CNL
chr15,Bn64019,27169872,83163106,55993234,CN
chr15,Bn64020,25002186,83159376,58157190,NBS
chr15,Bn64021,19266170,92306789,73040619,TN
chr15,Bn64022,87359982,91298062,3938080,CNL
chr15,Bn64023,78876379,88080962,9204583,TN
chr15,Bn64024,12234597,18565398,6330801,RLK
chr15,Bn64025,29588285,59532367,29944082,CN
chr15,Bn64026,17057308,17408153,350845,CN
chr15,Bn64027,4290582,15519666,11229084,NBS
chr15,Bn64028,45016151,72801084,27784933,RLP
chr15,Bn64029,17612059,98093087,80481028,RLP
chr15,Bn64030,28687875,37458722,8770847,RLK
chr15,Bn64031,89409645,94269952,4860307,TN
chr15,Bn64032,99075754,99921334,845580,CN
chr15,Bn64033,23323131,26578739,3255608,TNL
chr15,Bn64034,14545165,88747985,74202820,TN
chr15,Bn64035,98471359,99231335,759976,TNL
chr15,Bn64036,75327497,91147309,15819812,TNL
chr15,Bn64037,29978822,35229965,5251143,TN
chr15,Bn64038,97426295,97904126,477831,RLP
chr15,Bn64039,49835527,80522188,30686661,CN
chr15,Bn64040,33492733,87880832,54388099,RLP
chr15,Bn64041,77316158,98335120,21018962,RLK
chr15,Bn64042,18545549,89753359,71207810,CN
chr15,Bn64043,26549741,62041777,35492036,RLK
chr15,Bn64044,85898240,97518957,11620717,TN
chr15,Bn64045,94281089,98796753,4515664,NBS
chr15,Bn64046,76232523,76931956,699433,TN
chr15,Bn64047,61816248,79315819,17499571,RLK
chr15,Bn64048,57232265,99982112,42749847,RLP
chr15,Bn64049,36106622,58006902,21900280,RLK
chr15,Bn64050,83217496,99559129,16341633,CNL
chr15,Bn64051,1811812,17863521,16051709,CN
chr15,Bn64052,17228561,56042966,38814405,RLP
chr15,Bn64053,42528926,82921231,40392305,NBS
chr15,Bn64054,13254948,74932627,61677679,CNL
chr15,Bn64055,80067668,84767449,4699781,RLP
chr15,Bn64056,35843893,68355588,32511695,CN
chr15,Bn64057,77756177,93660293,15904116,RLK
chr15,Bn64058,59746494,98645155,38898661,TNL
chr15,Bn64059,52053185,94709390,42656205,CNL
chr15,Bn64060,29989518,92595977,62606459,TNL
chr15,Bn64061,72357190,81324784,8967594,TNL
chr15,Bn64062,15066134,66048958,50982824,TNL
chr15,Bn64063,62165415,68554047,6388632,TNL
chr15,Bn64064,76816896,99791159,22974263,NBS
chr15,Bn64065,70559548,99826893,29267345,TN
chr15,Bn64066,69221622,98109580,28887958,CNL
chr15,Bn64067,1901750,10633476,8731726,CNL
chr15,Bn64068,36615912,98512801,61896889,NBS
chr15,Bn64069,46324903,79591782,33266879,CNL
chr15,Bn64070,48219212,50023799,1804587,CN
chr15,Bn64071,30477840,34401965,3924125,RLK
chr15,Bn64072,68311287,98418469,30107182,TN
chr15,Bn64073,6423084,16750611,10327527,TNL
chr15,Bn64074,2894670,7881967,4987297,RLK
chr15,Bn64075,31903665,95759897,63856232,CN
chr15,Bn64076,17600807,34036762,16435955,CN
chr15,Bn64077,25232201,83132648,57900447,CN
chr15,Bn64078,34594270,57228618,22634348,CNL
chr15,Bn64079,63052676,95283324,32230648,TNL
chr15,Bn64080,79239990,88638035,9398045,NBS
chr15,Bn64081,58627124,66382119,7754995,CN
chr15,Bn64082,98198939,98402227,203288,NBS
chr15,Bn64083,23781128,39494853,15713725,CNL
chr15,Bn64084,12496005,75825556,63329551,CNL
chr15,Bn64085,59115063,69911140,10796077,CN
chr15,Bn64086,99422429,99640390,217961,RLP
chr15,Bn64087,2465280,49401661,46936381,NBS
chr15,Bn64088,77561774,93357049,15795275,CNL
chr15,Bn64089,85607075,92211434,6604359,NBS
chr15,Bn64090,16583405,75605125,59021720,TN
chr15,Bn64091,64935734,94338387,29402653,RLK
chr15,Bn64092,68095370,93122179,25026809,TN
chr15,Bn64093,20435848,75035900,54600052,TN
chr15,Bn64094,70373286,82814710,12441424,RLK
chr15,Bn64095,67108743,79351053,12242310,TN
chr15,Bn64096,54681080,58730100,4049020,CNL
chr15,Bn64097,16021273,40595492,24574219,TN
chr15,Bn64098,12598390,58505297,45906907,NBS
chr15,Bn64099,8875857,17362715,8486858,RLP
chr15,Bn64100,53469935,91551420,38081485,CNL
chr15,Bn64101,34750605,38264303,3513698,RLP
chr15,Bn64102,7621140,68279262,60658122,TNL
chr15,Bn64103,92607866,94128784,1520918,CNL
chr15,Bn64104,96274748,98505422,2230674,RLP
chr15,Bn64105,20883686,37356038,16472352,CN
chr15,Bn64106,28662736,73116861,44454125,CNL
chr15,Bn64107,97008764,98009551,1000787,RLP
chr15,Bn64108,26279610,84986399,58706789,RLP
chr15,Bn64109,80971963,87564730,6592767,TN
chr15,Bn64110,71570454,72445743,875289,NBS
chr15,Bn64111,94037939,98418510,4380571,CNL
chr15,Bn64112,53122675,68750571,15627896,RLP
chr15,Bn64113,95742815,99149497,3406682,RLP
chr15,Bn64114,76041794,83685018,7643224,TN
chr15,Bn64115,94039736,98055272,4015536,CN
chr15,Bn64116,70201446,94692727,24491281,TN
chr15,Bn64117,33357880,59924450,26566570,NBS
chr15,Bn64118,38386512,60638366,22251854,RLP
chr15,Bn64119,51846605,90351573,38504968,NBS
chr15,Bn64120,53732485,62873888,9141403,CNL
chr15,Bn64121,62840328,82345867,19505539,CNL
chr15,Bn64122,84057478,98732289,14674811,CNL
chr15,Bn64123,58490079,69288052,10797973,CNL
chr15,Bn64124,86425948,93453629,7027681,CN
chr15,Bn64125,27420263,88780283,61360020,CN
chr15,Bn64126,85643595,89721255,4077660,CN
chr15,Bn64127,9445908,84140825,74694917,NBS
chr15,Bn64128,85202055,86137345,935290,RLP
chr15,Bn64129,62525860,92955308,30429448,CNL
chr15,Bn64130,27991810,58092165,30100355,TNL
chr15,Bn64131,89008248,90893890,1885642,CNL
chr15,Bn64132,72359247,86289073,13929826,TNL
chr15,Bn64133,1481762,37538673,36056911,NBS
chr15,Bn64134,41319776,91760088,50440312,CN
chr15,Bn64135,38114807,79368836,41254029,CN
chr15,Bn64136,29039161,94195833,65156672,TNL
chr15,Bn64137,7684898,98797911,91113013,RLP
chr15,Bn64138,64011099,71638629,7627530,TNL
chr15,Bn64139,90044089,97204335,7160246,RLK
chr15,Bn64140,95360053,98430984,3070931,RLP
chr15,Bn64141,46063389,82646898,36583509,CNL
chr15,Bn64142,41288028,80879251,39591223,CNL
chr15,Bn64143,70974900,94609033,23634133,CN
chr15,Bn64144,75255614,75341115,85501,CN
chr15,Bn64145,9351933,16785856,7433923,TNL
chr15,Bn64146,94379809,98217431,3837622,RLK
chr15,Bn64147,60121909,75022928,14901019,RLK
chr15,Bn64148,32750552,84000017,51249465,RLK
chr15,Bn64149,41011880,65642813,24630933,NBS
chr15,Bn64150,87313660,97125034,9811374,NBS
chr15,Bn64151,79567302,84544610,4977308,RLK
chr15,Bn64152,21476986,48106933,26629947,CN
chr15,Bn64153,74874446,91745688,16871242,NBS
chr15,Bn64154,87491179,97601419,10110240,RLK
chr15,Bn64155,54593113,72101841,17508728,RLK
chr15,Bn64156,25159061,82307084,57148023,TN
chr15,Bn64157,82433433,92062823,9629390,RLK
chr15,Bn64158,26905700,99939864,73034164,TN
chr15,Bn64159,33811723,93834441,60022718,NBS
chr15,Bn64160,58691626,96250408,37558782,RLP
chr15,Bn64161,92525649,96935755,4410106,RLK
chr15,Bn64162,13018774,52339155,39320381,TNL
chr15,Bn64163,11705401,20143403,8438002,RLK
chr15,Bn64164,11945482,36888998,24943516,CNL
chr15,Bn64165,63255522,66551201,3295679,RLK
chr15,Bn64166,11429586,30600914,19171328,TN
chr15,Bn64167,9267798,26282349,17014551,CNL
chr15,Bn64168,93508908,98805750,5296842,CNL
chr15,Bn64169,84006216,89974232,5968016,RLP
chr15,Bn64170,69285446,70908511,1623065,TNL
chr15,Bn64171,16636870,70395289,53758419,RLK
chr16,Bn64172,58530049,86685714,28155665,CN
chr16,Bn64173,2870927,85790775,82919848,RLK
chr16,Bn64174,2498298,11613363,9115065,RLK
chr16,Bn64175,2230795,57622816,55392021,CN
chr16,Bn64176,47997591,74341163,26343572,TNL
chr16,Bn64177,63349520,63554358,204838,NBS
chr16,Bn64178,74125922,78349674,4223752,RLP
chr16,Bn64179,60065733,87609628,27543895,CNL
chr16,Bn64180,3634755,7462220,3827465,TNL
chr16,Bn64181,83018932,98342016,15323084,TN
chr16,Bn64182,71999474,88460747,16461273,NBS
chr16,Bn64183,44373200,83195860,38822660,RLK
chr16,Bn64184,38728004,73470193,34742189,CNL
chr16,Bn64185,10336754,37880236,27543482,RLK
chr16,Bn64186,43123493,54866319,11742826,TN
chr16,Bn64187,36587076,92318231,55731155,TN
chr16,Bn64188,8468972,18264353,9795381,TNL
chr16,Bn64189,70755167,76904411,6149244,CNL
chr16,Bn64190,76004090,98074574,22070484,TNL
chr16,Bn64191,4081085,44688573,40607488,NBS
chr16,Bn64192,2802380,88139107,85336727,RLK
chr16,Bn64193,80449994,89639734,9189740,NBS
chr16,Bn64194,19525532,45985324,26459792,NBS
chr16,Bn64195,37351957,98646937,61294980,CNL
chr16,Bn64196,17003573,45127887,28124314,RLP
chr16,Bn64197,41506799,46082747,4575948,NBS
chr16,Bn64198,98256735,99711151,1454416,RLP
chr16,Bn64199,96503582,99004509,2500927,TNL
chr16,Bn64200,68628703,76715254,8086551,TNL
chr16,Bn64201,34847923,72048614,37200691,TNL
chr16,Bn64202,7234331,78158028,70923697,TNL
chr16,Bn64203,85747153,90228108,4480955,NBS
chr16,Bn64204,13409154,68157309,54748155,CNL
chr16,Bn64205,41311498,51936259,10624761,TNL
chr16,Bn64206,38505917,97935123,59429206,CNL
chr16,Bn64207,67180458,84361571,17181113,TNL
chr16,Bn64208,44150640,78767671,34617031,TN
chr16,Bn64209,87595489,89353749,1758260,NBS
chr16,Bn64210,38899371,99173697,60274326,NBS
chr16,Bn64211,93486824,99864254,6377430,CN
chr16,Bn64212,4393077,53003414,48610337,CN
chr16,Bn64213,37050818,88054897,51004079,CN
chr16,Bn64214,95456941,99030283,3573342,TN
chr16,Bn64215,43615419,80899189,37283770,CN
chr16,Bn64216,69074248,84013749,14939501,TNL
chr16,Bn64217,42406054,72699505,30293451,CN
chr16,Bn64218,78717180,84784475,6067295,RLP
chr16,Bn64219,54410601,70837745,16427144,CNL
chr16,Bn64220,72517405,90294252,17776847,CN
chr16,Bn64221,14687241,90876718,76189477,CN
chr16,Bn64222,72792101,79111137,6319036,RLK
chr16,Bn64223,62599600,84891875,22292275,TNL
chr16,Bn64224,53651769,70702919,17051150,TNL
chr16,Bn64225,17141173,93093813,75952640,RLP
chr16,Bn64226,57729812,66415016,8685204,CNL
chr16,Bn64227,70355278,96784667,26429389,NBS
chr16,Bn64228,72445059,97283617,24838558,TNL
chr16,Bn64229,48199731,61180109,12980378,CN
chr16,Bn64230,45862284,91203288,45341004,CNL
chr16,Bn64231,21181591,29483546,8301955,TN
chr16,Bn64232,83104165,97265675,14161510,CNL
chr16,Bn64233,15821777,82139593,66317816,NBS
chr16,Bn64234,48999552,68528974,19529422,CNL
chr16,Bn64235,16890447,76160104,59269657,TN
chr16,Bn64236,31466373,90681379,59215006,TN
chr16,Bn64237,66938791,91056179,24117388,NBS
chr16,Bn64238,4285841,59305030,55019189,RLP
chr16,Bn64239,86188261,94182600,7994339,CNL
chr16,Bn64240,16074295,72758254,56683959,TNL
chr16,Bn64241,56230267,90779797,34549530,RLP
chr16,Bn64242,43283456,73268315,29984859,TN
chr16,Bn64243,5676747,31858887,26182140,CN
chr16,Bn64244,85716360,86990936,1274576,RLK
chr16,Bn64245,10546730,83875252,73328522,RLK
chr16,Bn64246,56106394,89550819,33444425,RLK
chr16,Bn64247,25487725,63660314,38172589,TNL
chr16,Bn64248,72604379,85830812,13226433,CN
chr16,Bn64249,3876014,47092715,43216701,CNL
chr16,Bn64250,4695622,34768891,30073269,CNL
chr16,Bn64251,5341330,62744533,57403203,TN
chr16,Bn64252,50599322,51874148,1274826,RLP
chr16,Bn64253,85336926,94198992,8862066,CN
chr16,Bn64254,87113003,99189423,12076420,TNL
chr16,Bn64255,58377196,64644081,6266885,RLP
chr16,Bn64256,77570547,86767495,9196948,CNL
chr16,Bn64257,88723602,91028832,2305230,TN
chr16,Bn64258,7891093,83661107,75770014,RLK
chr16,Bn64259,54917108,70766996,15849888,CNL
chr16,Bn64260,99482929,99640726,157797,RLK
chr16,Bn64261,2181262,7191063,5009801,CNL
chr16,Bn64262,41761957,50106160,8344203,CN
chr16,Bn64263,14927850,51122898,36195048,RLP
chr16,Bn64264,83912385,87049867,3137482,RLK
chr16,Bn64265,92069601,97486747,5417146,NBS
chr16,Bn64266,53472286,67557691,14085405,CN
chr16,Bn64267,45991485,48691508,2700023,NBS
chr16,Bn64268,35689677,74399566,38709889,CN
chr16,Bn64269,69690229,72461667,2771438,RLK
chr16,Bn64270,96212389,97774658,1562269,NBS
chr16,Bn64271,61845447,69166638,7321191,CNL
chr16,Bn64272,88310433,95949527,7639094,RLP
chr16,Bn64273,51223686,85494506,34270820,RLP
chr16,Bn64274,78109240,96454792,18345552,CNL
chr16,Bn64275,78771464,81040703,2269239,TN
chr16,Bn64276,38483992,55829319,17345327,RLP
chr16,Bn64277,41914609,54784381,12869772,TNL
chr16,Bn64278,97389091,99105982,1716891,CN
chr16,Bn64279,96234062,97830909,1596847,NBS
chr16,Bn64280,66397165,98651716,32254551,TNL
chr16,Bn64281,10265198,97514459,87249261,TNL
chr16,Bn64282,84070935,88914480,4843545,CNL
chr16,Bn64283,37610631,94009964,56399333,CNL
chr16,Bn64284,70713887,92316479,21602592,CNL
chr16,Bn64285,93542547,97018068,3475521,CN
chr16,Bn64286,24284380,48312387,24028007,TNL
chr16,Bn64287,92522129,93649221,1127092,RLK
chr16,Bn64288,75183346,78170261,2986915,TNL
chr16,Bn64289,94335857,94589512,253655,RLK
chr16,Bn64290,32088812,46823534,14734722,RLK
chr16,Bn64291,62359702,73919905,11560203,TNL
chr16,Bn64292,70664786,89314269,18649483,TN
chr16,Bn64293,3154071,36980886,33826815,TN
chr16,Bn64294,41653236,58865453,17212217,TNL
chr16,Bn64295,19201157,67879144,48677987,TNL
chr16,Bn64296,72816883,98336163,25519280,TNL
chr16,Bn64297,17075288,81309237,64233949,RLK
chr16,Bn64298,58839107,91003793,32164686,NBS
chr16,Bn64299,79324456,83348522,4024066,RLK
chr16,Bn64300,1164704,44363205,43198501,NBS
chr16,Bn64301,64981428,86137259,21155831,TNL
chr16,Bn64302,13782287,56299290,42517003,NBS
chr16,Bn64303,3240103,75783397,72543294,CNL
chr16,Bn64304,80730312,99485329,18755017,NBS
chr16,Bn64305,22571610,53688798,31117188,CN
chr16,Bn64306,23060055,45033846,21973791,CN
chr16,Bn64307,65175419,91078537,25903118,NBS
chr16,Bn64308,36518144,51834989,15316845,RLP
chr16,Bn64309,32093630,90294463,58200833,TNL
chr16,Bn64310,84198337,95283214,11084877,CN
chr16,Bn64311,76739046,94686145,17947099,NBS
chr16,Bn64312,72788841,97944881,25156040,TN
chr16,Bn64313,21065644,82017566,60951922,CN
chr16,Bn64314,60437597,73222634,12785037,CNL
chr16,Bn64315,83302495,89388565,6086070,TNL
chr16,Bn64316,45015605,55517621,10502016,TN
chr16,Bn64317,60772091,99414670,38642579,RLP
chr16,Bn64318,23897603,74864904,50967301,TNL
chr16,Bn64319,1968242,84366745,82398503,TNL
chr16,Bn64320,84747242,91151515,6404273,RLP
chr16,Bn64321,83711995,97444770,13732775,TN
chr16,Bn64322,84560551,96280243,11719692,RLK
chr16,Bn64323,97141403,98274245,1132842,CNL
chr16,Bn64324,37500943,41996031,4495088,NBS
chr16,Bn64325,26511774,63163855,36652081,RLK
chr16,Bn64326,95981150,97696142,1714992,TN
chr16,Bn64327,39751826,92600743,52848917,RLK
chr16,Bn64328,19008400,26690347,7681947,TNL
chr16,Bn64329,75582512,85466673,9884161,TNL
chr16,Bn64330,71830356,97024775,25194419,CNL
chr16,Bn64331,18379718,99613572,81233854,RLP
chr16,Bn64332,25265144,76126574,50861430,TN
chr16,Bn64333,40151052,59238244,19087192,CN
chr16,Bn64334,77331574,94145729,16814155,CNL
chr16,Bn64335,53460564,64227203,10766639,NBS
chr16,Bn64336,52747617,68550896,15803279,TNL
chr16,Bn64337,29277278,91745877,62468599,CN
chr16,Bn64338,54515086,54891733,376647,CN
chr16,Bn64339,37979186,71194905,33215719,TNL
chr16,Bn64340,9242637,85635996,76393359,TN
chr16,Bn64341,5619543,69104446,63484903,RLK
chr16,Bn64342,51626839,91436319,39809480,TN
chr16,Bn64343,90484444,99462934,8978490,CNL
chr16,Bn64344,38896603,61590488,22693885,CN
chr16,Bn64345,14715310,43276848,28561538,RLK
chr16,Bn64346,34652380,82299400,47647020,RLK
chr16,Bn64347,13774664,76777552,63002888,RLP
chr16,Bn64348,97829250,98099494,270244,CN
chr16,Bn64349,86841721,89313865,2472144,TNL
chr16,Bn64350,4788501,30451925,25663424,NBS
chr16,Bn64351,20294821,24207337,3912516,NBS
chr16,Bn64352,20322486,27624210,7301724,CN
chr16,Bn64353,66850186,79418871,12568685,TNL
chr16,Bn64354,16221398,68101462,51880064,TNL
chr16,Bn64355,58869011,95118171,36249160,RLK
chr16,Bn64356,85940073,96949571,11009498,CNL
chr16,Bn64357,7500955,47188625,39687670,TNL
chr16,Bn64358,88964801,95559237,6594436,TN
chr16,Bn64359,92967379,94309408,1342029,RLP
chr16,Bn64360,84248667,90731930,6483263,RLP
chr16,Bn64361,30511916,69293782,38781866,NBS
chr16,Bn64362,23729384,73941575,50212191,TNL
chr16,Bn64363,14891929,27815016,12923087,CN
chr16,Bn64364,3686343,13171763,9485420,CN
chr16,Bn64365,20085279,65013280,44928001,CN
chr16,Bn64366,12281843,98414413,86132570,RLK
chr16,Bn64367,81214762,99562474,18347712,RLK
chr16,Bn64368,78319636,99422429,21102793,TNL
chr16,Bn64369,2877811,17337485,14459674,CNL
chr16,Bn64370,23977283,69241643,45264360,RLP
chr16,Bn64371,12554586,90165410,77610824,RLP
chr16,Bn64372,39169474,79598654,40429180,CN
chr16,Bn64373,46996662,53676444,6679782,NBS
chr16,Bn64374,36048164,50791369,14743205,RLP
chr16,Bn64375,53435011,55700382,2265371,NBS
chr16,Bn64376,86906456,90215456,3309000,NBS
chr16,Bn64377,59266466,98605658,39339192,CNL
chr16,Bn64378,95454265,95756612,302347,CNL
chr16,Bn64379,88171023,98037137,9866114,RLK
chr16,Bn64380,35215295,98399672,63184377,CNL
chr16,Bn64381,93922552,95128649,1206097,CNL
chr16,Bn64382,55393885,57515728,2121843,TN
chr16,Bn64383,25879042,29721457,3842415,RLK
chr16,Bn64384,54524297,57368619,2844322,TN
chr16,Bn64385,84166691,95317749,11151058,CNL
chr16,Bn64386,51019967,55232389,4212422,CN
chr16,Bn64387,22661701,64861281,42199580,RLP
chr16,Bn64388,58876400,77323817,18447417,TN
chr16,Bn64389,96591034,96617309,26275,NBS
chr16,Bn64390,89340601,99315724,9975123,TN
chr16,Bn64391,80995410,87288108,6292698,NBS
chr16,Bn64392,44837557,53717766,8880209,TNL
chr16,Bn64393,72043698,72824858,781160,NBS
chr16,Bn64394,41345759,85403977,44058218,NBS
chr16,Bn64395,71990174,92950225,20960051,RLP
chr16,Bn64396,40451690,88367334,47915644,CN
chr16,Bn64397,5188670,34311475,29122805,TNL
chr16,Bn64398,32604515,76477577,43873062,RLK
chr16,Bn64399,38012084,83802066,45789982,CNL
chr16,Bn64400,10312361,31755323,21442962,NBS
chr16,Bn64401,23632491,57083557,33451066,TN
chr16,Bn64402,78503930,86939082,8435152,RLK
chr16,Bn64403,46749775,92391985,45642210,RLK
chr16,Bn64404,71225249,91890472,20665223,CNL
chr16,Bn64405,47771189,62975803,15204614,RLP
chr16,Bn64406,90356391,96042405,5686014,TN
chr16,Bn64407,68663144,87491845,18828701,RLK
chr16,Bn64408,28488594,48388128,19899534,RLP
chr16,Bn64409,19072808,27615212,8542404,CN
chr16,Bn64410,24981425,30477710,5496285,TN
chr16,Bn64411,73026133,92274369,19248236,TNL
chr16,Bn64412,2421520,99377218,96955698,RLP
chr16,Bn64413,39540823,70696393,31155570,RLK
chr16,Bn64414,10588807,12491968,1903161,CN
chr16,Bn64415,26535316,76571256,50035940,TNL
chr16,Bn64416,3803188,8842865,5039677,TN
chr16,Bn64417,97786125,99973122,2186997,CN
chr16,Bn64418,42195728,86769565,44573837,CNL
chr16,Bn64419,27619945,92620750,65000805,CNL
chr16,Bn64420,24602808,51252803,26649995,RLP
chr16,Bn64421,87627764,99465431,11837667,TNL
chr16,Bn64422,81246647,82793336,1546689,RLK
chr16,Bn64423,8052750,82709799,74657049,TN
chr16,Bn64424,40774527,70041347,29266820,TN
chr16,Bn64425,54069903,95452178,41382275,TN
chr16,Bn64426,45473054,58090775,12617721,CNL
chr16,Bn64427,32777571,67054842,34277271,TN
chr16,Bn64428,13162599,75110132,61947533,TN
chr16,Bn64429,52769891,80131869,27361978,CNL
chr16,Bn64430,36393130,91716085,55322955,TN
chr16,Bn64431,69826793,97515917,27689124,RLK
chr16,Bn64432,54460880,77035376,22574496,NBS
chr16,Bn64433,36261112,46329127,10068015,TNL
chr16,Bn64434,50273740,84056340,33782600,RLP
chr16,Bn64435,54592085,70421737,15829652,RLP
chr16,Bn64436,54808821,77931140,23122319,TNL
chr16,Bn64437,74734792,83662550,8927758,CNL
chr16,Bn64438,90835122,94050792,3215670,TN
chr16,Bn64439,82680100,90595595,7915495,CN
chr16,Bn64440,73021208,96192440,23171232,RLK
chr16,Bn64441,34234437,83610501,49376064,RLK
chr16,Bn64442,74078552,93763603,19685051,CNL
chr16,Bn64443,79071337,90984231,11912894,RLP
chr16,Bn64444,13304103,52219766,38915663,RLP
chr16,Bn64445,97250564,97799456,548892,CNL
chr16,Bn64446,97934777,98435803,501026,TNL
chr16,Bn64447,19423170,41085556,21662386,CNL
chr16,Bn64448,38255279,43257802,5002523,CN
chr16,Bn64449,97919174,97960355,41181,CNL
chr16,Bn64450,97554154,98970962,1416808,NBS
chr16,Bn64451,84331016,86525449,2194433,TN
chr16,Bn64452,66033029,92491531,26458502,NBS
chr16,Bn64453,41460506,99146497,57685991,RLK
chr16,Bn64454,86059062,92779202,6720140,CN
chr16,Bn64455,88414436,89833263,1418827,NBS
chr16,Bn64456,6316807,89813796,83496989,RLK
chr16,Bn64457,14716502,28760271,14043769,RLP
chr16,Bn64458,18263999,44689767,26425768,TN
chr16,Bn64459,77322747,85010718,7687971,CN
chr16,Bn64460,98277900,98480011,202111,TN
chr16,Bn64461,15423355,79196041,63772686,NBS
chr16,Bn64462,56894593,72026976,15132383,CN
chr16,Bn64463,65748037,91582044,25834007,NBS
chr16,Bn64464,60292020,78370939,18078919,CN
chr16,Bn64465,18891177,78110460,59219283,RLK
chr16,Bn64466,4119331,48017365,43898034,TNL
chr16,Bn64467,48572280,86719722,38147442,RLP
chr16,Bn64468,31168978,71259981,40091003,RLP
chr16,Bn64469,50712981,86571767,35858786,NBS
chr16,Bn64470,53587617,54356562,768945,CN
chr16,Bn64471,24651900,68648816,43996916,CNL
chr16,Bn64472,2922804,41834090,38911286,TN
chr16,Bn64473,94754228,96831056,2076828,RLK
chr16,Bn64474,4510395,5661754,1151359,RLP
chr16,Bn64475,79839154,89043090,9203936,RLK
chr16,Bn64476,77990713,96072267,18081554,RLP
chr16,Bn64477,76858169,81958178,5100009,TN
chr16,Bn64478,90669193,98031757,7362564,TN
chr16,Bn64479,35690020,88320122,52630102,CNL
chr16,Bn64480,70807562,97792355,26984793,RLK
chr16,Bn64481,97256907,98988276,1731369,TN
chr16,Bn64482,5520378,50162218,44641840,TN
chr16,Bn64483,84631298,89271855,4640557,CN
chr16,Bn64484,50547095,56803266,6256171,NBS
chr16,Bn64485,93344815,98667995,5323180,CNL
chr16,Bn64486,86081330,96515459,10434129,RLP
chr16,Bn64487,96231651,98567647,2335996,CN
chr16,Bn64488,4135050,97666603,93531553,RLK
chr16,Bn64489,49394210,79900111,30505901,RLK
chr16,Bn64490,70661911,75389230,4727319,TN
chr16,Bn64491,7843580,83888696,76045116,CN
chr16,Bn64492,62674231,68551439,5877208,RLK
chr16,Bn64493,82224714,89702629,7477915,TN
chr16,Bn64494,65889968,96304412,30414444,CN
chr16,Bn64495,72795360,75747025,2951665,NBS
chr16,Bn64496,83429903,88135651,4705748,CNL
chr16,Bn64497,33767227,39417515,5650288,RLP
chr16,Bn64498,21666597,25437249,3770652,CNL
chr16,Bn64499,72041191,85299833,13258642,RLK
chr16,Bn64500,74843879,96388772,21544893,TN
chr16,Bn64501,56713589,60291505,3577916,RLK
chr16,Bn64502,15409060,48089007,32679947,NBS
chr16,Bn64503,65835920,77490044,11654124,RLP
chr16,Bn64504,16941643,96098316,79156673,TNL
chr16,Bn64505,14137127,58436710,44299583,CN
chr16,Bn64506,95842178,99331086,3488908,TNL
chr16,Bn64507,56425499,87871026,31445527,TN
chr16,Bn64508,97380281,97467708,87427,RLK
chr16,Bn64509,90613487,98513195,7899708,TNL
chr16,Bn64510,64409275,75388027,10978752,CNL
chr16,Bn64511,48869131,53640280,4771149,RLK
chr16,Bn64512,82211373,92944999,10733626,RLK
chr16,Bn64513,31946298,59455100,27508802,RLP
chr16,Bn64514,70261074,73699718,3438644,NBS
chr16,Bn64515,33738970,67332451,33593481,CNL
chr16,Bn64516,8398276,94802441,86404165,CN
chr16,Bn64517,3927924,89466012,85538088,NBS
chr16,Bn64518,91940861,95550983,3610122,RLP
chr16,Bn64519,81384904,83573203,2188299,RLP
chr16,Bn64520,15625285,59368185,43742900,CNL
chr16,Bn64521,83380461,86645299,3264838,NBS
chr16,Bn64522,92890878,96397048,3506170,CN
chr16,Bn64523,49459077,76765457,27306380,TNL
chr16,Bn64524,33194260,97042766,63848506,TN
chr16,Bn64525,61122199,83085183,21962984,RLK
chr16,Bn64526,36915640,76183775,39268135,TNL
chr16,Bn64527,92222206,92311867,89661,TN
chr16,Bn64528,14439085,22506631,8067546,TNL
chr16,Bn64529,15070991,16021569,950578,CN
chr16,Bn64530,8013465,13584045,5570580,TNL
chr16,Bn64531,27795131,31328814,3533683,NBS
chr16,Bn64532,68393995,89841928,21447933,RLK
chr16,Bn64533,36321570,95679978,59358408,CN
chr16,Bn64534,28829933,79043641,50213708,RLP
chr16,Bn64535,24158703,60687760,36529057,RLP
chr16,Bn64536,26902413,93610899,66708486,CNL
chr16,Bn64537,86130020,94908492,8778472,CNL
chr16,Bn64538,94534284,99965762,5431478,RLK
chr16,Bn64539,63839535,93171790,29332255,RLP
chr16,Bn64540,61402626,91802759,30400133,RLP
chr16,Bn64541,24743688,98021418,73277730,CN
chr16,Bn64542,49938268,78889104,28950836,CN
chr16,Bn64543,69990767,73620436,3629669,CN
chr16,Bn64544,47441522,54969306,7527784,CNL
chr16,Bn64545,68297526,69622247,1324721,CN
chr16,Bn64546,32031917,55433214,23401297,CN
chr16,Bn64547,76624265,83300505,6676240,CNL
chr16,Bn64548,93354109,94788961,1434852,NBS
chr16,Bn64549,61433578,92197416,30763838,TN
chr16,Bn64550,74751323,99358407,24607084,TN
chr16,Bn64551,88513414,97803462,9290048,CNL
chr16,Bn64552,79757306,94398427,14641121,RLK
chr16,Bn64553,62226713,79884322,17657609,RLK
chr16,Bn64554,98697565,99833133,1135568,CN
chr16,Bn64555,35557253,66528907,30971654,RLK
chr16,Bn64556,18197212,41564033,23366821,CNL
chr16,Bn64557,22163746,58682539,36518793,RLK
chr16,Bn64558,27027941,56325739,29297798,RLK
chr16,Bn64559,47156444,60954810,13798366,RLP
chr16,Bn64560,49520249,93523747,44003498,NBS
chr16,Bn64561,3666382,96406290,92739908,TNL
chr16,Bn64562,84681070,95423547,10742477,TNL
chr16,Bn64563,90348466,94797251,4448785,TN
chr16,Bn64564,36331391,75120000,38788609,RLP
chr16,Bn64565,91591063,91999260,408197,RLK
chr16,Bn64566,68196005,96608269,28412264,TN
chr16,Bn64567,67843533,72942921,5099388,RLP
chr16,Bn64568,75668126,85944276,10276150,TNL
chr16,Bn64569,64106451,64353447,246996,TNL
chr16,Bn64570,17334659,72475288,55140629,RLK
chr16,Bn64571,78929381,88330491,9401110,NBS
chr16,Bn64572,78783955,81171379,2387424,TN
chr16,Bn64573,81667991,94144728,12476737,CNL
chr16,Bn64574,75977006,87886512,11909506,TN
chr16,Bn64575,67322403,88147093,20824690,NBS
chr16,Bn64576,56924217,74840358,17916141,CN
chr16,Bn64577,90326428,94675781,4349353,TN
chr16,Bn64578,37852309,73415031,35562722,RLK
chr16,Bn64579,48792948,87107521,38314573,RLK
chr16,Bn64580,58237529,80556035,22318506,CN
chr16,Bn64581,69586362,98167416,28581054,RLK
chr16,Bn64582,29299102,85623145,56324043,CN
chr16,Bn64583,71128275,82897838,11769563,TN
chr16,Bn64584,13149784,57149620,43999836,NBS
chr16,Bn64585,28471663,55495952,27024289,RLK
chr16,Bn64586,77765256,79378942,1613686,NBS
chr16,Bn64587,36877193,96165771,59288578,CNL
chr16,Bn64588,73328132,82098443,8770311,CNL
chr16,Bn64589,10170560,15249707,5079147,TN
chr16,Bn64590,38373888,63834336,25460448,NBS
chr16,Bn64591,40117336,62866301,22748965,RLP
chr16,Bn64592,41580356,58333854,16753498,CNL
chr16,Bn64593,35341592,86869792,51528200,CNL
chr16,Bn64594,28283826,60912645,32628819,RLP
chr16,Bn64595,24448233,95431614,70983381,CN
chr16,Bn64596,99248721,99805357,556636,NBS
chr16,Bn64597,26343526,96220575,69877049,RLK
chr16,Bn64598,65905578,79466356,13560778,NBS
chr16,Bn64599,71997431,90885889,18888458,TNL
chr16,Bn64600,85167335,95356959,10189624,RLP
chr16,Bn64601,53644365,56468181,2823816,TN
chr16,Bn64602,76657677,83867422,7209745,TNL
chr16,Bn64603,27437567,45668534,18230967,RLP
chr16,Bn64604,79483621,86099046,6615425,RLP
chr16,Bn64605,45474494,65164755,19690261,RLP
chr16,Bn64606,61078040,92604728,31526688,CNL
chr16,Bn64607,88815691,91859890,3044199,TN
chr16,Bn64608,25500930,85368903,59867973,RLP
chr16,Bn64609,86849137,97177634,10328497,CNL
chr16,Bn64610,37034497,98495770,61461273,CN
chr16,Bn64611,90175578,97460894,7285316,RLK
chr16,Bn64612,11706326,45379960,33673634,NBS
chr16,Bn64613,61334030,88195345,26861315,RLP
chr16,Bn64614,75757842,89582668,13824826,TN
chr16,Bn64615,7420118,13382453,5962335,RLK
chr16,Bn64616,86313247,89294066,2980819,CNL
chr16,Bn64617,9869476,93053730,83184254,TN
chr16,Bn64618,67500700,73627861,6127161,TN
chr16,Bn64619,69454035,85215843,15761808,RLP
chr16,Bn64620,26671310,97233053,70561743,TNL
chr16,Bn64621,35031350,59502809,24471459,CNL
chr16,Bn64622,91779179,97423462,5644283,TNL
chr16,Bn64623,74656013,77984739,3328726,TN
chr16,Bn64624,32690961,95665241,62974280,CN
chr16,Bn64625,76287249,93903672,17616423,TN
chr16,Bn64626,76569726,80678212,4108486,RLK
chr16,Bn64627,91693556,92667802,974246,RLP
chr16,Bn64628,49091930,80217552,31125622,TNL
chr16,Bn64629,19489349,77494955,58005606,RLP
chr16,Bn64630,55122904,77866971,22744067,NBS
chr16,Bn64631,63846007,99585763,35739756,TN
chr16,Bn64632,14133701,89668380,75534679,CNL
chr16,Bn64633,91092447,98571588,7479141,TN
chr16,Bn64634,83973276,92320559,8347283,CN
chr16,Bn64635,72249533,83224843,10975310,TNL
chr16,Bn64636,70087371,71468173,1380802,RLP
chr16,Bn64637,54444494,83242228,28797734,RLP
chr16,Bn64638,97028331,98602192,1573861,TNL
chr16,Bn64639,26954339,93185021,66230682,TNL
chr16,Bn64640,87771638,90533571,2761933,RLP
chr16,Bn64641,51127168,86515176,35388008,RLK
chr16,Bn64642,23910772,61135962,37225190,RLK
chr16,Bn64643,74575392,90865672,16290280,RLP
chr16,Bn64644,59300780,73108349,13807569,CN
chr16,Bn64645,61423215,66297976,4874761,RLK
chr16,Bn64646,51492709,74088637,22595928,CNL
chr16,Bn64647,62160998,71106506,8945508,CN
chr16,Bn64648,59081969,94438775,35356806,TN
chr16,Bn64649,5048207,95452853,90404646,CN
chr16,Bn64650,69018159,84436808,15418649,RLK
chr16,Bn64651,55712271,70481757,14769486,RLP
chr16,Bn64652,98855696,99188063,332367,NBS
chr16,Bn64653,9420889,27655884,18234995,RLK
chr16,Bn64654,92591591,93896383,1304792,TN
chr16,Bn64655,32435395,33998206,1562811,CN
chr16,Bn64656,57509907,65745365,8235458,CNL
chr16,Bn64657,69520858,80611515,11090657,RLK
chr16,Bn64658,96608828,97965523,1356695,TNL
chr16,Bn64659,52642282,77907946,25265664,CNL
chr16,Bn64660,99083792,99135419,51627,TNL
chr16,Bn64661,1392500,67210916,65818416,TNL
chr16,Bn64662,63092195,63635205,543010,TN
chr16,Bn64663,56196565,61086382,4889817,CN
chr16,Bn64664,62970327,84971180,22000853,TNL
chr16,Bn64665,84692906,95926616,11233710,CNL
chr16,Bn64666,66632623,84504709,17872086,CNL
chr16,Bn64667,66342632,77351960,11009328,CN
chr16,Bn64668,49009908,85901671,36891763,CN
chr16,Bn64669,33403675,45485013,12081338,RLK
chr16,Bn64670,67583576,91275228,23691652,CN
chr16,Bn64671,31703771,46678066,14974295,RLK
chr16,Bn64672,47774660,57484969,9710309,CNL
chr16,Bn64673,38618969,69059110,30440141,RLK
chr16,Bn64674,48064404,67297815,19233411,TNL
chr16,Bn64675,64612100,85451089,20838989,NBS
chr16,Bn64676,71606293,98058544,26452251,TN
chr16,Bn64677,90844150,96276811,5432661,NBS
chr16,Bn64678,34503472,58276049,23772577,CNL
chr16,Bn64679,94595436,99294741,4699305,CNL
chr16,Bn64680,18625766,46392363,27766597,NBS
chr16,Bn64681,27373649,44371709,16998060,RLP
chr16,Bn64682,36974003,45401130,8427127,TNL
chr16,Bn64683,1475149,58366897,56891748,TN
chr16,Bn64684,93532095,94057230,525135,RLP
chr16,Bn64685,63894683,99835356,35940673,NBS
chr16,Bn64686,2715093,50076558,47361465,CNL
chr16,Bn64687,24912841,41617944,16705103,RLK
chr16,Bn64688,6588591,87444909,80856318,RLK
chr16,Bn64689,90870712,97157492,6286780,NBS
chr16,Bn64690,73497738,91622355,18124617,CNL
chr16,Bn64691,49733497,95198443,45464946,CNL
chr16,Bn64692,80041330,90460399,10419069,TNL
chr16,Bn64693,21569928,39471759,17901831,CN
chr16,Bn64694,18221164,89557784,71336620,CNL
chr16,Bn64695,35844791,36068511,223720,TN
chr16,Bn64696,81532814,98997425,17464611,RLK
chr16,Bn64697,20981827,87515261,66533434,RLK
chr16,Bn64698,24653087,98192037,73538950,TN
chr16,Bn64699,15765336,69639301,53873965,RLK
chr16,Bn64700,21638658,96349017,74710359,RLP
chr16,Bn64701,96230888,96627984,397096,TN
chr16,Bn64702,64432826,78032022,13599196,CNL
chr16,Bn64703,16840937,25918541,9077604,TNL
chr16,Bn64704,95962134,99723854,3761720,TN
chr16,Bn64705,99596542,99737974,141432,NBS
chr16,Bn64706,32519486,50906249,18386763,RLK
chr16,Bn64707,75431500,95614422,20182922,NBS
chr16,Bn64708,14862943,15441843,578900,RLP
chr16,Bn64709,71168857,74690794,3521937,RLK
chr16,Bn64710,29228629,50352203,21123574,RLK
chr16,Bn64711,86688989,92874229,6185240,TNL
chr16,Bn64712,1727930,8852405,7124475,TNL
chr16,Bn64713,29039990,31527156,2487166,RLP
chr16,Bn64714,68108652,78607621,10498969,NBS
chr16,Bn64715,34089670,62443301,28353631,NBS
chr16,Bn64716,92494474,95943573,3449099,NBS
chr16,Bn64717,46984877,96277087,49292210,NBS
chr16,Bn64718,26576664,84771948,58195284,TN
chr16,Bn64719,81854564,89770504,7915940,TNL
chr16,Bn64720,59013229,64851366,5838137,CNL
chr16,Bn64721,19401851,81291925,61890074,RLP
chr16,Bn64722,15188500,17918588,2730088,TN
chr16,Bn64723,85775800,99237367,13461567,TNL
chr16,Bn64724,62381247,93405766,31024519,NBS
chr16,Bn64725,82846302,82881774,35472,TN
chr16,Bn64726,46942165,56422357,9480192,TNL
chr16,Bn64727,8334886,83030913,74696027,TN
chr16,Bn64728,52999605,54407839,1408234,TN
chr16,Bn64729,29544540,76388621,46844081,NBS
chr16,Bn64730,39783453,67529143,27745690,TN
chr16,Bn64731,21160313,82883428,61723115,RLK
chr16,Bn64732,16116916,92266436,76149520,NBS
chr16,Bn64733,56300980,73310148,17009168,RLK
chr16,Bn64734,98472132,98729139,257007,NBS
chr16,Bn64735,11014988,90503595,79488607,RLK
chr16,Bn64736,54515108,81030864,26515756,TN
chr16,Bn64737,32125750,78043981,45918231,NBS
chr16,Bn64738,2939487,75354353,72414866,CN
chr16,Bn64739,37373792,86019370,48645578,CNL
chr16,Bn64740,72722272,78177920,5455648,TNL
chr16,Bn64741,98501752,99358903,857151,TN
chr16,Bn64742,11765574,32030254,20264680,TN
chr16,Bn64743,23825422,76914689,53089267,CNL
chr16,Bn64744,15122699,34950354,19827655,RLP
chr16,Bn64745,19427418,54952436,35525018,TN
chr16,Bn64746,11882196,60492991,48610795,NBS
chr16,Bn64747,97531534,98927390,1395856,CNL
chr16,Bn64748,66927070,73144825,6217755,RLP
chr16,Bn64749,62767451,99516929,36749478,RLP
chr16,Bn64750,44554118,87572616,43018498,CNL
chr16,Bn64751,6856900,75362886,68505986,TNL
chr16,Bn64752,70710647,87198976,16488329,CN
chr16,Bn64753,97657984,98062083,404099,NBS
chr16,Bn64754,79600852,91721441,12120589,CNL
chr16,Bn64755,47717333,49564374,1847041,RLP
chr16,Bn64756,40821679,62879326,22057647,CNL
chr16,Bn64757,37107977,98287602,61179625,NBS
chr16,Bn64758,47150071,56389744,9239673,TN
chr16,Bn64759,93937296,94997536,1060240,CN
chr16,Bn64760,57645768,60712677,3066909,TN
chr16,Bn64761,57950247,79432092,21481845,TNL
chr16,Bn64762,80500299,88630192,8129893,TN
chr16,Bn64763,21133272,44288755,23155483,CNL
chr16,Bn64764,36118406,85146878,49028472,RLK
chr16,Bn64765,71373686,89902939,18529253,RLP
chr16,Bn64766,59186941,86253624,27066683,RLK
chr16,Bn64767,94362237,96069850,1707613,CN
chr16,Bn64768,15757177,24008047,8250870,NBS
chr16,Bn64769,27084696,99174971,72090275,RLP
chr16,Bn64770,29480679,33960900,4480221,TN
chr16,Bn64771,32252588,77145207,44892619,RLP
chr16,Bn64772,47381323,76949282,29567959,TN
chr16,Bn64773,11611236,77987890,66376654,TNL
chr16,Bn64774,60861033,96020250,35159217,RLK
chr16,Bn64775,8791355,19935022,11143667,RLP
chr16,Bn64776,86948727,97374126,10425399,TN
chr16,Bn64777,55664431,86117396,30452965,RLP
chr16,Bn64778,21389143,66766656,45377513,CN
chr16,Bn64779,42109855,69793092,27683237,NBS
chr16,Bn64780,40544506,53875913,13331407,RLP
chr16,Bn64781,89115116,95140541,6025425,CN
chr16,Bn64782,79339078,99603465,20264387,CN
chr16,Bn64783,96218688,97797109,1578421,NBS
chr16,Bn64784,81657032,96034394,14377362,RLK
chr16,Bn64785,19182646,79480062,60297416,NBS
chr16,Bn64786,2682080,48307071,45624991,NBS
chr16,Bn64787,8026660,18608798,10582138,RLP
chr16,Bn64788,67996693,95893984,27897291,TNL
chr16,Bn64789,83473862,97869909,14396047,CNL
chr16,Bn64790,62912656,98975070,36062414,CNL
chr16,Bn64791,85114740,94693579,9578839,TN
chr16,Bn64792,5221060,91635594,86414534,RLP
chr16,Bn64793,80340578,95665416,15324838,TN
chr16,Bn64794,26344863,67952205,41607342,CNL
chr16,Bn64795,47080025,71359048,24279023,RLP
chr16,Bn64796,49268205,50563864,1295659,RLP
chr16,Bn64797,59037019,71804099,12767080,TNL
chr16,Bn64798,48647558,77804304,29156746,CNL
chr16,Bn64799,37340516,76118059,38777543,CN
chr16,Bn64800,35416371,49848798,14432427,CNL
chr16,Bn64801,25693942,95689203,69995261,TNL
chr16,Bn64802,49498414,87041971,37543557,CN
chr16,Bn64803,26232280,29494660,3262380,NBS
chr16,Bn64804,4633682,26803390,22169708,RLP
chr16,Bn64805,3771683,68060033,64288350,RLP
chr16,Bn64806,1383215,48308385,46925170,TN
chr16,Bn64807,44945471,72920739,27975268,TNL
chr16,Bn64808,68887880,93395805,24507925,RLK
chr16,Bn64809,39117907,42979456,3861549,CNL
chr16,Bn64810,97838719,99101126,1262407,RLP
chr16,Bn64811,25458108,27009402,1551294,CN
chr16,Bn64812,41999948,60561908,18561960,CNL
chr16,Bn64813,21698506,64164577,42466071,NBS
chr16,Bn64814,79674364,87037463,7363099,CN
chr16,Bn64815,81753401,85536835,3783434,TNL
chr16,Bn64816,94167192,97686529,3519337,CN
chr16,Bn64817,67879304,99134332,31255028,RLK
chr16,Bn64818,48591964,61181444,12589480,CN
chr16,Bn64819,85451604,92124434,6672830,NBS
chr16,Bn64820,26005554,26682707,677153,TNL
chr16,Bn64821,86948385,97952102,11003717,CNL
chr16,Bn64822,37923385,50790708,12867323,RLP
chr16,Bn64823,40681832,49231303,8549471,NBS
chr16,Bn64824,24080384,68476876,44396492,CN
chr16,Bn64825,3023835,23730648,20706813,CNL
chr16,Bn64826,8955462,95323428,86367966,TN
chr16,Bn64827,26710468,96448291,69737823,CN
chr16,Bn64828,14396486,45235421,30838935,CN
chr16,Bn64829,46205557,85484633,39279076,TN
chr16,Bn64830,6454867,38651875,32197008,CN
chr16,Bn64831,25183220,69312284,44129064,RLP
chr16,Bn64832,81360547,95324135,13963588,RLP
chr16,Bn64833,85569148,88490607,2921459,CN
chr16,Bn64834,88193373,93468443,5275070,TNL
chr16,Bn64835,50050777,62643922,12593145,RLK
chr16,Bn64836,74298798,92688698,18389900,TN
chr16,Bn64837,7275957,80362802,73086845,TN
chr16,Bn64838,32486651,40717305,8230654,TN
chr16,Bn64839,4894060,84867112,79973052,CN
chr16,Bn64840,26823218,69645859,42822641,RLP
chr16,Bn64841,42104102,79496914,37392812,NBS
chr16,Bn64842,23143267,24981041,1837774,TNL
chr16,Bn64843,71066139,77133818,6067679,RLP
chr16,Bn64844,58592239,61767219,3174980,CN
chr16,Bn64845,40210277,57038432,16828155,TN
chr16,Bn64846,42207121,52539062,10331941,NBS
chr16,Bn64847,66912883,89400008,22487125,RLP
chr16,Bn64848,5583859,57459795,51875936,TN
chr16,Bn64849,32498254,60093121,27594867,RLP
chr16,Bn64850,99124272,99201366,77094,CN
chr16,Bn64851,12318535,97871156,85552621,TNL
chr16,Bn64852,7722702,39378262,31655560,CN
chr16,Bn64853,54748448,56799793,2051345,CNL
chr16,Bn64854,36052628,82636559,46583931,CN
chr16,Bn64855,58320816,85895494,27574678,CNL
chr16,Bn64856,53579079,89601240,36022161,CNL
chr16,Bn64857,86904933,93731579,6826646,RLK
chr16,Bn64858,44535441,54021214,9485773,CN
chr16,Bn64859,80703458,96447446,15743988,CNL
chr16,Bn64860,53967028,84203769,30236741,CN
chr16,Bn64861,74040071,91212564,17172493,RLK
chr16,Bn64862,19478206,97002612,77524406,TN
chr16,Bn64863,66823484,94494701,27671217,NBS
chr16,Bn64864,67302012,97526307,30224295,RLK
chr16,Bn64865,98064797,98273814,209017,TNL
chr16,Bn64866,93640582,94870172,1229590,NBS
chr16,Bn64867,75490459,78740989,3250530,TNL
chr16,Bn64868,28891938,64045923,35153985,TN
chr16,Bn64869,60397833,92756299,32358466,CNL
chr16,Bn64870,71773512,73746120,1972608,TN
chr16,Bn64871,7772735,26920127,19147392,CN
chr16,Bn64872,13077108,43983672,30906564,CNL
chr16,Bn64873,51895229,89608008,37712779,RLK
chr16,Bn64874,1157101,75577975,74420874,TN
chr16,Bn64875,66203684,85765709,19562025,TN
chr16,Bn64876,63561323,78872537,15311214,NBS
chr16,Bn64877,85728248,98327614,12599366,RLK
chr16,Bn64878,63829508,95617112,31787604,TN
chr16,Bn64879,31719204,49606017,17886813,TNL
chr16,Bn64880,90143564,90597496,453932,TN
chr16,Bn64881,94578049,98729012,4150963,TN
chr16,Bn64882,79298386,90307236,11008850,CNL
chr16,Bn64883,48674591,88985264,40310673,CNL
chr16,Bn64884,83421916,97559055,14137139,TN
chr16,Bn64885,42161868,88886554,46724686,TNL
chr16,Bn64886,50669702,50957004,287302,TN
chr16,Bn64887,75438983,79145599,3706616,RLK
chr16,Bn64888,16823008,17133811,310803,TN
chr16,Bn64889,80267363,89517627,9250264,CNL
chr16,Bn64890,19120517,43222682,24102165,CNL
chr16,Bn64891,20298262,53739359,33441097,RLP
chr16,Bn64892,27107744,30227313,3119569,RLK
chr16,Bn64893,65294931,69238522,3943591,RLK
chr16,Bn64894,43261806,64086615,20824809,RLP
chr16,Bn64895,87253332,87733254,479922,TNL
chr16,Bn64896,36731292,88149540,51418248,CNL
chr16,Bn64897,7724782,32740727,25015945,CNL
chr16,Bn64898,94018632,99894104,5875472,RLP
chr16,Bn64899,19110861,94443014,75332153,CN
chr16,Bn64900,8001062,50179962,42178900,NBS
chr16,Bn64901,93323928,99525091,6201163,RLK
chr16,Bn64902,14889344,35701834,20812490,NBS
chr16,Bn64903,66023042,66301366,278324,TN
chr16,Bn64904,4504740,88850581,84345841,CNL
chr16,Bn64905,95735344,97077122,1341778,NBS
chr16,Bn64906,73540728,73890908,350180,TN
chr16,Bn64907,21874887,63242575,41367688,TNL
chr16,Bn64908,50515169,66339736,15824567,TN
chr16,Bn64909,70222597,74451773,4229176,NBS
chr16,Bn64910,49993723,58605902,8612179,RLK
chr16,Bn64911,12332026,79876516,67544490,NBS
chr16,Bn64912,32783424,65207440,32424016,CN
chr16,Bn64913,56862391,82979366,26116975,RLP
chr16,Bn64914,56126262,75493603,19367341,RLK
chr16,Bn64915,63135355,78978219,15842864,CN
chr16,Bn64916,3712432,67113437,63401005,CN
chr16,Bn64917,30555997,72716408,42160411,TNL
chr16,Bn64918,89217087,95637210,6420123,RLK
chr16,Bn64919,11577764,22438147,10860383,NBS
chr16,Bn64920,59783456,79782903,19999447,RLP
chr16,Bn64921,74936390,79966233,5029843,RLP
chr16,Bn64922,82781927,86732433,3950506,NBS
chr16,Bn64923,83903367,96386116,12482749,RLK
chr16,Bn64924,57425120,97505891,40080771,TN
chr16,Bn64925,13078781,76640709,63561928,RLP
chr16,Bn64926,93700365,97718218,4017853,TNL
chr16,Bn64927,99793597,99886657,93060,RLK
chr16,Bn64928,4072309,38432677,34360368,TN
chr16,Bn64929,48878791,69064961,20186170,RLP
chr16,Bn64930,75990946,79948041,3957095,RLP
chr16,Bn64931,83098389,95614453,12516064,RLP
chr16,Bn64932,98118224,98826158,707934,RLK
chr16,Bn64933,93668596,97624606,3956010,TN
chr16,Bn64934,15351933,38058604,22706671,NBS
chr16,Bn64935,2791006,85626516,82835510,CNL
chr16,Bn64936,2165442,86836985,84671543,CNL
chr16,Bn64937,73479033,91035338,17556305,TNL
chr16,Bn64938,61260499,70273231,9012732,RLK
chr16,Bn64939,67868090,85194619,17326529,RLK
chr16,Bn64940,87467843,94177729,6709886,CN
chr16,Bn64941,47406833,73844277,26437444,TN
chr16,Bn64942,9478128,77676728,68198600,RLP
chr16,Bn64943,61805027,69220012,7414985,TNL
chr16,Bn64944,39568296,62422404,22854108,CNL
chr16,Bn64945,63648900,63856376,207476,CNL
chr16,Bn64946,7368761,38173238,30804477,TNL
chr16,Bn64947,89182627,93400361,4217734,RLK
chr16,Bn64948,54819039,92107771,37288732,TNL
chr16,Bn64949,38532335,41979827,3447492,RLK
chr16,Bn64950,46071571,66962165,20890594,RLP
chr16,Bn64951,57865783,59783176,1917393,RLK
chr16,Bn64952,89454297,89897608,443311,CN
chr16,Bn64953,58643253,70401155,11757902,RLK
chr16,Bn64954,73910548,86579594,12669046,NBS
chr16,Bn64955,22551441,94246740,71695299,TNL
chr16,Bn64956,9033389,30087956,21054567,NBS
chr16,Bn64957,63229502,92996889,29767387,TNL
chr16,Bn64958,94651657,95225075,573418,NBS
chr16,Bn64959,20625200,61238735,40613535,TNL
chr16,Bn64960,20480013,84834479,64354466,CN
chr16,Bn64961,97814889,98797248,982359,CN
chr16,Bn64962,93417697,93831809,414112,TN
chr16,Bn64963,84380770,91242980,6862210,TN
chr16,Bn64964,75146784,99798550,24651766,TN
chr16,Bn64965,8792762,86496980,77704218,RLP
chr16,Bn64966,2408661,54078031,51669370,RLK
chr16,Bn64967,72496804,90426723,17929919,TNL
chr16,Bn64968,21291357,45658236,24366879,TN
chr16,Bn64969,83475942,95229204,11753262,RLP
chr16,Bn64970,12421655,22454382,10032727,RLK
chr16,Bn64971,42994470,81530454,38535984,TNL
chr16,Bn64972,79788699,88887826,9099127,RLP
chr16,Bn64973,54534591,71627367,17092776,CN
chr16,Bn64974,47922889,76653570,28730681,TN
chr16,Bn64975,88929967,98451957,9521990,TNL
chr16,Bn64976,39215889,54931688,15715799,TNL
chr16,Bn64977,76686692,97598216,20911524,TN
chr16,Bn64978,74470903,95618767,21147864,CNL
chr16,Bn64979,26962784,66010187,39047403,NBS
chr16,Bn64980,56744645,88962029,32217384,CNL
chr16,Bn64981,91657273,93437498,1780225,CN
chr16,Bn64982,26514723,82930910,56416187,CN
chr16,Bn64983,9339952,52488718,43148766,RLK
chr16,Bn64984,80159683,94215829,14056146,RLP
chr16,Bn64985,6985149,30617782,23632633,CN
chr16,Bn64986,45142910,62085483,16942573,CNL
chr16,Bn64987,2587807,48876372,46288565,NBS
chr16,Bn64988,56856113,87663759,30807646,TNL
chr16,Bn64989,75740717,77215007,1474290,TN
chr16,Bn64990,78281240,95373119,17091879,CNL
chr16,Bn64991,70852231,86979367,16127136,NBS
chr16,Bn64992,79825095,92263750,12438655,RLK
chr16,Bn64993,76645910,79332521,2686611,NBS
chr16,Bn64994,99074565,99925219,850654,RLK
chr16,Bn64995,19031741,84469621,65437880,CN
chr16,Bn64996,91952499,98886359,6933860,CNL
chr16,Bn64997,3078152,44553980,41475828,CNL
chr16,Bn64998,81779505,89769709,7990204,RLP
chr16,Bn64999,98550123,99543487,993364,CNL
chr16,Bn65000,16699644,35063898,18364254,RLK
chr16,Bn65001,35990994,56101716,20110722,RLK
chr16,Bn65002,17437247,51004052,33566805,NBS
chr16,Bn65003,40662961,90892249,50229288,RLK
chr16,Bn65004,22449077,67264467,44815390,TNL
chr16,Bn65005,86729612,99027275,12297663,CN
chr16,Bn65006,68975262,74657651,5682389,RLK
chr16,Bn65007,81031071,84129269,3098198,CN
chr16,Bn65008,23918008,77303998,53385990,CNL
chr16,Bn65009,29973820,97202406,67228586,TN
chr16,Bn65010,54435195,77016303,22581108,TN
chr16,Bn65011,46373739,49286776,2913037,TNL
chr16,Bn65012,22310402,32085964,9775562,RLP
chr16,Bn65013,42735790,60736501,18000711,CNL
chr16,Bn65014,32991663,65782916,32791253,TN
chr16,Bn65015,11603774,52204443,40600669,RLK
chr16,Bn65016,87374820,94812035,7437215,TNL
chr16,Bn65017,64150905,74405445,10254540,RLK
chr16,Bn65018,59831865,64466498,4634633,CNL
chr16,Bn65019,11614020,19116698,7502678,NBS
chr16,Bn65020,7224629,30240538,23015909,RLK
chr16,Bn65021,39022531,87117604,48095073,CN
chr16,Bn65022,40293980,42645615,2351635,RLP
chr16,Bn65023,91622265,97449963,5827698,CNL
chr16,Bn65024,87899380,98506337,10606957,TN
chr16,Bn65025,69198247,88852287,19654040,TN
chr16,Bn65026,80827560,96202769,15375209,CNL
chr16,Bn65027,57298855,76051548,18752693,RLK
chr16,Bn65028,82643488,93214690,10571202,TN
chr16,Bn65029,14410218,16451654,2041436,TNL
chr16,Bn65030,89995572,90155475,159903,TNL
chr16,Bn65031,18684048,55439288,36755240,RLK
chr16,Bn65032,36060240,95673037,59612797,RLK
chr16,Bn65033,92901165,93505099,603934,RLK
chr16,Bn65034,32946344,81859283,48912939,TN
chr16,Bn65035,23573768,88236824,64663056,RLK
chr16,Bn65036,11451131,83459055,72007924,TNL
chr16,Bn65037,48261884,92407079,44145195,CNL
chr16,Bn65038,90544071,94216520,3672449,CNL
chr16,Bn65039,87331051,91926021,4594970,RLK
chr16,Bn65040,69700231,92817676,23117445,RLK
chr16,Bn65041,86105613,92638010,6532397,TN
chr16,Bn65042,80474093,85021055,4546962,CNL
chr16,Bn65043,35412130,63513215,28101085,CN
chr16,Bn65044,65443572,79467924,14024352,CNL
chr16,Bn65045,7232542,28588591,21356049,RLP
chr16,Bn65046,8420731,45562560,37141829,TNL
chr16,Bn65047,67153447,90127696,22974249,CNL
chr16,Bn65048,21719080,59400402,37681322,RLK
chr16,Bn65049,47311896,60921723,13609827,RLP
chr16,Bn65050,93151846,99079543,5927697,CN
chr16,Bn65051,45953562,73215101,27261539,RLK
chr16,Bn65052,54142572,71534070,17391498,RLP
chr16,Bn65053,88983258,94465915,5482657,CNL
chr16,Bn65054,1625972,69992468,68366496,TNL
chr16,Bn65055,47111293,48013324,902031,NBS
chr16,Bn65056,45364013,80521067,35157054,RLP
chr16,Bn65057,30454609,49781354,19326745,TNL
chr16,Bn65058,45006817,47937627,2930810,RLK
chr16,Bn65059,92945332,94024318,1078986,CN
chr16,Bn65060,40439443,85148712,44709269,RLK
chr16,Bn65061,4781275,69964040,65182765,NBS
chr16,Bn65062,21343984,54275313,32931329,NBS
chr16,Bn65063,92953095,97202953,4249858,RLP
chr16,Bn65064,57175422,91867161,34691739,NBS
chr16,Bn65065,89012044,89321692,309648,RLP
chr16,Bn65066,1737659,92041774,90304115,RLP
chr16,Bn65067,10772542,56297957,45525415,RLK
chr16,Bn65068,12029546,15259596,3230050,RLK
chr16,Bn65069,62668850,87326625,24657775,RLK
chr16,Bn65070,11255160,29723874,18468714,RLP
chr16,Bn65071,29627984,83166240,53538256,RLP
chr16,Bn65072,90593775,96566318,5972543,NBS
chr16,Bn65073,65522162,89713004,24190842,RLP
chr16,Bn65074,41585463,56714338,15128875,CN
chr16,Bn65075,59156230,82801779,23645549,NBS
chr16,Bn65076,98415035,98601435,186400,TN
chr16,Bn65077,44511280,83671049,39159769,NBS
chr16,Bn65078,73247592,85465732,12218140,TNL
chr16,Bn65079,80361481,84468554,4107073,NBS
chr16,Bn65080,96703990,97296474,592484,CNL
chr16,Bn65081,62458675,99849409,37390734,TNL
chr16,Bn65082,35521089,78634678,43113589,NBS
chr16,Bn65083,10261503,14626227,4364724,NBS
chr16,Bn65084,16652679,54743518,38090839,NBS
chr16,Bn65085,7424702,34024045,26599343,RLK
chr16,Bn65086,97309063,98110022,800959,TNL
chr16,Bn65087,38210167,79500839,41290672,NBS
chr16,Bn65088,14333273,97722130,83388857,TN
chr16,Bn65089,73700836,90317838,16617002,RLP
chr16,Bn65090,42901952,53864804,10962852,RLP
chr16,Bn65091,25631561,85993233,60361672,RLK
chr16,Bn65092,11055305,57795248,46739943,CNL
chr16,Bn65093,90313025,95557544,5244519,TNL
chr16,Bn65094,52646875,93972362,41325487,CNL
chr16,Bn65095,44186976,96844204,52657228,TNL
chr16,Bn65096,69192488,75376402,6183914,TN
chr16,Bn65097,70458796,78932508,8473712,RLK
chr16,Bn65098,88899394,94376083,5476689,NBS
chr16,Bn65099,78472906,82300035,3827129,NBS
chr16,Bn65100,32433394,33960373,1526979,NBS
chr16,Bn65101,67340478,76693243,9352765,CN
chr16,Bn65102,13643713,28100677,14456964,CNL
chr16,Bn65103,63620989,73106611,9485622,CN
chr16,Bn65104,73427345,97248780,23821435,CNL
chr16,Bn65105,99037824,99377776,339952,TN
chr16,Bn65106,56547042,59093726,2546684,TNL
chr16,Bn65107,41541573,82751871,41210298,CN
chr16,Bn65108,43739594,98096275,54356681,NBS
chr16,Bn65109,42565143,50796912,8231769,CN
chr16,Bn65110,13865422,87930332,74064910,CNL
chr16,Bn65111,91155036,96355189,5200153,TNL
chr16,Bn65112,18062028,45697194,27635166,CNL
chr16,Bn65113,42143147,55893685,13750538,RLP
chr16,Bn65114,23019880,31777277,8757397,RLP
chr16,Bn65115,77540261,84059962,6519701,CNL
chr16,Bn65116,83812620,83874601,61981,NBS
chr16,Bn65117,5113345,5700722,587377,TN
chr16,Bn65118,76052710,78405651,2352941,TN
chr16,Bn65119,82252917,97366981,15114064,RLK
chr16,Bn65120,61387340,99246786,37859446,TN
chr16,Bn65121,71413207,71968261,555054,CNL
chr16,Bn65122,7854101,53298993,45444892,RLK
chr16,Bn65123,87083434,99981431,12897997,CN
chr16,Bn65124,24661641,67631595,42969954,RLP
chr16,Bn65125,90371682,96271414,5899732,RLP
chr16,Bn65126,25336038,73418202,48082164,CNL
chr16,Bn65127,97814221,97898473,84252,RLP
chr16,Bn65128,15702349,18758224,3055875,TNL
chr16,Bn65129,91179014,96011105,4832091,RLP
chr16,Bn65130,60320786,95441600,35120814,RLK
chr16,Bn65131,63070036,63245341,175305,TN
chr16,Bn65132,97571282,98326896,755614,NBS
chr16,Bn65133,95684667,97073337,1388670,TNL
chr16,Bn65134,16070029,52088318,36018289,CN
chr16,Bn65135,87611641,90798589,3186948,TNL
chr16,Bn65136,51241061,70012410,18771349,RLK
chr16,Bn65137,52695166,63869782,11174616,RLP
chr16,Bn65138,59279192,82143724,22864532,TN
chr16,Bn65139,64345350,64822417,477067,TNL
chr16,Bn65140,44307240,47381802,3074562,RLP
chr16,Bn65141,95523247,99575990,4052743,TNL
chr16,Bn65142,39849394,47383840,7534446,CN
chr16,Bn65143,61892177,96805009,34912832,TN
chr16,Bn65144,88109704,99335142,11225438,CN
chr16,Bn65145,37566164,98500050,60933886,RLP
chr16,Bn65146,77053559,85469791,8416232,TNL
chr16,Bn65147,74963587,79119327,4155740,CNL
chr16,Bn65148,40627339,80099087,39471748,RLP
chr16,Bn65149,58928813,64612187,5683374,TNL
chr16,Bn65150,49980014,85362073,35382059,CN
chr16,Bn65151,69123962,85322790,16198828,NBS
chr16,Bn65152,64772837,75445227,10672390,RLP
chr16,Bn65153,60260121,92822519,32562398,CNL
chr16,Bn65154,94487366,95126659,639293,RLP
chr16,Bn65155,81784146,82832535,1048389,CNL
chr16,Bn65156,51988383,96780397,44792014,NBS
chr16,Bn65157,84320990,95331518,11010528,TN
chr16,Bn65158,25953253,66382200,40428947,TN
chr16,Bn65159,45880824,76154281,30273457,CNL
chr16,Bn65160,36136164,70829155,34692991,CN
chr16,Bn65161,78856734,91465154,12608420,RLK
chr16,Bn65162,75627101,81485690,5858589,TNL
chr16,Bn65163,7288937,70819371,63530434,RLK
chr16,Bn65164,87658846,94215189,6556343,RLK
chr16,Bn65165,61032973,82609471,21576498,NBS
chr16,Bn65166,50439827,95223953,44784126,RLP
chr16,Bn65167,14118987,81323495,67204508,NBS
chr16,Bn65168,88475416,96352234,7876818,RLK
chr16,Bn65169,2981805,83969173,80987368,TN
chr16,Bn65170,33063873,55827108,22763235,TNL
chr16,Bn65171,87014191,90887232,3873041,RLP
chr16,Bn65172,8701201,39761457,31060256,TN
chr16,Bn65173,28243556,36479182,8235626,RLP
chr16,Bn65174,77258051,80093724,2835673,CN
chr16,Bn65175,56111189,56384301,273112,NBS
chr16,Bn65176,17976449,58447421,40470972,RLK
chr16,Bn65177,38411339,78348074,39936735,TNL
chr16,Bn65178,29402707,91808134,62405427,RLK
chr16,Bn65179,47101189,79535652,32434463,CNL
chr16,Bn65180,59470707,61043407,1572700,TNL
chr16,Bn65181,56421660,88052336,31630676,TNL
chr16,Bn65182,47987671,58766556,10778885,RLK
chr16,Bn65183,11410991,55338322,43927331,CNL
chr16,Bn65184,85994710,86847468,852758,RLP
chr16,Bn65185,28483365,56558480,28075115,RLP
chr16,Bn65186,99199254,99329437,130183,TN
chr16,Bn65187,84613105,98379007,13765902,RLK
chr16,Bn65188,41447186,72953704,31506518,TN
chr16,Bn65189,72591594,81540396,8948802,TNL
chr16,Bn65190,72261030,72377702,116672,CN
chr16,Bn65191,64918666,93117864,28199198,CNL
chr16,Bn65192,82683022,88858647,6175625,NBS
chr16,Bn65193,2855356,5630173,2774817,CN
chr16,Bn65194,31836868,64094528,32257660,TNL
chr16,Bn65195,3519986,15742581,12222595,TNL
chr16,Bn65196,57405632,81357699,23952067,CN
chr16,Bn65197,96810632,99732737,2922105,TN
chr16,Bn65198,50480021,65613884,15133863,RLP
chr16,Bn65199,23142449,87683150,64540701,NBS
chr16,Bn65200,99698109,99773955,75846,CN
chr16,Bn65201,96787296,99157300,2370004,CNL
chr16,Bn65202,57844298,60701452,2857154,TNL
chr16,Bn65203,68664019,87769039,19105020,TNL
chr16,Bn65204,80374118,92289130,11915012,RLK
chr16,Bn65205,19393598,32446994,13053396,CN
chr16,Bn65206,68842735,74824566,5981831,NBS
chr16,Bn65207,9391972,31396991,22005019,CN
chr16,Bn65208,49156921,87099251,37942330,NBS
chr16,Bn65209,18156044,72449009,54292965,TNL
chr16,Bn65210,42429835,66765986,24336151,NBS
chr16,Bn65211,66532015,71059488,4527473,CN
chr16,Bn65212,81585353,93008598,11423245,TN
chr16,Bn65213,57559336,93577389,36018053,RLK
chr16,Bn65214,61003184,83900712,22897528,RLK
chr16,Bn65215,13770734,97876308,84105574,CN
chr16,Bn65216,64053303,75219858,11166555,RLK
chr16,Bn65217,22655251,51796178,29140927,TN
chr16,Bn65218,62939759,77767005,14827246,CN
chr16,Bn65219,41025659,81017792,39992133,CN
chr16,Bn65220,96333161,97104767,771606,CN
chr16,Bn65221,53877802,57032858,3155056,NBS
chr16,Bn65222,51295300,73691177,22395877,TNL
chr16,Bn65223,42863565,53519447,10655882,CNL
chr16,Bn65224,55681093,91021158,35340065,NBS
chr16,Bn65225,87445899,88098969,653070,NBS
chr16,Bn65226,44217849,53164286,8946437,TNL
chr16,Bn65227,75685200,82993400,7308200,TN
chr16,Bn65228,3695309,63408923,59713614,RLP
chr16,Bn65229,3536132,11430257,7894125,RLP
chr16,Bn65230,97373456,99547494,2174038,RLK
chr16,Bn65231,48312524,88370495,40057971,RLK
chr16,Bn65232,18182533,33289305,15106772,NBS
chr16,Bn65233,16172358,81208020,65035662,RLP
chr16,Bn65234,88704406,91597609,2893203,RLK
chr16,Bn65235,98073266,98623293,550027,NBS
chr16,Bn65236,39810494,62389316,22578822,NBS
chr16,Bn65237,70077967,84840366,14762399,NBS
chr16,Bn65238,67775908,86689137,18913229,RLK
chr16,Bn65239,9526333,29622386,20096053,TN
chr16,Bn65240,4035970,15313659,11277689,TN
chr16,Bn65241,46582245,48517436,1935191,TN
chr16,Bn65242,6755156,58664921,51909765,TN
chr16,Bn65243,27653633,43143429,15489796,RLK
chr16,Bn65244,22272010,90602566,68330556,NBS
chr16,Bn65245,81832557,96178194,14345637,CN
chr16,Bn65246,11017739,51378205,40360466,RLP
chr16,Bn65247,12134719,20871013,8736294,RLP
chr16,Bn65248,52850634,91445330,38594696,RLK
chr16,Bn65249,18709376,55121183,36411807,RLK
chr16,Bn65250,73375799,81022168,7646369,NBS
chr16,Bn65251,40171651,59659338,19487687,TN
chr16,Bn65252,98662904,99728925,1066021,RLP
chr16,Bn65253,91505352,95595823,4090471,RLK
chr16,Bn65254,91367951,96851893,5483942,RLK
chr16,Bn65255,95407999,98117383,2709384,CN
chr16,Bn65256,89527078,98455879,8928801,CNL
chr16,Bn65257,55022692,68399988,13377296,TN
chr16,Bn65258,47916511,94995413,47078902,CN
chr16,Bn65259,75671207,96650239,20979032,CN
chr16,Bn65260,75569861,87266909,11697048,RLP
chr16,Bn65261,28804872,97924889,69120017,NBS
chr16,Bn65262,84126717,87942359,3815642,NBS
chr16,Bn65263,38954192,60215714,21261522,RLK
chr16,Bn65264,46509906,52941278,6431372,NBS
chr16,Bn65265,42861219,66756378,23895159,CNL
chr16,Bn65266,94630389,95414595,784206,TNL
chr16,Bn65267,11596132,28726562,17130430,RLK
chr16,Bn65268,59744661,88483931,28739270,RLK
chr16,Bn65269,85942184,95925753,9983569,CN
chr16,Bn65270,68512018,98244629,29732611,TNL
chr16,Bn65271,8716716,64186578,55469862,NBS
chr16,Bn65272,78975828,92309416,13333588,RLP
chr16,Bn65273,53485361,89342670,35857309,TNL
chr16,Bn65274,87992536,89640058,1647522,CN
chr16,Bn65275,66271812,81315314,15043502,CNL
chr16,Bn65276,95690546,98689219,2998673,TN
chr16,Bn65277,56197727,83446089,27248362,CN
chr16,Bn65278,84747263,85068350,321087,NBS
chr16,Bn65279,82701456,92580209,9878753,CNL
chr16,Bn65280,85016492,89830125,4813633,NBS
chr16,Bn65281,8910014,79899797,70989783,RLK
chr16,Bn65282,12666364,83371808,70705444,NBS
chr16,Bn65283,34665331,53485230,18819899,RLP
chr16,Bn65284,84763142,99470703,14707561,CN
chr16,Bn65285,80785903,87082584,6296681,RLP
chr16,Bn65286,28728520,98104298,69375778,RLK
chr16,Bn65287,56401359,63452759,7051400,NBS
chr16,Bn65288,80150316,88961632,8811316,CNL
chr16,Bn65289,16755530,37263362,20507832,CNL
chr16,Bn65290,28765078,74741662,45976584,RLK
chr16,Bn65291,63395482,68579049,5183567,CNL
chr16,Bn65292,41667045,68724988,27057943,TNL
chr16,Bn65293,98108677,98921655,812978,TNL
chr16,Bn65294,54727841,62248691,7520850,CNL
chr16,Bn65295,25349018,77481812,52132794,TN
chr16,Bn65296,98236904,99576386,1339482,CN
chr16,Bn65297,42960216,68890913,25930697,CN
chr16,Bn65298,24002936,49871525,25868589,RLP
chr16,Bn65299,45796194,51857370,6061176,NBS
chr16,Bn65300,54852308,91352038,36499730,RLK
chr16,Bn65301,72866771,77338970,4472199,CN
chr16,Bn65302,74687019,90647027,15960008,NBS
chr16,Bn65303,24220933,70751515,46530582,TN
chr16,Bn65304,2313847,13677323,11363476,TNL
chr16,Bn65305,61437034,92507725,31070691,TNL
chr16,Bn65306,41144966,43725315,2580349,CN
chr16,Bn65307,40836680,72681034,31844354,TNL
chr16,Bn65308,47292667,70244042,22951375,RLP
chr16,Bn65309,60687727,82205202,21517475,RLK
chr16,Bn65310,33932620,69373698,35441078,TNL
chr16,Bn65311,21256281,48948676,27692395,CN
chr16,Bn65312,45717999,90294035,44576036,RLP
chr16,Bn65313,15047438,94953331,79905893,RLK
chr16,Bn65314,66673984,70576234,3902250,CNL
chr16,Bn65315,25552591,68160127,42607536,RLK
chr16,Bn65316,72021711,96834990,24813279,RLK
chr16,Bn65317,43743848,57710399,13966551,TN
chr16,Bn65318,67183933,96793760,29609827,NBS
chr16,Bn65319,96747928,98906063,2158135,RLP
chr16,Bn65320,70342280,72883910,2541630,CN
chr16,Bn65321,9702891,98949427,89246536,CN
chr16,Bn65322,45446930,56853269,11406339,CN
chr16,Bn65323,61242280,89512774,28270494,TN
chr16,Bn65324,42280665,71088440,28807775,RLK
chr16,Bn65325,21028111,48544601,27516490,RLK
chr16,Bn65326,64609684,91534280,26924596,NBS
chr16,Bn65327,36513740,53827364,17313624,RLK
chr16,Bn65328,65709129,79858263,14149134,CN
chr16,Bn65329,62544301,93396257,30851956,NBS
chr16,Bn65330,69895701,83090567,13194866,TN
chr16,Bn65331,55110970,91556041,36445071,CN
chr16,Bn65332,77236132,97447774,20211642,TNL
chr16,Bn65333,54345284,84830328,30485044,TNL
chr16,Bn65334,11414640,37053409,25638769,RLP
chr16,Bn65335,85936151,89279362,3343211,RLP
chr16,Bn65336,73312100,92892144,19580044,RLK
chr16,Bn65337,51133338,89933126,38799788,TNL
chr16,Bn65338,27508919,36167991,8659072,CN
chr16,Bn65339,33388989,48959730,15570741,TNL
chr16,Bn65340,64077719,79853076,15775357,NBS
chr16,Bn65341,42507232,46219938,3712706,CN
chr16,Bn65342,58429881,89814352,31384471,CNL
chr16,Bn65343,36093455,54788120,18694665,RLK
chr16,Bn65344,42625510,60506104,17880594,NBS
chr16,Bn65345,7364838,34573049,27208211,CN
chr16,Bn65346,96620400,97712922,1092522,TNL
chr16,Bn65347,44431899,87931960,43500061,NBS
chr16,Bn65348,89482590,90243703,761113,CNL
chr16,Bn65349,58661471,96708406,38046935,TNL
chr16,Bn65350,88639201,97883426,9244225,RLK
chr16,Bn65351,98153461,98471779,318318,CN
chr16,Bn65352,36282868,62187462,25904594,CN
chr16,Bn65353,79229976,95342771,16112795,CNL
chr16,Bn65354,5855428,12105242,6249814,TNL
chr16,Bn65355,15121569,59421913,44300344,CN
chr16,Bn65356,63610940,83915445,20304505,RLP
chr16,Bn65357,67297549,96469262,29171713,TNL
chr16,Bn65358,39783368,83384730,43601362,RLP
chr16,Bn65359,44155793,54217322,10061529,TN
chr16,Bn65360,90733946,97699627,6965681,TN
chr16,Bn65361,7875104,23549458,15674354,RLK
chr16,Bn65362,85594365,86236873,642508,RLK
chr16,Bn65363,39160792,62167846,23007054,TN
chr16,Bn65364,37058213,42888679,5830466,CNL
chr16,Bn65365,59284084,80320560,21036476,NBS
chr16,Bn65366,74055389,92532246,18476857,NBS
chr16,Bn65367,91984629,98249528,6264899,CN
chr16,Bn65368,41978195,53350825,11372630,NBS
chr16,Bn65369,83562423,93523497,9961074,NBS
chr16,Bn65370,26688530,48352563,21664033,TN
chr16,Bn65371,39575002,76104912,36529910,TNL
chr16,Bn65372,80824303,83689748,2865445,CN
chr16,Bn65373,30167603,67145216,36977613,RLP
chr16,Bn65374,99345510,99909735,564225,RLP
chr16,Bn65375,49494128,53202389,3708261,RLK
chr16,Bn65376,13216959,79015845,65798886,CN
chr16,Bn65377,58364583,71960969,13596386,TN
chr16,Bn65378,94633870,98488785,3854915,TNL
chr16,Bn65379,31041301,74050466,43009165,TN
chr16,Bn65380,93799118,97805137,4006019,CN
chr16,Bn65381,15824230,16022390,198160,CNL
chr16,Bn65382,59745572,85201957,25456385,TN
chr16,Bn65383,78447981,99054255,20606274,TNL
chr16,Bn65384,43804291,95400952,51596661,RLK
chr16,Bn65385,94910437,95403613,493176,RLK
chr16,Bn65386,4155734,52586344,48430610,TNL
chr16,Bn65387,20634057,78184394,57550337,CN
chr16,Bn65388,79633150,88734410,9101260,RLK
chr16,Bn65389,26952718,99979301,73026583,RLP
chr16,Bn65390,49277585,83450142,34172557,TN
chr16,Bn65391,12322584,31772702,19450118,TN
chr16,Bn65392,71817715,98005888,26188173,RLP
chr16,Bn65393,8733571,37517364,28783793,TNL
chr16,Bn65394,89392491,95168368,5775877,CNL
chr16,Bn65395,12124342,52872665,40748323,CN
chr16,Bn65396,45851698,92501583,46649885,TNL
chr16,Bn65397,33510423,58300843,24790420,TNL
chr16,Bn65398,60840371,83655722,22815351,RLP
chr16,Bn65399,13044840,89416642,76371802,RLK
chr16,Bn65400,21719168,79609821,57890653,RLP
chr16,Bn65401,90009819,92310991,2301172,CNL
chr16,Bn65402,17917954,36541104,18623150,CNL
chr16,Bn65403,65604724,85147602,19542878,CNL
chr16,Bn65404,8543025,77094484,68551459,CN
chr16,Bn65405,76999603,87456174,10456571,RLK
chr16,Bn65406,9884650,89051989,79167339,CNL
chr16,Bn65407,63019318,86618173,23598855,CN
chr16,Bn65408,18136156,46158606,28022450,TNL
chr16,Bn65409,21597433,80661359,59063926,TNL
chr16,Bn65410,40832126,59761075,18928949,NBS
chr16,Bn65411,38348847,90235969,51887122,CNL
chr16,Bn65412,32205330,39143750,6938420,RLK
chr16,Bn65413,38174844,39380877,1206033,NBS
chr16,Bn65414,41088950,89708135,48619185,TN
chr16,Bn65415,60883981,87049085,26165104,CN
chr16,Bn65416,36207380,53104361,16896981,RLK
chr16,Bn65417,92243804,92657353,413549,RLP
chr16,Bn65418,76853597,78511067,1657470,NBS
chr16,Bn65419,30122069,52160089,22038020,NBS
chr16,Bn65420,17914889,25592359,7677470,RLK
chr16,Bn65421,43422142,72454919,29032777,RLP
chr16,Bn65422,69244918,70174908,929990,TN
chr16,Bn65423,75390852,76753628,1362776,NBS
chr16,Bn65424,26863487,67719114,40855627,RLK
chr16,Bn65425,54697810,64750428,10052618,TNL
chr16,Bn65426,27421910,33382348,5960438,TN
chr16,Bn65427,61766019,74166067,12400048,CN
chr16,Bn65428,41982932,53769331,11786399,RLP
chr16,Bn65429,46647290,52959542,6312252,TN
chr16,Bn65430,10752532,53730901,42978369,TN
chr16,Bn65431,21509869,43793197,22283328,RLP
chr16,Bn65432,88430274,94121521,5691247,CNL
chr16,Bn65433,14010577,68771023,54760446,RLK
chr16,Bn65434,25308132,98139973,72831841,NBS
chr16,Bn65435,63319911,95269005,31949094,NBS
chr16,Bn65436,52770026,94482452,41712426,CN
chr16,Bn65437,73418944,86990425,13571481,TNL
chr16,Bn65438,80976642,82251342,1274700,CNL
chr16,Bn65439,23919697,63606571,39686874,RLK
chr16,Bn65440,48186184,97048906,48862722,TN
chr16,Bn65441,2330774,53977290,51646516,NBS
chr16,Bn65442,10181360,27192927,17011567,CNL
chr16,Bn65443,84234969,96010555,11775586,RLP
chr16,Bn65444,74019879,93344466,19324587,TNL
chr16,Bn65445,90491586,96440968,5949382,NBS
chr16,Bn65446,48350037,65150249,16800212,RLP
chr16,Bn65447,3474706,72958430,69483724,CNL
chr16,Bn65448,81159682,94434735,13275053,CNL
chr16,Bn65449,75596332,95469556,19873224,CN
chr16,Bn65450,96188343,97283537,1095194,CNL
chr16,Bn65451,34548961,42394350,7845389,RLK
chr16,Bn65452,30379313,50915591,20536278,TN
chr16,Bn65453,16554517,18324126,1769609,TNL
chr16,Bn65454,11169959,74046496,62876537,RLK
chr16,Bn65455,9558853,69864591,60305738,RLP
chr16,Bn65456,88103252,90172106,2068854,RLP
chr16,Bn65457,23490971,99013223,75522252,CN
chr16,Bn65458,45972610,70146992,24174382,RLK
chr16,Bn65459,75325230,87783157,12457927,RLP
chr16,Bn65460,43013047,71927105,28914058,CNL
chr16,Bn65461,3450349,36310195,32859846,CNL
chr16,Bn65462,85056732,96101104,11044372,RLP
chr16,Bn65463,7848225,57196824,49348599,RLP
chr16,Bn65464,95248470,95479110,230640,RLP
chr16,Bn65465,28325532,33110328,4784796,RLP
chr16,Bn65466,40370823,92065679,51694856,RLK
chr16,Bn65467,78051184,94748702,16697518,TNL
chr16,Bn65468,5944920,59521599,53576679,RLK
chr16,Bn65469,36574588,66887254,30312666,CN
chr16,Bn65470,34790489,42534054,7743565,TN
chr16,Bn65471,85605637,94024177,8418540,CNL
chr16,Bn65472,99074957,99329158,254201,TNL
chr16,Bn65473,27347381,67074016,39726635,CN
chr16,Bn65474,20425671,82758033,62332362,NBS
chr16,Bn65475,11236089,14276464,3040375,RLK
chr16,Bn65476,98611843,98879538,267695,CNL
chr16,Bn65477,9149637,39060053,29910416,CNL
chr16,Bn65478,79550212,99682302,20132090,RLP
chr16,Bn65479,57626186,57678566,52380,NBS
chr16,Bn65480,55819141,91819823,36000682,RLP
chr16,Bn65481,39658057,43060094,3402037,RLP
chr16,Bn65482,73558316,80196982,6638666,RLK
chr16,Bn65483,72883017,74630112,1747095,CNL
chr16,Bn65484,88676038,94426777,5750739,TN
chr16,Bn65485,79463598,83979216,4515618,RLK
chr16,Bn65486,15475058,26843300,11368242,RLK
chr16,Bn65487,60446523,70693436,10246913,RLK
chr16,Bn65488,87614647,99043331,11428684,NBS
chr16,Bn65489,38620143,96741581,58121438,TN
chr16,Bn65490,77047496,86317359,9269863,RLP
chr16,Bn65491,82760761,91729320,8968559,RLP
chr16,Bn65492,90185779,98281078,8095299,CNL
chr16,Bn65493,33437604,77822615,44385011,CN
chr16,Bn65494,83353235,90674054,7320819,CN
chr16,Bn65495,97294987,98199855,904868,CN
chr16,Bn65496,80664642,87171832,6507190,NBS
chr16,Bn65497,35811056,53460062,17649006,RLK
chr16,Bn65498,78470332,98644535,20174203,NBS
chr16,Bn65499,76943432,91688069,14744637,RLP
chr16,Bn65500,55428672,62702195,7273523,CN
chr16,Bn65501,39634955,88520674,48885719,CN
chr16,Bn65502,29925970,44458477,14532507,TNL
chr16,Bn65503,82159032,89398354,7239322,CN
chr16,Bn65504,11888322,37605946,25717624,RLP
chr16,Bn65505,50555443,84026666,33471223,RLP
chr16,Bn65506,73938626,87753902,13815276,CNL
chr16,Bn65507,7361513,43994023,36632510,TN
chr16,Bn65508,31088551,64331180,33242629,NBS
chr16,Bn65509,32915811,87314350,54398539,RLP
chr16,Bn65510,75272039,99736318,24464279,TNL
chr16,Bn65511,8618149,11805025,3186876,CN
chr16,Bn65512,54515285,78699120,24183835,TN
chr16,Bn65513,34205978,95563987,61358009,TN
chr16,Bn65514,37353896,70578540,33224644,RLK
chr16,Bn65515,82324138,90350027,8025889,RLK
chr16,Bn65516,10929573,63978953,53049380,CN
chr16,Bn65517,13777482,66531164,52753682,RLP
chr16,Bn65518,75646543,83961348,8314805,RLP
chr16,Bn65519,25713303,83466891,57753588,NBS
chr16,Bn65520,17317348,77944180,60626832,CN
chr16,Bn65521,58230365,79205070,20974705,TNL
chr16,Bn65522,7601913,12276538,4674625,CN
chr16,Bn65523,12829444,87982509,75153065,CNL
chr16,Bn65524,34444736,85523020,51078284,RLK
chr16,Bn65525,49188219,56688568,7500349,TNL
chr16,Bn65526,85119288,96102587,10983299,CN
chr16,Bn65527,43249955,93996429,50746474,TN
chr16,Bn65528,82924078,83294146,370068,RLP
chr16,Bn65529,52384399,97646243,45261844,RLP
chr16,Bn65530,37633556,87813111,50179555,TNL
chr16,Bn65531,25299462,79843414,54543952,NBS
chr16,Bn65532,48499301,82582831,34083530,CNL
chr16,Bn65533,75343753,91165704,15821951,NBS
chr16,Bn65534,92281388,92654572,373184,CN
chr16,Bn65535,70272269,93854461,23582192,CNL
chr16,Bn65536,97497332,98919013,1421681,RLK
chr16,Bn65537,86699896,86880480,180584,CN
chr16,Bn65538,17400734,71811651,54410917,CN
chr16,Bn65539,25328185,75630756,50302571,NBS
chr16,Bn65540,27049287,44746760,17697473,CNL
chr16,Bn65541,74719352,90431434,15712082,NBS
chr16,Bn65542,28291364,38564912,10273548,CNL
chr16,Bn65543,47415858,50411150,2995292,CN
chr16,Bn65544,56138167,62324590,6186423,CNL
chr16,Bn65545,2438984,98906283,96467299,CNL
chr16,Bn65546,80070338,82096098,2025760,TNL
chr16,Bn65547,30983868,90523755,59539887,TN
chr16,Bn65548,64593143,90775873,26182730,CN
chr16,Bn65549,50997273,96134966,45137693,CNL
chr16,Bn65550,50429742,70061025,19631283,TN
chr16,Bn65551,59496501,81674230,22177729,RLK
chr16,Bn65552,27332496,45920425,18587929,CN
chr16,Bn65553,74072484,93233204,19160720,NBS
chr16,Bn65554,7368237,14140925,6772688,RLK
chr16,Bn65555,29772592,48722058,18949466,TNL
chr16,Bn65556,89617395,92324305,2706910,NBS
chr16,Bn65557,44948227,90068255,45120028,NBS
chr16,Bn65558,41828897,68194288,26365391,RLP
chr16,Bn65559,8560557,48660693,40100136,TNL
chr16,Bn65560,71744201,91908418,20164217,CN
chr16,Bn65561,48793706,98880163,50086457,RLP
chr16,Bn65562,39793538,41232267,1438729,RLP
chr16,Bn65563,55817438,86757167,30939729,CNL
chr16,Bn65564,78362765,88452717,10089952,RLK
chr16,Bn65565,43433867,87040645,43606778,CN
chr16,Bn65566,43854109,66019376,22165267,RLP
chr16,Bn65567,65544296,87532498,21988202,RLP
chr16,Bn65568,88220068,91164307,2944239,TNL
chr16,Bn65569,21238135,98060986,76822851,CNL
chr16,Bn65570,86354261,96894852,10540591,CN
chr16,Bn65571,91003669,94855805,3852136,RLK
chr16,Bn65572,16323089,48130834,31807745,RLK
chr16,Bn65573,84234800,92223119,7988319,CNL
chr16,Bn65574,49652792,81670025,32017233,TN
chr16,Bn65575,50113795,54595636,4481841,TNL
chr16,Bn65576,31016377,49660329,18643952,TNL
chr16,Bn65577,64944577,92011798,27067221,TN
chr16,Bn65578,60091257,87602781,27511524,RLP
chr16,Bn65579,11961861,85002233,73040372,TN
chr16,Bn65580,41307663,90422470,49114807,TNL
chr16,Bn65581,47110670,87539121,40428451,TNL
chr16,Bn65582,50982367,87617474,36635107,CN
chr16,Bn65583,94445821,99203556,4757735,CNL
chr16,Bn65584,37274911,83484520,46209609,RLK
chr16,Bn65585,62676539,72515646,9839107,CN
chr16,Bn65586,56182198,86982358,30800160,TNL
chr16,Bn65587,72103092,92364715,20261623,TN
chr16,Bn65588,48419284,84420568,36001284,RLP
chr16,Bn65589,33732167,37808935,4076768,NBS
chr16,Bn65590,93760676,94192610,431934,NBS
chr16,Bn65591,17452730,26855769,9403039,CNL
chr16,Bn65592,81458592,81611330,152738,TN
chr16,Bn65593,47237905,68804644,21566739,CNL
chr16,Bn65594,51524036,92647779,41123743,NBS
chr16,Bn65595,47438931,66766239,19327308,CN
chr16,Bn65596,17021987,17737532,715545,CN
chr16,Bn65597,93590178,99947025,6356847,RLK
chr16,Bn65598,93322608,93434085,111477,CNL
chr16,Bn65599,82922756,93140348,10217592,TNL
chr16,Bn65600,28807181,96836382,68029201,CN
chr16,Bn65601,14291577,77461604,63170027,RLK
chr16,Bn65602,55953248,69422912,13469664,RLK
chr16,Bn65603,74434336,81142040,6707704,NBS
chr16,Bn65604,2127642,21260747,19133105,TN
chr16,Bn65605,67162995,80068890,12905895,RLK
chr16,Bn65606,88059300,93344204,5284904,RLP
chr16,Bn65607,32413208,50994007,18580799,TN
chr16,Bn65608,19105522,94625689,75520167,CNL
chr16,Bn65609,78508676,96026157,17517481,CNL
chr16,Bn65610,96174058,97233300,1059242,CN
chr16,Bn65611,26391351,33651277,7259926,RLK
chr16,Bn65612,42875457,59975103,17099646,NBS
chr16,Bn65613,7510789,44648718,37137929,RLP
chr16,Bn65614,1147873,48160686,47012813,TNL
chr16,Bn65615,65015212,98405215,33390003,RLK
chr16,Bn65616,67237658,90824040,23586382,RLK
chr16,Bn65617,92224618,99868276,7643658,CN
chr16,Bn65618,61273408,76337347,15063939,CNL
chr16,Bn65619,18685826,59955562,41269736,RLP
chr16,Bn65620,76039366,98252783,22213417,RLP
chr16,Bn65621,72524261,76855768,4331507,CN
chr16,Bn65622,44711156,96898691,52187535,CNL
chr16,Bn65623,31886856,37563194,5676338,CNL
chr16,Bn65624,97447184,99974833,2527649,RLP
chr16,Bn65625,7132961,64966552,57833591,TNL
chr16,Bn65626,37427219,82678586,45251367,TNL
chr16,Bn65627,11364442,52531838,41167396,RLP
chr16,Bn65628,78282990,98738259,20455269,CN
chr16,Bn65629,87850899,91811294,3960395,TN
chr16,Bn65630,60816994,75333224,14516230,NBS
chr16,Bn65631,34844001,63385880,28541879,CN
chr16,Bn65632,88842633,98304083,9461450,NBS
chr16,Bn65633,48330948,67836956,19506008,NBS
chr16,Bn65634,88453640,94105808,5652168,RLP
chr16,Bn65635,80867920,90070595,9202675,NBS
chr16,Bn65636,15364525,47230733,31866208,CNL
chr16,Bn65637,89093239,96691576,7598337,CN
chr16,Bn65638,67681807,86801072,19119265,NBS
chr16,Bn65639,42240656,71063596,28822940,TN
chr16,Bn65640,86267249,95466314,9199065,CNL
chr16,Bn65641,76123575,93134139,17010564,CNL
chr16,Bn65642,6219274,33554024,27334750,RLP
chr16,Bn65643,16965185,54578020,37612835,CN
chr16,Bn65644,62476076,94840167,32364091,CNL
chr16,Bn65645,3039300,26718195,23678895,RLP
chr16,Bn65646,2378624,28750267,26371643,RLP
chr16,Bn65647,47656427,89985313,42328886,CN
chr16,Bn65648,19209147,45829615,26620468,CNL
chr16,Bn65649,66017006,66979242,962236,CNL
chr16,Bn65650,46554929,75093003,28538074,TNL
chr16,Bn65651,34717231,60008422,25291191,RLP
chr16,Bn65652,35273801,76086579,40812778,RLP
chr16,Bn65653,94396003,98127865,3731862,TN
chr16,Bn65654,85890081,99878977,13988896,RLP
chr16,Bn65655,85934033,93989526,8055493,RLP
chr16,Bn65656,69333529,92167079,22833550,CN
chr16,Bn65657,55685710,74844536,19158826,NBS
chr16,Bn65658,42632722,62027127,19394405,TN
chr16,Bn65659,29925723,31561412,1635689,RLP
chr16,Bn65660,1720625,39869801,38149176,CNL
chr16,Bn65661,24035947,48071844,24035897,TNL
chr16,Bn65662,85410787,93606479,8195692,RLK
chr16,Bn65663,1419139,56681738,55262599,NBS
chr16,Bn65664,38981812,63377265,24395453,TNL
chr16,Bn65665,30495694,62319710,31824016,TNL
chr16,Bn65666,80078985,84574747,4495762,RLK
chr16,Bn65667,98909438,99174181,264743,CNL
chr16,Bn65668,90089866,98566301,8476435,RLP
chr16,Bn65669,67561537,88230738,20669201,TN
chr16,Bn65670,71748887,95522540,23773653,RLP
chr16,Bn65671,94824874,95062379,237505,TNL
chr16,Bn65672,50156186,75306383,25150197,RLK
chr16,Bn65673,23193406,32022929,8829523,CN
chr16,Bn65674,98307673,98942554,634881,TNL
chr16,Bn65675,76076741,98398718,22321977,TN
chr16,Bn65676,28602655,30433484,1830829,TNL
chr16,Bn65677,97431988,99540780,2108792,TN
chr16,Bn65678,40347469,48006767,7659298,RLP
chr16,Bn65679,5115786,19486623,14370837,RLK
chr16,Bn65680,22074866,76744062,54669196,RLP
chr16,Bn65681,97661816,98103763,441947,TNL
chr16,Bn65682,49721951,92573518,42851567,RLP
chr16,Bn65683,32913529,76216726,43303197,RLK
chr16,Bn65684,8084833,10113248,2028415,CNL
chr16,Bn65685,93729093,94212667,483574,RLK
chr16,Bn65686,42704955,81471107,38766152,CN
chr16,Bn65687,95236433,96875470,1639037,CN
chr16,Bn65688,13993906,98418215,84424309,TNL
chr16,Bn65689,55910080,81810456,25900376,TNL
chr16,Bn65690,79048029,83621770,4573741,TNL
chr16,Bn65691,86124491,94027749,7903258,NBS
chr16,Bn65692,70687014,71248912,561898,RLP
chr16,Bn65693,97869185,99487223,1618038,TNL
chr16,Bn65694,47886697,92816691,44929994,TN
chr16,Bn65695,33278328,55851313,22572985,RLK
chr16,Bn65696,13310246,20465144,7154898,RLK
chr16,Bn65697,2224904,14040523,11815619,RLP
chr16,Bn65698,22900278,29617282,6717004,NBS
chr16,Bn65699,33651055,41433585,7782530,RLK
chr16,Bn65700,20026179,22367080,2340901,TN
chr16,Bn65701,30209190,85189056,54979866,TNL
chr16,Bn65702,86267886,89887032,3619146,TN
chr16,Bn65703,5629102,91290790,85661688,TN
chr16,Bn65704,45866350,58922366,13056016,RLK
chr16,Bn65705,93589077,99860766,6271689,TN
chr16,Bn65706,3712093,30462703,26750610,TNL
chr16,Bn65707,66894140,78231985,11337845,TNL
chr16,Bn65708,80022473,86304355,6281882,CNL
chr16,Bn65709,23091153,57154661,34063508,NBS
chr16,Bn65710,99592410,99955539,363129,NBS
chr16,Bn65711,90400491,90695504,295013,TNL
chr16,Bn65712,19547542,76793230,57245688,RLP
chr16,Bn65713,12522538,71345213,58822675,NBS
chr16,Bn65714,13594740,79097952,65503212,CN
chr16,Bn65715,9840343,87659715,77819372,CN
chr16,Bn65716,88138742,92998993,4860251,NBS
chr16,Bn65717,40367088,95223580,54856492,CNL
chr16,Bn65718,97052793,98278877,1226084,TNL
chr16,Bn65719,19956452,60055987,40099535,RLP
chr16,Bn65720,15704422,94423977,78719555,RLP
chr16,Bn65721,75580576,82609517,7028941,RLK
chr16,Bn65722,10171809,32860789,22688980,RLK
chr16,Bn65723,14378738,29430763,15052025,CN
chr16,Bn65724,34519384,86238160,51718776,TNL
chr16,Bn65725,73443101,77148723,3705622,TNL
chr16,Bn65726,26930064,68450478,41520414,TNL
chr16,Bn65727,76877795,97969696,21091901,CNL
chr16,Bn65728,41020042,91950178,50930136,NBS
chr16,Bn65729,48909099,88819743,39910644,TNL
chr16,Bn65730,30577217,82301388,51724171,RLK
chr16,Bn65731,18944291,21610746,2666455,CNL
chr16,Bn65732,10197179,95561816,85364637,TN
chr16,Bn65733,31097690,85867778,54770088,RLK
chr16,Bn65734,94165270,98246222,4080952,TNL
chr16,Bn65735,74641543,86629436,11987893,RLK
chr16,Bn65736,77398675,82577712,5179037,RLP
chr16,Bn65737,89870465,91748206,1877741,NBS
chr16,Bn65738,80823781,85069509,4245728,RLK
chr16,Bn65739,97539161,97684140,144979,TNL
chr16,Bn65740,47670991,76596875,28925884,TN
chr16,Bn65741,6940148,96028698,89088550,RLP
chr16,Bn65742,20203998,91374149,71170151,RLP
chr16,Bn65743,17306877,61473292,44166415,RLK
chr16,Bn65744,85301759,87984356,2682597,TN
chr16,Bn65745,54697691,66278339,11580648,NBS
chr16,Bn65746,13507846,92128615,78620769,RLP
chr16,Bn65747,94209281,96386462,2177181,NBS
chr16,Bn65748,69422998,79807839,10384841,RLK
chr16,Bn65749,70029843,88325353,18295510,RLP
chr16,Bn65750,45584699,65114086,19529387,CN
chr16,Bn65751,49026044,73116082,24090038,CNL
chr16,Bn65752,10202968,94877348,84674380,RLK
chr16,Bn65753,24722613,44192291,19469678,CNL
chr16,Bn65754,1869493,84610232,82740739,CN
chr16,Bn65755,26520814,74519759,47998945,CN
chr16,Bn65756,55239082,81035058,25795976,RLK
chr16,Bn65757,32404468,72829299,40424831,CNL
chr16,Bn65758,52176651,90791156,38614505,CNL
chr16,Bn65759,23272692,65323756,42051064,TNL
chr16,Bn65760,86682140,87060119,377979,RLP
chr16,Bn65761,24417808,54436751,30018943,RLK
chr16,Bn65762,92856413,95096210,2239797,RLP
chr16,Bn65763,15881947,51963765,36081818,NBS
chr16,Bn65764,4259365,49695332,45435967,NBS
chr16,Bn65765,69808905,70501409,692504,NBS
chr16,Bn65766,74331719,84868901,10537182,TN
chr16,Bn65767,98107547,99523902,1416355,NBS
chr16,Bn65768,10094752,95413551,85318799,TN
chr16,Bn65769,63379590,67553497,4173907,CNL
chr16,Bn65770,17182616,85448254,68265638,RLK
chr16,Bn65771,94132475,97797719,3665244,CNL
chr16,Bn65772,71784251,75600008,3815757,TNL
chr16,Bn65773,67576777,77768126,10191349,CN
chr16,Bn65774,23010855,32580725,9569870,RLK
chr16,Bn65775,60752741,79042155,18289414,TNL
chr16,Bn65776,89475164,93319558,3844394,CNL
chr16,Bn65777,84703677,87802516,3098839,NBS
chr16,Bn65778,46981095,68152241,21171146,CN
chr16,Bn65779,83545605,89707111,6161506,TN
chr16,Bn65780,87617671,93807637,6189966,CN
chr16,Bn65781,45422138,93119137,47696999,NBS
chr16,Bn65782,12995664,96522831,83527167,RLP
chr16,Bn65783,79029490,86073172,7043682,NBS
chr16,Bn65784,19082054,23033177,3951123,RLP
chr16,Bn65785,75574348,78336791,2762443,TNL
chr16,Bn65786,92789222,97955129,5165907,TNL
chr16,Bn65787,53592461,56453056,2860595,TN
chr16,Bn65788,74390704,77173101,2782397,RLP
chr16,Bn65789,63113751,67063123,3949372,RLK
chr16,Bn65790,93357006,95001355,1644349,NBS
chr16,Bn65791,82327107,97167676,14840569,RLK
chr16,Bn65792,28857961,61510886,32652925,TN
chr16,Bn65793,81337109,94918947,13581838,RLP
chr16,Bn65794,4975647,8713497,3737850,RLK
chr16,Bn65795,99806618,99822297,15679,CN
chr16,Bn65796,45491595,64498241,19006646,TNL
chr16,Bn65797,88572012,89166266,594254,CNL
chr16,Bn65798,74642357,95893296,21250939,CN
chr16,Bn65799,22695903,62418278,39722375,TNL
chr16,Bn65800,6618033,26103729,19485696,RLK
chr16,Bn65801,33160985,85985863,52824878,RLP
chr16,Bn65802,62309187,88982352,26673165,TN
chr16,Bn65803,21920595,38648128,16727533,TN
chr16,Bn65804,88568332,89678171,1109839,TN
chr16,Bn65805,82728977,92499258,9770281,NBS
chr16,Bn65806,24333892,52010218,27676326,CNL
chr16,Bn65807,68633860,80895580,12261720,CN
chr16,Bn65808,71427000,85395633,13968633,RLP
chr16,Bn65809,44655359,57868854,13213495,NBS
chr16,Bn65810,27983603,56776627,28793024,CNL
chr16,Bn65811,97367274,98620501,1253227,TNL
chr16,Bn65812,99380605,99440192,59587,RLK
chr16,Bn65813,51302767,52587128,1284361,TNL
chr16,Bn65814,94589885,98918532,4328647,TNL
chr16,Bn65815,12575177,61310032,48734855,CNL
chr16,Bn65816,6432133,81805056,75372923,TNL
chr16,Bn65817,27325110,48227975,20902865,RLK
chr16,Bn65818,37715865,59848511,22132646,RLP
chr16,Bn65819,81416879,97815094,16398215,CNL
chr16,Bn65820,95556964,96713924,1156960,RLP
chr16,Bn65821,38642199,94983878,56341679,CNL
chr16,Bn65822,93396640,96153100,2756460,NBS
chr16,Bn65823,12289004,78890401,66601397,CN
chr16,Bn65824,63308144,84594090,21285946,RLP
chr16,Bn65825,69406328,83294614,13888286,CNL
chr16,Bn65826,32370636,76078770,43708134,RLK
chr16,Bn65827,38283008,62012251,23729243,RLK
chr16,Bn65828,57076773,98869775,41793002,CNL
chr16,Bn65829,1911482,62380112,60468630,CN
chr16,Bn65830,69822162,97631588,27809426,CN
chr16,Bn65831,18727219,98160994,79433775,RLP
chr16,Bn65832,42276150,75051516,32775366,RLP
chr16,Bn65833,1473681,12850520,11376839,CN
chr16,Bn65834,55556313,64371946,8815633,TN
chr16,Bn65835,78987971,86732742,7744771,TN
chr16,Bn65836,16839210,82514376,65675166,RLP
chr16,Bn65837,11152179,99344285,88192106,CN
chr16,Bn65838,49088223,96003596,46915373,NBS
chr16,Bn65839,16838329,67319486,50481157,TN
chr16,Bn65840,57229714,87263025,30033311,NBS
chr16,Bn65841,11113313,18058648,6945335,RLP
chr16,Bn65842,29770221,68087169,38316948,TNL
chr16,Bn65843,16636275,97916175,81279900,TN
chr16,Bn65844,32708869,79818138,47109269,NBS
chr16,Bn65845,26842825,58461795,31618970,TN
chr16,Bn65846,71153539,74016178,2862639,TN
chr16,Bn65847,62059386,88399674,26340288,TNL
chr16,Bn65848,94764935,95937008,1172073,CNL
chr16,Bn65849,70114392,79534309,9419917,RLP
chr16,Bn65850,2035952,30491163,28455211,RLP
chr16,Bn65851,68663054,79420946,10757892,NBS
chr16,Bn65852,29855678,69218340,39362662,NBS
chr16,Bn65853,34945052,82597302,47652250,NBS
chr16,Bn65854,74518021,82216604,7698583,TN
chr16,Bn65855,26175884,33931908,7756024,RLP
chr16,Bn65856,97727211,99100747,1373536,TNL
chr16,Bn65857,34241798,59379236,25137438,RLK
chr16,Bn65858,67852474,97462999,29610525,CNL
chr16,Bn65859,42166265,82166959,40000694,CNL
chr16,Bn65860,42659597,78304570,35644973,TNL
chr16,Bn65861,24020145,45002379,20982234,TN
chr16,Bn65862,31180473,35799782,4619309,TNL
chr16,Bn65863,30351645,95539918,65188273,CN
chr16,Bn65864,12651679,56669827,44018148,RLP
chr16,Bn65865,45733639,97756588,52022949,TNL
chr16,Bn65866,2782316,93917222,91134906,RLP
chr16,Bn65867,62054146,97736969,35682823,RLP
chr16,Bn65868,90770260,90931671,161411,TN
chr16,Bn65869,82681037,98828230,16147193,TNL
chr16,Bn65870,78054731,99285834,21231103,RLK
chr16,Bn65871,8467035,74752318,66285283,TNL
chr16,Bn65872,19710947,40634595,20923648,CN
chr16,Bn65873,22286237,23354220,1067983,RLP
chr16,Bn65874,42579504,93426785,50847281,TN
chr16,Bn65875,59121283,70531740,11410457,NBS
chr16,Bn65876,62380900,71538634,9157734,RLP
chr16,Bn65877,35019210,97545666,62526456,TNL
chr16,Bn65878,1482027,65543970,64061943,CNL
chr16,Bn65879,81194861,83910704,2715843,RLK
chr16,Bn65880,44506960,95516426,51009466,CN
chr16,Bn65881,80267361,97842191,17574830,TN
chr16,Bn65882,47341733,81861228,34519495,TN
chr16,Bn65883,9988800,98287372,88298572,RLK
chr16,Bn65884,82742283,84406965,1664682,TNL
chr16,Bn65885,42666858,49301180,6634322,TN
chr16,Bn65886,46040648,84265193,38224545,TNL
chr16,Bn65887,5755334,18365466,12610132,RLP
chr16,Bn65888,51421917,99807299,48385382,CN
chr16,Bn65889,90504221,92984028,2479807,TN
chr16,Bn65890,20563367,55036005,34472638,TN
chr16,Bn65891,61127752,77526767,16399015,TN
chr16,Bn65892,65822388,90578785,24756397,TN
chr16,Bn65893,44978991,55531488,10552497,TNL
chr16,Bn65894,3748371,67304234,63555863,TN
chr16,Bn65895,55195511,73840710,18645199,TN
chr16,Bn65896,18669013,64847195,46178182,RLK
chr16,Bn65897,94862031,95727348,865317,RLK
chr16,Bn65898,42100325,56455760,14355435,TNL
chr16,Bn65899,39630214,89873161,50242947,TNL
chr16,Bn65900,95592950,98154297,2561347,CN
chr16,Bn65901,19559536,30671786,11112250,TN
chr16,Bn65902,57440710,74688082,17247372,CNL
chr16,Bn65903,58840316,84235169,25394853,TNL
chr16,Bn65904,13682989,87357692,73674703,TN
chr16,Bn65905,61501884,99628505,38126621,RLK
chr16,Bn65906,49188832,55042539,5853707,TNL
chr16,Bn65907,34116459,53595171,19478712,NBS
chr16,Bn65908,57115358,90823503,33708145,RLK
chr16,Bn65909,85227493,97981668,12754175,NBS
chr16,Bn65910,31426091,50405372,18979281,RLK
chr16,Bn65911,57252556,88126794,30874238,CNL
chr16,Bn65912,47925210,82503541,34578331,RLP
chr16,Bn65913,27821178,31221996,3400818,TN
chr16,Bn65914,36580535,62257554,25677019,RLK
chr16,Bn65915,90520698,95243239,4722541,RLK
chr16,Bn65916,52968420,96920370,43951950,TN
chr16,Bn65917,14066370,36598821,22532451,CN
chr16,Bn65918,79010235,91628488,12618253,TNL
chr16,Bn65919,87746295,93692734,5946439,TN
chr16,Bn65920,3318801,33358451,30039650,TN
chr16,Bn65921,38666571,45216966,6550395,RLK
chr16,Bn65922,21595165,95466839,73871674,CNL
chr16,Bn65923,77750867,88993254,11242387,CN
chr16,Bn65924,51810373,53218105,1407732,CN
chr16,Bn65925,2631725,27307165,24675440,TNL
chr16,Bn65926,70393376,74994782,4601406,TNL
chr16,Bn65927,54190864,91211558,37020694,TN
chr16,Bn65928,90859998,99532076,8672078,CNL
chr16,Bn65929,82186467,91453867,9267400,TNL
chr16,Bn65930,14285717,70815742,56530025,TNL
chr16,Bn65931,19237699,97495790,78258091,TNL
chr16,Bn65932,73381184,86736258,13355074,TN
chr16,Bn65933,43334087,75312309,31978222,TN
chr16,Bn65934,59138441,72132643,12994202,CNL
chr16,Bn65935,31361721,71960823,40599102,RLP
chr16,Bn65936,25073435,43100737,18027302,CN
chr16,Bn65937,29559118,80678044,51118926,CNL
chr16,Bn65938,75431576,88991193,13559617,CN
chr16,Bn65939,16327216,66697012,50369796,TNL
chr16,Bn65940,47499357,87538334,40038977,RLP
chr16,Bn65941,23242623,58046582,34803959,CNL
chr16,Bn65942,68831382,91984276,23152894,CN
chr16,Bn65943,88499021,96917322,8418301,RLP
chr16,Bn65944,24983834,55746570,30762736,TN
chr16,Bn65945,68123264,84023624,15900360,CNL
chr16,Bn65946,27203427,96490757,69287330,RLP
chr16,Bn65947,8925972,96761364,87835392,CNL
chr16,Bn65948,89959731,91885867,1926136,CN
chr16,Bn65949,84217791,87276963,3059172,CN
chr16,Bn65950,94483989,97625058,3141069,TNL
chr16,Bn65951,96303851,97402545,1098694,CNL
chr16,Bn65952,90794115,95217579,4423464,CN
chr16,Bn65953,80091439,82212250,2120811,NBS
chr16,Bn65954,6502514,9717649,3215135,RLP
chr16,Bn65955,20689673,80971650,60281977,CN
chr16,Bn65956,1738151,3312893,1574742,RLP
chr16,Bn65957,34542396,65722976,31180580,TN
chr16,Bn65958,16968108,90612821,73644713,CN
chr16,Bn65959,48727646,92294730,43567084,RLK
chr16,Bn65960,10732864,50548944,39816080,CN
chr16,Bn65961,37748475,92671076,54922601,NBS
chr16,Bn65962,98626426,99755183,1128757,RLP
chr16,Bn65963,42056186,65034798,22978612,RLP
chr16,Bn65964,7689000,26930144,19241144,CNL
chr16,Bn65965,73474259,96112925,22638666,RLP
chr16,Bn65966,10538337,83187104,72648767,NBS
chr16,Bn65967,95529655,96791789,1262134,RLK
chr16,Bn65968,81037219,96440795,15403576,CNL
chr16,Bn65969,24068104,43702431,19634327,RLK
chr16,Bn65970,6227938,20392304,14164366,CN
chr16,Bn65971,46026296,47395508,1369212,RLP
chr16,Bn65972,52147137,78581497,26434360,CNL
chr16,Bn65973,25187102,77973096,52785994,TN
chr16,Bn65974,74527598,85675497,11147899,RLP
chr16,Bn65975,28149334,49341633,21192299,RLP
chr16,Bn65976,86376665,93227346,6850681,TN
chr16,Bn65977,66472584,70127889,3655305,TN
chr16,Bn65978,23934150,62024188,38090038,RLK
chr16,Bn65979,85637845,93706716,8068871,TNL
chr16,Bn65980,91686270,97126012,5439742,CNL
chr16,Bn65981,33326089,88951131,55625042,TN
chr16,Bn65982,38047156,44071071,6023915,TN
chr16,Bn65983,3389727,98755084,95365357,NBS
chr16,Bn65984,60420456,97391508,36971052,NBS
chr16,Bn65985,82046074,92596413,10550339,CNL
chr16,Bn65986,61652265,85004993,23352728,RLK
chr16,Bn65987,26723265,72665981,45942716,RLP
chr16,Bn65988,71315503,71655439,339936,CNL
chr16,Bn65989,67959570,78400252,10440682,RLK
chr16,Bn65990,84513906,89057925,4544019,CN
chr16,Bn65991,73082311,99429669,26347358,RLK
chr16,Bn65992,5995036,57224942,51229906,RLK
chr16,Bn65993,82824852,82889843,64991,NBS
chr16,Bn65994,53691254,70003942,16312688,RLK
chr16,Bn65995,22296754,94571798,72275044,CN
chr16,Bn65996,58196625,88340924,30144299,NBS
chr16,Bn65997,16577827,72409386,55831559,RLP
chr16,Bn65998,93963230,96901263,2938033,RLP
chr16,Bn65999,27610562,70792476,43181914,RLP
chr16,Bn66000,50214614,66070559,15855945,RLP
chr16,Bn66001,98797818,99704850,907032,NBS
chr16,Bn66002,83145468,89640232,6494764,CNL
chr16,Bn66003,71951308,74148422,2197114,RLP
chr16,Bn66004,4368466,15548014,11179548,RLK
chr16,Bn66005,25143398,56058913,30915515,NBS
chr16,Bn66006,85191506,94375793,9184287,CN
chr16,Bn66007,51034291,92686754,41652463,TNL
chr16,Bn66008,55707786,62799405,7091619,TNL
chr16,Bn66009,1443309,62721819,61278510,CN
chr16,Bn66010,45864440,93141162,47276722,CN
chr16,Bn66011,12565563,31707631,19142068,TN
chr16,Bn66012,4047353,36987230,32939877,NBS
chr16,Bn66013,6727643,86922073,80194430,TNL
chr16,Bn66014,81928484,91220339,9291855,TN
chr16,Bn66015,6331365,7738723,1407358,NBS
chr16,Bn66016,98160051,98290694,130643,TNL
chr16,Bn66017,82590745,95132153,12541408,TNL
chr16,Bn66018,7609933,30566912,22956979,RLP
chr16,Bn66019,59795087,59818947,23860,TNL
chr16,Bn66020,7947357,46842554,38895197,TN
chr16,Bn66021,61603379,68767090,7163711,RLP
chr16,Bn66022,45840527,61465107,15624580,CNL
chr16,Bn66023,81017577,97148441,16130864,NBS
chr16,Bn66024,47322974,82360138,35037164,TNL
chr16,Bn66025,64143495,81069619,16926124,CN
chr16,Bn66026,74747893,88408543,13660650,TN
chr16,Bn66027,40671703,91563102,50891399,RLP
chr16,Bn66028,84270598,93955431,9684833,CN
chr16,Bn66029,75743901,92904394,17160493,CNL
chr16,Bn66030,57406760,85169286,27762526,RLP
chr16,Bn66031,25500140,30453702,4953562,RLP
chr16,Bn66032,80662615,98267745,17605130,TN
chr16,Bn66033,40408397,57814532,17406135,RLP
chr16,Bn66034,29384548,35133209,5748661,RLP
chr16,Bn66035,11705578,49911990,38206412,TN
chr16,Bn66036,13364067,77172573,63808506,TNL
chr16,Bn66037,7305459,82123072,74817613,CN
chr16,Bn66038,5629109,47324504,41695395,NBS
chr16,Bn66039,25022079,27534162,2512083,TNL
chr16,Bn66040,22084073,68183940,46099867,RLP
chr16,Bn66041,36972264,42982158,6009894,TN
chr16,Bn66042,86243922,87165807,921885,CN
chr16,Bn66043,56355117,77172191,20817074,TN
chr16,Bn66044,21684656,59052141,37367485,CNL
chr16,Bn66045,65264055,65496342,232287,NBS
chr16,Bn66046,60243067,75786063,15542996,NBS
chr16,Bn66047,28321089,96563610,68242521,CN
chr16,Bn66048,44200984,48049615,3848631,CN
chr16,Bn66049,50309226,73517278,23208052,RLK
chr16,Bn66050,75991364,98237743,22246379,RLK
chr16,Bn66051,54685923,68203026,13517103,CNL
chr16,Bn66052,86552028,88271427,1719399,RLP
chr16,Bn66053,70232250,79163289,8931039,CNL
chr16,Bn66054,37988949,91139205,53150256,TNL
chr16,Bn66055,29630972,36560155,6929183,CNL
chr16,Bn66056,29253832,66543827,37289995,NBS
chr16,Bn66057,37874250,71202360,33328110,RLP
chr16,Bn66058,44764901,95284606,50519705,NBS
chr16,Bn66059,90797114,97568727,6771613,NBS
chr16,Bn66060,77723861,93735006,16011145,CN
chr16,Bn66061,53147869,68970120,15822251,RLK
chr16,Bn66062,60346550,74846255,14499705,TN
chr16,Bn66063,52661794,99766553,47104759,RLK
chr16,Bn66064,47433324,73253868,25820544,CN
chr16,Bn66065,31499364,88557998,57058634,CN
chr16,Bn66066,10869905,66982389,56112484,NBS
chr16,Bn66067,8589176,61109884,52520708,RLK
chr16,Bn66068,97585767,99660998,2075231,CNL
chr16,Bn66069,11985046,54532043,42546997,NBS
chr16,Bn66070,76391846,86939022,10547176,NBS
chr16,Bn66071,29505253,42559206,13053953,CNL
chr16,Bn66072,57601682,78323503,20721821,CNL
chr16,Bn66073,8398304,33736642,25338338,CN
chr16,Bn66074,26693086,29031286,2338200,NBS
chr16,Bn66075,16354407,33400628,17046221,RLK
chr16,Bn66076,59824017,92002726,32178709,TN
chr16,Bn66077,85229155,96860762,11631607,CN
chr16,Bn66078,91180953,97241010,6060057,RLK
chr16,Bn66079,36914593,66063967,29149374,CNL
chr16,Bn66080,95793043,97721297,1928254,RLP
chr16,Bn66081,42636652,57880441,15243789,CNL
chr16,Bn66082,85714488,92510916,6796428,CN
chr16,Bn66083,47404851,83867590,36462739,TN
chr16,Bn66084,95195343,95950764,755421,TNL
chr16,Bn66085,38488433,39950947,1462514,TNL
chr16,Bn66086,50768370,93121413,42353043,TN
chr16,Bn66087,28565666,64116949,35551283,TNL
chr16,Bn66088,66488351,88184433,21696082,RLK
chr16,Bn66089,86051664,94331403,8279739,CN
chr16,Bn66090,64483541,93951542,29468001,TN
chr16,Bn66091,67842375,92654516,24812141,RLP
chr16,Bn66092,22964768,33764504,10799736,CN
chr16,Bn66093,75920325,90054905,14134580,RLP
chr16,Bn66094,72547060,92260457,19713397,TNL
chr16,Bn66095,20878072,36121552,15243480,NBS
chr16,Bn66096,50515437,64111408,13595971,RLK
chr16,Bn66097,96840114,97327402,487288,TN
chr16,Bn66098,50456675,78384403,27927728,RLK
chr16,Bn66099,24192482,78263131,54070649,RLP
chr16,Bn66100,1512162,5304441,3792279,RLK
chr16,Bn66101,70996397,92634321,21637924,RLP
chr16,Bn66102,20506643,77727883,57221240,CN
chr16,Bn66103,97990824,99676094,1685270,TNL
chr16,Bn66104,77950985,89173878,11222893,TNL
chr16,Bn66105,41808307,79484107,37675800,TNL
chr16,Bn66106,69664549,71090092,1425543,RLP
chr16,Bn66107,26484044,52195703,25711659,TN
chr16,Bn66108,68363096,78864799,10501703,TN
chr16,Bn66109,78769810,90285281,11515471,NBS
chr16,Bn66110,22312941,56783435,34470494,CNL
chr16,Bn66111,85439309,92273115,6833806,NBS
chr16,Bn66112,85565065,91806067,6241002,TNL
chr16,Bn66113,40706844,49046474,8339630,NBS
chr16,Bn66114,3146648,35464232,32317584,RLP
chr16,Bn66115,26755126,58694759,31939633,CNL
chr16,Bn66116,25419654,65512057,40092403,NBS
chr16,Bn66117,16448632,34075194,17626562,RLP
chr16,Bn66118,15249963,66442511,51192548,RLK
chr16,Bn66119,64345916,85213534,20867618,TNL
chr16,Bn66120,49947285,83153889,33206604,CN
chr16,Bn66121,77134347,79884489,2750142,CNL
chr16,Bn66122,8350687,29958178,21607491,RLP
chr16,Bn66123,54278886,99900955,45622069,NBS
chr16,Bn66124,58388863,65920137,7531274,RLP
chr16,Bn66125,54722499,93624747,38902248,NBS
chr16,Bn66126,92383842,94798127,2414285,CNL
chr16,Bn66127,75905691,92687802,16782111,CN
chr16,Bn66128,96712326,98313706,1601380,NBS
chr16,Bn66129,62791975,94344531,31552556,TN
chr16,Bn66130,44981703,98791381,53809678,CNL
chr16,Bn66131,89027742,94626527,5598785,NBS
chr16,Bn66132,41435324,51570363,10135039,CN
chr16,Bn66133,38413635,43893193,5479558,TNL
chr16,Bn66134,51762375,97951839,46189464,NBS
chr16,Bn66135,57163444,72562905,15399461,TN
chr16,Bn66136,56017985,72779249,16761264,CN
chr16,Bn66137,60781534,94313735,33532201,RLK
chr16,Bn66138,16782298,97800107,81017809,RLP
chr16,Bn66139,91107855,94330444,3222589,RLP
chr16,Bn66140,40973719,77161156,36187437,CNL
chr16,Bn66141,20360585,83433795,63073210,CN
chr16,Bn66142,38421807,47196443,8774636,CN
chr16,Bn66143,77688632,80165678,2477046,CNL
chr16,Bn66144,70655997,77773153,7117156,NBS
chr16,Bn66145,47232041,96496471,49264430,TN
chr16,Bn66146,69323731,89995445,20671714,TNL
chr16,Bn66147,8425885,48345583,39919698,RLK
chr16,Bn66148,53798728,59574809,5776081,NBS
chr16,Bn66149,99709821,99999087,289266,CN
chr16,Bn66150,43903388,47307736,3404348,TNL
chr16,Bn66151,67424473,67851091,426618,NBS
chr16,Bn66152,30119461,68678313,38558852,NBS
chr16,Bn66153,89743432,94615419,4871987,CNL
chr16,Bn66154,79486030,84922109,5436079,TN
chr16,Bn66155,18455817,98198078,79742261,CN
chr16,Bn66156,57332344,90708916,33376572,RLP
chr16,Bn66157,34389944,88304351,53914407,CNL
chr16,Bn66158,45543424,57837512,12294088,NBS
chr16,Bn66159,99865749,99921283,55534,RLK
chr16,Bn66160,86575907,96924116,10348209,CN
chr16,Bn66161,51046543,90163730,39117187,TNL
chr16,Bn66162,28221839,42339210,14117371,RLP
chr16,Bn66163,23567647,83460249,59892602,RLK
chr16,Bn66164,2029008,38571854,36542846,CN
chr16,Bn66165,88034360,88392012,357652,RLK
chr16,Bn66166,89693052,96415039,6721987,CN
chr16,Bn66167,99382693,99501503,118810,RLP
chr16,Bn66168,7255779,67063777,59807998,RLP
chr16,Bn66169,63233363,65053796,1820433,TN
chr16,Bn66170,90531276,99627597,9096321,TNL
chr16,Bn66171,51518417,70206827,18688410,NBS
chr16,Bn66172,78920692,98643946,19723254,NBS
chr16,Bn66173,68042058,99675620,31633562,TNL
chr16,Bn66174,57578069,82939212,25361143,RLP
chr16,Bn66175,14897786,69965143,55067357,CNL
chr16,Bn66176,35583072,38969461,3386389,CNL
chr16,Bn66177,74883389,96116282,21232893,RLP
chr16,Bn66178,18736863,19872706,1135843,RLK
chr16,Bn66179,17335724,62106113,44770389,RLK
chr16,Bn66180,56815357,68452078,11636721,RLK
chr16,Bn66181,75550510,88117708,12567198,NBS
chr16,Bn66182,88444846,94441399,5996553,CNL
chr16,Bn66183,32696572,82767445,50070873,CN
chr16,Bn66184,70651897,90778819,20126922,NBS
chr16,Bn66185,94862944,99730783,4867839,CNL
chr16,Bn66186,16519833,99369810,82849977,CN
chr16,Bn66187,26612351,63392098,36779747,TN
chr16,Bn66188,4074078,13609329,9535251,CN
chr16,Bn66189,49937418,64880444,14943026,RLK
chr16,Bn66190,90817501,92921113,2103612,NBS
chr16,Bn66191,80099243,98941847,18842604,RLK
chr16,Bn66192,28201689,88127825,59926136,RLK
chr16,Bn66193,20958870,60955890,39997020,TNL
chr16,Bn66194,15393961,32283284,16889323,RLK
chr16,Bn66195,79136069,79454037,317968,TNL
chr16,Bn66196,88729448,99901717,11172269,TN
chr16,Bn66197,34169203,64588694,30419491,TNL
chr16,Bn66198,25801520,82603236,56801716,TNL
chr16,Bn66199,93212746,95314511,2101765,CN
chr16,Bn66200,22011947,42234589,20222642,CN
chr16,Bn66201,63681412,86965288,23283876,CNL
chr16,Bn66202,70653710,70953033,299323,RLK
chr16,Bn66203,53163171,54471548,1308377,TNL
chr16,Bn66204,99188837,99736688,547851,NBS
chr16,Bn66205,95388587,96722188,1333601,CN
chr16,Bn66206,13386781,29498488,16111707,RLK
chr16,Bn66207,19733629,19794427,60798,CN
chr16,Bn66208,39284040,86276368,46992328,CN
chr16,Bn66209,88121876,97203067,9081191,RLP
chr16,Bn66210,8882201,47659130,38776929,TN
chr16,Bn66211,76523184,94808694,18285510,CNL
chr16,Bn66212,70545225,87082489,16537264,CN
chr16,Bn66213,83066873,96198392,13131519,NBS
chr16,Bn66214,61205156,67007510,5802354,RLK
chr16,Bn66215,22414934,43420716,21005782,TNL
chr16,Bn66216,23658478,30741109,7082631,CNL
chr16,Bn66217,44349474,92688246,48338772,NBS
chr16,Bn66218,60850732,61514263,663531,RLK
chr16,Bn66219,26343520,55672557,29329037,NBS
chr16,Bn66220,52329186,78464119,26134933,CN
chr16,Bn66221,11890257,92282031,80391774,CNL
chr16,Bn66222,14823129,90221542,75398413,RLK
chr16,Bn66223,28056164,62627421,34571257,TN
chr16,Bn66224,90612674,93493770,2881096,NBS
chr16,Bn66225,6023139,29475626,23452487,CN
chr16,Bn66226,91110574,99066577,7956003,CNL
chr16,Bn66227,91580056,98175901,6595845,NBS
chr16,Bn66228,45884141,59294301,13410160,NBS
chr16,Bn66229,67113382,71479878,4366496,NBS
chr16,Bn66230,65489314,83806820,18317506,TNL
chr16,Bn66231,86459073,95856075,9397002,NBS
chr16,Bn66232,75843440,84286850,8443410,TN
chr16,Bn66233,53212127,94089618,40877491,TN
chr16,Bn66234,45070515,74979373,29908858,CN
chr16,Bn66235,65086887,77848880,12761993,NBS
chr16,Bn66236,49205087,89963076,40757989,TN
chr16,Bn66237,78735925,80092337,1356412,NBS
chr16,Bn66238,25774805,89376657,63601852,NBS
chr16,Bn66239,78974422,81583061,2608639,CNL
chr16,Bn66240,97414413,98621743,1207330,CNL
chr16,Bn66241,46902957,95470346,48567389,CN
chr16,Bn66242,42978993,99005025,56026032,NBS
chr16,Bn66243,47037699,64053281,17015582,TN
chr16,Bn66244,94450704,97543548,3092844,RLK
chr16,Bn66245,58879262,96628762,37749500,NBS
chr16,Bn66246,24409521,60684741,36275220,TNL
chr16,Bn66247,32202975,34001445,1798470,TNL
chr16,Bn66248,83395164,90432752,7037588,CN
chr16,Bn66249,19439773,96069571,76629798,RLP
chr16,Bn66250,24524343,51737151,27212808,CN
chr16,Bn66251,54803875,93548910,38745035,RLK
chr16,Bn66252,54237565,58749535,4511970,TNL
chr16,Bn66253,97046043,97430076,384033,CNL
chr16,Bn66254,65822586,84236311,18413725,RLP
chr16,Bn66255,6663801,87445598,80781797,RLK
chr16,Bn66256,18611047,35863283,17252236,CNL
chr16,Bn66257,82051232,96696025,14644793,RLK
chr16,Bn66258,36558863,87275122,50716259,NBS
chr16,Bn66259,96625497,98730807,2105310,CN
chr16,Bn66260,21527334,25888296,4360962,NBS
chr16,Bn66261,23719534,85707663,61988129,TN
chr16,Bn66262,78116268,79549239,1432971,RLK
chr16,Bn66263,48059996,64373949,16313953,NBS
chr16,Bn66264,23716557,34959914,11243357,CN
chr16,Bn66265,94802986,99667463,4864477,TN
chr16,Bn66266,38641663,68599466,29957803,RLK
chr16,Bn66267,77469142,86889588,9420446,CNL
chr16,Bn66268,73359838,76227561,2867723,RLK
chr16,Bn66269,58465027,78082529,19617502,CN
chr16,Bn66270,59950149,86758325,26808176,CN
chr16,Bn66271,81326761,86737648,5410887,CNL
chr16,Bn66272,56799074,92860528,36061454,NBS
chr16,Bn66273,6497047,63130947,56633900,TNL
chr16,Bn66274,95569212,96075180,505968,TN
chr16,Bn66275,43103613,83515386,40411773,RLK
chr16,Bn66276,40631453,68256942,27625489,CNL
chr16,Bn66277,83928060,87689299,3761239,RLP
chr16,Bn66278,24266859,90268972,66002113,CN
chr16,Bn66279,45273680,75420769,30147089,TN
chr16,Bn66280,65081241,81223194,16141953,TNL
chr16,Bn66281,85837761,97821914,11984153,RLP
chr16,Bn66282,27247422,63597744,36350322,NBS
chr16,Bn66283,46323741,93450799,47127058,CN
chr16,Bn66284,28569152,74646414,46077262,NBS
chr16,Bn66285,9041750,69297540,60255790,TNL
chr16,Bn66286,61909680,78116483,16206803,RLK
chr16,Bn66287,4229000,11923069,7694069,NBS
chr16,Bn66288,4259399,50113808,45854409,CNL
chr16,Bn66289,24309412,79873520,55564108,RLK
chr16,Bn66290,94192845,94809695,616850,CNL
chr16,Bn66291,75434179,99076531,23642352,CN
chr16,Bn66292,73786872,92493827,18706955,CN
chr16,Bn66293,89451663,99287257,9835594,TN
chr16,Bn66294,73427761,75724999,2297238,RLK
chr16,Bn66295,65233262,69734068,4500806,TNL
chr16,Bn66296,99558733,99694462,135729,NBS
chr16,Bn66297,15025299,69222143,54196844,NBS
chr16,Bn66298,73694491,80554391,6859900,RLP
chr16,Bn66299,68636993,76357779,7720786,NBS
chr16,Bn66300,95345351,96891642,1546291,NBS
chr16,Bn66301,78787156,92526395,13739239,RLK
chr16,Bn66302,15764260,72753463,56989203,TNL
chr16,Bn66303,42524219,87058333,44534114,NBS
chr16,Bn66304,27427612,53405191,25977579,NBS
chr16,Bn66305,25947203,25980644,33441,CNL
chr16,Bn66306,45482306,72734637,27252331,RLP
chr17,Bn66307,21562438,23104094,1541656,RLP
chr17,Bn66308,41608699,75334592,33725893,CNL
chr17,Bn66309,54985666,86125868,31140202,CN
chr17,Bn66310,15827946,73389987,57562041,CN
chr17,Bn66311,11392321,89843302,78450981,TNL
chr17,Bn66312,45010857,87061748,42050891,RLK
chr17,Bn66313,14126166,87727004,73600838,NBS
chr17,Bn66314,74924098,87418016,12493918,TNL
chr17,Bn66315,92233453,93948128,1714675,RLK
chr17,Bn66316,87915933,98612749,10696816,RLK
chr17,Bn66317,9715922,50242278,40526356,TN
chr17,Bn66318,88982575,98494055,9511480,NBS
chr17,Bn66319,16013667,22166827,6153160,NBS
chr17,Bn66320,8361906,82538369,74176463,TNL
chr17,Bn66321,94031432,98646401,4614969,TN
chr17,Bn66322,53487363,55276085,1788722,TNL
chr17,Bn66323,52776880,98779244,46002364,NBS
chr17,Bn66324,42937849,70840678,27902829,CNL
chr17,Bn66325,7576851,31607007,24030156,CN
chr17,Bn66326,81857384,93461543,11604159,CN
chr17,Bn66327,57133779,73210197,16076418,RLK
chr17,Bn66328,38760511,42691957,3931446,RLK
chr17,Bn66329,10406885,97380579,86973694,TNL
chr17,Bn66330,75077812,95533442,20455630,RLK
chr17,Bn66331,59609925,65992736,6382811,TNL
chr17,Bn66332,70601502,81483572,10882070,RLP
chr17,Bn66333,63895911,66553850,2657939,CNL
chr17,Bn66334,12650103,29292370,16642267,RLP
chr17,Bn66335,95927755,96514472,586717,CNL
chr17,Bn66336,20842989,58703808,37860819,CN
chr17,Bn66337,78132589,80392126,2259537,TNL
chr17,Bn66338,29278209,42499141,13220932,RLP
chr17,Bn66339,19667320,33758064,14090744,TNL
chr17,Bn66340,38657400,75225084,36567684,RLK
chr17,Bn66341,92189014,99769619,7580605,TN
chr17,Bn66342,80718424,84880050,4161626,RLK
chr17,Bn66343,82870559,95298096,12427537,RLP
chr17,Bn66344,39186922,66843169,27656247,CNL
chr17,Bn66345,61317477,77165949,15848472,RLK
chr17,Bn66346,29546715,87682997,58136282,TN
chr17,Bn66347,38771340,50263153,11491813,NBS
chr17,Bn66348,91988884,96174787,4185903,CNL
chr17,Bn66349,74516644,94624293,20107649,TNL
chr17,Bn66350,46790585,49957536,3166951,CNL
chr17,Bn66351,87411665,89243400,1831735,RLK
chr17,Bn66352,59094329,85392083,26297754,TN
chr17,Bn66353,37076120,45030156,7954036,NBS
chr17,Bn66354,70344896,96376556,26031660,NBS
chr17,Bn66355,69637593,75665608,6028015,TNL
chr17,Bn66356,56344899,88339186,31994287,CN
chr17,Bn66357,14804950,72407673,57602723,CNL
chr17,Bn66358,72447378,88021533,15574155,CN
chr17,Bn66359,71909967,86733914,14823947,CN
chr17,Bn66360,22854043,61184714,38330671,CN
chr17,Bn66361,95966423,97693591,1727168,CN
chr17,Bn66362,23416682,86831938,63415256,NBS
chr17,Bn66363,38182026,89903271,51721245,NBS
chr17,Bn66364,20927134,39820046,18892912,TN
chr17,Bn66365,20863925,70155523,49291598,TNL
chr17,Bn66366,14711597,60939370,46227773,CNL
chr17,Bn66367,49580164,93157915,43577751,NBS
chr17,Bn66368,95401519,98766024,3364505,RLK
chr17,Bn66369,29295093,55737554,26442461,TNL
chr17,Bn66370,24418924,89714802,65295878,NBS
chr17,Bn66371,66916527,97913551,30997024,CNL
chr17,Bn66372,19114010,70678769,51564759,TN
chr17,Bn66373,8082013,14115986,6033973,RLK
chr17,Bn66374,15455324,45251002,29795678,RLP
chr17,Bn66375,63970378,66568698,2598320,CNL
chr17,Bn66376,46048299,96155743,50107444,RLP
chr17,Bn66377,86841424,97407824,10566400,TN
chr17,Bn66378,8081426,28288557,20207131,CN
chr17,Bn66379,10867540,13049667,2182127,TNL
chr17,Bn66380,92772046,92972522,200476,CN
chr17,Bn66381,39045412,45164674,6119262,RLP
chr17,Bn66382,82665201,95169883,12504682,RLP
chr17,Bn66383,85269862,86265081,995219,TNL
chr17,Bn66384,66308865,69206055,2897190,NBS
chr17,Bn66385,90206786,90950732,743946,CNL
chr17,Bn66386,77400013,95851187,18451174,TNL
chr17,Bn66387,96989975,97163796,173821,NBS
chr17,Bn66388,19552652,39874301,20321649,RLK
chr17,Bn66389,22580548,99703598,77123050,CN
chr17,Bn66390,50452014,88740890,38288876,NBS
chr17,Bn66391,47047901,52020471,4972570,TNL
chr17,Bn66392,58043599,70422062,12378463,RLP
chr17,Bn66393,27107394,94904666,67797272,TNL
chr17,Bn66394,92560193,96333065,3772872,CNL
chr17,Bn66395,90157409,96648931,6491522,NBS
chr17,Bn66396,37260864,48462832,11201968,CN
chr17,Bn66397,98861385,99427121,565736,TN
chr17,Bn66398,81966572,89281007,7314435,RLK
chr17,Bn66399,7094049,76971187,69877138,RLP
chr17,Bn66400,39498257,69935387,30437130,RLP
chr17,Bn66401,23799300,61543356,37744056,CN
chr17,Bn66402,79789302,88246093,8456791,RLK
chr17,Bn66403,47758501,83131342,35372841,NBS
chr17,Bn66404,28708548,40065154,11356606,RLK
chr17,Bn66405,89758206,99980347,10222141,RLP
chr17,Bn66406,74889107,79216787,4327680,NBS
chr17,Bn66407,27401411,99498201,72096790,RLK
chr17,Bn66408,20500988,88658589,68157601,RLP
chr17,Bn66409,75494347,82131575,6637228,CN
chr17,Bn66410,72743479,87515990,14772511,TNL
chr17,Bn66411,22342719,40873326,18530607,CN
chr17,Bn66412,2693697,97707443,95013746,RLK
chr17,Bn66413,54545221,72801966,18256745,RLP
chr17,Bn66414,77259568,84371879,7112311,CNL
chr17,Bn66415,14084517,40022747,25938230,CN
chr17,Bn66416,97918457,98828404,909947,TNL
chr17,Bn66417,75034655,90105211,15070556,NBS
chr17,Bn66418,27939335,53733679,25794344,RLK
chr17,Bn66419,9839132,76370795,66531663,TNL
chr17,Bn66420,94442552,98748555,4306003,RLP
chr17,Bn66421,8307424,63574295,55266871,TNL
chr17,Bn66422,80279565,84826167,4546602,NBS
chr17,Bn66423,40329743,71385047,31055304,RLK
chr17,Bn66424,57799862,72866860,15066998,CNL
chr17,Bn66425,4739938,28793425,24053487,CNL
chr17,Bn66426,51434022,95001941,43567919,RLK
chr17,Bn66427,40901075,55941446,15040371,RLP
chr17,Bn66428,36026473,52787771,16761298,NBS
chr17,Bn66429,90543091,91213290,670199,CNL
chr17,Bn66430,21965057,64191164,42226107,CN
chr17,Bn66431,73551089,87418088,13866999,TN
chr17,Bn66432,74911296,85420409,10509113,CN
chr17,Bn66433,52948475,78474239,25525764,CNL
chr17,Bn66434,16384984,99617558,83232574,NBS
chr17,Bn66435,88959490,95617793,6658303,TNL
chr17,Bn66436,3629756,76627418,72997662,TN
chr17,Bn66437,73448859,85160986,11712127,RLK
chr17,Bn66438,60731699,68574366,7842667,CN
chr17,Bn66439,14164361,34203921,20039560,CNL
chr17,Bn66440,54528049,68940513,14412464,RLP
chr17,Bn66441,66252803,96602709,30349906,TNL
chr17,Bn66442,18167381,76978139,58810758,RLK
chr17,Bn66443,60268229,77438773,17170544,RLK
chr17,Bn66444,26894494,83317729,56423235,RLP
chr17,Bn66445,65511882,90403809,24891927,CN
chr17,Bn66446,26870025,35362883,8492858,NBS
chr17,Bn66447,72007190,86975002,14967812,RLK
chr17,Bn66448,2341549,61475787,59134238,RLK
chr17,Bn66449,62536270,82371765,19835495,RLP
chr17,Bn66450,6205202,73231972,67026770,CNL
chr17,Bn66451,39846594,52450882,12604288,CN
chr17,Bn66452,89671498,97663096,7991598,TN
chr17,Bn66453,76068628,82153711,6085083,RLP
chr17,Bn66454,11675685,90055283,78379598,RLP
chr17,Bn66455,33377081,50092125,16715044,CN
chr17,Bn66456,70323261,88083839,17760578,CNL
chr17,Bn66457,64728685,96811738,32083053,RLP
chr17,Bn66458,44761722,77461269,32699547,TNL
chr17,Bn66459,25552119,75752743,50200624,TNL
chr17,Bn66460,77920783,85860779,7939996,RLK
chr17,Bn66461,1433459,3080244,1646785,CN
chr17,Bn66462,32219648,43385017,11165369,CNL
chr17,Bn66463,78392518,79497910,1105392,RLP
chr17,Bn66464,72980935,94590514,21609579,TNL
chr17,Bn66465,96152071,98289071,2137000,CN
chr17,Bn66466,27042028,30413002,3370974,TN
chr17,Bn66467,85538027,88011948,2473921,CNL
chr17,Bn66468,38918043,57518972,18600929,NBS
chr17,Bn66469,56942564,88084473,31141909,CNL
chr17,Bn66470,82236444,96105130,13868686,CNL
chr17,Bn66471,29416785,45850171,16433386,CN
chr17,Bn66472,98586265,98773144,186879,NBS
chr17,Bn66473,89532442,93214711,3682269,RLP
chr17,Bn66474,92593924,97933337,5339413,TN
chr17,Bn66475,7753653,53545196,45791543,CNL
chr17,Bn66476,39642412,97636224,57993812,NBS
chr17,Bn66477,21157674,88013075,66855401,CN
chr17,Bn66478,74326792,93759337,19432545,RLK
chr17,Bn66479,30744741,78675961,47931220,CNL
chr17,Bn66480,29006163,96396243,67390080,RLP
chr17,Bn66481,39346525,84825445,45478920,RLP
chr17,Bn66482,41374540,48994774,7620234,NBS
chr17,Bn66483,97326044,98236162,910118,RLP
chr17,Bn66484,56378721,71673131,15294410,CNL
chr17,Bn66485,10591320,90895011,80303691,CN
chr17,Bn66486,58066295,58712940,646645,RLK
chr17,Bn66487,14665075,65849732,51184657,NBS
chr17,Bn66488,83412824,95159474,11746650,CN
chr17,Bn66489,2726780,66484067,63757287,CN
chr17,Bn66490,31457746,78186266,46728520,TNL
chr17,Bn66491,41358687,98848026,57489339,TN
chr17,Bn66492,9875830,28759073,18883243,TN
chr17,Bn66493,41381045,99689010,58307965,RLK
chr17,Bn66494,97610803,99948581,2337778,TNL
chr17,Bn66495,99522423,99690992,168569,RLK
chr17,Bn66496,31895320,88234911,56339591,RLP
chr17,Bn66497,11638601,16576054,4937453,TN
chr17,Bn66498,58500983,87857318,29356335,TN
chr17,Bn66499,98518536,99005737,487201,CNL
chr17,Bn66500,23688236,78661034,54972798,TNL
chr17,Bn66501,97274953,99124856,1849903,TNL
chr17,Bn66502,33660707,91920520,58259813,CN
chr17,Bn66503,21008678,28396434,7387756,NBS
chr17,Bn66504,73626520,82447579,8821059,TNL
chr17,Bn66505,71826962,87126280,15299318,CNL
chr17,Bn66506,22057480,33844703,11787223,CN
chr17,Bn66507,95114784,96543994,1429210,RLP
chr17,Bn66508,16678819,91732822,75054003,CNL
chr17,Bn66509,1506727,84747193,83240466,TNL
chr17,Bn66510,40704813,45032131,4327318,RLK
chr17,Bn66511,86458086,96855415,10397329,TNL
chr17,Bn66512,89534708,95374198,5839490,CNL
chr17,Bn66513,50838975,78023462,27184487,NBS
chr17,Bn66514,70406275,85703755,15297480,TN
chr17,Bn66515,29943756,38647141,8703385,TN
chr17,Bn66516,98753840,98874748,120908,RLP
chr17,Bn66517,1654933,77892727,76237794,TNL
chr17,Bn66518,74471375,85379977,10908602,TNL
chr17,Bn66519,51669510,95023747,43354237,RLP
chr17,Bn66520,22187083,37813769,15626686,NBS
chr17,Bn66521,13403778,58256736,44852958,RLK
chr17,Bn66522,97685576,99753684,2068108,NBS
chr17,Bn66523,91663927,96676939,5013012,RLP
chr17,Bn66524,78052563,86471489,8418926,TN
chr17,Bn66525,68988193,97139020,28150827,TN
chr17,Bn66526,47635518,64730324,17094806,RLK
chr17,Bn66527,70728782,95242938,24514156,RLP
chr17,Bn66528,22516648,29927813,7411165,TN
chr17,Bn66529,8634153,72712112,64077959,NBS
chr17,Bn66530,64122745,89022935,24900190,RLP
chr17,Bn66531,3257985,28351873,25093888,RLP
chr17,Bn66532,20900549,69499685,48599136,NBS
chr17,Bn66533,28951603,94285557,65333954,RLK
chr17,Bn66534,35407036,66259871,30852835,NBS
chr17,Bn66535,32891711,61473591,28581880,CN
chr17,Bn66536,77312434,82387998,5075564,NBS
chr17,Bn66537,58466814,61801471,3334657,TN
chr17,Bn66538,45326556,46836964,1510408,RLK
chr17,Bn66539,92363477,94155855,1792378,TNL
chr17,Bn66540,87202167,96637999,9435832,RLK
chr17,Bn66541,36518793,94915390,58396597,NBS
chr17,Bn66542,38098054,39479129,1381075,TN
chr17,Bn66543,66876653,92521678,25645025,CNL
chr17,Bn66544,53619059,64634564,11015505,NBS
chr17,Bn66545,20823520,84641223,63817703,CN
chr17,Bn66546,8454298,38725473,30271175,TN
chr17,Bn66547,73798112,89924201,16126089,CN
chr17,Bn66548,1666513,30516057,28849544,TNL
chr17,Bn66549,98102255,99349352,1247097,TNL
chr17,Bn66550,25711498,52820408,27108910,NBS
chr17,Bn66551,34856221,42102555,7246334,CNL
chr17,Bn66552,85462303,98858582,13396279,RLK
chr17,Bn66553,97698419,98527806,829387,TNL
chr17,Bn66554,9507260,79605953,70098693,NBS
chr17,Bn66555,82917480,97484121,14566641,TN
chr17,Bn66556,7943183,95547216,87604033,TN
chr17,Bn66557,64713178,95454018,30740840,CNL
chr17,Bn66558,4850009,38389917,33539908,TN
chr17,Bn66559,69107011,81226613,12119602,RLK
chr17,Bn66560,11430271,70209106,58778835,TN
chr17,Bn66561,93181936,96099276,2917340,NBS
chr17,Bn66562,1574913,31262947,29688034,RLP
chr17,Bn66563,37571345,41481156,3909811,RLK
chr17,Bn66564,41759668,59669633,17909965,CN
chr17,Bn66565,25909423,56202910,30293487,TN
chr17,Bn66566,80602115,85990643,5388528,CN
chr17,Bn66567,88446979,97410040,8963061,RLP
chr17,Bn66568,23175197,86763189,63587992,CNL
chr17,Bn66569,57623338,82262846,24639508,TNL
chr17,Bn66570,78059468,79923584,1864116,CN
chr17,Bn66571,51700513,84672538,32972025,TNL
chr17,Bn66572,64160419,93333608,29173189,NBS
chr17,Bn66573,79140336,83904026,4763690,CNL
chr17,Bn66574,23725713,40149587,16423874,CN
chr17,Bn66575,53822873,82175302,28352429,CNL
chr17,Bn66576,5454069,96082839,90628770,NBS
chr17,Bn66577,38686581,47863141,9176560,CN
chr17,Bn66578,6388515,88323216,81934701,CNL
chr17,Bn66579,81946421,92271571,10325150,NBS
chr17,Bn66580,40824637,46200329,5375692,CN
chr17,Bn66581,76922462,80551101,3628639,TNL
chr17,Bn66582,56102670,69589955,13487285,RLP
chr17,Bn66583,77020775,87330080,10309305,RLK
chr17,Bn66584,55133090,86457848,31324758,NBS
chr17,Bn66585,33237498,93031957,59794459,CNL
chr17,Bn66586,18245164,63423247,45178083,TN
chr17,Bn66587,83289937,96397856,13107919,CN
chr17,Bn66588,22451412,96382776,73931364,TNL
chr17,Bn66589,91547481,91629045,81564,NBS
chr17,Bn66590,48997154,77230227,28233073,RLP
chr17,Bn66591,56936466,71720025,14783559,CNL
chr17,Bn66592,98186092,98334711,148619,RLP
chr17,Bn66593,45481756,51662874,6181118,TN
chr17,Bn66594,76073784,96483176,20409392,NBS
chr17,Bn66595,91671800,99062416,7390616,RLK
chr17,Bn66596,62478523,80608112,18129589,RLK
chr17,Bn66597,27568527,91133116,63564589,RLP
chr17,Bn66598,34476999,91584412,57107413,RLK
chr17,Bn66599,72160790,98628313,26467523,CNL
chr17,Bn66600,93100697,94020218,919521,NBS
chr17,Bn66601,35737899,92482844,56744945,NBS
chr17,Bn66602,25842309,64536950,38694641,TN
chr17,Bn66603,50009898,95737930,45728032,RLP
chr17,Bn66604,2769608,35605956,32836348,CN
chr17,Bn66605,71784929,88777151,16992222,CN
chr17,Bn66606,45713254,58936845,13223591,NBS
chr17,Bn66607,83974440,96088326,12113886,CN
chr17,Bn66608,66130114,87297919,21167805,TN
chr17,Bn66609,82473831,98152470,15678639,TNL
chr17,Bn66610,15001715,35708027,20706312,TN
chr17,Bn66611,67344200,90128860,22784660,TNL
chr17,Bn66612,13563878,84987884,71424006,RLP
chr17,Bn66613,23599014,61986063,38387049,RLK
chr17,Bn66614,80774375,99494586,18720211,NBS
chr17,Bn66615,67646223,90087249,22441026,RLK
chr17,Bn66616,86312766,97218931,10906165,TNL
chr17,Bn66617,68300244,90173345,21873101,TN
chr17,Bn66618,42637472,70286434,27648962,TNL
chr17,Bn66619,91094010,95916620,4822610,RLK
chr17,Bn66620,88724840,89155562,430722,TN
chr17,Bn66621,18904163,68366781,49462618,TN
chr17,Bn66622,30207304,68937463,38730159,TN
chr17,Bn66623,98329876,98874450,544574,RLK
chr17,Bn66624,58500117,92056417,33556300,RLP
chr17,Bn66625,32477044,89660158,57183114,CN
chr17,Bn66626,96021021,99729485,3708464,NBS
chr17,Bn66627,82560502,83195914,635412,CN
chr17,Bn66628,42630437,92194009,49563572,RLP
chr17,Bn66629,23938451,48220826,24282375,TNL
chr17,Bn66630,53785989,86058614,32272625,CNL
chr17,Bn66631,16984389,36521058,19536669,RLP
chr17,Bn66632,23946192,46699285,22753093,NBS
chr17,Bn66633,72663794,92478036,19814242,TN
chr17,Bn66634,81167367,81534998,367631,RLK
chr17,Bn66635,68215150,75517223,7302073,TN
chr17,Bn66636,68464628,92793614,24328986,RLP
chr17,Bn66637,62297431,95377166,33079735,CNL
chr17,Bn66638,26476856,44511741,18034885,RLK
chr17,Bn66639,98072046,99307780,1235734,TN
chr17,Bn66640,1617197,12973379,11356182,NBS
chr17,Bn66641,37160062,95902079,58742017,CNL
chr17,Bn66642,44789107,81763014,36973907,RLP
chr17,Bn66643,96573913,98697565,2123652,TN
chr17,Bn66644,74974074,81882755,6908681,RLK
chr17,Bn66645,18135904,62864210,44728306,CN
chr17,Bn66646,39880366,74598226,34717860,RLP
chr17,Bn66647,29310092,85457200,56147108,TN
chr17,Bn66648,7928289,47427248,39498959,TN
chr17,Bn66649,5242170,90706603,85464433,CN
chr17,Bn66650,21094349,89291017,68196668,TNL
chr17,Bn66651,68212574,87901291,19688717,TN
chr17,Bn66652,41733005,80704056,38971051,NBS
chr17,Bn66653,21959231,44635338,22676107,NBS
chr17,Bn66654,8444066,29681792,21237726,TN
chr17,Bn66655,25749281,62231783,36482502,NBS
chr17,Bn66656,57444532,64088969,6644437,TNL
chr17,Bn66657,60036806,61897441,1860635,RLK
chr17,Bn66658,25821773,97566371,71744598,TNL
chr17,Bn66659,15920282,59613871,43693589,CNL
chr17,Bn66660,1164581,26533372,25368791,RLP
chr17,Bn66661,89217547,98663544,9445997,CN
chr17,Bn66662,62657154,91921324,29264170,NBS
chr17,Bn66663,84983659,95759203,10775544,RLP
chr17,Bn66664,44139283,87131398,42992115,CNL
chr17,Bn66665,54079735,96634336,42554601,RLK
chr17,Bn66666,9252143,74962850,65710707,RLP
chr17,Bn66667,22375177,44688625,22313448,TN
chr17,Bn66668,45011768,79698003,34686235,NBS
chr17,Bn66669,49690325,69786069,20095744,TNL
chr17,Bn66670,46793003,91952715,45159712,RLK
chr17,Bn66671,51225553,56162752,4937199,RLK
chr17,Bn66672,79965071,93076363,13111292,NBS
chr17,Bn66673,21672649,82371446,60698797,CN
chr17,Bn66674,71862536,88963924,17101388,CNL
chr17,Bn66675,95717231,98507134,2789903,CNL
chr17,Bn66676,1323794,43623453,42299659,NBS
chr17,Bn66677,32320046,53722288,21402242,RLK
chr17,Bn66678,28816458,67736185,38919727,RLK
chr17,Bn66679,9191496,19665763,10474267,NBS
chr17,Bn66680,37781524,79451461,41669937,RLK
chr17,Bn66681,31796439,65870869,34074430,CN
chr17,Bn66682,20980272,32304776,11324504,TNL
chr17,Bn66683,31605708,80589420,48983712,TNL
chr17,Bn66684,42584985,75026329,32441344,TN
chr17,Bn66685,74920892,95410656,20489764,TN
chr17,Bn66686,56191403,70148319,13956916,CNL
chr17,Bn66687,3724968,86273326,82548358,CNL
chr17,Bn66688,82857817,88561556,5703739,CNL
chr17,Bn66689,51368964,88001450,36632486,RLP
chr17,Bn66690,29074525,35074353,5999828,TNL
chr17,Bn66691,28166653,54841959,26675306,TN
chr17,Bn66692,48023886,50770114,2746228,NBS
chr17,Bn66693,54999563,96205230,41205667,RLK
chr17,Bn66694,67043026,91933008,24889982,RLK
chr17,Bn66695,17290635,61164082,43873447,CN
chr17,Bn66696,12496674,64246673,51749999,NBS
chr17,Bn66697,54390061,67129665,12739604,CN
chr17,Bn66698,18988758,83463289,64474531,NBS
chr17,Bn66699,85813817,98011897,12198080,RLK
chr17,Bn66700,78159979,95718542,17558563,CNL
chr17,Bn66701,42805268,67938665,25133397,RLP
chr17,Bn66702,12463660,58740757,46277097,TNL
chr17,Bn66703,63482307,93445442,29963135,CNL
chr17,Bn66704,80355589,99611652,19256063,RLK
chr17,Bn66705,68971324,83181569,14210245,TNL
chr17,Bn66706,70623518,91101519,20478001,TN
chr17,Bn66707,10904022,49388060,38484038,NBS
chr17,Bn66708,59273444,84774086,25500642,RLP
chr17,Bn66709,61954908,71850218,9895310,CN
chr17,Bn66710,3582815,34241785,30658970,NBS
chr17,Bn66711,78846731,79762980,916249,RLP
chr17,Bn66712,6484334,20726805,14242471,TN
chr17,Bn66713,13659078,57604077,43944999,CN
chr17,Bn66714,94926066,96622326,1696260,RLP
chr17,Bn66715,56856937,86874884,30017947,TN
chr17,Bn66716,21630025,64140204,42510179,RLP
chr17,Bn66717,85472457,95404838,9932381,TN
chr17,Bn66718,71564804,73628160,2063356,NBS
chr17,Bn66719,41198770,55272573,14073803,CN
chr17,Bn66720,76808871,81861258,5052387,CNL
chr17,Bn66721,96619613,99244096,2624483,TNL
chr17,Bn66722,99603606,99856701,253095,CN
chr17,Bn66723,59180633,91114073,31933440,RLP
chr17,Bn66724,63233581,90942001,27708420,TNL
chr17,Bn66725,57503908,89078512,31574604,CNL
chr17,Bn66726,80134515,99515227,19380712,TNL
chr17,Bn66727,7786645,27668980,19882335,TNL
chr17,Bn66728,64134779,87041789,22907010,CN
chr17,Bn66729,5250291,89532374,84282083,CNL
chr17,Bn66730,38276678,46975687,8699009,NBS
chr17,Bn66731,50465490,66720401,16254911,TNL
chr17,Bn66732,53999559,76254975,22255416,NBS
chr17,Bn66733,94678612,96297986,1619374,NBS
chr17,Bn66734,45156550,67098673,21942123,CN
chr17,Bn66735,34936059,91272733,56336674,TNL
chr17,Bn66736,6470981,98241643,91770662,CNL
chr17,Bn66737,93989265,99329524,5340259,TNL
chr17,Bn66738,44518420,60730471,16212051,CNL
chr17,Bn66739,17419882,96767076,79347194,RLK
chr17,Bn66740,74679466,77730337,3050871,NBS
chr17,Bn66741,74812211,75612488,800277,TN
chr17,Bn66742,47917990,67189183,19271193,TNL
chr17,Bn66743,42829839,56820476,13990637,CN
chr17,Bn66744,5111565,16111284,10999719,RLP
chr17,Bn66745,22068507,46212793,24144286,TN
chr17,Bn66746,98671389,99063135,391746,RLK
chr17,Bn66747,7554504,81982609,74428105,TN
chr17,Bn66748,49898360,69452425,19554065,CNL
chr17,Bn66749,79246568,82727805,3481237,CN
chr17,Bn66750,78370745,93781194,15410449,RLP
chr17,Bn66751,57519549,59214514,1694965,NBS
chr17,Bn66752,63485208,65568810,2083602,CNL
chr17,Bn66753,46396029,66864189,20468160,NBS
chr17,Bn66754,66898645,72364347,5465702,RLP
chr17,Bn66755,29418009,73494405,44076396,TN
chr17,Bn66756,7474899,72329506,64854607,NBS
chr17,Bn66757,40666005,67209967,26543962,NBS
chr17,Bn66758,88981170,95127215,6146045,RLP
chr17,Bn66759,47149818,77308431,30158613,CN
chr17,Bn66760,64568346,94490820,29922474,TNL
chr17,Bn66761,2486278,39668208,37181930,CN
chr17,Bn66762,57562064,98266507,40704443,NBS
chr17,Bn66763,59893855,93492705,33598850,CNL
chr17,Bn66764,95203194,95535704,332510,TNL
chr17,Bn66765,99643715,99777478,133763,CNL
chr17,Bn66766,97547840,98084579,536739,RLK
chr17,Bn66767,17698982,45070888,27371906,TNL
chr17,Bn66768,42424611,77297098,34872487,NBS
chr17,Bn66769,75917658,84383006,8465348,CNL
chr17,Bn66770,89569333,99834357,10265024,NBS
chr17,Bn66771,46847115,53503848,6656733,NBS
chr17,Bn66772,88525240,98395375,9870135,TN
chr17,Bn66773,6450015,59171266,52721251,TNL
chr17,Bn66774,10415522,99477890,89062368,TNL
chr17,Bn66775,37915968,96498525,58582557,CNL
chr17,Bn66776,97639860,99730595,2090735,CN
chr17,Bn66777,92476196,99896196,7420000,TNL
chr17,Bn66778,81489600,91307467,9817867,TN
chr17,Bn66779,94972053,99812252,4840199,RLK
chr17,Bn66780,33781761,83238605,49456844,TN
chr17,Bn66781,14048084,17943173,3895089,NBS
chr17,Bn66782,61708843,80962685,19253842,RLK
chr17,Bn66783,74225299,90054984,15829685,CN
chr17,Bn66784,91732037,96034670,4302633,CNL
chr17,Bn66785,33033671,70007904,36974233,CN
chr17,Bn66786,47015975,80836228,33820253,NBS
chr17,Bn66787,90501866,93712450,3210584,CNL
chr17,Bn66788,73484233,86161324,12677091,NBS
chr17,Bn66789,31179517,46482807,15303290,NBS
chr17,Bn66790,47840902,60898939,13058037,TNL
chr17,Bn66791,50300485,69216817,18916332,CN
chr17,Bn66792,51076941,80396048,29319107,TNL
chr17,Bn66793,99096487,99148559,52072,TN
chr17,Bn66794,80257631,84100712,3843081,CN
chr17,Bn66795,19539324,53079278,33539954,CNL
chr17,Bn66796,79228799,80646722,1417923,CN
chr17,Bn66797,39717795,80794023,41076228,CN
chr17,Bn66798,64305054,76587110,12282056,RLK
chr17,Bn66799,36471770,88350249,51878479,RLK
chr17,Bn66800,15443212,87886724,72443512,CNL
chr17,Bn66801,47516554,52408805,4892251,CN
chr17,Bn66802,98257162,98679409,422247,RLP
chr17,Bn66803,46639018,52219938,5580920,NBS
chr17,Bn66804,21591741,73373717,51781976,TNL
chr17,Bn66805,46637084,63592395,16955311,CNL
chr17,Bn66806,7391517,88562283,81170766,CNL
chr17,Bn66807,99709783,99888494,178711,RLK
chr17,Bn66808,70570575,87102364,16531789,RLP
chr17,Bn66809,73138161,74647687,1509526,TN
chr17,Bn66810,48994956,85509070,36514114,CN
chr17,Bn66811,50206241,88710701,38504460,CNL
chr17,Bn66812,55405620,72427021,17021401,RLP
chr17,Bn66813,54654729,88035637,33380908,CN
chr17,Bn66814,58299179,61184344,2885165,RLK
chr17,Bn66815,76869663,82885237,6015574,RLK
chr17,Bn66816,40083610,88327618,48244008,RLK
chr17,Bn66817,42081926,42481618,399692,RLK
chr17,Bn66818,92210164,94722893,2512729,RLK
chr17,Bn66819,15004293,61628996,46624703,CNL
chr17,Bn66820,28108065,85392010,57283945,NBS
chr17,Bn66821,31754977,71036419,39281442,CNL
chr17,Bn66822,26883034,61052909,34169875,TNL
chr17,Bn66823,8671867,14048302,5376435,RLP
chr17,Bn66824,95134374,96300427,1166053,NBS
chr17,Bn66825,5749658,91119516,85369858,TNL
chr17,Bn66826,36702840,38598275,1895435,RLK
chr17,Bn66827,13304902,56285783,42980881,NBS
chr17,Bn66828,53313450,80235815,26922365,TNL
chr17,Bn66829,1650342,4512213,2861871,RLK
chr17,Bn66830,76878637,82649772,5771135,TN
chr17,Bn66831,51334959,62891747,11556788,NBS
chr17,Bn66832,18662999,81447733,62784734,RLK
chr17,Bn66833,63290664,97525511,34234847,TN
chr17,Bn66834,19093844,45939204,26845360,RLP
chr17,Bn66835,86774609,92407541,5632932,RLK
chr17,Bn66836,9597042,16282801,6685759,CNL
chr17,Bn66837,3779183,83505701,79726518,CNL
chr17,Bn66838,92937028,96933241,3996213,TN
chr17,Bn66839,76217349,92202157,15984808,TNL
chr17,Bn66840,61897242,94856250,32959008,RLP
chr17,Bn66841,58034917,77628734,19593817,RLK
chr17,Bn66842,32613235,65788945,33175710,RLK
chr17,Bn66843,61084705,72503024,11418319,TN
chr17,Bn66844,76501189,82502911,6001722,TN
chr17,Bn66845,71274835,83814552,12539717,TN
chr17,Bn66846,70506307,79646171,9139864,TN
chr17,Bn66847,9075827,58825156,49749329,CNL
chr17,Bn66848,66484792,72880571,6395779,CNL
chr17,Bn66849,37945759,45390039,7444280,NBS
chr17,Bn66850,83174076,98888374,15714298,TNL
chr17,Bn66851,31736944,51187715,19450771,NBS
chr17,Bn66852,30295714,76550841,46255127,TN
chr17,Bn66853,58562157,76087831,17525674,RLP
chr17,Bn66854,32958388,45537278,12578890,NBS
chr17,Bn66855,46185297,78399378,32214081,NBS
chr17,Bn66856,98770579,99093315,322736,CNL
chr17,Bn66857,32141981,51767593,19625612,RLK
chr17,Bn66858,68373486,71420489,3047003,CN
chr17,Bn66859,94892866,95524956,632090,CNL
chr17,Bn66860,89356945,92266250,2909305,CN
chr17,Bn66861,39615856,61341473,21725617,NBS
chr17,Bn66862,26909515,76298286,49388771,RLP
chr17,Bn66863,18754257,53083098,34328841,CN
chr17,Bn66864,79864644,93230967,13366323,NBS
chr17,Bn66865,5313070,16079317,10766247,RLP
chr17,Bn66866,76738397,78787235,2048838,NBS
chr17,Bn66867,81975377,84301530,2326153,RLK
chr17,Bn66868,77630015,92621325,14991310,NBS
chr17,Bn66869,74377473,77753108,3375635,RLK
chr17,Bn66870,41736650,92406420,50669770,TNL
chr17,Bn66871,81616249,93451083,11834834,CN
chr17,Bn66872,89128576,89431932,303356,RLP
chr17,Bn66873,15233653,64023789,48790136,CNL
chr17,Bn66874,33006833,63650784,30643951,RLP
chr17,Bn66875,88647353,97513027,8865674,RLK
chr17,Bn66876,77752017,88792629,11040612,NBS
chr17,Bn66877,96693180,98747671,2054491,NBS
chr17,Bn66878,27600615,36859027,9258412,TN
chr17,Bn66879,35183697,37620538,2436841,RLP
chr17,Bn66880,9597220,48915420,39318200,TNL
chr17,Bn66881,91981378,99986297,8004919,TN
chr17,Bn66882,62817409,95897198,33079789,RLP
chr17,Bn66883,46644552,71017663,24373111,RLP
chr17,Bn66884,95717331,98108759,2391428,NBS
chr17,Bn66885,2378538,29588490,27209952,TN
chr17,Bn66886,77696922,89592882,11895960,NBS
chr17,Bn66887,79102471,98631970,19529499,CNL
chr17,Bn66888,31718487,72794792,41076305,RLP
chr17,Bn66889,53379301,72515213,19135912,CNL
chr17,Bn66890,84593633,89904462,5310829,CN
chr17,Bn66891,9348150,54752077,45403927,NBS
chr17,Bn66892,21902029,43014755,21112726,TNL
chr17,Bn66893,69099976,72714640,3614664,NBS
chr17,Bn66894,66727795,97497115,30769320,TNL
chr17,Bn66895,87840940,91968458,4127518,TNL
chr17,Bn66896,47186691,87439445,40252754,CN
chr17,Bn66897,47209932,98015691,50805759,CNL
chr17,Bn66898,76885320,87703139,10817819,CN
chr17,Bn66899,78507679,88253798,9746119,RLK
chr17,Bn66900,64343158,65320188,977030,TN
chr17,Bn66901,9301932,96526567,87224635,NBS
chr17,Bn66902,87990556,91816137,3825581,TNL
chr17,Bn66903,37520400,61802206,24281806,RLP
chr17,Bn66904,99691348,99913330,221982,TNL
chr17,Bn66905,36668652,39225049,2556397,CN
chr17,Bn66906,20062158,37414711,17352553,RLP
chr17,Bn66907,38458395,73872869,35414474,CNL
chr17,Bn66908,15398712,80637628,65238916,CN
chr17,Bn66909,92480912,94501781,2020869,CNL
chr17,Bn66910,94678241,96681705,2003464,CN
chr17,Bn66911,10616619,32384150,21767531,RLK
chr17,Bn66912,2893298,93347221,90453923,TNL
chr17,Bn66913,40927566,59830741,18903175,TNL
chr17,Bn66914,34675301,53189431,18514130,CN
chr17,Bn66915,22656016,79914202,57258186,RLP
chr17,Bn66916,90103332,91844607,1741275,CNL
chr17,Bn66917,47257138,50216201,2959063,TNL
chr17,Bn66918,33749042,89586785,55837743,TN
chr17,Bn66919,17603408,49414932,31811524,TN
chr17,Bn66920,45784834,56017635,10232801,CNL
chr17,Bn66921,51442839,90144418,38701579,RLK
chr17,Bn66922,26229070,96154837,69925767,RLP
chr17,Bn66923,61351951,95764626,34412675,TNL
chr17,Bn66924,84338503,89799534,5461031,CNL
chr17,Bn66925,52778255,62945962,10167707,TN
chr17,Bn66926,88976223,92376124,3399901,TNL
chr17,Bn66927,53510851,73461495,19950644,CNL
chr17,Bn66928,32845857,63674453,30828596,TN
chr17,Bn66929,66090793,76317187,10226394,RLK
chr17,Bn66930,50115615,51754253,1638638,CNL
chr17,Bn66931,88671740,96441800,7770060,CN
chr17,Bn66932,19591225,51797622,32206397,CNL
chr17,Bn66933,86384254,94785687,8401433,CN
chr17,Bn66934,85443684,92024995,6581311,TNL
chr17,Bn66935,2950079,50146622,47196543,CN
chr17,Bn66936,40942396,68921946,27979550,TN
chr17,Bn66937,70064417,74697013,4632596,RLP
chr17,Bn66938,93512769,96638566,3125797,TN
chr17,Bn66939,34952566,63853279,28900713,CN
chr17,Bn66940,35295136,43189029,7893893,CN
chr17,Bn66941,46840080,47009067,168987,RLK
chr17,Bn66942,39203429,69009924,29806495,RLP
chr17,Bn66943,93828289,95399336,1571047,RLP
chr17,Bn66944,36638845,46841064,10202219,TN
chr17,Bn66945,16782995,90333096,73550101,CNL
chr17,Bn66946,59319526,75050652,15731126,RLK
chr17,Bn66947,17600971,60989162,43388191,CNL
chr17,Bn66948,2939341,35178186,32238845,TN
chr17,Bn66949,20277352,36404859,16127507,RLK
chr17,Bn66950,78657950,90993222,12335272,CNL
chr17,Bn66951,76413986,87176237,10762251,NBS
chr17,Bn66952,55363846,87072164,31708318,TN
chr17,Bn66953,22889016,49880126,26991110,NBS
chr17,Bn66954,4774666,67638316,62863650,TNL
chr17,Bn66955,1633322,88559752,86926430,CN
chr17,Bn66956,60859638,90288422,29428784,CNL
chr17,Bn66957,43339132,48929422,5590290,RLK
chr17,Bn66958,41381018,73533764,32152746,TNL
chr17,Bn66959,40495914,91653494,51157580,CNL
chr17,Bn66960,21125900,72642008,51516108,TN
chr17,Bn66961,92672750,98156471,5483721,TN
chr17,Bn66962,29082796,85481133,56398337,CN
chr17,Bn66963,50137867,76145216,26007349,CN
chr17,Bn66964,19338972,72030884,52691912,RLP
chr17,Bn66965,54600886,56491977,1891091,NBS
chr17,Bn66966,29256965,39788130,10531165,NBS
chr17,Bn66967,3424847,93209935,89785088,NBS
chr17,Bn66968,53918678,98373444,44454766,CN
chr17,Bn66969,50618878,59489229,8870351,RLK
chr17,Bn66970,23797358,66070589,42273231,CN
chr17,Bn66971,56291755,79356157,23064402,TN
chr17,Bn66972,34002995,52657964,18654969,TNL
chr17,Bn66973,33348811,52094316,18745505,RLK
chr17,Bn66974,23928623,60109406,36180783,CN
chr17,Bn66975,36172151,91436349,55264198,CNL
chr17,Bn66976,47116682,48636284,1519602,TN
chr17,Bn66977,46876436,64207758,17331322,TN
chr17,Bn66978,84932867,85016820,83953,NBS
chr17,Bn66979,97936525,98240441,303916,RLK
chr17,Bn66980,37150453,42851277,5700824,CN
chr17,Bn66981,87338203,93760451,6422248,CNL
chr17,Bn66982,72394642,96320087,23925445,TN
chr17,Bn66983,30375294,42247409,11872115,NBS
chr17,Bn66984,56635890,58338745,1702855,CNL
chr17,Bn66985,44224416,50916987,6692571,NBS
chr17,Bn66986,73812111,94484338,20672227,NBS
chr17,Bn66987,64610649,79794895,15184246,CN
chr17,Bn66988,64138372,93047735,28909363,CN
chr17,Bn66989,90310822,93290340,2979518,CNL
chr17,Bn66990,63911386,97022535,33111149,CNL
chr17,Bn66991,59899113,93113754,33214641,RLP
chr17,Bn66992,84998884,94129573,9130689,TN
chr17,Bn66993,26351671,45619409,19267738,RLP
chr17,Bn66994,62669614,73952899,11283285,TNL
chr17,Bn66995,83133696,87366686,4232990,RLP
chr17,Bn66996,35548944,80964735,45415791,TNL
chr17,Bn66997,17688706,91677587,73988881,RLK
chr17,Bn66998,73631112,89073226,15442114,CNL
chr17,Bn66999,78179359,99672770,21493411,NBS
chr17,Bn67000,21670733,51382269,29711536,CN
chr17,Bn67001,21804265,74312107,52507842,RLP
chr17,Bn67002,37714303,49611613,11897310,CN
chr17,Bn67003,94308441,99073017,4764576,RLK
chr17,Bn67004,82358185,86016943,3658758,TN
chr17,Bn67005,1990766,26088445,24097679,TNL
chr17,Bn67006,4412125,20907588,16495463,CNL
chr17,Bn67007,69182792,78806820,9624028,RLP
chr17,Bn67008,21291094,90149054,68857960,RLP
chr17,Bn67009,84236529,87355667,3119138,CNL
chr17,Bn67010,32178200,52326999,20148799,CNL
chr17,Bn67011,17522156,54273838,36751682,TNL
chr17,Bn67012,29595264,43313972,13718708,RLP
chr17,Bn67013,17584798,20280162,2695364,CNL
chr17,Bn67014,93949567,97550740,3601173,TNL
chr17,Bn67015,92711269,95642717,2931448,CNL
chr17,Bn67016,18005567,64124442,46118875,TN
chr17,Bn67017,79430885,85814777,6383892,RLK
chr17,Bn67018,4971207,83410262,78439055,CN
chr17,Bn67019,90653944,93237356,2583412,RLK
chr17,Bn67020,26943494,85271600,58328106,CN
chr17,Bn67021,79726923,92101249,12374326,TNL
chr17,Bn67022,37075729,69234405,32158676,RLK
chr17,Bn67023,72765838,75958254,3192416,CN
chr17,Bn67024,55804829,84097391,28292562,CN
chr17,Bn67025,18389415,78928629,60539214,TN
chr17,Bn67026,34510117,65356813,30846696,NBS
chr17,Bn67027,35353415,66834952,31481537,TNL
chr17,Bn67028,73776010,95844185,22068175,CNL
chr17,Bn67029,76603702,91775216,15171514,CN
chr17,Bn67030,26447163,58569894,32122731,CN
chr17,Bn67031,52616381,91639542,39023161,NBS
chr17,Bn67032,15730414,95099578,79369164,CNL
chr17,Bn67033,15235115,91741773,76506658,TNL
chr17,Bn67034,24783554,39707906,14924352,RLK
chr17,Bn67035,38043477,47605444,9561967,CNL
chr17,Bn67036,76212957,93099614,16886657,TN
chr17,Bn67037,82095528,96566035,14470507,CNL
chr17,Bn67038,57481578,92790113,35308535,TNL
chr17,Bn67039,5187948,83627178,78439230,NBS
chr17,Bn67040,82054037,93263458,11209421,TNL
chr17,Bn67041,4043856,77983778,73939922,TN
chr17,Bn67042,53219474,84626642,31407168,RLP
chr17,Bn67043,29717200,42802626,13085426,CN
chr17,Bn67044,15860453,22827086,6966633,RLK
chr17,Bn67045,6110443,32586207,26475764,RLK
chr17,Bn67046,42142498,93594552,51452054,NBS
chr17,Bn67047,42874128,78723625,35849497,RLP
chr17,Bn67048,10093103,61402304,51309201,CN
chr17,Bn67049,3422232,6481546,3059314,CNL
chr17,Bn67050,81291518,97552328,16260810,CNL
chr17,Bn67051,51602644,61518301,9915657,NBS
chr17,Bn67052,24015333,34603799,10588466,CNL
chr17,Bn67053,96648120,96892663,244543,TNL
chr17,Bn67054,90667149,96485599,5818450,RLP
chr17,Bn67055,76652677,88564886,11912209,RLK
chr17,Bn67056,45910526,60765435,14854909,CNL
chr17,Bn67057,91866711,97853620,5986909,NBS
chr17,Bn67058,91186553,97121949,5935396,CN
chr17,Bn67059,4248312,88065038,83816726,NBS
chr17,Bn67060,89503533,89871473,367940,CNL
chr17,Bn67061,96441445,98921619,2480174,RLK
chr17,Bn67062,12847525,78189526,65342001,CNL
chr17,Bn67063,50946640,94678067,43731427,NBS
chr17,Bn67064,25055691,83371958,58316267,TN
chr17,Bn67065,54887506,61417001,6529495,TNL
chr17,Bn67066,93142112,99531180,6389068,NBS
chr17,Bn67067,98281361,98896701,615340,RLK
chr17,Bn67068,12173827,80103618,67929791,NBS
chr17,Bn67069,3125170,75996066,72870896,TN
chr17,Bn67070,15038182,87932931,72894749,RLP
chr17,Bn67071,52684396,59066857,6382461,TN
chr17,Bn67072,46523393,72040445,25517052,TNL
chr17,Bn67073,79038822,98803234,19764412,TNL
chr17,Bn67074,47621860,78847105,31225245,TN
chr17,Bn67075,8810153,68278641,59468488,TNL
chr17,Bn67076,61582366,98773000,37190634,RLP
chr17,Bn67077,40856490,79464369,38607879,TN
chr17,Bn67078,62041069,93711267,31670198,TNL
chr17,Bn67079,60269353,87575045,27305692,CN
chr17,Bn67080,92022804,97341926,5319122,RLK
chr17,Bn67081,56393046,88056327,31663281,NBS
chr17,Bn67082,2686793,62095056,59408263,TN
chr17,Bn67083,18168293,31190887,13022594,CN
chr17,Bn67084,85998788,86734478,735690,TNL
chr17,Bn67085,4588872,95374353,90785481,TN
chr17,Bn67086,73160328,81063406,7903078,RLK
chr17,Bn67087,93394138,94113271,719133,RLK
chr17,Bn67088,16358528,61522310,45163782,RLP
chr17,Bn67089,8164558,24300064,16135506,NBS
chr17,Bn67090,8745747,13244587,4498840,RLK
chr17,Bn67091,2734236,72769912,70035676,CN
chr17,Bn67092,19167475,88886990,69719515,RLP
chr17,Bn67093,87079200,91779081,4699881,CNL
chr17,Bn67094,81645331,86155422,4510091,RLP
chr17,Bn67095,44745441,71008407,26262966,NBS
chr17,Bn67096,73016196,83310639,10294443,RLK
chr17,Bn67097,89138402,99629744,10491342,RLP
chr17,Bn67098,12003707,15554781,3551074,CNL
chr17,Bn67099,71961839,73137258,1175419,RLK
chr17,Bn67100,3596423,23286492,19690069,TNL
chr17,Bn67101,75457522,77378257,1920735,NBS
chr17,Bn67102,15118358,17226617,2108259,TNL
chr17,Bn67103,62254593,67115573,4860980,RLP
chr17,Bn67104,78572447,87371836,8799389,TNL
chr17,Bn67105,12558639,23519188,10960549,CN
chr17,Bn67106,98304483,99494698,1190215,TN
chr17,Bn67107,49270432,82104390,32833958,RLP
chr17,Bn67108,31486385,75728516,44242131,RLP
chr17,Bn67109,61516122,84616907,23100785,CNL
chr17,Bn67110,70298014,98726416,28428402,CN
chr17,Bn67111,7847492,57535453,49687961,NBS
chr17,Bn67112,75306350,85060260,9753910,RLK
chr17,Bn67113,60210342,92569999,32359657,NBS
chr17,Bn67114,89748830,99687968,9939138,TNL
chr17,Bn67115,75571325,95564474,19993149,CN
chr17,Bn67116,23822919,33183968,9361049,TN
chr17,Bn67117,12081028,90369293,78288265,RLK
chr17,Bn67118,93283567,98783154,5499587,CN
chr17,Bn67119,63348352,83891951,20543599,TN
chr17,Bn67120,51335170,97349007,46013837,RLK
chr17,Bn67121,38109178,88381169,50271991,CN
chr17,Bn67122,34620946,37543265,2922319,RLK
chr17,Bn67123,30598826,49018527,18419701,TN
chr17,Bn67124,13481821,32024287,18542466,NBS
chr17,Bn67125,10032072,53560936,43528864,CN
chr17,Bn67126,94784279,98981795,4197516,RLK
chr17,Bn67127,72683191,81219143,8535952,CN
chr17,Bn67128,53068154,55639298,2571144,NBS
chr17,Bn67129,83809149,89626534,5817385,CN
chr17,Bn67130,44411403,73940929,29529526,NBS
chr17,Bn67131,95045209,95299700,254491,RLP
chr17,Bn67132,12375733,59300014,46924281,NBS
chr17,Bn67133,70878084,77155736,6277652,TNL
chr17,Bn67134,38172534,85681311,47508777,RLP
chr17,Bn67135,29923266,52227433,22304167,TN
chr17,Bn67136,91176267,98671886,7495619,RLK
chr17,Bn67137,20306712,51474566,31167854,TN
chr17,Bn67138,86398903,93040996,6642093,CN
chr17,Bn67139,32257441,47838238,15580797,TN
chr17,Bn67140,11259896,42910605,31650709,TNL
chr17,Bn67141,56404981,81719921,25314940,RLK
chr17,Bn67142,59194908,71078445,11883537,CN
chr17,Bn67143,10702291,51258448,40556157,RLP
chr17,Bn67144,6568569,30768277,24199708,CNL
chr17,Bn67145,58336660,64672002,6335342,TN
chr17,Bn67146,18483170,31091835,12608665,RLK
chr17,Bn67147,65613692,72936674,7322982,RLP
chr17,Bn67148,23295342,58906291,35610949,TN
chr17,Bn67149,76608202,82121706,5513504,TNL
chr17,Bn67150,55013873,71276251,16262378,NBS
chr17,Bn67151,14876747,32468936,17592189,NBS
chr17,Bn67152,45791715,61772205,15980490,TN
chr17,Bn67153,42855246,73169013,30313767,RLP
chr17,Bn67154,63943859,77384550,13440691,RLP
chr17,Bn67155,34026896,47078832,13051936,CNL
chr17,Bn67156,77926308,78504411,578103,TNL
chr17,Bn67157,26313767,92803182,66489415,RLP
chr17,Bn67158,45410936,73253493,27842557,TNL
chr17,Bn67159,65156586,72176472,7019886,RLP
chr17,Bn67160,79149682,96520926,17371244,TNL
chr17,Bn67161,22339394,92697908,70358514,CNL
chr17,Bn67162,87710350,94029198,6318848,NBS
chr17,Bn67163,40371662,90055603,49683941,RLP
chr17,Bn67164,64156226,84881506,20725280,CN
chr17,Bn67165,44454869,85682519,41227650,CNL
chr17,Bn67166,66416904,93015872,26598968,RLK
chr17,Bn67167,17022444,47821349,30798905,RLK
chr17,Bn67168,22793799,58910251,36116452,CN
chr17,Bn67169,20347449,32729738,12382289,TN
chr17,Bn67170,53549887,68129643,14579756,CNL
chr17,Bn67171,10893595,12499246,1605651,RLP
chr17,Bn67172,85734091,93159542,7425451,RLP
chr17,Bn67173,79975418,85355475,5380057,RLP
chr17,Bn67174,97726359,98611109,884750,CN
chr17,Bn67175,51475045,79971599,28496554,NBS
chr17,Bn67176,16904200,50928348,34024148,CNL
chr17,Bn67177,98040321,99795927,1755606,CN
chr17,Bn67178,50256092,74435383,24179291,TNL
chr17,Bn67179,2709324,63093974,60384650,NBS
chr17,Bn67180,41045051,53548518,12503467,CNL
chr17,Bn67181,34204624,89799656,55595032,RLP
chr17,Bn67182,37766078,85170009,47403931,CN
chr17,Bn67183,47493808,63076403,15582595,CN
chr17,Bn67184,44625573,74235929,29610356,TNL
chr17,Bn67185,41499391,61019279,19519888,TN
chr17,Bn67186,89786834,92498480,2711646,CN
chr17,Bn67187,77932628,92327386,14394758,RLK
chr17,Bn67188,17567911,49541986,31974075,TN
chr17,Bn67189,42225383,72193300,29967917,TNL
chr17,Bn67190,26813911,53521841,26707930,NBS
chr17,Bn67191,30146422,74222517,44076095,RLP
chr17,Bn67192,58550718,66596149,8045431,RLP
chr17,Bn67193,29145551,39414540,10268989,CNL
chr17,Bn67194,20774651,71702994,50928343,NBS
chr17,Bn67195,90916992,91141633,224641,TN
chr17,Bn67196,9473207,93963558,84490351,NBS
chr17,Bn67197,26678080,42865857,16187777,RLK
chr17,Bn67198,52752137,87816073,35063936,NBS
chr17,Bn67199,69182147,79686608,10504461,RLK
chr17,Bn67200,3831217,23042970,19211753,RLK
chr17,Bn67201,51444209,84648826,33204617,RLP
chr17,Bn67202,51780379,65486158,13705779,TN
chr17,Bn67203,11759553,87373055,75613502,RLK
chr17,Bn67204,27913756,34287526,6373770,RLP
chr17,Bn67205,78323363,98371984,20048621,RLK
chr17,Bn67206,15203717,48512089,33308372,TN
chr17,Bn67207,50828022,89713135,38885113,RLP
chr17,Bn67208,47908267,91444110,43535843,CN
chr17,Bn67209,24465712,95327334,70861622,NBS
chr17,Bn67210,50405421,56643218,6237797,RLK
chr17,Bn67211,56152472,61823776,5671304,CN
chr17,Bn67212,2325759,60727459,58401700,TNL
chr17,Bn67213,66198161,97649656,31451495,RLK
chr17,Bn67214,87850185,97891665,10041480,NBS
chr17,Bn67215,26413657,30210361,3796704,CNL
chr17,Bn67216,65094835,82911424,17816589,CN
chr17,Bn67217,58391982,83739386,25347404,TNL
chr17,Bn67218,41010626,41910788,900162,CN
chr17,Bn67219,13263108,63297723,50034615,TNL
chr17,Bn67220,51181008,79609297,28428289,TNL
chr17,Bn67221,52521015,98157894,45636879,TN
chr17,Bn67222,55621626,65934711,10313085,RLP
chr17,Bn67223,44382297,49262134,4879837,RLK
chr17,Bn67224,10481558,13002932,2521374,RLP
chr17,Bn67225,86149580,91411304,5261724,RLP
chr17,Bn67226,15081211,99099592,84018381,TN
chr17,Bn67227,30231003,40354335,10123332,CNL
chr17,Bn67228,69243943,93805951,24562008,CN
chr17,Bn67229,67242778,97805667,30562889,NBS
chr17,Bn67230,49101246,79213857,30112611,NBS
chr17,Bn67231,36577779,37868596,1290817,TNL
chr17,Bn67232,70963157,73022290,2059133,NBS
chr17,Bn67233,87547771,99687676,12139905,RLK
chr17,Bn67234,68316241,95981278,27665037,RLK
chr17,Bn67235,40170656,87681153,47510497,CN
chr17,Bn67236,67942068,77574727,9632659,TN
chr17,Bn67237,50674533,88319411,37644878,TN
chr17,Bn67238,55608967,78045048,22436081,RLP
chr17,Bn67239,80564463,86144630,5580167,CN
chr17,Bn67240,70144928,99313897,29168969,NBS
chr17,Bn67241,49568414,57098057,7529643,TN
chr17,Bn67242,82999756,88955770,5956014,TN
chr17,Bn67243,68384153,91020302,22636149,RLP
chr17,Bn67244,74410530,84642496,10231966,RLK
chr17,Bn67245,11802214,26744720,14942506,RLK
chr17,Bn67246,90940663,97467602,6526939,TN
chr17,Bn67247,72008025,79487175,7479150,TNL
chr17,Bn67248,32246628,67820020,35573392,CN
chr17,Bn67249,99701015,99703943,2928,RLP
chr17,Bn67250,94961110,97281541,2320431,RLK
chr17,Bn67251,57107224,97900636,40793412,RLP
chr17,Bn67252,60204653,74737794,14533141,CN
chr17,Bn67253,4707841,92597848,87890007,CNL
chr17,Bn67254,5135097,42782570,37647473,RLP
chr17,Bn67255,76547700,82235855,5688155,RLK
chr17,Bn67256,98748327,99531685,783358,CN
chr17,Bn67257,25627626,56299577,30671951,TNL
chr17,Bn67258,77674484,91974674,14300190,TNL
chr17,Bn67259,89151480,91101016,1949536,TN
chr17,Bn67260,26604024,43432245,16828221,RLP
chr17,Bn67261,59369170,82863604,23494434,NBS
chr17,Bn67262,41456158,60647032,19190874,CNL
chr17,Bn67263,1184980,17142814,15957834,RLK
chr17,Bn67264,43246014,63071680,19825666,NBS
chr17,Bn67265,36351785,87117493,50765708,CN
chr17,Bn67266,21751052,75733245,53982193,RLK
chr17,Bn67267,16703762,73181062,56477300,TNL
chr17,Bn67268,24335487,80683146,56347659,TNL
chr17,Bn67269,24782276,36683642,11901366,CN
chr17,Bn67270,54003936,66504596,12500660,TNL
chr17,Bn67271,76591553,85855484,9263931,RLP
chr17,Bn67272,88007537,94068169,6060632,CNL
chr17,Bn67273,84969565,86472805,1503240,TNL
chr17,Bn67274,37052213,88573271,51521058,RLP
chr17,Bn67275,92586377,95412846,2826469,RLK
chr17,Bn67276,72507736,82431708,9923972,TN
chr17,Bn67277,74185608,82778166,8592558,TNL
chr17,Bn67278,65834121,73664933,7830812,RLP
chr17,Bn67279,91441237,95115844,3674607,NBS
chr17,Bn67280,55476834,86297378,30820544,CNL
chr17,Bn67281,94341287,94388932,47645,TNL
chr17,Bn67282,6753399,13191858,6438459,TNL
chr17,Bn67283,62867620,75746923,12879303,RLK
chr17,Bn67284,98397064,99168336,771272,RLP
chr17,Bn67285,13345720,82324175,68978455,CN
chr17,Bn67286,65463605,94341493,28877888,RLP
chr17,Bn67287,38095383,44139665,6044282,RLP
chr17,Bn67288,59565238,86268057,26702819,CN
chr17,Bn67289,27748692,85901426,58152734,RLP
chr17,Bn67290,60005746,66426637,6420891,CNL
chr17,Bn67291,35162113,63377314,28215201,NBS
chr17,Bn67292,66407708,90829244,24421536,CN
chr17,Bn67293,7271111,95312200,88041089,RLP
chr17,Bn67294,49397346,69847987,20450641,TNL
chr17,Bn67295,61273468,94541300,33267832,TNL
chr17,Bn67296,28906216,56459309,27553093,TN
chr17,Bn67297,61924509,91312777,29388268,NBS
chr17,Bn67298,36503290,46113942,9610652,TN
chr17,Bn67299,60949859,89592001,28642142,RLK
chr17,Bn67300,66697067,82338112,15641045,NBS
chr17,Bn67301,23866994,42544624,18677630,NBS
chr17,Bn67302,29165822,83230198,54064376,TN
chr17,Bn67303,69697264,76906951,7209687,RLK
chr17,Bn67304,57890817,85042382,27151565,CNL
chr17,Bn67305,75247903,80477304,5229401,NBS
chr17,Bn67306,61484301,75869261,14384960,CN
chr17,Bn67307,51966675,70309720,18343045,CNL
chr17,Bn67308,50456285,80823504,30367219,TN
chr17,Bn67309,32894874,97608123,64713249,TN
chr17,Bn67310,69299005,84254908,14955903,TN
chr17,Bn67311,92978891,97548727,4569836,NBS
chr17,Bn67312,32857759,41774157,8916398,TN
chr17,Bn67313,50222538,81519690,31297152,CN
chr17,Bn67314,58464460,80563410,22098950,RLK
chr17,Bn67315,51983118,87421127,35438009,CN
chr17,Bn67316,68203575,84711417,16507842,CN
chr17,Bn67317,43896916,97443693,53546777,NBS
chr17,Bn67318,99406069,99898136,492067,CN
chr17,Bn67319,60465233,77248736,16783503,CN
chr17,Bn67320,41400953,80008981,38608028,CNL
chr17,Bn67321,17524114,90874780,73350666,TN
chr17,Bn67322,6262551,47278497,41015946,NBS
chr17,Bn67323,85501760,89249671,3747911,TNL
chr17,Bn67324,44407848,81186947,36779099,CNL
chr17,Bn67325,9003524,36675340,27671816,TN
chr17,Bn67326,41132701,85356264,44223563,TNL
chr17,Bn67327,74000534,79019047,5018513,NBS
chr17,Bn67328,75506779,81485810,5979031,TN
chr17,Bn67329,92062331,92307847,245516,CN
chr17,Bn67330,58143549,86509587,28366038,RLK
chr17,Bn67331,31635799,56069229,24433430,TNL
chr17,Bn67332,43888199,81263626,37375427,TN
chr17,Bn67333,91163988,96362460,5198472,TN
chr17,Bn67334,19412370,74177681,54765311,CNL
chr17,Bn67335,38769324,55430028,16660704,RLK
chr17,Bn67336,82451443,86393381,3941938,CN
chr17,Bn67337,77250052,81204573,3954521,TNL
chr17,Bn67338,80807984,86635383,5827399,RLK
chr17,Bn67339,73224496,93427189,20202693,CNL
chr17,Bn67340,3837720,39992118,36154398,TNL
chr17,Bn67341,2074006,88217208,86143202,TNL
chr17,Bn67342,65947134,78294382,12347248,RLK
chr17,Bn67343,69652427,75482896,5830469,CN
chr17,Bn67344,41015218,50716664,9701446,RLP
chr17,Bn67345,78576701,99064706,20488005,TNL
chr17,Bn67346,32752763,41730821,8978058,CN
chr17,Bn67347,19141021,59937544,40796523,RLK
chr17,Bn67348,34612664,60427215,25814551,CNL
chr17,Bn67349,41183784,73687185,32503401,CNL
chr17,Bn67350,5867222,10909709,5042487,TN
chr17,Bn67351,99582383,99618295,35912,TN
chr17,Bn67352,47916627,58335434,10418807,RLP
chr17,Bn67353,42223482,61215067,18991585,NBS
chr17,Bn67354,76305323,97159928,20854605,RLK
chr17,Bn67355,52434351,90839599,38405248,NBS
chr17,Bn67356,60438583,63963883,3525300,NBS
chr17,Bn67357,2288193,48366905,46078712,NBS
chr17,Bn67358,3716204,4797479,1081275,CN
chr17,Bn67359,72549408,87234121,14684713,RLK
chr17,Bn67360,93156340,95334830,2178490,CN
chr17,Bn67361,54684152,69755685,15071533,RLK
chr17,Bn67362,16219535,16438952,219417,RLP
chr17,Bn67363,84322706,87902630,3579924,TN
chr17,Bn67364,57479323,97301267,39821944,CNL
chr17,Bn67365,49319455,99019336,49699881,CNL
chr17,Bn67366,11450491,49230579,37780088,NBS
chr17,Bn67367,79319983,93076055,13756072,NBS
chr17,Bn67368,12802191,85861084,73058893,CNL
chr17,Bn67369,74888556,96961274,22072718,NBS
chr17,Bn67370,58572437,65264623,6692186,RLK
chr17,Bn67371,64294676,97395786,33101110,RLK
chr17,Bn67372,99641832,99665127,23295,TNL
chr17,Bn67373,97158419,97838987,680568,CN
chr17,Bn67374,77061110,92265013,15203903,CN
chr17,Bn67375,40558105,99594752,59036647,TN
chr17,Bn67376,23683871,88917248,65233377,RLP
chr17,Bn67377,50208451,54663279,4454828,TNL
chr17,Bn67378,69501898,98909044,29407146,RLK
chr17,Bn67379,31420831,97827463,66406632,CN
chr17,Bn67380,79880738,95672427,15791689,RLK
chr17,Bn67381,16274586,16802041,527455,RLP
chr17,Bn67382,77122306,86628010,9505704,RLK
chr17,Bn67383,70683112,95262621,24579509,RLK
chr17,Bn67384,60833912,80390552,19556640,TN
chr17,Bn67385,4427630,44650063,40222433,CNL
chr17,Bn67386,75454714,75809045,354331,RLK
chr17,Bn67387,59088055,87764615,28676560,TNL
chr17,Bn67388,43693258,91640076,47946818,TNL
chr17,Bn67389,29338274,61256803,31918529,CNL
chr17,Bn67390,46892919,52554559,5661640,NBS
chr17,Bn67391,3999722,73781798,69782076,CNL
chr17,Bn67392,59845275,97144370,37299095,RLP
chr17,Bn67393,66808904,85508253,18699349,NBS
chr17,Bn67394,4423257,23949704,19526447,CN
chr17,Bn67395,23942437,64477227,40534790,RLK
chr17,Bn67396,55633638,70335887,14702249,TNL
chr17,Bn67397,81215388,97250955,16035567,CNL
chr17,Bn67398,23331418,41857701,18526283,TNL
chr17,Bn67399,70345233,82466071,12120838,RLK
chr17,Bn67400,6071191,38423450,32352259,RLP
chr17,Bn67401,92388033,95275544,2887511,TNL
chr17,Bn67402,22127102,22368758,241656,NBS
chr17,Bn67403,91045735,96830730,5784995,NBS
chr17,Bn67404,40511396,74120320,33608924,CN
chr17,Bn67405,33688636,74638019,40949383,NBS
chr17,Bn67406,84465846,84936055,470209,RLP
chr17,Bn67407,96922888,98804656,1881768,CNL
chr17,Bn67408,13616934,43125162,29508228,RLK
chr17,Bn67409,20742979,54590749,33847770,RLK
chr17,Bn67410,63007652,76826447,13818795,TN
chr17,Bn67411,46666686,96646482,49979796,CN
chr17,Bn67412,96680586,99395795,2715209,TN
chr17,Bn67413,88502770,99865564,11362794,RLP
chr17,Bn67414,48214164,68314324,20100160,TNL
chr17,Bn67415,1031059,25204288,24173229,RLP
chr17,Bn67416,7460924,11514389,4053465,RLP
chr17,Bn67417,63844275,97133516,33289241,CNL
chr17,Bn67418,27879895,35838201,7958306,CN
chr17,Bn67419,79444862,81253302,1808440,NBS
chr17,Bn67420,62138632,79286173,17147541,RLP
chr17,Bn67421,8613578,59529256,50915678,RLK
chr17,Bn67422,10033331,56596150,46562819,CN
chr17,Bn67423,72812177,79426835,6614658,CN
chr17,Bn67424,21739555,57264427,35524872,TN
chr17,Bn67425,38785285,43827496,5042211,NBS
chr17,Bn67426,70273069,84253248,13980179,TN
chr17,Bn67427,75706901,76081966,375065,TNL
chr17,Bn67428,4709578,6897193,2187615,RLK
chr17,Bn67429,14219930,73731413,59511483,CN
chr17,Bn67430,59362990,73733160,14370170,TNL
chr17,Bn67431,78933502,83378250,4444748,NBS
chr17,Bn67432,21633531,46759992,25126461,CNL
chr17,Bn67433,6178950,40637930,34458980,RLK
chr17,Bn67434,28291522,50295588,22004066,CNL
chr17,Bn67435,10312324,25728134,15415810,NBS
chr17,Bn67436,65485613,99766291,34280678,TNL
chr17,Bn67437,53464112,65842765,12378653,RLK
chr17,Bn67438,92161809,94233147,2071338,RLP
chr17,Bn67439,36341711,89868900,53527189,TNL
chr17,Bn67440,74374933,96165357,21790424,CNL
chr17,Bn67441,96302301,97617466,1315165,CN
chr17,Bn67442,79113701,81564439,2450738,TN
chr17,Bn67443,62645586,77850486,15204900,TNL
chr17,Bn67444,63740706,70047474,6306768,RLK
chr17,Bn67445,18214224,80047803,61833579,TNL
chr17,Bn67446,8541704,41903197,33361493,TNL
chr17,Bn67447,95299511,99311173,4011662,TN
chr17,Bn67448,81857767,85087137,3229370,CNL
chr17,Bn67449,74142456,77931053,3788597,TNL
chr17,Bn67450,13020280,52997231,39976951,RLK
chr17,Bn67451,54059449,93386143,39326694,TN
chr17,Bn67452,14087505,46050040,31962535,NBS
chr17,Bn67453,11217618,76893970,65676352,TN
chr17,Bn67454,13615676,57560427,43944751,NBS
chr17,Bn67455,61687378,86059329,24371951,CN
chr17,Bn67456,61938813,85771918,23833105,RLK
chr17,Bn67457,25984765,48277313,22292548,TNL
chr17,Bn67458,67666744,97835372,30168628,TNL
chr17,Bn67459,55935224,59644603,3709379,RLP
chr17,Bn67460,17426654,88321964,70895310,RLK
chr17,Bn67461,86761633,97879102,11117469,CN
chr17,Bn67462,95784041,97096727,1312686,RLK
chr17,Bn67463,56467992,89283877,32815885,CN
chr17,Bn67464,8382790,82100073,73717283,CNL
chr17,Bn67465,89330984,93869961,4538977,NBS
chr17,Bn67466,38591412,54573034,15981622,RLK
chr17,Bn67467,55625240,81613167,25987927,TNL
chr17,Bn67468,52404895,97975527,45570632,TNL
chr17,Bn67469,56061144,98155444,42094300,RLP
chr17,Bn67470,56910891,82435213,25524322,TN
chr17,Bn67471,46563779,57760714,11196935,RLK
chr17,Bn67472,50509255,77049167,26539912,RLK
chr17,Bn67473,84870455,92257972,7387517,CNL
chr17,Bn67474,15441842,56665662,41223820,TNL
chr17,Bn67475,67294086,77232990,9938904,NBS
chr17,Bn67476,30624510,66268581,35644071,CNL
chr17,Bn67477,99504945,99868400,363455,CN
chr17,Bn67478,71105876,84209690,13103814,TN
chr17,Bn67479,26427425,54044880,27617455,TN
chr17,Bn67480,88653312,91308202,2654890,RLP
chr17,Bn67481,34708935,89081199,54372264,TNL
chr17,Bn67482,92957215,99049036,6091821,TN
chr17,Bn67483,41303441,89700098,48396657,TN
chr17,Bn67484,22544843,34060107,11515264,RLK
chr17,Bn67485,38421848,91082572,52660724,CNL
chr17,Bn67486,40987962,68363851,27375889,CNL
chr17,Bn67487,73741973,94024007,20282034,RLK
chr17,Bn67488,89033532,96119789,7086257,RLP
chr17,Bn67489,6160952,91236234,85075282,NBS
chr17,Bn67490,5345947,56516445,51170498,RLK
chr17,Bn67491,63835977,88080624,24244647,CN
chr17,Bn67492,54040856,72502739,18461883,CN
chr17,Bn67493,94938385,95084773,146388,CN
chr17,Bn67494,74120056,81147057,7027001,RLP
chr17,Bn67495,3167309,38276420,35109111,CNL
chr17,Bn67496,80229227,88308692,8079465,NBS
chr17,Bn67497,19476666,19797093,320427,RLK
chr17,Bn67498,31121626,48671466,17549840,CNL
chr17,Bn67499,19069884,67195465,48125581,NBS
chr17,Bn67500,38861687,56160022,17298335,RLK
chr17,Bn67501,31676698,45299288,13622590,RLP
chr17,Bn67502,33859910,54181686,20321776,TNL
chr17,Bn67503,38956393,46285964,7329571,RLK
chr17,Bn67504,5106476,8227040,3120564,RLP
chr17,Bn67505,44769557,81911815,37142258,TNL
chr17,Bn67506,35418749,92138130,56719381,NBS
chr17,Bn67507,89596897,91017534,1420637,TNL
chr17,Bn67508,3743802,50367836,46624034,NBS
chr17,Bn67509,1613211,33746357,32133146,RLP
chr17,Bn67510,74146939,76234070,2087131,RLK
chr17,Bn67511,85198151,87653839,2455688,TN
chr17,Bn67512,70777790,74003148,3225358,RLK
chr17,Bn67513,77481235,87800087,10318852,CNL
chr17,Bn67514,76574669,96641988,20067319,CN
chr17,Bn67515,40184138,61624334,21440196,RLK
chr17,Bn67516,6196256,71127170,64930914,TN
chr17,Bn67517,6009827,51779097,45769270,TNL
chr17,Bn67518,43613179,83714751,40101572,TNL
chr17,Bn67519,49066569,77862653,28796084,RLK
chr17,Bn67520,36894304,62212839,25318535,RLK
chr17,Bn67521,62263150,90628681,28365531,RLK
chr17,Bn67522,47771222,58599883,10828661,TNL
chr17,Bn67523,21999584,83512803,61513219,CN
chr17,Bn67524,66558561,79802469,13243908,RLP
chr17,Bn67525,36540595,94092564,57551969,RLP
chr17,Bn67526,37933495,86424533,48491038,CNL
chr17,Bn67527,19860912,31263034,11402122,TN
chr17,Bn67528,46548837,89859655,43310818,TN
chr17,Bn67529,73601768,95405587,21803819,CNL
chr17,Bn67530,76467099,97222011,20754912,NBS
chr17,Bn67531,13632242,79610979,65978737,TNL
chr17,Bn67532,81920222,96681721,14761499,CN
chr17,Bn67533,10292559,69927057,59634498,RLK
chr17,Bn67534,49510719,78481961,28971242,RLK
chr17,Bn67535,24885611,66318039,41432428,RLP
chr17,Bn67536,61076462,89531791,28455329,TN
chr17,Bn67537,32548796,90636644,58087848,NBS
chr17,Bn67538,60357993,61528191,1170198,RLP
chr17,Bn67539,21510617,38162464,16651847,TNL
chr17,Bn67540,10824774,69204667,58379893,CNL
chr17,Bn67541,87422513,96715265,9292752,CNL
chr17,Bn67542,75065727,81596025,6530298,TNL
chr17,Bn67543,40247985,74271194,34023209,CNL
chr17,Bn67544,51554119,82079423,30525304,TN
chr17,Bn67545,62014615,85184142,23169527,NBS
chr17,Bn67546,77787751,79470762,1683011,CNL
chr17,Bn67547,69654074,86535706,16881632,TNL
chr17,Bn67548,89128548,89141694,13146,NBS
chr17,Bn67549,61515838,66329509,4813671,TNL
chr17,Bn67550,70145518,77471161,7325643,CNL
chr17,Bn67551,42713601,62368627,19655026,CN
chr17,Bn67552,19621027,25486181,5865154,CN
chr17,Bn67553,30078684,75003482,44924798,CNL
chr17,Bn67554,81199921,83657755,2457834,RLK
chr17,Bn67555,11756465,19728175,7971710,TNL
chr17,Bn67556,55823518,59209437,3385919,CNL
chr17,Bn67557,33866624,76085259,42218635,TNL
chr17,Bn67558,76258972,80649338,4390366,RLK
chr17,Bn67559,88613097,92413180,3800083,TN
chr17,Bn67560,75076499,87426376,12349877,RLP
chr17,Bn67561,96611778,97288309,676531,RLK
chr17,Bn67562,3712991,12236782,8523791,RLP
chr17,Bn67563,90826862,96051505,5224643,RLP
chr17,Bn67564,48362407,89619126,41256719,NBS
chr17,Bn67565,97648038,97700995,52957,CNL
chr17,Bn67566,35236560,69881260,34644700,RLK
chr17,Bn67567,74732963,97744251,23011288,TN
chr17,Bn67568,31704382,94844655,63140273,RLP
chr17,Bn67569,12641148,18198470,5557322,CN
chr17,Bn67570,91032449,92741213,1708764,CN
chr17,Bn67571,63384595,86827235,23442640,RLP
chr17,Bn67572,5165713,59445045,54279332,RLK
chr17,Bn67573,29904803,36364254,6459451,CNL
chr17,Bn67574,13073017,17948782,4875765,RLP
chr17,Bn67575,96934770,98714386,1779616,CN
chr17,Bn67576,29602005,67307883,37705878,RLK
chr17,Bn67577,97024320,98374885,1350565,RLP
chr17,Bn67578,94626888,96389354,1762466,RLP
chr17,Bn67579,16353106,78726678,62373572,CN
chr17,Bn67580,67447598,76129350,8681752,RLK
chr17,Bn67581,23270756,59470423,36199667,TNL
chr17,Bn67582,41325356,52963734,11638378,CN
chr17,Bn67583,69489024,78117074,8628050,TN
chr17,Bn67584,12536804,92475881,79939077,CN
chr17,Bn67585,30620664,36802647,6181983,RLP
chr17,Bn67586,99746850,99979563,232713,RLK
chr17,Bn67587,5506822,60303704,54796882,CNL
chr17,Bn67588,81089814,95420839,14331025,RLP
chr17,Bn67589,72601219,77152054,4550835,RLP
chr17,Bn67590,91678937,93996442,2317505,RLK
chr17,Bn67591,10135120,48276729,38141609,CN
chr17,Bn67592,24961246,84024279,59063033,RLK
chr17,Bn67593,98668349,99130829,462480,CN
chr17,Bn67594,10922972,37910114,26987142,CN
chr17,Bn67595,97558663,98554348,995685,CNL
chr17,Bn67596,97302661,98582874,1280213,TN
chr17,Bn67597,91534039,98440750,6906711,NBS
chr17,Bn67598,90929998,98355321,7425323,NBS
chr17,Bn67599,49441156,58875034,9433878,TN
chr17,Bn67600,24785784,67362107,42576323,NBS
chr17,Bn67601,90534127,91369903,835776,CNL
chr17,Bn67602,66419223,92412224,25993001,CNL
chr17,Bn67603,66444737,74001237,7556500,CNL
chr17,Bn67604,52370594,85556615,33186021,TN
chr17,Bn67605,24918372,82990539,58072167,NBS
chr17,Bn67606,7344012,8961869,1617857,TN
chr17,Bn67607,82308081,97988219,15680138,RLK
chr17,Bn67608,31819092,39858476,8039384,CNL
chr17,Bn67609,94607229,98984532,4377303,RLP
chr17,Bn67610,7132471,63035941,55903470,CN
chr17,Bn67611,12395253,37547968,25152715,TN
chr17,Bn67612,93626255,97950083,4323828,CNL
chr17,Bn67613,11193037,58178385,46985348,TNL
chr17,Bn67614,70471664,89899334,19427670,RLK
chr17,Bn67615,17041233,83337210,66295977,CNL
chr17,Bn67616,35001667,50159557,15157890,CN
chr17,Bn67617,46609212,77658154,31048942,NBS
chr17,Bn67618,65206261,97996022,32789761,TN
chr17,Bn67619,49400954,89947174,40546220,TNL
chr17,Bn67620,79008951,96586972,17578021,RLP
chr17,Bn67621,98740767,99393244,652477,TNL
chr17,Bn67622,40662336,52582897,11920561,NBS
chr17,Bn67623,25194935,92085394,66890459,RLK
chr17,Bn67624,18692867,67646047,48953180,RLK
chr17,Bn67625,11499582,20319505,8819923,CN
chr17,Bn67626,55018007,60568901,5550894,TN
chr17,Bn67627,25191042,75895666,50704624,NBS
chr17,Bn67628,32940698,46277116,13336418,TNL
chr17,Bn67629,17286960,33826933,16539973,NBS
chr17,Bn67630,5043367,76500804,71457437,TNL
chr17,Bn67631,71086824,88638770,17551946,TN
chr17,Bn67632,77120967,88518556,11397589,RLP
chr17,Bn67633,92450433,99824402,7373969,RLK
chr17,Bn67634,65740994,76172017,10431023,TNL
chr17,Bn67635,23927130,99698949,75771819,RLK
chr17,Bn67636,69342093,99662614,30320521,RLP
chr17,Bn67637,39696257,55365950,15669693,RLK
chr17,Bn67638,27895950,99347239,71451289,NBS
chr17,Bn67639,49627803,55709650,6081847,RLP
chr17,Bn67640,59998501,78076666,18078165,RLK
chr17,Bn67641,88525217,91424142,2898925,CN
chr17,Bn67642,27868416,45088324,17219908,CNL
chr17,Bn67643,16428518,25960016,9531498,RLP
chr17,Bn67644,2931388,50427311,47495923,TN
chr17,Bn67645,37335550,58951392,21615842,NBS
chr17,Bn67646,88476608,97199755,8723147,RLP
chr17,Bn67647,14146996,83802580,69655584,CN
chr17,Bn67648,37013750,53399279,16385529,CN
chr17,Bn67649,38801507,49979421,11177914,TNL
chr17,Bn67650,11579780,20388284,8808504,CN
chr17,Bn67651,79744806,99535480,19790674,TNL
chr17,Bn67652,6866226,87455850,80589624,TNL
chr17,Bn67653,64385913,81029036,16643123,RLP
chr17,Bn67654,25526399,48640845,23114446,RLK
chr17,Bn67655,86669227,96543126,9873899,RLP
chr17,Bn67656,32217613,64161248,31943635,RLK
chr17,Bn67657,76258606,80726001,4467395,CN
chr17,Bn67658,7975272,38749856,30774584,NBS
chr17,Bn67659,59744384,60238115,493731,TNL
chr17,Bn67660,22186399,74015414,51829015,TNL
chr17,Bn67661,39051615,59259685,20208070,TNL
chr17,Bn67662,63995893,85151269,21155376,CNL
chr17,Bn67663,83174530,95947713,12773183,TN
chr17,Bn67664,96013609,99428834,3415225,RLK
chr17,Bn67665,75615865,76424980,809115,TNL
chr17,Bn67666,1800174,50143266,48343092,RLP
chr17,Bn67667,81097468,93668002,12570534,CNL
chr17,Bn67668,14210358,90255170,76044812,NBS
chr17,Bn67669,50909993,67107935,16197942,CNL
chr17,Bn67670,48308222,94166978,45858756,NBS
chr17,Bn67671,69073306,92959170,23885864,CN
chr17,Bn67672,73650194,89626843,15976649,TN
chr17,Bn67673,5925200,14649362,8724162,RLK
chr17,Bn67674,63591291,88164229,24572938,RLP
chr17,Bn67675,17921984,32233319,14311335,CNL
chr17,Bn67676,42103148,49940284,7837136,RLK
chr17,Bn67677,47491874,77593875,30102001,CNL
chr17,Bn67678,45575195,98248862,52673667,TNL
chr17,Bn67679,76134383,93458062,17323679,RLP
chr17,Bn67680,40441684,57111712,16670028,RLP
chr17,Bn67681,24602422,48255462,23653040,CN
chr17,Bn67682,68836082,76716216,7880134,RLK
chr17,Bn67683,8932738,46431669,37498931,RLK
chr17,Bn67684,49802908,70824795,21021887,TNL
chr17,Bn67685,63815148,99694302,35879154,NBS
chr17,Bn67686,56464452,70350415,13885963,CN
chr17,Bn67687,34004629,98743064,64738435,TNL
chr17,Bn67688,55614796,94572481,38957685,RLP
chr17,Bn67689,76098516,82764045,6665529,CN
chr17,Bn67690,48510146,58748109,10237963,RLK
chr17,Bn67691,86282761,96466923,10184162,TNL
chr17,Bn67692,12973883,18497479,5523596,RLP
chr17,Bn67693,48807771,49327498,519727,NBS
chr17,Bn67694,74088931,75297953,1209022,CNL
chr17,Bn67695,81657492,93964558,12307066,NBS
chr17,Bn67696,17544476,52764507,35220031,TN
chr17,Bn67697,89565480,90498641,933161,CN
chr17,Bn67698,32762613,33136178,373565,RLP
chr17,Bn67699,82213646,94691007,12477361,CN
chr17,Bn67700,60235120,97841197,37606077,TN
chr17,Bn67701,55226623,96942207,41715584,TNL
chr17,Bn67702,33971289,86245102,52273813,RLP
chr17,Bn67703,81753196,89072369,7319173,RLP
chr17,Bn67704,29198371,51258248,22059877,RLK
chr17,Bn67705,66140061,76829812,10689751,RLK
chr17,Bn67706,18428735,82104125,63675390,TNL
chr17,Bn67707,15646416,56774729,41128313,TN
chr17,Bn67708,85071652,96770655,11699003,CN
chr17,Bn67709,73598015,98332678,24734663,RLP
chr17,Bn67710,32845974,95891155,63045181,TNL
chr17,Bn67711,10626251,64016560,53390309,TN
chr17,Bn67712,49668439,97836018,48167579,NBS
chr17,Bn67713,60090738,73908880,13818142,CNL
chr17,Bn67714,12415927,17436047,5020120,RLP
chr17,Bn67715,51221274,68184076,16962802,RLP
chr17,Bn67716,52121742,66027337,13905595,TN
chr17,Bn67717,81179044,98686402,17507358,RLK
chr17,Bn67718,52006056,81293615,29287559,TNL
chr17,Bn67719,96710383,99716144,3005761,RLK
chr17,Bn67720,9125147,50553063,41427916,CN
chr17,Bn67721,17367395,86472048,69104653,NBS
chr17,Bn67722,22965399,48139371,25173972,RLK
chr17,Bn67723,93975518,95552837,1577319,RLP
chr17,Bn67724,32117260,99780060,67662800,TN
chr17,Bn67725,85055359,98467064,13411705,TN
chr17,Bn67726,67133148,88988783,21855635,CN
chr17,Bn67727,5590098,44523809,38933711,TN
chr17,Bn67728,31781625,64290961,32509336,CNL
chr17,Bn67729,80361410,93779676,13418266,RLP
chr17,Bn67730,70489230,85245425,14756195,RLK
chr17,Bn67731,97019560,97424441,404881,TN
chr17,Bn67732,23028279,28834205,5805926,RLK
chr17,Bn67733,87008952,97123378,10114426,TNL
chr17,Bn67734,25812791,82281878,56469087,TNL
chr17,Bn67735,72592047,90119300,17527253,TNL
chr17,Bn67736,59330015,73857530,14527515,RLK
chr17,Bn67737,90383730,90799254,415524,RLP
chr17,Bn67738,51209394,78924612,27715218,TNL
chr17,Bn67739,13496233,48876709,35380476,CN
chr17,Bn67740,87621699,98145585,10523886,RLP
chr17,Bn67741,6728776,36295015,29566239,CN
chr17,Bn67742,59497298,68464017,8966719,RLK
chr17,Bn67743,51573689,59179145,7605456,NBS
chr17,Bn67744,44060244,77645352,33585108,CN
chr17,Bn67745,11026553,94405519,83378966,RLP
chr17,Bn67746,39906978,64198027,24291049,CN
chr17,Bn67747,96828744,99094032,2265288,NBS
chr17,Bn67748,91533502,94275489,2741987,RLP
chr17,Bn67749,55976895,93221896,37245001,CNL
chr17,Bn67750,14681097,87458873,72777776,RLK
chr17,Bn67751,19673847,90614260,70940413,CN
chr17,Bn67752,71233790,75642220,4408430,RLP
chr17,Bn67753,24501151,89978035,65476884,RLP
chr17,Bn67754,38366517,94598348,56231831,RLK
chr17,Bn67755,78500483,89785296,11284813,CNL
chr17,Bn67756,86899534,93625619,6726085,CNL
chr17,Bn67757,92261125,96047570,3786445,CNL
chr17,Bn67758,34537549,59935283,25397734,RLK
chr17,Bn67759,53740834,97827863,44087029,NBS
chr17,Bn67760,1911598,33439558,31527960,TN
chr17,Bn67761,33852440,92508645,58656205,RLK
chr17,Bn67762,84654554,91499746,6845192,TN
chr17,Bn67763,62054369,69564703,7510334,RLK
chr17,Bn67764,86514167,89929387,3415220,CN
chr17,Bn67765,57268341,76779029,19510688,RLP
chr17,Bn67766,16540157,69663480,53123323,RLK
chr17,Bn67767,86950325,92228040,5277715,TNL
chr17,Bn67768,30713905,66907535,36193630,TN
chr17,Bn67769,2276133,18609069,16332936,CNL
chr17,Bn67770,11288464,54785976,43497512,NBS
chr17,Bn67771,59815739,73505118,13689379,RLK
chr17,Bn67772,54377739,59780350,5402611,TNL
chr17,Bn67773,40811219,59703721,18892502,NBS
chr17,Bn67774,38089658,44438684,6349026,RLP
chr17,Bn67775,77607981,89155672,11547691,TNL
chr17,Bn67776,74525169,92884847,18359678,RLP
chr17,Bn67777,84991594,89499946,4508352,RLK
chr17,Bn67778,91616319,99590318,7973999,TN
chr17,Bn67779,30788901,52857724,22068823,TNL
chr17,Bn67780,5963223,41045033,35081810,TNL
chr17,Bn67781,37221002,76526199,39305197,TNL
chr17,Bn67782,62115769,82475500,20359731,CN
chr17,Bn67783,4576636,93057803,88481167,TN
chr17,Bn67784,40151166,50202162,10050996,RLK
chr17,Bn67785,83446032,87838231,4392199,TNL
chr17,Bn67786,9100907,18382712,9281805,TNL
chr17,Bn67787,71115016,90379986,19264970,CNL
chr17,Bn67788,6062158,30821410,24759252,RLK
chr17,Bn67789,76925727,85693348,8767621,CNL
chr17,Bn67790,89362908,97948058,8585150,CN
chr17,Bn67791,44316154,46691480,2375326,RLK
chr17,Bn67792,75714102,86515514,10801412,TN
chr17,Bn67793,19060499,75760370,56699871,RLK
chr17,Bn67794,18228896,82656599,64427703,TNL
chr17,Bn67795,22958272,42389857,19431585,RLK
chr17,Bn67796,85144456,91511266,6366810,RLK
chr17,Bn67797,37820985,92295374,54474389,CN
chr17,Bn67798,18031216,69471494,51440278,CN
chr17,Bn67799,56144570,73481214,17336644,RLK
chr17,Bn67800,36379552,42091626,5712074,CNL
chr17,Bn67801,93799525,97303201,3503676,CN
chr17,Bn67802,32739568,56809912,24070344,RLK
chr17,Bn67803,31971709,77956615,45984906,RLP
chr17,Bn67804,52353942,73359531,21005589,CNL
chr17,Bn67805,78099187,79544385,1445198,RLP
chr17,Bn67806,21486508,21640848,154340,TN
chr17,Bn67807,8433773,57034680,48600907,TNL
chr17,Bn67808,85724827,99344983,13620156,RLK
chr17,Bn67809,75660075,84179615,8519540,RLK
chr17,Bn67810,22974541,54734729,31760188,CNL
chr17,Bn67811,8232650,93812085,85579435,RLK
chr17,Bn67812,92961734,96857544,3895810,CN
chr17,Bn67813,65727426,79724881,13997455,CNL
chr17,Bn67814,98389156,99299692,910536,CN
chr17,Bn67815,98912933,99847687,934754,RLK
chr17,Bn67816,97043401,97610905,567504,RLP
chr17,Bn67817,83199750,92960738,9760988,TN
chr17,Bn67818,40741305,79553845,38812540,RLP
chr17,Bn67819,56008461,73644747,17636286,NBS
chr17,Bn67820,53473417,94069430,40596013,NBS
chr17,Bn67821,80663358,96390169,15726811,RLK
chr17,Bn67822,27831370,61950149,34118779,RLK
chr17,Bn67823,69961661,88341669,18380008,NBS
chr17,Bn67824,44695459,81531218,36835759,NBS
chr17,Bn67825,48744390,66735094,17990704,RLK
chr17,Bn67826,45285753,57269406,11983653,RLP
chr17,Bn67827,54720817,74131860,19411043,CN
chr17,Bn67828,85141607,89536472,4394865,TN
chr17,Bn67829,81700835,91838031,10137196,RLP
chr17,Bn67830,35566101,43756274,8190173,TN
chr17,Bn67831,99985701,99992642,6941,NBS
chr17,Bn67832,41145855,48589205,7443350,TNL
chr17,Bn67833,45795545,81893433,36097888,NBS
chr17,Bn67834,5476661,74341679,68865018,TN
chr17,Bn67835,86440409,96298137,9857728,CNL
chr17,Bn67836,7675652,57014326,49338674,TNL
chr17,Bn67837,58686588,91530790,32844202,RLP
chr17,Bn67838,75968904,76986866,1017962,RLK
chr17,Bn67839,98501484,99456161,954677,RLK
chr17,Bn67840,10500850,47190108,36689258,TNL
chr17,Bn67841,61516706,87597920,26081214,CNL
chr17,Bn67842,11946938,96351484,84404546,CN
chr17,Bn67843,50311917,73553681,23241764,RLK
chr17,Bn67844,85336641,94583401,9246760,CNL
chr17,Bn67845,29932222,59357489,29425267,NBS
chr17,Bn67846,61724123,81847341,20123218,TNL
chr17,Bn67847,54940320,76653048,21712728,RLK
chr17,Bn67848,32749126,55900597,23151471,CNL
chr17,Bn67849,44978778,66216708,21237930,RLK
chr17,Bn67850,82065231,85766562,3701331,CNL
chr17,Bn67851,78326755,88793437,10466682,TNL
chr17,Bn67852,57988860,93427005,35438145,CNL
chr17,Bn67853,40250719,68635489,28384770,TN
chr17,Bn67854,30480666,43509633,13028967,NBS
chr17,Bn67855,5142979,76629298,71486319,CN
chr17,Bn67856,74784922,86561430,11776508,RLK
chr17,Bn67857,88172545,99313370,11140825,RLK
chr17,Bn67858,38588271,75075173,36486902,CN
chr17,Bn67859,48166741,86734256,38567515,RLP
chr17,Bn67860,23538297,59109503,35571206,RLK
chr17,Bn67861,44419131,47862276,3443145,TN
chr17,Bn67862,30204948,45610813,15405865,TNL
chr17,Bn67863,82395730,99352315,16956585,RLK
chr17,Bn67864,91950190,94430652,2480462,CN
chr17,Bn67865,86121678,89985202,3863524,CNL
chr17,Bn67866,54241454,79332700,25091246,RLK
chr17,Bn67867,49208617,96072147,46863530,CNL
chr17,Bn67868,29266249,90049184,60782935,TNL
chr17,Bn67869,56631242,73610408,16979166,RLP
chr17,Bn67870,42801380,76421187,33619807,TN
chr17,Bn67871,50256125,72568216,22312091,TNL
chr17,Bn67872,25701817,58182025,32480208,RLP
chr17,Bn67873,34208756,40040253,5831497,TNL
chr17,Bn67874,92596393,97060486,4464093,RLK
chr17,Bn67875,56914431,64225150,7310719,CN
chr17,Bn67876,98238507,98994645,756138,RLK
chr17,Bn67877,41973186,97089871,55116685,TNL
chr17,Bn67878,37614838,46132953,8518115,CNL
chr17,Bn67879,98902985,99152707,249722,TN
chr17,Bn67880,61819623,82712806,20893183,TNL
chr17,Bn67881,93120971,98536048,5415077,RLK
chr17,Bn67882,70987373,91903154,20915781,TNL
chr17,Bn67883,32304017,36056540,3752523,TN
chr17,Bn67884,47756912,75222988,27466076,RLP
chr17,Bn67885,54529355,59654966,5125611,RLK
chr17,Bn67886,97767386,98827369,1059983,RLP
chr17,Bn67887,84350106,87417969,3067863,NBS
chr17,Bn67888,72858869,85226849,12367980,CN
chr17,Bn67889,98995428,99723471,728043,NBS
chr17,Bn67890,51659092,93563402,41904310,RLP
chr17,Bn67891,44418851,59534411,15115560,TNL
chr17,Bn67892,71413459,81115261,9701802,CN
chr17,Bn67893,82420425,89212191,6791766,RLK
chr17,Bn67894,17836739,46912299,29075560,CNL
chr17,Bn67895,80668517,87198706,6530189,TNL
chr17,Bn67896,92538215,95424063,2885848,NBS
chr17,Bn67897,60755480,71141208,10385728,RLP
chr17,Bn67898,80149582,88635318,8485736,RLK
chr17,Bn67899,66765792,98535549,31769757,RLK
chr17,Bn67900,95068198,98026917,2958719,RLP
chr17,Bn67901,80851110,82300390,1449280,RLK
chr17,Bn67902,45710095,59989968,14279873,TN
chr17,Bn67903,45163485,85916572,40753087,NBS
chr17,Bn67904,98478999,98692491,213492,RLP
chr17,Bn67905,29820949,76749308,46928359,RLK
chr17,Bn67906,93539530,94801792,1262262,RLK
chr17,Bn67907,52839243,53412476,573233,TNL
chr17,Bn67908,70161027,99335531,29174504,CN
chr17,Bn67909,34863617,65448098,30584481,CNL
chr17,Bn67910,28207146,50798452,22591306,TNL
chr17,Bn67911,87853659,90232283,2378624,TNL
chr17,Bn67912,3405061,32388155,28983094,RLK
chr17,Bn67913,44128110,85563199,41435089,TN
chr17,Bn67914,23310735,47766438,24455703,CNL
chr17,Bn67915,20606965,38044233,17437268,NBS
chr17,Bn67916,40310503,53652444,13341941,CN
chr17,Bn67917,12825396,85086587,72261191,CN
chr17,Bn67918,74707984,91955285,17247301,CNL
chr17,Bn67919,67923070,81095083,13172013,NBS
chr17,Bn67920,61743609,86668960,24925351,CNL
chr17,Bn67921,95555528,99599488,4043960,NBS
chr17,Bn67922,40118433,43347390,3228957,RLK
chr17,Bn67923,24859744,41958449,17098705,CN
chr17,Bn67924,62796273,62895776,99503,RLP
chr17,Bn67925,36123808,61839639,25715831,CN
chr17,Bn67926,20438778,24517879,4079101,TNL
chr17,Bn67927,58269707,77480314,19210607,TN
chr17,Bn67928,65653666,93858464,28204798,TNL
chr17,Bn67929,20914729,74416287,53501558,CNL
chr17,Bn67930,50948501,93927767,42979266,RLK
chr17,Bn67931,57072399,69676486,12604087,NBS
chr17,Bn67932,91518917,95493275,3974358,TN
chr17,Bn67933,60225659,89734528,29508869,RLK
chr17,Bn67934,48648495,57669310,9020815,CNL
chr17,Bn67935,96413263,98914699,2501436,RLP
chr17,Bn67936,54060783,73748447,19687664,TN
chr17,Bn67937,8437449,88586577,80149128,RLP
chr17,Bn67938,83531241,98516787,14985546,NBS
chr17,Bn67939,48283463,65772165,17488702,TN
chr17,Bn67940,77088133,84422473,7334340,CN
chr17,Bn67941,98850560,99685380,834820,NBS
chr17,Bn67942,10539934,65156957,54617023,CNL
chr17,Bn67943,47806473,57435114,9628641,NBS
chr17,Bn67944,92926902,94059624,1132722,CNL
chr17,Bn67945,31831873,84422609,52590736,CN
chr17,Bn67946,67751052,88051334,20300282,TNL
chr17,Bn67947,84417084,88744645,4327561,RLK
chr17,Bn67948,36582544,66519467,29936923,CN
chr17,Bn67949,68481213,69821333,1340120,CNL
chr17,Bn67950,89666887,98226288,8559401,TNL
chr17,Bn67951,29369005,69909155,40540150,CN
chr17,Bn67952,32788519,47389822,14601303,RLP
chr17,Bn67953,5647721,55786747,50139026,TN
chr17,Bn67954,56722158,78523220,21801062,TNL
chr17,Bn67955,13424185,73228302,59804117,RLP
chr17,Bn67956,75501778,91910087,16408309,CN
chr17,Bn67957,72293512,96999224,24705712,TNL
chr17,Bn67958,40644883,43403707,2758824,NBS
chr17,Bn67959,1148621,72038924,70890303,RLK
chr17,Bn67960,60746327,65636790,4890463,CNL
chr17,Bn67961,82459477,97604073,15144596,NBS
chr17,Bn67962,3879595,27585246,23705651,NBS
chr17,Bn67963,9811830,89035229,79223399,RLP
chr17,Bn67964,47132785,85409866,38277081,TNL
chr17,Bn67965,29617861,90517802,60899941,TN
chr17,Bn67966,46029854,60166568,14136714,NBS
chr17,Bn67967,27537480,58639771,31102291,NBS
chr17,Bn67968,32567904,98346102,65778198,TNL
chr17,Bn67969,61162987,97063432,35900445,TNL
chr17,Bn67970,69654654,84008666,14354012,RLP
chr17,Bn67971,28272516,75439809,47167293,TNL
chr17,Bn67972,94562801,99337015,4774214,TN
chr17,Bn67973,55893862,76720196,20826334,RLP
chr17,Bn67974,39817321,89580888,49763567,CN
chr17,Bn67975,22742926,90169027,67426101,NBS
chr17,Bn67976,10261819,34770151,24508332,TN
chr17,Bn67977,72345635,72855093,509458,TN
chr17,Bn67978,70078269,75376806,5298537,CN
chr17,Bn67979,7060117,51757727,44697610,TN
chr17,Bn67980,20135674,85607640,65471966,NBS
chr17,Bn67981,42222393,62845483,20623090,TN
chr17,Bn67982,48079333,61470470,13391137,RLP
chr17,Bn67983,17706662,46139397,28432735,RLP
chr17,Bn67984,26329742,40822022,14492280,CNL
chr17,Bn67985,51512791,52367338,854547,RLP
chr17,Bn67986,61485555,73750837,12265282,RLP
chr17,Bn67987,93944751,99190153,5245402,CN
chr17,Bn67988,68424469,98855826,30431357,RLK
chr17,Bn67989,76037729,89769960,13732231,RLP
chr17,Bn67990,99639650,99996865,357215,TNL
chr17,Bn67991,24243689,80170771,55927082,RLP
chr17,Bn67992,27246000,38646338,11400338,RLK
chr17,Bn67993,93556433,98828227,5271794,NBS
chr17,Bn67994,41117302,43628235,2510933,TN
chr17,Bn67995,97214316,99093705,1879389,NBS
chr17,Bn67996,28298714,52228422,23929708,CN
chr17,Bn67997,20940250,45225954,24285704,TN
chr17,Bn67998,61874941,68601054,6726113,TN
chr17,Bn67999,36977104,87427979,50450875,TNL
chr17,Bn68000,43109034,84101141,40992107,RLK
chr17,Bn68001,23047680,54637754,31590074,NBS
chr17,Bn68002,2470066,3824313,1354247,RLP
chr17,Bn68003,82937147,91804609,8867462,TNL
chr17,Bn68004,12059132,28592118,16532986,TNL
chr17,Bn68005,24248285,46407361,22159076,CN
chr17,Bn68006,72938884,81695606,8756722,TN
chr17,Bn68007,12925736,26042675,13116939,NBS
chr17,Bn68008,29423368,81889564,52466196,RLK
chr17,Bn68009,51069944,65774927,14704983,RLK
chr17,Bn68010,53914750,61054729,7139979,NBS
chr17,Bn68011,50443139,56935616,6492477,TN
chr17,Bn68012,47001602,53477458,6475856,RLK
chr17,Bn68013,91241589,97130007,5888418,RLP
chr17,Bn68014,71272548,98984330,27711782,CN
chr17,Bn68015,1522440,6873851,5351411,TNL
chr17,Bn68016,66644067,85913107,19269040,CNL
chr17,Bn68017,80999679,81298959,299280,TNL
chr17,Bn68018,11523167,51362054,39838887,NBS
chr17,Bn68019,16785354,48510911,31725557,TN
chr17,Bn68020,4286711,50243615,45956904,NBS
chr17,Bn68021,29305000,52308545,23003545,TN
chr17,Bn68022,13245485,35951395,22705910,RLK
chr17,Bn68023,75826815,83846470,8019655,RLK
chr17,Bn68024,4307664,6422799,2115135,RLK
chr17,Bn68025,97869536,99273175,1403639,CN
chr17,Bn68026,86072498,87416026,1343528,CNL
chr17,Bn68027,14344373,86586635,72242262,CN
chr17,Bn68028,74964620,77381943,2417323,TN
chr17,Bn68029,6198749,24227360,18028611,RLK
chr17,Bn68030,52552062,73380461,20828399,CNL
chr17,Bn68031,66603179,78550732,11947553,TNL
chr17,Bn68032,65061070,66313932,1252862,NBS
chr17,Bn68033,66096922,80908003,14811081,NBS
chr17,Bn68034,61487510,70344234,8856724,TN
chr17,Bn68035,97259087,97599366,340279,TN
chr17,Bn68036,55926025,56576080,650055,CNL
chr17,Bn68037,33593796,97889659,64295863,RLK
chr17,Bn68038,90957737,99122093,8164356,RLP
chr17,Bn68039,98519369,99153436,634067,RLP
chr17,Bn68040,87507750,87942804,435054,TNL
chr17,Bn68041,68334308,69280393,946085,TNL
chr17,Bn68042,93027256,93191091,163835,TN
chr17,Bn68043,59877140,76724695,16847555,TN
chr17,Bn68044,97881641,99739459,1857818,TN
chr17,Bn68045,71573941,88864224,17290283,CN
chr17,Bn68046,82985095,94924950,11939855,CNL
chr17,Bn68047,5813579,24951725,19138146,RLP
chr17,Bn68048,97756151,99266072,1509921,CN
chr17,Bn68049,78867072,95535670,16668598,CNL
chr17,Bn68050,56082305,76234244,20151939,NBS
chr17,Bn68051,28861767,44810743,15948976,NBS
chr17,Bn68052,46869686,67789630,20919944,TN
chr17,Bn68053,21744619,47407121,25662502,CNL
chr17,Bn68054,40387856,70193310,29805454,CN
chr17,Bn68055,4929201,90025286,85096085,NBS
chr17,Bn68056,54525969,99579275,45053306,NBS
chr17,Bn68057,18075279,64639790,46564511,CNL
chr17,Bn68058,17771043,49662069,31891026,RLK
chr17,Bn68059,37982127,69700641,31718514,CN
chr17,Bn68060,30769831,89341806,58571975,CN
chr17,Bn68061,45718519,69066426,23347907,TNL
chr17,Bn68062,48392830,77373410,28980580,TN
chr17,Bn68063,28964211,91746739,62782528,CNL
chr17,Bn68064,28635381,35646092,7010711,TN
chr17,Bn68065,16552863,55473169,38920306,NBS
chr17,Bn68066,35273573,92871259,57597686,RLP
chr17,Bn68067,96077972,99885083,3807111,CN
chr17,Bn68068,74583941,95245011,20661070,TNL
chr17,Bn68069,40033724,59908522,19874798,TN
chr17,Bn68070,45179629,79244727,34065098,RLP
chr17,Bn68071,24242510,33853188,9610678,RLP
chr17,Bn68072,46806368,55649822,8843454,RLK
chr17,Bn68073,13462407,88484942,75022535,RLP
chr17,Bn68074,46558366,99259533,52701167,RLP
chr17,Bn68075,84202987,85405896,1202909,TN
chr17,Bn68076,77932999,95954383,18021384,TNL
chr17,Bn68077,82369015,89458789,7089774,CNL
chr17,Bn68078,43724051,47785880,4061829,NBS
chr17,Bn68079,24806832,85797235,60990403,CNL
chr17,Bn68080,37245685,68503039,31257354,TNL
chr17,Bn68081,37980671,62701144,24720473,NBS
chr17,Bn68082,92562010,95550277,2988267,TNL
chr17,Bn68083,93732471,97070523,3338052,RLK
chr17,Bn68084,93112511,98213416,5100905,CNL
chr17,Bn68085,63069364,64289679,1220315,CN
chr17,Bn68086,22042230,46779949,24737719,RLP
chr17,Bn68087,55023699,79231297,24207598,CNL
chr17,Bn68088,65642265,98735582,33093317,TN
chr17,Bn68089,24679666,85584559,60904893,RLP
chr17,Bn68090,38886278,65497945,26611667,RLK
chr17,Bn68091,29154079,67329670,38175591,TN
chr17,Bn68092,75223296,83852277,8628981,TNL
chr17,Bn68093,63261188,83702289,20441101,TNL
chr17,Bn68094,36393428,63757340,27363912,NBS
chr17,Bn68095,2045955,68849732,66803777,TN
chr17,Bn68096,51084832,72361507,21276675,RLK
chr17,Bn68097,35074891,82254909,47180018,TNL
chr17,Bn68098,65532973,93232267,27699294,CN
chr17,Bn68099,18573911,95861879,77287968,TNL
chr17,Bn68100,51429810,78747981,27318171,RLK
chr17,Bn68101,26955525,44105796,17150271,NBS
chr17,Bn68102,84683597,92953818,8270221,RLK
chr17,Bn68103,75449420,82644469,7195049,TN
chr17,Bn68104,12223936,96890146,84666210,RLK
chr17,Bn68105,93241295,97294113,4052818,CN
chr17,Bn68106,75995990,90726487,14730497,CNL
chr17,Bn68107,9562908,86981666,77418758,RLP
chr17,Bn68108,35219117,90606390,55387273,RLK
chr17,Bn68109,62133586,95434891,33301305,TNL
chr17,Bn68110,17787660,69105697,51318037,TN
chr17,Bn68111,9525763,61303759,51777996,TNL
chr17,Bn68112,21234526,88269092,67034566,NBS
chr17,Bn68113,48295616,57121803,8826187,NBS
chr17,Bn68114,53896109,80525786,26629677,RLK
chr17,Bn68115,40592840,85525117,44932277,RLK
chr17,Bn68116,62195443,78011064,15815621,CNL
chr17,Bn68117,80449847,99090144,18640297,TNL
chr17,Bn68118,45457786,48570046,3112260,CNL
chr17,Bn68119,79591867,85229879,5638012,RLP
chr17,Bn68120,29550790,68788800,39238010,CNL
chr17,Bn68121,41538832,69665183,28126351,CN
chr17,Bn68122,21945052,66087455,44142403,RLP
chr17,Bn68123,36691715,98032606,61340891,TNL
chr17,Bn68124,35778170,59499150,23720980,NBS
chr17,Bn68125,27320439,70343297,43022858,NBS
chr17,Bn68126,49656994,87889704,38232710,TN
chr17,Bn68127,44079326,69669969,25590643,CNL
chr17,Bn68128,77364722,87642964,10278242,NBS
chr17,Bn68129,50089196,64068754,13979558,RLP
chr17,Bn68130,91189260,93814648,2625388,CN
chr17,Bn68131,90169880,93017473,2847593,TNL
chr17,Bn68132,93823321,99684186,5860865,TN
chr17,Bn68133,16654901,91121083,74466182,CN
chr17,Bn68134,29263442,88068563,58805121,CN
chr17,Bn68135,44048405,62172598,18124193,CNL
chr17,Bn68136,78163237,98300488,20137251,RLP
chr17,Bn68137,84552536,94329209,9776673,RLP
chr17,Bn68138,96460724,98928905,2468181,TN
chr17,Bn68139,38968824,51673722,12704898,CNL
chr17,Bn68140,80162930,81329712,1166782,NBS
chr17,Bn68141,78302338,85003693,6701355,CNL
chr17,Bn68142,11859913,72545369,60685456,TN
chr17,Bn68143,26932716,43224266,16291550,TNL
chr17,Bn68144,38207844,96861859,58654015,CN
chr17,Bn68145,49368012,60773760,11405748,RLK
chr17,Bn68146,2307991,56461068,54153077,TNL
chr17,Bn68147,12323261,54247009,41923748,RLK
chr17,Bn68148,77535826,81395946,3860120,RLP
chr17,Bn68149,91538956,97751074,6212118,RLK
chr17,Bn68150,87789013,98887580,11098567,CN
chr17,Bn68151,67466791,71893524,4426733,CN
chr17,Bn68152,1619887,53264218,51644331,NBS
chr17,Bn68153,92273575,93141008,867433,RLP
chr17,Bn68154,15326848,19275240,3948392,NBS
chr17,Bn68155,5012547,16563844,11551297,CN
chr17,Bn68156,15567540,25086820,9519280,RLK
chr17,Bn68157,33296369,82388363,49091994,RLP
chr17,Bn68158,92513351,97673074,5159723,CNL
chr17,Bn68159,64339116,79307767,14968651,TN
chr17,Bn68160,55842481,83764638,27922157,RLP
chr17,Bn68161,12421162,62327800,49906638,RLK
chr17,Bn68162,1132919,18679297,17546378,CN
chr17,Bn68163,56204328,59598325,3393997,CN
chr17,Bn68164,29111650,73667037,44555387,RLK
chr17,Bn68165,21513479,72676744,51163265,CNL
chr17,Bn68166,65820061,76253429,10433368,TNL
chr17,Bn68167,55425827,83446313,28020486,RLK
chr17,Bn68168,46223906,49027738,2803832,CN
chr17,Bn68169,58784952,62014951,3229999,CN
chr17,Bn68170,59237840,67531933,8294093,TNL
chr17,Bn68171,47578201,71588637,24010436,CNL
chr17,Bn68172,62510105,67861616,5351511,RLK
chr17,Bn68173,12508493,58309602,45801109,TNL
chr17,Bn68174,8595496,46500010,37904514,TN
chr17,Bn68175,71197037,88575473,17378436,NBS
chr17,Bn68176,55637366,61795144,6157778,CNL
chr17,Bn68177,74103888,87095208,12991320,NBS
chr17,Bn68178,81571665,86710268,5138603,CNL
chr17,Bn68179,95316529,98986902,3670373,TNL
chr17,Bn68180,41068656,95730545,54661889,NBS
chr17,Bn68181,96672329,97882638,1210309,RLP
chr17,Bn68182,36146222,90821460,54675238,RLP
chr17,Bn68183,98501265,99980444,1479179,RLP
chr17,Bn68184,95281931,96006452,724521,CN
chr17,Bn68185,86287509,96738265,10450756,NBS
chr17,Bn68186,98191357,98431856,240499,TN
chr17,Bn68187,81352968,99048688,17695720,TN
chr17,Bn68188,86491004,89148145,2657141,CNL
chr17,Bn68189,68259254,91433683,23174429,TN
chr17,Bn68190,18107416,23140476,5033060,RLK
chr17,Bn68191,45612685,89842312,44229627,CN
chr17,Bn68192,76286286,83087247,6800961,CNL
chr17,Bn68193,40464157,50607559,10143402,RLP
chr17,Bn68194,50665536,91803655,41138119,TN
chr17,Bn68195,37608105,88807527,51199422,RLK
chr17,Bn68196,95109106,99530542,4421436,RLP
chr17,Bn68197,92902432,98654256,5751824,CNL
chr17,Bn68198,83698445,92475189,8776744,NBS
chr17,Bn68199,63235630,95190230,31954600,TNL
chr17,Bn68200,69327228,82525579,13198351,CNL
chr17,Bn68201,66729690,91527291,24797601,TN
chr17,Bn68202,76117052,85491036,9373984,NBS
chr17,Bn68203,54024537,97236940,43212403,RLP
chr17,Bn68204,78795596,82390297,3594701,CN
chr17,Bn68205,18560837,80289405,61728568,NBS
chr17,Bn68206,59328992,87359954,28030962,TN
chr17,Bn68207,76579433,98873891,22294458,CN
chr17,Bn68208,39349191,48631005,9281814,TN
chr17,Bn68209,72599428,86945151,14345723,NBS
chr17,Bn68210,23568131,52957103,29388972,TN
chr17,Bn68211,84462902,86808586,2345684,TN
chr17,Bn68212,10060004,69058486,58998482,CN
chr17,Bn68213,30956295,82648781,51692486,CN
chr17,Bn68214,78640115,91731346,13091231,TN
chr17,Bn68215,6801896,32241264,25439368,RLP
chr17,Bn68216,52704201,68691326,15987125,CNL
chr17,Bn68217,27411188,42042431,14631243,TNL
chr17,Bn68218,72843392,91444040,18600648,RLP
chr17,Bn68219,22412380,38306157,15893777,CN
chr17,Bn68220,68096735,74610426,6513691,CN
chr17,Bn68221,40890616,95153028,54262412,CNL
chr17,Bn68222,2071846,53206672,51134826,TN
chr17,Bn68223,2921398,6860119,3938721,TN
chr17,Bn68224,47020388,51921119,4900731,TNL
chr17,Bn68225,73370129,79323809,5953680,CN
chr17,Bn68226,68886662,85722898,16836236,TNL
chr17,Bn68227,68566269,74453989,5887720,TNL
chr17,Bn68228,86206203,87997075,1790872,RLK
chr17,Bn68229,15376778,17813493,2436715,TNL
chr17,Bn68230,86754935,96448200,9693265,CN
chr17,Bn68231,22279320,62050662,39771342,NBS
chr17,Bn68232,53904835,61996954,8092119,TNL
chr17,Bn68233,69680370,80629765,10949395,CNL
chr17,Bn68234,7146313,61405063,54258750,NBS
chr17,Bn68235,16201346,82287153,66085807,TNL
chr17,Bn68236,65989805,80042063,14052258,CNL
chr17,Bn68237,85442239,96188853,10746614,CN
chr17,Bn68238,69057956,82998475,13940519,NBS
chr17,Bn68239,22247188,50482178,28234990,TNL
chr17,Bn68240,48833935,91756669,42922734,TNL
chr17,Bn68241,49669467,70926474,21257007,RLK
chr17,Bn68242,22998857,47268991,24270134,RLK
chr17,Bn68243,3315612,92522063,89206451,RLP
chr17,Bn68244,62930666,98074058,35143392,NBS
chr17,Bn68245,55792284,56973935,1181651,RLK
chr17,Bn68246,81138845,84579592,3440747,NBS
chr17,Bn68247,39073171,83172558,44099387,RLP
chr17,Bn68248,53456789,78877610,25420821,RLP
chr17,Bn68249,64477017,80918789,16441772,TNL
chr17,Bn68250,92784271,95404016,2619745,NBS
chr17,Bn68251,12124837,17659249,5534412,NBS
chr17,Bn68252,13907668,75882161,61974493,NBS
chr17,Bn68253,54032894,57207364,3174470,RLK
chr17,Bn68254,33450982,76629756,43178774,TN
chr17,Bn68255,58248052,71857386,13609334,RLK
chr17,Bn68256,71292123,80386796,9094673,RLK
chr17,Bn68257,77832655,94460376,16627721,CN
chr17,Bn68258,25954513,81130594,55176081,NBS
chr17,Bn68259,91294268,95129927,3835659,TNL
chr17,Bn68260,6591670,48202984,41611314,TNL
chr17,Bn68261,76596177,81182877,4586700,CN
chr17,Bn68262,61060623,90320421,29259798,RLP
chr17,Bn68263,63405964,90468488,27062524,TNL
chr17,Bn68264,5025037,73363102,68338065,CN
chr17,Bn68265,70403315,95301237,24897922,CN
chr17,Bn68266,29898223,89180954,59282731,NBS
chr17,Bn68267,55072598,78086018,23013420,TN
chr17,Bn68268,65275201,68459206,3184005,TNL
chr17,Bn68269,95251377,99710159,4458782,NBS
chr17,Bn68270,99461327,99870150,408823,RLK
chr17,Bn68271,69559025,97619808,28060783,NBS
chr17,Bn68272,78945056,95925169,16980113,RLK
chr17,Bn68273,29160929,69709897,40548968,RLK
chr17,Bn68274,67793130,86505158,18712028,RLK
chr17,Bn68275,20842867,45130302,24287435,TN
chr17,Bn68276,32845766,45899667,13053901,CNL
chr17,Bn68277,42725283,85572913,42847630,TN
chr17,Bn68278,81333690,89267570,7933880,NBS
chr17,Bn68279,71131844,87091956,15960112,RLK
chr17,Bn68280,74671713,85641469,10969756,RLP
chr17,Bn68281,12701087,81075998,68374911,CN
chr17,Bn68282,27872111,74424243,46552132,CNL
chr17,Bn68283,14640246,28713685,14073439,TNL
chr17,Bn68284,72369980,84743450,12373470,TN
chr17,Bn68285,47713313,81648344,33935031,RLP
chr17,Bn68286,15633358,28134557,12501199,NBS
chr17,Bn68287,90618168,99290318,8672150,CNL
chr17,Bn68288,17552404,61105424,43553020,RLK
chr17,Bn68289,91667593,96912992,5245399,NBS
chr17,Bn68290,23345714,47713625,24367911,RLP
chr17,Bn68291,73285637,98582423,25296786,CN
chr17,Bn68292,44117946,63767702,19649756,TN
chr17,Bn68293,74066151,80171552,6105401,RLK
chr17,Bn68294,79029006,88129387,9100381,NBS
chr17,Bn68295,11039281,26685065,15645784,CNL
chr17,Bn68296,28656924,34682482,6025558,RLP
chr17,Bn68297,13233360,19726399,6493039,CNL
chr17,Bn68298,19430941,42051350,22620409,CN
chr17,Bn68299,84496092,97947037,13450945,NBS
chr17,Bn68300,15726160,29819218,14093058,TNL
chr17,Bn68301,31750938,81862079,50111141,CNL
chr17,Bn68302,82368357,96394331,14025974,RLK
chr17,Bn68303,11934179,15603722,3669543,TN
chr17,Bn68304,70522857,89062092,18539235,TN
chr17,Bn68305,63132818,93602026,30469208,RLK
chr17,Bn68306,90864149,91341663,477514,CNL
chr17,Bn68307,10357020,67846854,57489834,TNL
chr17,Bn68308,43035317,53170640,10135323,CN
chr17,Bn68309,65073017,97267203,32194186,CNL
chr17,Bn68310,29612106,71394217,41782111,RLK
chr17,Bn68311,88915593,96958734,8043141,TNL
chr17,Bn68312,55536386,68997107,13460721,CN
chr17,Bn68313,2429823,95994350,93564527,CN
chr17,Bn68314,49528639,61558277,12029638,TN
chr17,Bn68315,71609011,88028440,16419429,CNL
chr17,Bn68316,45873205,53702493,7829288,NBS
chr17,Bn68317,84401851,91707042,7305191,CNL
chr17,Bn68318,60538829,85488782,24949953,CNL
chr17,Bn68319,71254544,79640784,8386240,CNL
chr17,Bn68320,52303883,77193331,24889448,TN
chr17,Bn68321,36842962,53170051,16327089,RLP
chr17,Bn68322,29238246,49118669,19880423,TN
chr17,Bn68323,39802074,40077536,275462,CNL
chr17,Bn68324,44946555,81316109,36369554,NBS
chr17,Bn68325,93996745,94879883,883138,TNL
chr17,Bn68326,15709713,87321137,71611424,TN
chr17,Bn68327,8423912,97371957,88948045,CN
chr17,Bn68328,83339457,89760887,6421430,RLP
chr17,Bn68329,15363183,19116528,3753345,TNL
chr17,Bn68330,61452784,63302840,1850056,RLK
chr17,Bn68331,79108809,89496938,10388129,NBS
chr17,Bn68332,81435345,90010361,8575016,TNL
chr17,Bn68333,42520802,49023762,6502960,NBS
chr17,Bn68334,85874947,90447247,4572300,CN
chr17,Bn68335,6692980,54134194,47441214,NBS
chr17,Bn68336,28004225,89774882,61770657,TN
chr17,Bn68337,98414003,98436456,22453,TN
chr17,Bn68338,69474892,76194171,6719279,NBS
chr17,Bn68339,18002639,46848714,28846075,RLP
chr17,Bn68340,20539304,56141283,35601979,TNL
chr17,Bn68341,50319499,71589697,21270198,CNL
chr17,Bn68342,34697948,65829190,31131242,TN
chr17,Bn68343,8829224,42343620,33514396,CN
chr17,Bn68344,2088769,95284459,93195690,NBS
chr17,Bn68345,10960692,15255173,4294481,CN
chr17,Bn68346,95439489,97922171,2482682,CNL
chr17,Bn68347,96442990,98935026,2492036,NBS
chr17,Bn68348,80687920,83050758,2362838,NBS
chr17,Bn68349,35790369,85936778,50146409,TN
chr17,Bn68350,9868525,25196221,15327696,TN
chr17,Bn68351,76603445,78492533,1889088,CN
chr17,Bn68352,50190170,53118459,2928289,TNL
chr17,Bn68353,31166542,91476757,60310215,TN
chr17,Bn68354,45119359,49848301,4728942,CNL
chr17,Bn68355,60241083,66134010,5892927,NBS
chr17,Bn68356,15937285,48922027,32984742,TN
chr17,Bn68357,72554564,84075276,11520712,NBS
chr17,Bn68358,76552044,86125914,9573870,TN
chr17,Bn68359,84133889,90980970,6847081,RLK
chr17,Bn68360,50071628,68558600,18486972,NBS
chr17,Bn68361,73897780,79912116,6014336,RLP
chr17,Bn68362,66644499,71030019,4385520,RLP
chr17,Bn68363,77795537,79043101,1247564,CNL
chr17,Bn68364,43535116,97226500,53691384,TN
chr17,Bn68365,67743962,79125775,11381813,TN
chr17,Bn68366,44436742,93904059,49467317,RLK
chr17,Bn68367,26976100,78774924,51798824,NBS
chr17,Bn68368,54980022,75179707,20199685,TN
chr17,Bn68369,26345206,79303498,52958292,NBS
chr17,Bn68370,79922705,94201774,14279069,TN
chr17,Bn68371,23254291,90577198,67322907,NBS
chr17,Bn68372,61319419,86382055,25062636,TNL
chr17,Bn68373,24518722,39387955,14869233,RLK
chr17,Bn68374,49557251,69334739,19777488,RLP
chr17,Bn68375,79933616,99846138,19912522,TN
chr17,Bn68376,26825904,91998914,65173010,NBS
chr17,Bn68377,76271091,84241399,7970308,TNL
chr17,Bn68378,56081787,77995532,21913745,TNL
chr17,Bn68379,54999226,66032412,11033186,CN
chr17,Bn68380,89749710,95528505,5778795,CN
chr17,Bn68381,9000688,27171278,18170590,TN
chr17,Bn68382,24154728,62499855,38345127,CN
chr17,Bn68383,10446757,48981152,38534395,CN
chr17,Bn68384,70967060,72027548,1060488,CN
chr17,Bn68385,2146916,34553396,32406480,RLP
chr17,Bn68386,98821262,99204054,382792,NBS
chr17,Bn68387,55291135,57528015,2236880,CN
chr17,Bn68388,60058303,80787322,20729019,NBS
chr17,Bn68389,84459765,89576121,5116356,CN
chr17,Bn68390,22580959,42175506,19594547,CNL
chr17,Bn68391,34141673,60234158,26092485,TNL
chr17,Bn68392,60334969,66021563,5686594,RLK
chr17,Bn68393,66917665,71954995,5037330,CNL
chr17,Bn68394,41845819,48959473,7113654,CNL
chr17,Bn68395,24148425,65846567,41698142,TN
chr17,Bn68396,12597695,24115749,11518054,RLP
chr17,Bn68397,52768548,70545037,17776489,TN
chr17,Bn68398,20305136,36593385,16288249,NBS
chr17,Bn68399,2550506,72242763,69692257,CNL
chr17,Bn68400,52839979,64259194,11419215,TNL
chr17,Bn68401,90760462,97883279,7122817,CNL
chr17,Bn68402,22283226,59790623,37507397,RLP
chr17,Bn68403,99629402,99679047,49645,NBS
chr17,Bn68404,93855212,95656527,1801315,TN
chr17,Bn68405,75600173,80466914,4866741,TN
chr17,Bn68406,23434840,31348857,7914017,RLK
chr17,Bn68407,51536101,92329338,40793237,CNL
chr17,Bn68408,12923846,75568328,62644482,CN
chr17,Bn68409,21190256,36578542,15388286,RLP
chr17,Bn68410,48185794,75961027,27775233,TNL
chr17,Bn68411,57238575,83581558,26342983,CNL
chr17,Bn68412,59301750,75243317,15941567,CNL
chr17,Bn68413,77947462,78517806,570344,CN
chr17,Bn68414,59352188,78169950,18817762,TNL
chr17,Bn68415,15910627,49551739,33641112,RLK
chr17,Bn68416,97671050,99061028,1389978,NBS
chr17,Bn68417,24369897,61907942,37538045,CNL
chr17,Bn68418,55061668,86970102,31908434,RLK
chr17,Bn68419,41897698,64655187,22757489,TN
chr17,Bn68420,43605024,89669219,46064195,RLP
chr17,Bn68421,48436077,98216417,49780340,RLP
chr17,Bn68422,87562499,98620456,11057957,TNL
chr17,Bn68423,81042202,87770489,6728287,CN
chr17,Bn68424,56848508,80324006,23475498,TNL
chr17,Bn68425,85709016,89173554,3464538,CNL
chr17,Bn68426,97996802,99718814,1722012,CN
chr17,Bn68427,72076269,95661300,23585031,CN
chr17,Bn68428,89503574,90905793,1402219,RLK
chr17,Bn68429,10416071,87474131,77058060,CNL
chr17,Bn68430,78633445,96420958,17787513,CNL
chr17,Bn68431,50254946,95581447,45326501,CNL
chr17,Bn68432,26289108,56529142,30240034,CNL
chr17,Bn68433,92009327,92053406,44079,RLP
chr17,Bn68434,3562833,13503773,9940940,RLK
chr17,Bn68435,80899292,97902953,17003661,RLK
chr17,Bn68436,21663036,64274240,42611204,NBS
chr17,Bn68437,67989588,84565461,16575873,CN
chr17,Bn68438,67958339,83533114,15574775,NBS
chr17,Bn68439,15404510,63743901,48339391,TN
chr17,Bn68440,27016329,53157749,26141420,NBS
chr17,Bn68441,11401069,15607579,4206510,CN
chr17,Bn68442,98235508,99150752,915244,CN
chr17,Bn68443,49760241,90154545,40394304,RLP
chr17,Bn68444,29718946,81999839,52280893,CNL
chr17,Bn68445,21394645,44939274,23544629,CNL
chr17,Bn68446,18070446,55350421,37279975,NBS
chr17,Bn68447,69620511,94690923,25070412,TNL
chr17,Bn68448,50279725,87155030,36875305,TNL
chr17,Bn68449,87051935,92486009,5434074,CN
chr17,Bn68450,92634024,96327998,3693974,NBS
chr17,Bn68451,30055500,38071665,8016165,CN
chr17,Bn68452,50136166,54596874,4460708,NBS
chr17,Bn68453,36026327,48585163,12558836,TN
chr17,Bn68454,19221365,23299945,4078580,TN
chr17,Bn68455,61110897,63804582,2693685,RLP
chr17,Bn68456,43373207,71611645,28238438,CNL
chr17,Bn68457,11677692,37690868,26013176,CN
chr17,Bn68458,14072662,18417715,4345053,NBS
chr17,Bn68459,64850517,68839380,3988863,NBS
chr17,Bn68460,73996610,96626063,22629453,TNL
chr17,Bn68461,89674775,93010263,3335488,CN
chr17,Bn68462,44727934,89061102,44333168,RLK
chr17,Bn68463,97156857,97227539,70682,RLP
chr17,Bn68464,91969633,94798495,2828862,TN
chr17,Bn68465,99679326,99995423,316097,TN
chr17,Bn68466,28566044,82565034,53998990,CN
chr17,Bn68467,61265181,85823201,24558020,CNL
chr17,Bn68468,50210295,85668338,35458043,TN
chr17,Bn68469,71758209,92192908,20434699,RLK
chr17,Bn68470,14461914,97111861,82649947,RLK
chr17,Bn68471,28566325,48373641,19807316,TN
chr17,Bn68472,47605766,86630465,39024699,TNL
chr17,Bn68473,37325069,91420864,54095795,NBS
chr17,Bn68474,95045851,99949145,4903294,TN
chr17,Bn68475,55070479,76799504,21729025,TN
chr17,Bn68476,14188506,78369188,64180682,NBS
chr17,Bn68477,73642180,87818638,14176458,RLP
chr17,Bn68478,53298051,60552927,7254876,TNL
chr17,Bn68479,71956307,91280857,19324550,RLP
chr17,Bn68480,2715404,76476912,73761508,TN
chr17,Bn68481,75051201,84478218,9427017,CNL
chr17,Bn68482,20116183,53017464,32901281,TN
chr17,Bn68483,63397101,89769155,26372054,NBS
chr17,Bn68484,35877972,68301942,32423970,TN
chr17,Bn68485,93882851,94988479,1105628,CNL
chr17,Bn68486,82063111,95834978,13771867,RLP
chr17,Bn68487,29120828,36843995,7723167,CN
chr17,Bn68488,55882258,96946152,41063894,CN
chr17,Bn68489,96160957,97793638,1632681,TN
chr17,Bn68490,6570197,11642221,5072024,RLK
chr17,Bn68491,25743747,97780152,72036405,RLP
chr17,Bn68492,66269175,67618356,1349181,CN
chr17,Bn68493,8571129,9514789,943660,TNL
chr17,Bn68494,70651977,94712259,24060282,TNL
chr17,Bn68495,71879852,86437060,14557208,RLP
chr17,Bn68496,29969896,40813493,10843597,NBS
chr17,Bn68497,90888234,95199896,4311662,RLK
chr17,Bn68498,2619163,22537764,19918601,TNL
chr17,Bn68499,48611076,65558073,16946997,TNL
chr17,Bn68500,66568466,91326792,24758326,TN
chr17,Bn68501,28967071,44573763,15606692,RLK
chr17,Bn68502,85694976,89419326,3724350,CNL
chr17,Bn68503,18774770,44892540,26117770,NBS
chr17,Bn68504,35755104,37010493,1255389,TNL
chr17,Bn68505,48349549,71035691,22686142,TN
chr17,Bn68506,46304538,68800174,22495636,RLK
chr17,Bn68507,40931916,56919039,15987123,CN
chr17,Bn68508,7796042,72481751,64685709,RLK
chr17,Bn68509,38408493,84989718,46581225,RLP
chr17,Bn68510,3955737,6140427,2184690,CNL
chr17,Bn68511,69581672,78061826,8480154,CN
chr17,Bn68512,19378158,28298266,8920108,NBS
chr17,Bn68513,37443717,92170585,54726868,RLP
chr17,Bn68514,58477606,80893393,22415787,TNL
chr17,Bn68515,60603509,64088597,3485088,CN
chr17,Bn68516,85132252,96377570,11245318,CN
chr17,Bn68517,44549535,45853023,1303488,CNL
chr17,Bn68518,9977321,69258891,59281570,RLP
chr17,Bn68519,3686404,67517282,63830878,RLK
chr17,Bn68520,5474343,72787172,67312829,TN
chr17,Bn68521,45281586,89754842,44473256,CN
chr17,Bn68522,93815617,94219052,403435,RLK
chr17,Bn68523,81244421,88598839,7354418,NBS
chr17,Bn68524,41337738,44629956,3292218,RLK
chr17,Bn68525,41680375,89664910,47984535,NBS
chr17,Bn68526,26375318,88818706,62443388,TNL
chr17,Bn68527,53080068,91737637,38657569,CN
chr17,Bn68528,7174594,98863709,91689115,NBS
chr17,Bn68529,15802509,36283265,20480756,CN
chr17,Bn68530,1416837,95433063,94016226,CN
chr17,Bn68531,37065704,43334595,6268891,TN
chr17,Bn68532,10854607,29605310,18750703,TN
chr17,Bn68533,58425899,62488572,4062673,RLP
chr17,Bn68534,90189043,90371743,182700,TNL
chr17,Bn68535,63722492,78241541,14519049,CN
chr17,Bn68536,3065008,11649850,8584842,RLP
chr17,Bn68537,92598405,96673855,4075450,TN
chr17,Bn68538,87358739,89661566,2302827,TNL
chr17,Bn68539,36927810,44096044,7168234,TN
chr17,Bn68540,4405851,85459773,81053922,CNL
chr17,Bn68541,7562752,31734775,24172023,RLK
chr17,Bn68542,90627148,97771459,7144311,RLP
chr17,Bn68543,41662035,89344726,47682691,RLP
chr17,Bn68544,69157271,86218683,17061412,TNL
chr17,Bn68545,55389085,99730739,44341654,CNL
chr17,Bn68546,48922090,54434721,5512631,RLK
chr17,Bn68547,15123675,83059667,67935992,CNL
chr17,Bn68548,14037650,43649036,29611386,NBS
chr17,Bn68549,14022914,52806807,38783893,TN
chr17,Bn68550,25766736,56257929,30491193,RLK
chr17,Bn68551,91404487,99188798,7784311,TN
chr17,Bn68552,64679360,70860650,6181290,NBS
chr17,Bn68553,59945632,98300669,38355037,CNL
chr17,Bn68554,67935473,69044177,1108704,TN
chr17,Bn68555,10706072,74398837,63692765,TNL
chr17,Bn68556,71138221,98206907,27068686,TN
chr17,Bn68557,48426016,75796813,27370797,NBS
chr17,Bn68558,11900407,67643769,55743362,RLP
chr17,Bn68559,16989530,36422160,19432630,CN
chr17,Bn68560,86595861,90202572,3606711,TN
chr17,Bn68561,49090704,86521294,37430590,RLP
chr17,Bn68562,80432253,89740242,9307989,RLP
chr17,Bn68563,72156132,81576820,9420688,CN
chr17,Bn68564,63026546,92375160,29348614,CNL
chr17,Bn68565,44034199,78114622,34080423,TN
chr17,Bn68566,22860492,34432654,11572162,CNL
chr17,Bn68567,34791859,38603963,3812104,RLP
chr17,Bn68568,97410888,98986181,1575293,NBS
chr17,Bn68569,40624550,77806908,37182358,TNL
chr17,Bn68570,82197349,90651449,8454100,CN
chr17,Bn68571,16991396,62106817,45115421,RLK
chr17,Bn68572,48705926,92219220,43513294,NBS
chr17,Bn68573,92207830,94066698,1858868,CNL
chr17,Bn68574,65377806,87765667,22387861,CN
chr17,Bn68575,15976907,58682534,42705627,TNL
chr17,Bn68576,72985476,76355968,3370492,CNL
chr17,Bn68577,17212512,54856792,37644280,TNL
chr17,Bn68578,10371251,96461140,86089889,NBS
chr17,Bn68579,97594254,99348288,1754034,NBS
chr17,Bn68580,76184434,97581421,21396987,RLP
chr17,Bn68581,80368865,92230335,11861470,TN
chr17,Bn68582,25473292,45065182,19591890,RLP
chr17,Bn68583,3638621,34355898,30717277,RLK
chr17,Bn68584,13967589,23409922,9442333,RLK
chr17,Bn68585,23269073,29964242,6695169,CN
chr17,Bn68586,32516669,75047852,42531183,TN
chr17,Bn68587,14125999,85501906,71375907,RLP
chr17,Bn68588,44773508,73740197,28966689,TNL
chr17,Bn68589,64470919,84590323,20119404,RLK
chr17,Bn68590,95729544,99482930,3753386,CNL
chr17,Bn68591,16101116,98937416,82836300,CNL
chr17,Bn68592,85208580,90233203,5024623,CNL
chr17,Bn68593,89818701,91237376,1418675,TNL
chr17,Bn68594,60641037,97316968,36675931,RLK
chr17,Bn68595,46528878,53740493,7211615,RLP
chr17,Bn68596,7833537,96014903,88181366,RLK
chr17,Bn68597,4704928,81784604,77079676,RLK
chr17,Bn68598,53315408,68751393,15435985,NBS
chr17,Bn68599,94177770,94590736,412966,RLP
chr17,Bn68600,98982759,99414389,431630,CNL
chr17,Bn68601,51518076,68028020,16509944,TN
chr17,Bn68602,96732942,98435944,1703002,NBS
chr17,Bn68603,40181105,92180560,51999455,TN
chr17,Bn68604,80701133,88485472,7784339,CN
chr17,Bn68605,1210049,53559273,52349224,TN
chr17,Bn68606,23565327,45427174,21861847,TNL
chr17,Bn68607,87061480,87694923,633443,RLK
chr17,Bn68608,32316138,52841760,20525622,NBS
chr17,Bn68609,59938904,85526961,25588057,CN
chr17,Bn68610,5301833,94049671,88747838,RLP
chr17,Bn68611,66583797,82683430,16099633,TNL
chr17,Bn68612,47007924,94458039,47450115,RLP
chr17,Bn68613,28403627,89133661,60730034,CNL
chr17,Bn68614,42814626,50966206,8151580,CNL
chr17,Bn68615,41795224,62902975,21107751,NBS
chr17,Bn68616,77380720,97948535,20567815,CNL
chr17,Bn68617,58604471,82703292,24098821,RLK
chr17,Bn68618,17039552,40706750,23667198,CN
chr17,Bn68619,24370262,32254988,7884726,NBS
chr17,Bn68620,83630711,99427914,15797203,NBS
chr17,Bn68621,33665834,41520389,7854555,TN
chr17,Bn68622,81760346,91463740,9703394,TNL
chr17,Bn68623,88270506,93801892,5531386,CN
chr17,Bn68624,20688985,84640392,63951407,CN
chr17,Bn68625,79294810,90188621,10893811,NBS
chr17,Bn68626,90913468,98521741,7608273,TN
chr17,Bn68627,33101887,69088146,35986259,RLK
chr17,Bn68628,39639821,67903329,28263508,RLK
chr17,Bn68629,22567700,93281910,70714210,CN
chr17,Bn68630,50158275,68671205,18512930,RLP
chr17,Bn68631,60042531,90673672,30631141,NBS
chr17,Bn68632,60968863,83717695,22748832,NBS
chr17,Bn68633,5968335,32793646,26825311,NBS
chr17,Bn68634,25564841,28540540,2975699,CN
chr17,Bn68635,33495923,67846422,34350499,TNL
chr17,Bn68636,18184322,94102045,75917723,TNL
chr17,Bn68637,23628167,73641902,50013735,RLK
chr17,Bn68638,60059711,93511754,33452043,TN
chr17,Bn68639,34086972,93417086,59330114,NBS
chr17,Bn68640,20193239,78823124,58629885,CNL
chr17,Bn68641,39925378,69179186,29253808,TN
chr17,Bn68642,40493226,96512999,56019773,TN
chr17,Bn68643,95065726,98868687,3802961,CNL
chr17,Bn68644,54820829,95121722,40300893,CNL
chr17,Bn68645,86927761,95364479,8436718,NBS
chr17,Bn68646,8654194,37922502,29268308,TN
chr17,Bn68647,42840879,52052868,9211989,CN
chr17,Bn68648,18209860,43555424,25345564,RLK
chr17,Bn68649,33711553,49150679,15439126,RLP
chr17,Bn68650,40762094,98018837,57256743,RLP
chr17,Bn68651,92987474,98431496,5444022,TN
chr17,Bn68652,97917015,98701507,784492,CN
chr17,Bn68653,40254893,69951902,29697009,RLK
chr17,Bn68654,97616679,99215192,1598513,TNL
chr17,Bn68655,54296330,99959599,45663269,CNL
chr17,Bn68656,90315434,91874719,1559285,CN
chr17,Bn68657,15004475,35039772,20035297,RLP
chr17,Bn68658,75892039,79077794,3185755,NBS
chr17,Bn68659,75912766,85551505,9638739,CNL
chr17,Bn68660,58948484,74253523,15305039,NBS
chr17,Bn68661,56759578,94167398,37407820,CNL
chr17,Bn68662,19155708,22081478,2925770,TNL
chr17,Bn68663,79865294,90290229,10424935,TN
chr17,Bn68664,85856499,93644226,7787727,CN
chr17,Bn68665,45318384,87543467,42225083,RLP
chr17,Bn68666,32265267,54855720,22590453,CNL
chr17,Bn68667,76164809,92200456,16035647,CN
chr17,Bn68668,50786942,98839675,48052733,CN
chr17,Bn68669,61562591,90965983,29403392,CN
chr17,Bn68670,99940724,99959456,18732,TN
chr17,Bn68671,22438471,66382653,43944182,CN
chr17,Bn68672,56619731,78031379,21411648,TNL
chr17,Bn68673,31243325,66509954,35266629,TNL
chr17,Bn68674,97984087,99597615,1613528,RLK
chr17,Bn68675,28147786,90471781,62323995,NBS
chr17,Bn68676,86846842,94426612,7579770,NBS
chr17,Bn68677,4546031,75054209,70508178,CN
chr17,Bn68678,86456141,99368257,12912116,CNL
chr17,Bn68679,5702491,83503278,77800787,CNL
chr17,Bn68680,75475368,81190018,5714650,RLP
chr17,Bn68681,19278918,21751038,2472120,RLK
chr17,Bn68682,80563833,82696411,2132578,RLP
chr17,Bn68683,31199257,95925971,64726714,RLK
chr17,Bn68684,17827983,95207795,77379812,TNL
chr17,Bn68685,94377937,99442622,5064685,NBS
chr17,Bn68686,75195998,94924243,19728245,RLK
chr17,Bn68687,70373063,80368124,9995061,RLP
chr17,Bn68688,65791390,92607000,26815610,CN
chr17,Bn68689,37316344,90859152,53542808,CN
chr17,Bn68690,39223109,53044352,13821243,CNL
chr17,Bn68691,94994290,99456927,4462637,RLP
chr17,Bn68692,33684261,50566377,16882116,NBS
chr17,Bn68693,68933127,97192814,28259687,NBS
chr17,Bn68694,27225545,41902249,14676704,TNL
chr17,Bn68695,84841192,90482132,5640940,TN
chr17,Bn68696,19692197,59208602,39516405,CN
chr17,Bn68697,15311813,97384746,82072933,CN
chr17,Bn68698,23752421,87640288,63887867,TNL
chr17,Bn68699,26917028,67069964,40152936,RLP
chr17,Bn68700,1777668,88043108,86265440,TN
chr17,Bn68701,93672265,98459343,4787078,CNL
chr17,Bn68702,76901515,81547928,4646413,CNL
chr17,Bn68703,14612109,74771136,60159027,CN
chr17,Bn68704,12230943,19213955,6983012,CN
chr17,Bn68705,68833839,93784637,24950798,RLK
chr17,Bn68706,20343665,52998266,32654601,NBS
chr17,Bn68707,94788856,99950616,5161760,RLK
chr17,Bn68708,43661660,54956458,11294798,TNL
chr17,Bn68709,91542102,98886314,7344212,RLP
chr17,Bn68710,85421190,99084282,13663092,RLP
chr17,Bn68711,81738949,86468707,4729758,TN
chr17,Bn68712,44703628,90726312,46022684,TNL
chr17,Bn68713,35151806,93790934,58639128,RLK
chr17,Bn68714,64951703,69753182,4801479,CN
chr17,Bn68715,53848471,84276850,30428379,CN
chr17,Bn68716,9133831,69139087,60005256,NBS
chr17,Bn68717,68388088,73018128,4630040,CN
chr17,Bn68718,47774211,62569315,14795104,NBS
chr17,Bn68719,16513815,97774834,81261019,CNL
chr17,Bn68720,57870547,76243751,18373204,RLP
chr17,Bn68721,20714720,92683122,71968402,CN
chr17,Bn68722,9599101,82785587,73186486,CNL
chr17,Bn68723,85124252,89819355,4695103,CN
chr17,Bn68724,10918615,15982481,5063866,TN
chr17,Bn68725,33832208,91802251,57970043,RLP
chr17,Bn68726,70546350,95153742,24607392,TNL
chr17,Bn68727,93139234,93635543,496309,CN
chr17,Bn68728,62257163,81184805,18927642,RLP
chr17,Bn68729,97627810,97742651,114841,TNL
chr17,Bn68730,18663011,55761461,37098450,RLP
chr17,Bn68731,87202283,93392721,6190438,RLP
chr17,Bn68732,52275278,62194232,9918954,NBS
chr17,Bn68733,95133811,99246326,4112515,TN
chr17,Bn68734,71838449,87907134,16068685,NBS
chr17,Bn68735,89937019,93427892,3490873,CN
chr17,Bn68736,95464284,99584265,4119981,CN
chr17,Bn68737,35920936,41028729,5107793,RLP
chr17,Bn68738,71492901,76881620,5388719,NBS
chr17,Bn68739,3696004,38357213,34661209,NBS
chr17,Bn68740,8026499,81747553,73721054,RLK
chr17,Bn68741,94445529,96695702,2250173,RLK
chr17,Bn68742,44685449,69849564,25164115,RLK
chr17,Bn68743,19162999,44073774,24910775,CNL
chr17,Bn68744,44105242,95734825,51629583,RLK
chr17,Bn68745,54231204,98155836,43924632,RLP
chr17,Bn68746,43099430,90822739,47723309,TN
chr17,Bn68747,55495037,75684531,20189494,CN
chr17,Bn68748,11092739,58516326,47423587,RLK
chr17,Bn68749,76173378,92026998,15853620,CNL
chr17,Bn68750,5742981,58583586,52840605,TN
chr17,Bn68751,65385419,65661697,276278,CN
chr17,Bn68752,19782326,50089134,30306808,TNL
chr17,Bn68753,39313097,46377232,7064135,TNL
chr17,Bn68754,48372959,63935075,15562116,CN
chr17,Bn68755,7995249,93209234,85213985,NBS
chr17,Bn68756,93556955,93871707,314752,CN
chr17,Bn68757,96734542,97145678,411136,CN
chr17,Bn68758,31244559,46847651,15603092,CNL
chr17,Bn68759,93597559,95044876,1447317,CNL
chr17,Bn68760,92179964,93477755,1297791,NBS
chr17,Bn68761,22713931,74604201,51890270,RLP
chr17,Bn68762,77862782,85448431,7585649,CNL
chr17,Bn68763,66810561,87611590,20801029,RLK
chr17,Bn68764,9682377,78544721,68862344,TN
chr17,Bn68765,17247675,97408390,80160715,CN
chr17,Bn68766,99447462,99624476,177014,RLP
chr17,Bn68767,73785981,90971383,17185402,RLP
chr17,Bn68768,6558369,57415567,50857198,NBS
chr17,Bn68769,66191743,81070805,14879062,RLK
chr17,Bn68770,93533083,95286319,1753236,RLP
chr17,Bn68771,37546295,74367175,36820880,CNL
chr17,Bn68772,23609932,39575755,15965823,CN
chr17,Bn68773,64722862,80535972,15813110,RLK
chr17,Bn68774,62379845,85143388,22763543,RLP
chr17,Bn68775,75133384,87992570,12859186,RLK
chr17,Bn68776,97499821,99003003,1503182,CN
chr17,Bn68777,22928725,88106819,65178094,RLK
chr17,Bn68778,60381214,85390370,25009156,CN
chr17,Bn68779,16503428,19497430,2994002,CNL
chr17,Bn68780,4404244,46112934,41708690,RLK
chr17,Bn68781,31312452,80122902,48810450,NBS
chr17,Bn68782,18166228,80094961,61928733,CNL
chr17,Bn68783,80490444,91741438,11250994,TNL
chr17,Bn68784,65025216,96673075,31647859,TNL
chr17,Bn68785,78346510,91735380,13388870,NBS
chr17,Bn68786,36323058,68107352,31784294,TNL
chr17,Bn68787,79660232,86404195,6743963,RLK
chr17,Bn68788,81810520,86063474,4252954,RLP
chr17,Bn68789,87443648,87582144,138496,CNL
chr17,Bn68790,58231567,68339622,10108055,TNL
chr17,Bn68791,70359504,87219665,16860161,CN
chr17,Bn68792,57041608,88971413,31929805,NBS
chr17,Bn68793,41587486,66745448,25157962,RLK
chr17,Bn68794,84810304,97968144,13157840,TNL
chr17,Bn68795,55195989,72887469,17691480,RLK
chr17,Bn68796,22785131,73814931,51029800,RLK
chr17,Bn68797,26978048,27917440,939392,RLP
chr17,Bn68798,56322251,57678331,1356080,CN
chr17,Bn68799,80251074,83063433,2812359,CNL
chr17,Bn68800,28299570,70148978,41849408,NBS
chr17,Bn68801,23807153,26534466,2727313,TNL
chr17,Bn68802,37157691,41646553,4488862,TNL
chr17,Bn68803,90183551,99318027,9134476,RLP
chr17,Bn68804,41062330,81294876,40232546,RLP
chr17,Bn68805,43128231,65181444,22053213,TN
chr17,Bn68806,15709786,41348489,25638703,TNL
chr17,Bn68807,48103071,82760564,34657493,TNL
chr17,Bn68808,9083568,18711850,9628282,TN
chr17,Bn68809,8524610,57330031,48805421,RLK
chr17,Bn68810,81897013,97081092,15184079,TN
chr17,Bn68811,39438285,59542132,20103847,CN
chr17,Bn68812,40478875,85325935,44847060,TN
chr17,Bn68813,82044309,89912550,7868241,RLP
chr17,Bn68814,95373297,95686303,313006,NBS
chr17,Bn68815,91228488,95146450,3917962,CNL
chr17,Bn68816,57870594,84379231,26508637,TNL
chr17,Bn68817,95126391,96942101,1815710,CN
chr17,Bn68818,72664309,96753800,24089491,CN
chr17,Bn68819,14756751,85325988,70569237,RLP
chr17,Bn68820,61361270,79298126,17936856,RLK
chr17,Bn68821,1663936,75017125,73353189,TNL
chr17,Bn68822,24059875,69026189,44966314,TNL
chr17,Bn68823,48024647,73240058,25215411,TNL
chr17,Bn68824,26300893,36556230,10255337,CN
chr17,Bn68825,35757999,35973427,215428,TNL
chr17,Bn68826,50531763,56805561,6273798,TNL
chr17,Bn68827,8588736,10883216,2294480,TN
chr17,Bn68828,93011843,93441371,429528,RLP
chr17,Bn68829,79193135,87259663,8066528,TN
chr17,Bn68830,81571082,95993666,14422584,CNL
chr17,Bn68831,60371898,82106704,21734806,CN
chr17,Bn68832,13294420,70243003,56948583,RLK
chr17,Bn68833,14952552,65476405,50523853,TN
chr17,Bn68834,19545980,49877104,30331124,CN
chr17,Bn68835,52056224,55831766,3775542,CN
chr17,Bn68836,64257463,85650164,21392701,TN
chr17,Bn68837,96540610,99408471,2867861,NBS
chr17,Bn68838,91131411,92677412,1546001,RLK
chr17,Bn68839,71563379,73876301,2312922,CN
chr17,Bn68840,81590902,91554739,9963837,TN
chr17,Bn68841,68500438,68512806,12368,RLK
chr17,Bn68842,90835465,96407220,5571755,CNL
chr17,Bn68843,40875446,71954764,31079318,TNL
chr17,Bn68844,2222739,80737735,78514996,CN
chr17,Bn68845,97266214,98214887,948673,TNL
chr17,Bn68846,69629187,73224219,3595032,TNL
chr17,Bn68847,59050771,61364793,2314022,RLK
chr17,Bn68848,43584146,66787413,23203267,CNL
chr17,Bn68849,70580184,72326600,1746416,RLP
chr17,Bn68850,59475797,71233087,11757290,TNL
chr17,Bn68851,69108186,69900638,792452,CN
chr17,Bn68852,17413899,96323435,78909536,CN
chr17,Bn68853,10017872,85485984,75468112,TNL
chr17,Bn68854,65539045,70644046,5105001,RLP
chr17,Bn68855,90849629,99555243,8705614,CN
chr17,Bn68856,11334864,74072492,62737628,CNL
chr17,Bn68857,12446027,73267123,60821096,RLP
chr17,Bn68858,28806330,40951604,12145274,TNL
chr17,Bn68859,97936496,99900274,1963778,CN
chr17,Bn68860,39117395,66016832,26899437,TNL
chr17,Bn68861,48941543,92510645,43569102,CN
chr17,Bn68862,87726321,99246487,11520166,NBS
chr17,Bn68863,40731596,63446597,22715001,NBS
chr17,Bn68864,23491711,77371178,53879467,CNL
chr17,Bn68865,30219923,36420984,6201061,RLK
chr17,Bn68866,77680488,86228395,8547907,TN
chr17,Bn68867,60654908,73187980,12533072,RLP
chr17,Bn68868,64857379,71562699,6705320,RLK
chr17,Bn68869,2429334,61268071,58838737,NBS
chr17,Bn68870,12917319,73905374,60988055,RLK
chr17,Bn68871,76596239,84248400,7652161,CNL
chr17,Bn68872,83127788,94683621,11555833,CNL
chr17,Bn68873,29121474,45718694,16597220,TN
chr17,Bn68874,15433807,98185317,82751510,RLK
chr17,Bn68875,99158698,99471794,313096,RLP
chr17,Bn68876,42638760,79425476,36786716,NBS
chr17,Bn68877,90347277,94377133,4029856,CN
chr17,Bn68878,85641003,90077348,4436345,CN
chr17,Bn68879,81533693,99497339,17963646,TN
chr17,Bn68880,58272351,80163281,21890930,TNL
chr17,Bn68881,50149575,85092452,34942877,TNL
chr17,Bn68882,57756378,83921532,26165154,RLP
chr17,Bn68883,66233044,67156502,923458,CN
chr17,Bn68884,97331998,98360915,1028917,NBS
chr17,Bn68885,80565924,93432362,12866438,RLK
chr17,Bn68886,15400505,54557457,39156952,CNL
chr17,Bn68887,45436802,81520408,36083606,RLP
chr17,Bn68888,47522798,64912291,17389493,RLK
chr17,Bn68889,97573750,98174962,601212,RLK
chr17,Bn68890,92648779,99196774,6547995,RLK
chr17,Bn68891,37578269,99198733,61620464,CNL
chr17,Bn68892,4367923,56142313,51774390,RLP
chr17,Bn68893,50151322,86285223,36133901,RLP
chr17,Bn68894,6627183,13788368,7161185,CNL
chr17,Bn68895,36687478,46328940,9641462,CNL
chr17,Bn68896,54423560,75301366,20877806,RLK
chr17,Bn68897,53368180,66898533,13530353,TNL
chr17,Bn68898,18898764,33219149,14320385,TNL
chr17,Bn68899,47901367,72523006,24621639,NBS
chr17,Bn68900,97368063,99561211,2193148,CNL
chr17,Bn68901,96227543,99775821,3548278,NBS
chr17,Bn68902,86518990,92528304,6009314,CNL
chr17,Bn68903,64198501,89457175,25258674,RLK
chr17,Bn68904,71211228,84451216,13239988,TNL
chr17,Bn68905,44411775,56609579,12197804,CNL
chr17,Bn68906,41559224,42806127,1246903,RLK
chr17,Bn68907,12063236,20841292,8778056,RLP
chr17,Bn68908,81219001,87101392,5882391,CN
chr17,Bn68909,24268469,49695480,25427011,TN
chr17,Bn68910,32925349,72201101,39275752,TNL
chr17,Bn68911,68870449,79959093,11088644,TNL
chr17,Bn68912,6239271,13377719,7138448,CNL
chr17,Bn68913,10634675,73993817,63359142,NBS
chr17,Bn68914,58279752,73372398,15092646,TN
chr17,Bn68915,81376957,89276142,7899185,RLP
chr17,Bn68916,90292090,95260992,4968902,RLK
chr17,Bn68917,17339565,67685028,50345463,TN
chr17,Bn68918,79645371,83681989,4036618,NBS
chr17,Bn68919,54596375,99609306,45012931,RLP
chr17,Bn68920,54932238,57342293,2410055,TNL
chr17,Bn68921,89875200,99293644,9418444,NBS
chr17,Bn68922,80641438,87431223,6789785,RLK
chr17,Bn68923,20162521,81139459,60976938,RLK
chr17,Bn68924,1161898,96746205,95584307,RLP
chr17,Bn68925,3379467,71560478,68181011,TN
chr17,Bn68926,74117327,79713746,5596419,RLP
chr17,Bn68927,79346169,83169739,3823570,TNL
chr17,Bn68928,77397171,95111827,17714656,TN
chr17,Bn68929,37880842,81972614,44091772,CNL
chr17,Bn68930,40361233,40699803,338570,TN
chr17,Bn68931,45975808,70634633,24658825,CNL
chr17,Bn68932,1470575,4715995,3245420,CN
chr17,Bn68933,99134146,99529012,394866,NBS
chr17,Bn68934,35502519,56010822,20508303,TN
chr17,Bn68935,29959405,48021317,18061912,RLP
chr17,Bn68936,46402890,82806147,36403257,RLK
chr17,Bn68937,16929309,50970330,34041021,TN
chr17,Bn68938,19040016,24219017,5179001,CNL
chr17,Bn68939,74805743,92767107,17961364,TNL
chr17,Bn68940,65486428,73440580,7954152,TNL
chr17,Bn68941,35496072,68451299,32955227,NBS
chr17,Bn68942,88077200,96421837,8344637,RLK
chr17,Bn68943,94176057,95004696,828639,TNL
chr17,Bn68944,97557263,97916537,359274,CNL
chr17,Bn68945,69610399,91733436,22123037,RLP
chr17,Bn68946,18605391,32305997,13700606,CN
chr17,Bn68947,54529468,81930881,27401413,CN
chr17,Bn68948,96205468,97644326,1438858,CN
chr17,Bn68949,89084486,95600250,6515764,TNL
chr17,Bn68950,97539377,98833515,1294138,RLK
chr17,Bn68951,9891793,74915270,65023477,CN
chr17,Bn68952,74844801,98000542,23155741,NBS
chr17,Bn68953,33055365,78277882,45222517,CNL
chr17,Bn68954,19887000,40871709,20984709,TNL
chr17,Bn68955,3720823,74265194,70544371,RLP
chr17,Bn68956,10424217,57962522,47538305,NBS
chr17,Bn68957,1043288,54587278,53543990,TNL
chr17,Bn68958,89398803,95174091,5775288,CN
chr17,Bn68959,58090643,76723726,18633083,CNL
chr17,Bn68960,78600342,81543024,2942682,TNL
chr17,Bn68961,60840116,92300570,31460454,RLP
chr17,Bn68962,66357602,82787033,16429431,RLK
chr17,Bn68963,50607228,53499277,2892049,TNL
chr17,Bn68964,91050833,95919069,4868236,TNL
chr17,Bn68965,45102431,89228810,44126379,TN
chr17,Bn68966,97709609,97748448,38839,CNL
chr17,Bn68967,38698148,49532622,10834474,CNL
chr17,Bn68968,49922593,89613553,39690960,RLP
chr17,Bn68969,96860113,98552163,1692050,NBS
chr17,Bn68970,73611146,97224595,23613449,CN
chr17,Bn68971,52374229,66737070,14362841,CNL
chr17,Bn68972,44816934,48023316,3206382,RLK
chr17,Bn68973,80664267,87379470,6715203,TNL
chr17,Bn68974,57220114,98402663,41182549,NBS
chr17,Bn68975,86291580,88794007,2502427,RLP
chr17,Bn68976,10240640,28962666,18722026,TN
chr17,Bn68977,20575096,53089619,32514523,CNL
chr17,Bn68978,70757089,82617754,11860665,CN
chr17,Bn68979,29635620,74438019,44802399,CN
chr17,Bn68980,73923570,99327272,25403702,TNL
chr17,Bn68981,50798786,61951199,11152413,NBS
chr17,Bn68982,59134899,63706840,4571941,NBS
chr17,Bn68983,83378602,84053869,675267,CNL
chr17,Bn68984,72692311,76729137,4036826,CN
chr17,Bn68985,12620872,91803894,79183022,CNL
chr17,Bn68986,99675717,99793382,117665,TN
chr17,Bn68987,82772524,87455347,4682823,NBS
chr17,Bn68988,30288583,40201706,9913123,RLP
chr17,Bn68989,22147481,81906953,59759472,CN
chr17,Bn68990,53794123,89913184,36119061,CNL
chr17,Bn68991,67975848,94723927,26748079,TNL
chr17,Bn68992,18082682,70138213,52055531,RLK
chr17,Bn68993,32275238,53361540,21086302,RLP
chr17,Bn68994,7820488,17847741,10027253,RLK
chr17,Bn68995,9452807,58065251,48612444,RLK
chr17,Bn68996,18548266,44585554,26037288,TNL
chr17,Bn68997,63273550,69889802,6616252,RLK
chr17,Bn68998,65575593,78085955,12510362,NBS
chr17,Bn68999,13705534,51405362,37699828,RLP
chr17,Bn69000,63675648,84639157,20963509,RLK
chr17,Bn69001,23599964,41363315,17763351,CNL
chr17,Bn69002,75257119,84229331,8972212,CN
chr17,Bn69003,44271754,48338423,4066669,RLK
chr17,Bn69004,75045941,98259975,23214034,TNL
chr17,Bn69005,20406509,89380257,68973748,TNL
chr17,Bn69006,1664926,58276124,56611198,RLK
chr17,Bn69007,6227922,88028413,81800491,RLK
chr17,Bn69008,71892614,89472829,17580215,TN
chr17,Bn69009,28339597,31011017,2671420,RLP
chr17,Bn69010,73848166,86277426,12429260,RLP
chr17,Bn69011,94637830,99645303,5007473,TNL
chr17,Bn69012,41923263,85090958,43167695,TNL
chr17,Bn69013,27523070,42019242,14496172,TNL
chr17,Bn69014,47259757,73674979,26415222,RLP
chr17,Bn69015,96545753,96667114,121361,RLP
chr17,Bn69016,70267077,88196923,17929846,TNL
chr17,Bn69017,28418003,31657423,3239420,NBS
chr17,Bn69018,37456437,40147078,2690641,TNL
chr17,Bn69019,98898886,99195752,296866,TNL
chr17,Bn69020,18171078,60097864,41926786,NBS
chr17,Bn69021,15423932,79067696,63643764,TNL
chr17,Bn69022,42112165,79923450,37811285,RLP
chr17,Bn69023,62021868,82176244,20154376,CN
chr17,Bn69024,63598839,76733540,13134701,RLK
chr17,Bn69025,10486717,74059193,63572476,RLK
chr17,Bn69026,17328781,58587530,41258749,TN
chr17,Bn69027,49753639,75996327,26242688,CNL
chr17,Bn69028,79539491,89916228,10376737,NBS
chr17,Bn69029,48351150,97828489,49477339,TN
chr17,Bn69030,73873654,81080543,7206889,CNL
chr17,Bn69031,49371465,75169879,25798414,CN
chr17,Bn69032,58194658,83642538,25447880,RLP
chr17,Bn69033,12231665,31718434,19486769,NBS
chr17,Bn69034,93284184,96360091,3075907,TNL
chr17,Bn69035,67517058,70463416,2946358,RLP
chr17,Bn69036,30840191,48835933,17995742,RLP
chr17,Bn69037,46683884,94526558,47842674,TN
chr17,Bn69038,41378479,54231471,12852992,RLP
chr17,Bn69039,95444357,96722143,1277786,TNL
chr17,Bn69040,20874957,58660481,37785524,NBS
chr17,Bn69041,82659917,96900889,14240972,CNL
chr17,Bn69042,94345500,98082751,3737251,TNL
chr17,Bn69043,41726381,50394191,8667810,CNL
chr17,Bn69044,43489207,81824409,38335202,CN
chr17,Bn69045,76811806,99336099,22524293,CNL
chr17,Bn69046,66822802,86000143,19177341,TNL
chr17,Bn69047,70565365,96596542,26031177,NBS
chr17,Bn69048,95768206,98568385,2800179,TN
chr17,Bn69049,82114332,98165107,16050775,RLK
chr17,Bn69050,20323939,39342328,19018389,RLK
chr17,Bn69051,1497271,9954439,8457168,CNL
chr17,Bn69052,18642857,89815751,71172894,RLK
chr17,Bn69053,72945367,77566176,4620809,TN
chr17,Bn69054,28421161,72836335,44415174,RLK
chr17,Bn69055,93724087,98159347,4435260,RLP
chr17,Bn69056,58103771,96709159,38605388,TN
chr17,Bn69057,79277739,83525793,4248054,RLK
chr17,Bn69058,6247518,26092948,19845430,TN
chr17,Bn69059,61782552,95307210,33524658,CN
chr17,Bn69060,40841767,73155569,32313802,RLP
chr17,Bn69061,93961506,94758560,797054,TN
chr17,Bn69062,87743764,98532603,10788839,RLK
chr17,Bn69063,5154329,51421412,46267083,CN
chr17,Bn69064,4188859,9463026,5274167,CNL
chr17,Bn69065,47944251,55404618,7460367,CNL
chr17,Bn69066,70173296,83573283,13399987,RLP
chr17,Bn69067,91593970,98855679,7261709,TNL
chr17,Bn69068,8535466,70439774,61904308,TN
chr17,Bn69069,82000237,91718216,9717979,RLP
chr17,Bn69070,31034880,49108619,18073739,CN
chr17,Bn69071,18872139,19414316,542177,CNL
chr17,Bn69072,84460924,89388619,4927695,RLP
chr17,Bn69073,31733030,87959721,56226691,TN
chr17,Bn69074,76550765,91541159,14990394,TNL
chr17,Bn69075,37658674,70965671,33306997,TNL
chr17,Bn69076,73437096,73672663,235567,TNL
chr17,Bn69077,40932484,61759699,20827215,CNL
chr17,Bn69078,52944456,86265972,33321516,RLP
chr17,Bn69079,68482058,78068252,9586194,TN
chr17,Bn69080,22535969,90997285,68461316,RLP
chr17,Bn69081,44210452,50888002,6677550,RLK
chr17,Bn69082,17951947,67223041,49271094,CNL
chr17,Bn69083,32166716,72119385,39952669,CNL
chr17,Bn69084,22942092,34629297,11687205,RLP
chr17,Bn69085,88543980,97451851,8907871,RLP
chr17,Bn69086,98328841,99054958,726117,RLK
chr17,Bn69087,15421065,76173041,60751976,TN
chr17,Bn69088,68690515,72820687,4130172,RLK
chr17,Bn69089,8628757,61514303,52885546,NBS
chr17,Bn69090,24197839,96288418,72090579,RLP
chr17,Bn69091,91160855,96341496,5180641,CNL
chr17,Bn69092,26150199,58532331,32382132,RLK
chr17,Bn69093,76261034,91911718,15650684,CNL
chr17,Bn69094,10664233,66412460,55748227,NBS
chr17,Bn69095,92818297,99806550,6988253,RLK
chr17,Bn69096,15015255,46460525,31445270,RLP
chr17,Bn69097,30272488,30741645,469157,CNL
chr17,Bn69098,57088169,74273389,17185220,TNL
chr17,Bn69099,98973126,99116426,143300,CN
chr17,Bn69100,76379667,79747995,3368328,CNL
chr17,Bn69101,8660683,37645510,28984827,RLP
chr17,Bn69102,61125812,95621263,34495451,CN
chr17,Bn69103,50868812,54877132,4008320,RLP
chr17,Bn69104,43936684,76895434,32958750,RLK
chr17,Bn69105,73330659,93336947,20006288,RLK
chr17,Bn69106,69883675,82594681,12711006,RLK
chr17,Bn69107,68858001,74983556,6125555,NBS
chr17,Bn69108,26178865,85254038,59075173,TN
chr17,Bn69109,57459879,83906851,26446972,CN
chr17,Bn69110,98275428,99395370,1119942,RLK
chr17,Bn69111,14304568,31332478,17027910,NBS
chr17,Bn69112,75814188,93422055,17607867,TN
chr17,Bn69113,58491458,70432061,11940603,TN
chr17,Bn69114,74861634,76100029,1238395,TNL
chr17,Bn69115,51314038,97003092,45689054,TN
chr17,Bn69116,4346803,46985964,42639161,TNL
chr17,Bn69117,35311739,43440749,8129010,CN
chr17,Bn69118,93538747,97742733,4203986,CN
chr17,Bn69119,86992128,99946685,12954557,CN
chr17,Bn69120,26722217,64630796,37908579,RLK
chr17,Bn69121,35744449,91922324,56177875,TN
chr17,Bn69122,66591210,67184080,592870,RLP
chr17,Bn69123,21290956,70283619,48992663,CNL
chr17,Bn69124,81555690,90930558,9374868,TN
chr17,Bn69125,63828819,88574500,24745681,RLK
chr17,Bn69126,31742819,55445321,23702502,RLP
chr17,Bn69127,3596510,89955378,86358868,CN
chr17,Bn69128,40510679,56158761,15648082,CNL
chr17,Bn69129,2197188,13956752,11759564,CNL
chr17,Bn69130,42245154,91431575,49186421,TNL
chr17,Bn69131,24492854,75296886,50804032,NBS
chr17,Bn69132,47902168,60610622,12708454,TNL
chr17,Bn69133,76647856,98081866,21434010,NBS
chr17,Bn69134,27901230,87955894,60054664,CN
chr17,Bn69135,9684141,95840051,86155910,RLK
chr17,Bn69136,89951073,98159469,8208396,TNL
chr17,Bn69137,89654363,92753549,3099186,RLP
chr17,Bn69138,26279217,33253038,6973821,TNL
chr17,Bn69139,40879213,92722482,51843269,TNL
chr17,Bn69140,70351080,81055576,10704496,RLK
chr17,Bn69141,29920284,39522904,9602620,NBS
chr17,Bn69142,53802035,68154099,14352064,RLK
chr17,Bn69143,99317507,99381665,64158,CNL
chr17,Bn69144,58820768,76565559,17744791,CNL
chr17,Bn69145,98047685,98273938,226253,RLP
chr17,Bn69146,17958895,64006268,46047373,NBS
chr17,Bn69147,73484352,75462342,1977990,CNL
chr17,Bn69148,43414498,59562077,16147579,RLP
chr17,Bn69149,1205548,78663730,77458182,CNL
chr17,Bn69150,38841296,87093622,48252326,CN
chr17,Bn69151,59167264,94714356,35547092,NBS
chr17,Bn69152,48806258,84987460,36181202,CN
chr17,Bn69153,95378442,96430773,1052331,CN
chr17,Bn69154,71156568,76542078,5385510,TN
chr17,Bn69155,23183779,67844017,44660238,TN
chr17,Bn69156,96829202,99695350,2866148,RLP
chr17,Bn69157,71923508,99084520,27161012,CN
chr17,Bn69158,3870831,5931887,2061056,NBS
chr17,Bn69159,77190366,86901488,9711122,CN
chr17,Bn69160,26101839,51410883,25309044,NBS
chr17,Bn69161,99670084,99888058,217974,TN
chr17,Bn69162,60786083,86716870,25930787,RLK
chr17,Bn69163,29591073,43459044,13867971,CN
chr17,Bn69164,27894526,57134438,29239912,NBS
chr17,Bn69165,85893479,99418237,13524758,TNL
chr17,Bn69166,59090163,81635345,22545182,CNL
chr17,Bn69167,79242468,94008435,14765967,TN
chr17,Bn69168,78419407,88601838,10182431,TN
chr17,Bn69169,11777829,37165006,25387177,NBS
chr17,Bn69170,17060113,18236658,1176545,NBS
chr17,Bn69171,47501543,79154414,31652871,RLP
chr17,Bn69172,87172381,96703464,9531083,NBS
chr17,Bn69173,48161328,91553543,43392215,NBS
chr17,Bn69174,66315966,96398510,30082544,NBS
chr17,Bn69175,96612913,98508331,1895418,RLP
chr17,Bn69176,30129145,52874914,22745769,NBS
chr17,Bn69177,5465071,43235398,37770327,TNL
chr17,Bn69178,38128078,76477260,38349182,NBS
chr17,Bn69179,34146537,84757036,50610499,CN
chr17,Bn69180,21711745,56737757,35026012,RLK
chr17,Bn69181,14709713,58071721,43362008,CNL
chr17,Bn69182,45587855,75037699,29449844,RLK
chr17,Bn69183,45518739,62212523,16693784,TNL
chr17,Bn69184,92058741,99832817,7774076,TN
chr17,Bn69185,34319762,80197623,45877861,RLK
chr17,Bn69186,55322001,90539483,35217482,RLP
chr17,Bn69187,59168180,82366429,23198249,CNL
chr17,Bn69188,30522826,82540681,52017855,RLP
chr17,Bn69189,72271791,98087443,25815652,RLP
chr17,Bn69190,28152351,67643222,39490871,CNL
chr17,Bn69191,29892654,75056362,45163708,TN
chr17,Bn69192,66077145,97789799,31712654,RLP
chr17,Bn69193,96837138,98769402,1932264,RLP
chr17,Bn69194,14959870,83155917,68196047,RLK
chr17,Bn69195,75457830,92670805,17212975,CNL
chr17,Bn69196,46650586,87931064,41280478,TNL
chr17,Bn69197,41149715,87083407,45933692,RLK
chr17,Bn69198,83446177,92162292,8716115,NBS
chr17,Bn69199,19495111,43628226,24133115,NBS
chr17,Bn69200,95217390,97162523,1945133,RLK
chr17,Bn69201,64397812,74536370,10138558,NBS
chr17,Bn69202,59645420,86206494,26561074,CN
chr17,Bn69203,13429803,79253123,65823320,CNL
chr17,Bn69204,28935611,38682222,9746611,NBS
chr17,Bn69205,24166578,45615126,21448548,CNL
chr17,Bn69206,76282844,97587201,21304357,CN
chr17,Bn69207,8465256,52404047,43938791,TNL
chr17,Bn69208,22018595,62059784,40041189,CN
chr17,Bn69209,50037514,65863326,15825812,CN
chr17,Bn69210,67825488,93242414,25416926,RLP
chr17,Bn69211,77555039,81011163,3456124,NBS
chr17,Bn69212,36463968,98699642,62235674,TNL
chr17,Bn69213,85381784,90106436,4724652,TN
chr17,Bn69214,75033578,82163150,7129572,NBS
chr17,Bn69215,20469108,74505545,54036437,CNL
chr17,Bn69216,79351596,80162669,811073,TNL
chr17,Bn69217,49068038,60124462,11056424,CNL
chr17,Bn69218,64490562,82193516,17702954,CN
chr17,Bn69219,42190447,49643799,7453352,TN
chr17,Bn69220,99323600,99808611,485011,TNL
chr17,Bn69221,91062739,97393414,6330675,RLK
chr17,Bn69222,25549710,33056803,7507093,TN
chr17,Bn69223,4033038,60086066,56053028,RLP
chr17,Bn69224,15612552,71772469,56159917,RLP
chr17,Bn69225,16743049,68875707,52132658,TNL
chr17,Bn69226,47353706,97683687,50329981,RLP
chr17,Bn69227,63816134,85355033,21538899,NBS
chr17,Bn69228,58673021,99429904,40756883,CN
chr17,Bn69229,26549852,66340981,39791129,TN
chr17,Bn69230,91627947,97037507,5409560,TNL
chr17,Bn69231,4256422,68004705,63748283,TN
chr17,Bn69232,42025145,63846115,21820970,RLP
chr17,Bn69233,99841939,99878612,36673,CN
chr17,Bn69234,76066471,99035948,22969477,NBS
chr17,Bn69235,73158220,81676437,8518217,RLK
chr17,Bn69236,11747099,18404686,6657587,TN
chr17,Bn69237,34313572,79475782,45162210,RLP
chr17,Bn69238,91394159,96726701,5332542,RLK
chr17,Bn69239,5259089,82615967,77356878,RLK
chr17,Bn69240,30872457,94576188,63703731,NBS
chr17,Bn69241,11266818,66197023,54930205,RLK
chr17,Bn69242,63285199,97812559,34527360,TN
chr17,Bn69243,24851169,82149477,57298308,NBS
chr17,Bn69244,66755831,70555070,3799239,NBS
chr17,Bn69245,56486028,76266013,19779985,RLK
chr17,Bn69246,10225070,38062368,27837298,NBS
chr17,Bn69247,18141176,18510591,369415,RLK
chr17,Bn69248,15947464,85570133,69622669,NBS
chr17,Bn69249,28470297,56354231,27883934,TN
chr17,Bn69250,5317473,78209307,72891834,TN
chr17,Bn69251,86359238,87161717,802479,CNL
chr17,Bn69252,70324785,74546031,4221246,TN
chr17,Bn69253,75676851,82461437,6784586,NBS
chr17,Bn69254,75184935,75693657,508722,CNL
chr17,Bn69255,25153078,27330089,2177011,CN
chr17,Bn69256,71503726,79923369,8419643,NBS
chr17,Bn69257,53725568,98326153,44600585,CN
chr17,Bn69258,15292193,93219239,77927046,NBS
chr17,Bn69259,60732226,96174955,35442729,CN
chr17,Bn69260,73969629,77754349,3784720,CN
chr17,Bn69261,61143971,89451475,28307504,CN
chr17,Bn69262,29616858,53421817,23804959,RLP
chr17,Bn69263,83517042,92258691,8741649,TN
chr17,Bn69264,13085625,40018250,26932625,RLP
chr17,Bn69265,39566732,73233399,33666667,RLP
chr17,Bn69266,21413806,66696961,45283155,NBS
chr17,Bn69267,30414361,74137978,43723617,RLP
chr17,Bn69268,26345450,65888682,39543232,TN
chr17,Bn69269,75688109,93491385,17803276,TN
chr17,Bn69270,64317720,64741716,423996,RLP
chr17,Bn69271,41445670,90024343,48578673,TN
chr17,Bn69272,31782913,45809547,14026634,RLP
chr17,Bn69273,38280730,60429341,22148611,TNL
chr17,Bn69274,96390018,98483518,2093500,RLP
chr17,Bn69275,12005559,33313878,21308319,TNL
chr17,Bn69276,99507870,99628445,120575,TN
chr17,Bn69277,64622861,99053916,34431055,CNL
chr17,Bn69278,41225108,50100170,8875062,TN
chr17,Bn69279,18682506,40118538,21436032,CNL
chr17,Bn69280,35857354,54792232,18934878,RLK
chr17,Bn69281,94393578,95854324,1460746,TNL
chr17,Bn69282,61437149,62689176,1252027,NBS
chr17,Bn69283,73980672,78105181,4124509,TNL
chr17,Bn69284,24859952,43717699,18857747,TN
chr17,Bn69285,58976888,81072754,22095866,RLP
chr17,Bn69286,38243359,98493221,60249862,CN
chr17,Bn69287,35013718,72938056,37924338,TN
chr17,Bn69288,62371155,86688861,24317706,NBS
chr17,Bn69289,95543622,98857784,3314162,RLP
chr17,Bn69290,41656101,45135741,3479640,CNL
chr17,Bn69291,42090303,94829302,52738999,RLK
chr17,Bn69292,13103654,54986402,41882748,NBS
chr17,Bn69293,14708423,52435379,37726956,CN
chr17,Bn69294,1180566,64540759,63360193,RLP
chr17,Bn69295,20610659,77882515,57271856,RLK
chr17,Bn69296,98866852,99381850,514998,TNL
chr17,Bn69297,86868085,94650049,7781964,CNL
chr17,Bn69298,10238087,65538151,55300064,TN
chr17,Bn69299,59953067,95833498,35880431,TN
chr17,Bn69300,56657932,70919705,14261773,CN
chr17,Bn69301,90155265,95103279,4948014,TNL
chr17,Bn69302,31368138,97171407,65803269,CN
chr17,Bn69303,83017857,90224667,7206810,RLP
chr17,Bn69304,9314574,53933738,44619164,CNL
chr17,Bn69305,15340971,64363366,49022395,NBS
chr17,Bn69306,76475254,77412724,937470,NBS
chr17,Bn69307,6453260,46841787,40388527,RLK
chr17,Bn69308,69039742,86986966,17947224,NBS
chr17,Bn69309,22019289,58482128,36462839,CNL
chr17,Bn69310,62068677,67584815,5516138,CN
chr17,Bn69311,91911127,94212045,2300918,TNL
chr17,Bn69312,34591068,37120257,2529189,TNL
chr17,Bn69313,91248482,95836629,4588147,CNL
chr17,Bn69314,50474795,60417419,9942624,TNL
chr17,Bn69315,96973043,99850807,2877764,CNL
chr17,Bn69316,14990048,35163789,20173741,NBS
chr17,Bn69317,42898147,91078738,48180591,RLP
chr17,Bn69318,93513107,95154939,1641832,NBS
chr17,Bn69319,66189725,74164462,7974737,RLK
chr17,Bn69320,71991447,80698151,8706704,NBS
chr17,Bn69321,86064571,96347080,10282509,CN
chr17,Bn69322,25350977,54188160,28837183,CN
chr17,Bn69323,53623336,84507786,30884450,TN
chr17,Bn69324,43732513,81229138,37496625,CN
chr17,Bn69325,69163619,96010014,26846395,TN
chr17,Bn69326,14530174,46281132,31750958,CNL
chr17,Bn69327,81304776,87545603,6240827,TN
chr17,Bn69328,5996725,18271530,12274805,CNL
chr17,Bn69329,11946817,70241089,58294272,CNL
chr17,Bn69330,61710884,65714915,4004031,CNL
chr17,Bn69331,80415385,83198037,2782652,NBS
chr17,Bn69332,7016091,42566148,35550057,CNL
chr17,Bn69333,82473988,89704529,7230541,CNL
chr17,Bn69334,39925000,70320705,30395705,CN
chr17,Bn69335,14372512,46562186,32189674,RLK
chr17,Bn69336,75774327,88415197,12640870,RLK
chr17,Bn69337,6439490,49228735,42789245,RLK
chr17,Bn69338,8839260,94343897,85504637,CNL
chr17,Bn69339,8555781,48279709,39723928,CN
chr17,Bn69340,77179972,88449193,11269221,CN
chr17,Bn69341,61538703,61630183,91480,RLK
chr17,Bn69342,39540953,77828456,38287503,RLK
chr17,Bn69343,24527896,50924792,26396896,RLP
chr17,Bn69344,52526615,72021856,19495241,TN
chr17,Bn69345,97217811,98065056,847245,RLK
chr17,Bn69346,30432424,49976511,19544087,CN
chr17,Bn69347,82349336,88107017,5757681,RLP
chr17,Bn69348,92862856,98037307,5174451,TN
chr17,Bn69349,62384350,94963750,32579400,RLK
chr17,Bn69350,47472899,67009249,19536350,CNL
chr17,Bn69351,17687108,22099703,4412595,TNL
chr17,Bn69352,94368664,97615270,3246606,NBS
chr17,Bn69353,67665115,77163104,9497989,TN
chr17,Bn69354,84951138,87999191,3048053,CNL
chr17,Bn69355,7719487,80629646,72910159,CNL
chr17,Bn69356,74785483,89045310,14259827,CN
chr17,Bn69357,70848836,81150476,10301640,TNL
chr17,Bn69358,63588934,90535365,26946431,CNL
chr17,Bn69359,8969828,15781297,6811469,TN
chr17,Bn69360,56939000,68129450,11190450,TN
chr17,Bn69361,11094700,22023666,10928966,NBS
chr17,Bn69362,82351173,85537318,3186145,TNL
chr17,Bn69363,70012527,86459159,16446632,RLP
chr17,Bn69364,4576910,10415254,5838344,NBS
chr17,Bn69365,44581457,80972205,36390748,TNL
chr17,Bn69366,99517559,99907762,390203,RLP
chr17,Bn69367,45768786,51140293,5371507,TN
chr17,Bn69368,68590899,93947311,25356412,TNL
chr17,Bn69369,87037489,91362641,4325152,CNL
chr17,Bn69370,27579328,47930709,20351381,CN
chr17,Bn69371,62405562,74867007,12461445,CN
chr17,Bn69372,36854670,89282122,52427452,RLP
chr17,Bn69373,95183506,98009804,2826298,CN
chr17,Bn69374,78377504,90194037,11816533,CNL
chr17,Bn69375,22891479,42690689,19799210,CNL
chr17,Bn69376,83746205,97715594,13969389,TN
chr17,Bn69377,22615433,74159481,51544048,TN
chr17,Bn69378,31787008,82439291,50652283,CNL
chr17,Bn69379,26708569,40004631,13296062,RLP
chr17,Bn69380,61322217,99183101,37860884,NBS
chr17,Bn69381,85025547,92099279,7073732,RLP
chr17,Bn69382,29145635,86215863,57070228,TN
chr17,Bn69383,29515305,30954702,1439397,NBS
chr17,Bn69384,29111149,43475299,14364150,CNL
chr17,Bn69385,88856298,88929926,73628,TNL
chr17,Bn69386,40316389,69675463,29359074,CN
chr17,Bn69387,90363405,92412302,2048897,TN
chr17,Bn69388,61058470,78768958,17710488,RLP
chr17,Bn69389,64440142,80579040,16138898,CN
chr17,Bn69390,42693585,51496131,8802546,TNL
chr17,Bn69391,15763335,22950492,7187157,CN
chr17,Bn69392,33280251,42823651,9543400,TN
chr17,Bn69393,68488755,84145329,15656574,NBS
chr17,Bn69394,65645472,81563804,15918332,RLK
chr17,Bn69395,72564415,90191016,17626601,TN
chr17,Bn69396,66004922,67459794,1454872,RLK
chr17,Bn69397,98351982,99893147,1541165,RLP
chr17,Bn69398,78811301,79265218,453917,NBS
chr17,Bn69399,85982386,89966127,3983741,TN
chr17,Bn69400,47945709,84521791,36576082,NBS
chr17,Bn69401,67624712,77789955,10165243,RLP
chr17,Bn69402,13638077,25540180,11902103,RLK
chr17,Bn69403,59695963,98846737,39150774,NBS
chr17,Bn69404,18827397,38038224,19210827,CNL
chr17,Bn69405,23531378,37436559,13905181,RLP
chr17,Bn69406,48565463,93969505,45404042,TN
chr17,Bn69407,27940664,88996274,61055610,CNL
chr17,Bn69408,99328637,99544574,215937,RLP
chr17,Bn69409,73029168,92627179,19598011,CN
chr17,Bn69410,60779766,77927605,17147839,CNL
chr17,Bn69411,13545985,86863463,73317478,RLP
chr17,Bn69412,56144216,63326265,7182049,NBS
chr17,Bn69413,29822301,58443385,28621084,RLK
chr17,Bn69414,12963608,55984688,43021080,TN
chr17,Bn69415,85006707,97780946,12774239,TNL
chr17,Bn69416,1800432,15661784,13861352,TN
chr17,Bn69417,96850231,99211413,2361182,RLK
chr17,Bn69418,12572916,22852246,10279330,TN
chr17,Bn69419,22579197,31249243,8670046,RLK
chr17,Bn69420,56120332,93516792,37396460,TNL
chr17,Bn69421,91938152,93288270,1350118,CNL
chr17,Bn69422,84980253,94121779,9141526,RLK
chr17,Bn69423,32245028,79412846,47167818,CNL
chr17,Bn69424,82368178,97691126,15322948,RLP
chr17,Bn69425,71144935,77300589,6155654,RLP
chr17,Bn69426,75564992,82984778,7419786,CNL
chr17,Bn69427,45044572,69909402,24864830,TN
chr17,Bn69428,17729983,39865644,22135661,CN
chr17,Bn69429,46888836,96187879,49299043,CN
chr17,Bn69430,90297397,91515506,1218109,CN
chr17,Bn69431,51909555,57427501,5517946,CN
chr17,Bn69432,24159909,49654531,25494622,NBS
chr17,Bn69433,66341375,75060117,8718742,TNL
chr17,Bn69434,61555305,63564900,2009595,CNL
chr17,Bn69435,96489598,98618343,2128745,CN
chr17,Bn69436,58279261,72975866,14696605,CN
chr17,Bn69437,85725195,95095223,9370028,TNL
chr17,Bn69438,24428588,30420983,5992395,RLK
chr17,Bn69439,48742854,63035802,14292948,NBS
chr17,Bn69440,85724079,92964491,7240412,TN
chr17,Bn69441,65487003,75818264,10331261,CNL
chr17,Bn69442,80779326,97055023,16275697,CN
chr17,Bn69443,77491479,91534664,14043185,TN
chr17,Bn69444,28113030,93386921,65273891,RLP
chr17,Bn69445,29375114,89409839,60034725,RLP
chr17,Bn69446,69238524,81746988,12508464,TN
chr17,Bn69447,97337129,97562484,225355,TN
chr17,Bn69448,45198895,71437412,26238517,CNL
chr17,Bn69449,92306145,93361499,1055354,RLP
chr17,Bn69450,79790376,87435652,7645276,TNL
chr17,Bn69451,85883943,91533748,5649805,TN
chr17,Bn69452,74136632,85492286,11355654,TN
chr17,Bn69453,23094946,26530289,3435343,RLP
chr17,Bn69454,44183337,51978166,7794829,CNL
chr17,Bn69455,30415652,41018478,10602826,CN
chr17,Bn69456,11635984,17969105,6333121,RLK
chr17,Bn69457,63734750,80429728,16694978,RLK
chr17,Bn69458,28130875,86198063,58067188,TN
chr17,Bn69459,89061069,92975982,3914913,NBS
chr17,Bn69460,94896311,95419109,522798,TNL
chr17,Bn69461,45344658,59770946,14426288,NBS
chr17,Bn69462,69959975,80401938,10441963,RLK
chr17,Bn69463,83736517,89001281,5264764,CNL
chr17,Bn69464,76141832,94874569,18732737,TN
chr17,Bn69465,69372370,97122372,27750002,TN
chr17,Bn69466,89204297,93716607,4512310,TNL
chr17,Bn69467,60510500,62129455,1618955,CN
chr17,Bn69468,46942798,90377097,43434299,TN
chr17,Bn69469,1010692,79044211,78033519,NBS
chr17,Bn69470,51015247,83452262,32437015,RLK
chr17,Bn69471,96708834,98943648,2234814,RLP
chr17,Bn69472,23423508,82446780,59023272,RLP
chr17,Bn69473,73805561,88757028,14951467,NBS
chr17,Bn69474,57360642,72282298,14921656,NBS
chr17,Bn69475,15527803,71662835,56135032,TN
chr17,Bn69476,4382084,42567531,38185447,CN
chr17,Bn69477,43329636,52147923,8818287,TN
chr17,Bn69478,64090212,88282181,24191969,NBS
chr17,Bn69479,44261876,94328245,50066369,CNL
chr17,Bn69480,84929663,89222875,4293212,RLP
chr17,Bn69481,45539693,87336790,41797097,RLK
chr17,Bn69482,49248926,62738463,13489537,TN
chr17,Bn69483,71228118,99554656,28326538,RLK
chr17,Bn69484,77412290,95755028,18342738,NBS
chr17,Bn69485,1022422,62107884,61085462,CNL
chr17,Bn69486,32152790,53100810,20948020,RLK
chr17,Bn69487,3055017,93072187,90017170,CNL
chr17,Bn69488,49217572,90340231,41122659,TN
chr17,Bn69489,79217727,83107720,3889993,RLP
chr17,Bn69490,71527422,86519621,14992199,RLK
chr17,Bn69491,73823849,99783858,25960009,TNL
chr17,Bn69492,15885571,50592535,34706964,NBS
chr17,Bn69493,48395002,82123805,33728803,CN
chr17,Bn69494,56355882,97787048,41431166,CNL
chr17,Bn69495,95315129,96399107,1083978,RLP
chr17,Bn69496,17752645,94060252,76307607,RLK
chr17,Bn69497,87914026,90028041,2114015,CNL
chr17,Bn69498,71618961,98581312,26962351,CNL
chr17,Bn69499,4326833,80914461,76587628,TNL
chr17,Bn69500,7965363,14726824,6761461,RLK
chr17,Bn69501,80329415,89411377,9081962,RLK
chr17,Bn69502,94989709,98413196,3423487,RLK
chr17,Bn69503,14625473,97103777,82478304,CN
chr17,Bn69504,1059660,36739385,35679725,CN
chr17,Bn69505,60783124,96782119,35998995,RLP
chr17,Bn69506,78243963,99289527,21045564,CNL
chr17,Bn69507,30931682,36646342,5714660,CNL
chr17,Bn69508,7044750,9802561,2757811,RLK
chr17,Bn69509,16413097,53423437,37010340,RLP
chr17,Bn69510,68072792,69607965,1535173,TN
chr17,Bn69511,56477285,71953434,15476149,RLK
chr17,Bn69512,86221863,89884033,3662170,TN
chr17,Bn69513,79264379,98001076,18736697,TN
chr17,Bn69514,27491876,46718867,19226991,RLK
chr17,Bn69515,77509049,85083711,7574662,CNL
chr17,Bn69516,52606228,71431623,18825395,RLK
chr17,Bn69517,17888384,67934371,50045987,TNL
chr17,Bn69518,45132699,90559587,45426888,NBS
chr17,Bn69519,17509016,87961692,70452676,TN
chr17,Bn69520,27791770,40441536,12649766,RLP
chr17,Bn69521,86935011,99043541,12108530,RLP
chr17,Bn69522,84804620,95447312,10642692,NBS
chr17,Bn69523,83812962,93879293,10066331,CN
chr17,Bn69524,68148847,71887524,3738677,CN
chr17,Bn69525,58639332,66873826,8234494,TNL
chr17,Bn69526,75885569,96033768,20148199,TNL
chr17,Bn69527,76728582,84363364,7634782,RLK
chr17,Bn69528,60082571,67043587,6961016,CN
chr17,Bn69529,90475259,93856409,3381150,TN
chr17,Bn69530,68521872,83426219,14904347,RLP
chr17,Bn69531,74847187,97991991,23144804,RLK
chr17,Bn69532,77874333,99304103,21429770,CN
chr17,Bn69533,87971737,89101315,1129578,CNL
chr17,Bn69534,82785198,99930547,17145349,RLK
chr17,Bn69535,83063604,84738594,1674990,CN
chr17,Bn69536,44803838,70306887,25503049,RLK
chr17,Bn69537,90787947,97828234,7040287,TNL
chr17,Bn69538,96318734,96639063,320329,CN
chr17,Bn69539,43364840,92956999,49592159,CN
chr17,Bn69540,76701190,84009164,7307974,NBS
chr17,Bn69541,11951403,19190804,7239401,NBS
chr17,Bn69542,96408539,98988693,2580154,RLP
chr17,Bn69543,70449366,86031096,15581730,NBS
chr17,Bn69544,6043832,24411059,18367227,CN
chr17,Bn69545,3126241,95511211,92384970,RLP
chr17,Bn69546,68563781,84276137,15712356,CN
chr17,Bn69547,74271360,93762738,19491378,TNL
chr17,Bn69548,9668951,79957075,70288124,TN
chr17,Bn69549,76299017,91171865,14872848,TNL
chr17,Bn69550,28640564,85990696,57350132,TN
chr17,Bn69551,42263988,70633366,28369378,NBS
chr17,Bn69552,72749420,79183097,6433677,RLK
chr17,Bn69553,12076383,81014502,68938119,TNL
chr17,Bn69554,36940196,69392084,32451888,NBS
chr17,Bn69555,52896356,66984472,14088116,NBS
chr17,Bn69556,21089737,23363269,2273532,RLP
chr17,Bn69557,50479674,97990510,47510836,RLK
chr17,Bn69558,50325241,97746246,47421005,RLP
chr17,Bn69559,9902535,22921829,13019294,CN
chr17,Bn69560,90964674,99960920,8996246,CN
chr17,Bn69561,49638420,78510452,28872032,RLP
chr17,Bn69562,5489953,20738979,15249026,NBS
chr17,Bn69563,94786965,99356173,4569208,RLK
chr17,Bn69564,99741730,99963003,221273,NBS
chr17,Bn69565,23711650,39275865,15564215,CN
chr17,Bn69566,32466531,90425697,57959166,CN
chr17,Bn69567,53896025,77792295,23896270,CN
chr17,Bn69568,30412369,40160144,9747775,RLK
chr17,Bn69569,86052841,93445102,7392261,TNL
chr17,Bn69570,68872698,81295510,12422812,RLK
chr17,Bn69571,85855607,88509233,2653626,NBS
chr17,Bn69572,29676619,97309731,67633112,CNL
chr17,Bn69573,60394131,96536136,36142005,RLK
chr17,Bn69574,17997027,50356936,32359909,TN
chr17,Bn69575,69801747,95014768,25213021,CN
chr17,Bn69576,94264037,96975455,2711418,TN
chr17,Bn69577,18056992,96454589,78397597,CN
chr17,Bn69578,20294907,77573384,57278477,CNL
chr17,Bn69579,67711271,92143423,24432152,TNL
chr17,Bn69580,57508757,59686855,2178098,RLP
chr17,Bn69581,11390010,20676768,9286758,RLK
chr17,Bn69582,37835737,47512515,9676778,CN
chr17,Bn69583,75171330,85810089,10638759,RLP
chr17,Bn69584,61132046,71737250,10605204,RLP
chr17,Bn69585,51309477,89008014,37698537,RLP
chr17,Bn69586,77192181,90300302,13108121,TNL
chr17,Bn69587,75365567,79715962,4350395,TNL
chr17,Bn69588,61853682,98884120,37030438,CN
chr17,Bn69589,52434587,92011936,39577349,RLK
chr17,Bn69590,27751048,45028187,17277139,NBS
chr17,Bn69591,74546658,86181503,11634845,RLK
chr17,Bn69592,85855104,88979647,3124543,RLP
chr17,Bn69593,44476193,91503332,47027139,TNL
chr17,Bn69594,31757090,41476154,9719064,NBS
chr17,Bn69595,90802716,96882957,6080241,CNL
chr17,Bn69596,2020437,66670342,64649905,RLK
chr17,Bn69597,71588094,83460949,11872855,RLK
chr17,Bn69598,89186659,94650662,5464003,RLK
chr17,Bn69599,1352587,62036289,60683702,RLK
chr17,Bn69600,97226281,98827731,1601450,CN
chr17,Bn69601,65696671,86092168,20395497,CN
chr17,Bn69602,99053917,99095621,41704,RLP
chr17,Bn69603,38357211,40207113,1849902,RLK
chr17,Bn69604,53047608,62671173,9623565,NBS
chr17,Bn69605,8089093,14951786,6862693,TN
chr17,Bn69606,15000219,89516676,74516457,RLP
chr17,Bn69607,62206305,81965315,19759010,TN
chr17,Bn69608,48312405,55799203,7486798,RLP
chr17,Bn69609,95942534,99461439,3518905,TN
chr17,Bn69610,24988603,34882089,9893486,TN
chr17,Bn69611,69204001,99442804,30238803,CNL
chr17,Bn69612,50540711,72183000,21642289,RLK
chr17,Bn69613,18439611,42669260,24229649,RLP
chr17,Bn69614,95271290,96252610,981320,CN
chr17,Bn69615,44923112,84290480,39367368,RLK
chr17,Bn69616,58322102,68966938,10644836,TN
chr17,Bn69617,89538997,90380020,841023,TN
chr17,Bn69618,62188075,71707167,9519092,TNL
chr17,Bn69619,10032011,25848995,15816984,NBS
chr17,Bn69620,76504219,90846815,14342596,TN
chr17,Bn69621,88232241,96910724,8678483,CN
chr17,Bn69622,27599942,50217621,22617679,TNL
chr17,Bn69623,79689380,82886492,3197112,CNL
chr17,Bn69624,74142537,77142414,2999877,RLP
chr17,Bn69625,56368867,63556257,7187390,CNL
chr17,Bn69626,47843133,62894991,15051858,RLK
chr17,Bn69627,41103002,60557479,19454477,CNL
chr17,Bn69628,79078189,79939643,861454,RLK
chr17,Bn69629,62140496,97847006,35706510,RLP
chr17,Bn69630,6821800,98461304,91639504,TNL
chr17,Bn69631,31367678,40879455,9511777,TN
chr17,Bn69632,64930812,92465601,27534789,RLK
chr17,Bn69633,78829692,79638721,809029,NBS
chr17,Bn69634,76542001,83284126,6742125,RLK
chr17,Bn69635,53244517,82494971,29250454,CN
chr17,Bn69636,23987483,58213094,34225611,CN
chr17,Bn69637,12986565,29045422,16058857,RLP
chr17,Bn69638,47369860,70628413,23258553,TN
chr17,Bn69639,70382640,81035993,10653353,CNL
chr17,Bn69640,12498035,29226972,16728937,CN
chr17,Bn69641,44866311,81608235,36741924,RLK
chr17,Bn69642,23010026,80085204,57075178,RLP
chr17,Bn69643,39281149,62725105,23443956,RLP
chr17,Bn69644,94466859,99671389,5204530,TN
chr17,Bn69645,3545123,77727155,74182032,CN
chr17,Bn69646,37148441,71052174,33903733,RLP
chr17,Bn69647,77035231,77488772,453541,CNL
chr17,Bn69648,63847890,90104826,26256936,RLP
chr17,Bn69649,12571279,52529598,39958319,RLP
chr17,Bn69650,79327539,80199266,871727,RLK
chr17,Bn69651,90065088,94738996,4673908,RLK
chr17,Bn69652,3468404,35234033,31765629,RLK
chr17,Bn69653,34281271,60128886,25847615,TN
chr17,Bn69654,54980980,92464236,37483256,CNL
chr17,Bn69655,85911600,86009847,98247,CN
chr17,Bn69656,59533576,83729066,24195490,RLP
chr17,Bn69657,88579059,99653765,11074706,NBS
chr17,Bn69658,10052544,63694859,53642315,TNL
chr17,Bn69659,18857545,23593589,4736044,TN
chr17,Bn69660,42547526,45817171,3269645,NBS
chr17,Bn69661,50335545,84860979,34525434,RLK
chr17,Bn69662,13545471,95444242,81898771,RLP
chr17,Bn69663,3519050,51749041,48229991,TNL
chr17,Bn69664,48783150,76975831,28192681,CN
chr17,Bn69665,75412584,84279437,8866853,CN
chr17,Bn69666,40267592,73663484,33395892,TNL
chr17,Bn69667,89009771,98367041,9357270,NBS
chr17,Bn69668,68897410,79915750,11018340,CN
chr17,Bn69669,10028429,26929194,16900765,RLP
chr17,Bn69670,36394339,99945199,63550860,TN
chr17,Bn69671,19986149,41259460,21273311,RLK
chr17,Bn69672,69982433,87127218,17144785,TN
chr17,Bn69673,6804321,20410521,13606200,RLP
chr17,Bn69674,85279782,97426957,12147175,TN
chr17,Bn69675,27350739,65810147,38459408,RLP
chr17,Bn69676,79351380,95393124,16041744,RLK
chr17,Bn69677,68239701,73055784,4816083,NBS
chr17,Bn69678,90864817,98514704,7649887,TNL
chr17,Bn69679,70501282,76813544,6312262,TNL
chr17,Bn69680,16675982,25342019,8666037,RLP
chr17,Bn69681,59104291,82302586,23198295,TNL
chr17,Bn69682,34716666,65549689,30833023,CN
chr17,Bn69683,71911977,86926809,15014832,CNL
chr17,Bn69684,15234959,61545286,46310327,NBS
chr17,Bn69685,28381190,39677704,11296514,TNL
chr17,Bn69686,48268156,97623506,49355350,TN
chr17,Bn69687,19973566,84716871,64743305,NBS
chr17,Bn69688,29209025,74954983,45745958,TN
chr17,Bn69689,26709350,43290197,16580847,CN
chr17,Bn69690,51584362,83563776,31979414,RLP
chr17,Bn69691,16667383,21332246,4664863,TN
chr17,Bn69692,84523186,87606537,3083351,CNL
chr17,Bn69693,77912697,93190344,15277647,RLK
chr17,Bn69694,44253453,58001371,13747918,NBS
chr17,Bn69695,68207893,74518729,6310836,CNL
chr17,Bn69696,29862366,86442044,56579678,CNL
chr17,Bn69697,25673616,90325580,64651964,RLP
chr17,Bn69698,4431809,26195658,21763849,RLP
chr17,Bn69699,38114425,44199441,6085016,TNL
chr17,Bn69700,53811421,92995234,39183813,CN
chr17,Bn69701,49861914,83242830,33380916,CNL
chr17,Bn69702,12308201,80340398,68032197,RLK
chr17,Bn69703,32097137,55272490,23175353,CNL
chr17,Bn69704,50747712,62224755,11477043,RLP
chr17,Bn69705,8428455,91187931,82759476,TN
chr17,Bn69706,46024671,82300272,36275601,CN
chr17,Bn69707,1829242,74860167,73030925,CNL
chr17,Bn69708,20852872,42725603,21872731,RLP
chr17,Bn69709,36664155,74754278,38090123,CNL
chr17,Bn69710,91199471,96057959,4858488,TNL
chr17,Bn69711,33609995,69779112,36169117,RLK
chr17,Bn69712,32912288,45147046,12234758,NBS
chr17,Bn69713,11201545,76148127,64946582,CNL
chr17,Bn69714,86702505,99547230,12844725,CNL
chr17,Bn69715,73406689,90682928,17276239,CNL
chr17,Bn69716,78965100,84492230,5527130,RLP
chr17,Bn69717,93867113,99300866,5433753,TN
chr17,Bn69718,4832690,37312847,32480157,RLK
chr17,Bn69719,45398287,64355506,18957219,CN
chr17,Bn69720,13675372,78864399,65189027,CN
chr17,Bn69721,87741988,92755988,5014000,TNL
chr17,Bn69722,75618861,85048250,9429389,CNL
chr17,Bn69723,55350275,66582357,11232082,RLP
chr17,Bn69724,8642216,38837735,30195519,RLP
chr17,Bn69725,12972700,39811408,26838708,RLP
chr17,Bn69726,21993187,60678874,38685687,RLK
chr17,Bn69727,82042235,96787745,14745510,RLP
chr17,Bn69728,3692015,15881830,12189815,NBS
chr17,Bn69729,66625851,86434611,19808760,NBS
chr17,Bn69730,26129684,58592541,32462857,CNL
chr17,Bn69731,77036124,95719267,18683143,CN
chr17,Bn69732,60104555,65948955,5844400,RLK
chr17,Bn69733,23952441,60846756,36894315,RLK
chr17,Bn69734,73235946,92725311,19489365,NBS
chr17,Bn69735,5978336,17536145,11557809,CNL
chr17,Bn69736,98074126,98584359,510233,TN
chr17,Bn69737,31209546,47819734,16610188,CNL
chr17,Bn69738,98027522,99970254,1942732,CN
chr17,Bn69739,44183181,91350817,47167636,CNL
chr17,Bn69740,13546894,67041594,53494700,RLP
chr17,Bn69741,28996075,82609321,53613246,RLK
chr17,Bn69742,10464554,65949580,55485026,NBS
chr17,Bn69743,4252501,95027436,90774935,RLP
chr17,Bn69744,66317905,87790455,21472550,TNL
chr17,Bn69745,2347882,67365459,65017577,CNL
chr17,Bn69746,37551481,96948382,59396901,RLP
chr17,Bn69747,35813370,62751646,26938276,RLK
chr17,Bn69748,27281591,82829095,55547504,TNL
chr17,Bn69749,63287415,72437625,9150210,NBS
chr17,Bn69750,39934573,42384560,2449987,CNL
chr17,Bn69751,53566330,95761499,42195169,RLP
chr17,Bn69752,67325704,96855653,29529949,CNL
chr17,Bn69753,25949137,65417403,39468266,RLP
chr17,Bn69754,48167501,90378614,42211113,RLP
chr17,Bn69755,38196527,88843085,50646558,RLP
chr17,Bn69756,86478317,99255337,12777020,NBS
chr17,Bn69757,27975805,82665409,54689604,TNL
chr17,Bn69758,88942906,92215342,3272436,NBS
chr17,Bn69759,29658443,58017639,28359196,CNL
chr17,Bn69760,7408423,22366655,14958232,RLP
chr17,Bn69761,53969451,79832198,25862747,CNL
chr17,Bn69762,90633135,94590585,3957450,RLP
chr17,Bn69763,62646492,87585252,24938760,CNL
chr17,Bn69764,86623800,92841500,6217700,CNL
chr17,Bn69765,95529217,97586112,2056895,TN
chr17,Bn69766,48027805,92605134,44577329,RLP
chr17,Bn69767,67985744,86434346,18448602,CNL
chr17,Bn69768,53862609,74463085,20600476,RLP
chr17,Bn69769,95499827,95665445,165618,RLP
chr17,Bn69770,36882944,51866038,14983094,NBS
chr17,Bn69771,1417461,32120041,30702580,CNL
chr17,Bn69772,79629500,99608095,19978595,TNL
chr17,Bn69773,37503849,62779062,25275213,TNL
chr17,Bn69774,85079183,95928820,10849637,TNL
chr17,Bn69775,38974537,56088434,17113897,TN
chr17,Bn69776,41392230,97809343,56417113,RLK
chr17,Bn69777,60953412,89003866,28050454,TNL
chr17,Bn69778,33391137,79826361,46435224,CN
chr17,Bn69779,50019372,97483903,47464531,CNL
chr17,Bn69780,52339783,57292513,4952730,TNL
chr17,Bn69781,31296894,76525583,45228689,CN
chr17,Bn69782,18114807,54021572,35906765,TNL
chr17,Bn69783,29141978,70218266,41076288,RLP
chr17,Bn69784,44347944,86375325,42027381,RLP
chr17,Bn69785,20958170,62579685,41621515,TNL
chr17,Bn69786,9509369,54647342,45137973,TNL
chr17,Bn69787,7047108,27143643,20096535,TN
chr17,Bn69788,98171636,98549390,377754,TNL
chr17,Bn69789,45106040,71528313,26422273,CNL
chr17,Bn69790,79113468,85368317,6254849,NBS
chr17,Bn69791,75880378,83855506,7975128,TN
chr17,Bn69792,11425443,27886494,16461051,TNL
chr17,Bn69793,89637344,90121460,484116,RLK
chr17,Bn69794,6611740,95089564,88477824,TNL
chr17,Bn69795,51941884,71196463,19254579,TN
chr17,Bn69796,10217576,75637198,65419622,CNL
chr17,Bn69797,95780263,98686558,2906295,RLK
chr17,Bn69798,95701757,95828884,127127,RLK
chr17,Bn69799,69798176,77827373,8029197,RLK
chr17,Bn69800,66399334,80942030,14542696,CNL
chr17,Bn69801,53622195,70962241,17340046,NBS
chr17,Bn69802,14240761,76931033,62690272,NBS
chr17,Bn69803,2035365,81208708,79173343,TNL
chr17,Bn69804,52779539,95925896,43146357,RLP
chr17,Bn69805,21271249,40654383,19383134,TN
chr17,Bn69806,22495482,88555138,66059656,NBS
chr17,Bn69807,99113303,99265711,152408,CN
chr17,Bn69808,26537154,40676684,14139530,NBS
chr17,Bn69809,42651427,70874815,28223388,TNL
chr17,Bn69810,59786785,84469699,24682914,TNL
chr17,Bn69811,47444354,51832831,4388477,TN
chr17,Bn69812,16245502,57141102,40895600,RLK
chr17,Bn69813,68593176,78928967,10335791,CNL
chr17,Bn69814,79411878,86565050,7153172,CNL
chr17,Bn69815,25239980,52037348,26797368,TNL
chr17,Bn69816,77697752,95446908,17749156,CN
chr17,Bn69817,29185330,78843063,49657733,NBS
chr17,Bn69818,66612355,84105366,17493011,RLK
chr17,Bn69819,14808296,41071519,26263223,RLP
chr17,Bn69820,33069978,43265934,10195956,TN
chr17,Bn69821,87401683,94659247,7257564,TN
chr17,Bn69822,93616981,97027864,3410883,NBS
chr17,Bn69823,8189426,96463201,88273775,TN
chr17,Bn69824,3717698,19788541,16070843,TNL
chr17,Bn69825,2479280,28368662,25889382,TN
chr17,Bn69826,14754604,92393802,77639198,CN
chr17,Bn69827,84012777,85325254,1312477,TN
chr17,Bn69828,68758885,85887924,17129039,TN
chr17,Bn69829,23695143,39685257,15990114,RLK
chr17,Bn69830,67545933,77566328,10020395,CNL
chr17,Bn69831,22358063,85289692,62931629,NBS
chr17,Bn69832,84490496,93189282,8698786,TN
chr17,Bn69833,23874868,94018572,70143704,CN
chr17,Bn69834,52709741,72601763,19892022,TNL
chr17,Bn69835,65777634,80767992,14990358,TN
chr17,Bn69836,86588627,95278672,8690045,RLP
chr17,Bn69837,89730445,99351910,9621465,RLK
chr17,Bn69838,91774090,99973688,8199598,TN
chr17,Bn69839,28251978,95272107,67020129,NBS
chr17,Bn69840,42003953,60679068,18675115,RLK
chr17,Bn69841,72190404,80432499,8242095,CN
chr17,Bn69842,32785501,84543948,51758447,RLK
chr17,Bn69843,36379915,87936016,51556101,CNL
chr17,Bn69844,68734583,79982287,11247704,TN
chr17,Bn69845,24198313,26987254,2788941,TN
chr17,Bn69846,24998219,94711997,69713778,RLP
chr17,Bn69847,36067744,57632104,21564360,TNL
chr17,Bn69848,53702878,95631759,41928881,RLK
chr17,Bn69849,97028462,98449567,1421105,TN
chr17,Bn69850,61087985,73880608,12792623,RLK
chr17,Bn69851,53987505,86084540,32097035,RLP
chr17,Bn69852,16442209,72850840,56408631,NBS
chr17,Bn69853,18288713,56709044,38420331,RLK
chr17,Bn69854,13673576,56510580,42837004,CN
chr17,Bn69855,27960370,64815320,36854950,RLP
chr17,Bn69856,9627387,19952295,10324908,TNL
chr17,Bn69857,51884490,55618084,3733594,NBS
chr17,Bn69858,57289734,75708172,18418438,CNL
chr17,Bn69859,8719524,72749348,64029824,TNL
chr17,Bn69860,74105538,96871597,22766059,CN
chr17,Bn69861,29389283,77579586,48190303,CNL
chr17,Bn69862,51749564,80704665,28955101,RLK
chr17,Bn69863,13609512,76636250,63026738,CNL
chr17,Bn69864,41597423,87949526,46352103,TN
chr17,Bn69865,48916649,56030952,7114303,RLP
chr17,Bn69866,10035836,15272554,5236718,NBS
chr17,Bn69867,93887964,99930586,6042622,NBS
chr17,Bn69868,70569836,81222621,10652785,TN
chr17,Bn69869,38037500,51924888,13887388,CNL
chr17,Bn69870,30797760,66442667,35644907,TN
chr17,Bn69871,10294661,72462574,62167913,RLK
chr17,Bn69872,91684217,99330608,7646391,RLK
chr17,Bn69873,18934491,92888108,73953617,RLP
chr17,Bn69874,63156298,77889947,14733649,RLK
chr17,Bn69875,79830767,88963131,9132364,CNL
chr17,Bn69876,68158661,84237579,16078918,RLP
chr17,Bn69877,24514596,96487019,71972423,NBS
chr17,Bn69878,86473983,96099948,9625965,CNL
chr17,Bn69879,59136955,96013368,36876413,TNL
chr17,Bn69880,74806678,96223025,21416347,CNL
chr17,Bn69881,50920675,89513581,38592906,CN
chr17,Bn69882,78613141,85378295,6765154,RLP
chr17,Bn69883,93281226,96661106,3379880,TNL
chr17,Bn69884,26980901,35086899,8105998,CN
chr17,Bn69885,92359144,98027449,5668305,CN
chr17,Bn69886,28601239,47293909,18692670,CNL
chr17,Bn69887,35547366,85540548,49993182,CN
chr17,Bn69888,74600055,90442000,15841945,NBS
chr17,Bn69889,56582340,96436961,39854621,TN
chr17,Bn69890,47758056,50706518,2948462,RLK
chr17,Bn69891,14079143,53181576,39102433,RLP
chr17,Bn69892,88449830,97236945,8787115,CNL
chr17,Bn69893,11041115,60526489,49485374,CN
chr17,Bn69894,71392158,72659409,1267251,NBS
chr17,Bn69895,77662859,92185571,14522712,CNL
chr17,Bn69896,70932677,71256099,323422,RLK
chr17,Bn69897,70615909,91704557,21088648,RLP
chr17,Bn69898,90858359,92550510,1692151,CN
chr17,Bn69899,70091964,92848793,22756829,CN
chr17,Bn69900,79505770,97605621,18099851,RLK
chr17,Bn69901,11733097,29802633,18069536,NBS
chr17,Bn69902,62458972,63859239,1400267,RLK
chr17,Bn69903,57744314,84883658,27139344,TN
chr17,Bn69904,62404429,75251346,12846917,RLP
chr17,Bn69905,21371377,44345708,22974331,CN
chr17,Bn69906,1053633,97229253,96175620,CNL
chr17,Bn69907,57525051,82685526,25160475,NBS
chr17,Bn69908,81147329,89186421,8039092,CNL
chr17,Bn69909,64666188,86687103,22020915,RLP
chr17,Bn69910,78950826,83477091,4526265,NBS
chr17,Bn69911,23375909,92686166,69310257,RLK
chr17,Bn69912,93248368,99134795,5886427,RLP
chr17,Bn69913,21493293,22047888,554595,TN
chr17,Bn69914,45462617,64867121,19404504,RLP
chr17,Bn69915,55557717,86317238,30759521,NBS
chr17,Bn69916,81064416,87421422,6357006,TN
chr17,Bn69917,19782792,51805408,32022616,NBS
chr17,Bn69918,93940810,94915686,974876,CN
chr17,Bn69919,89736458,97135342,7398884,RLP
chr17,Bn69920,9216268,37903007,28686739,TNL
chr17,Bn69921,47746547,80037968,32291421,RLK
chr17,Bn69922,41543554,79644593,38101039,RLP
chr17,Bn69923,10028582,24795369,14766787,RLK
chr17,Bn69924,42253082,45696266,3443184,RLK
chr17,Bn69925,50309577,93421692,43112115,CN
chr17,Bn69926,54702744,75600472,20897728,TN
chr17,Bn69927,70348226,98897101,28548875,NBS
chr17,Bn69928,38914831,89526764,50611933,RLK
chr17,Bn69929,70710773,72175177,1464404,CNL
chr17,Bn69930,6229430,14158037,7928607,TNL
chr17,Bn69931,29232554,42375771,13143217,NBS
chr17,Bn69932,95139644,99484612,4344968,RLK
chr17,Bn69933,72221844,83575538,11353694,CNL
chr17,Bn69934,82263890,84670010,2406120,CN
chr17,Bn69935,20018912,47280258,27261346,CNL
chr17,Bn69936,84212177,99612668,15400491,TNL
chr17,Bn69937,40032688,96807717,56775029,CN
chr17,Bn69938,93845410,95002401,1156991,TNL
chr17,Bn69939,73575222,86917433,13342211,TN
chr17,Bn69940,13437123,23907654,10470531,NBS
chr17,Bn69941,21510010,96772595,75262585,TN
chr17,Bn69942,73219200,96949826,23730626,NBS
chr17,Bn69943,21949805,56597802,34647997,TN
chr17,Bn69944,64935460,91947715,27012255,CNL
chr17,Bn69945,57669215,64269949,6600734,NBS
chr17,Bn69946,45289763,73390493,28100730,CNL
chr17,Bn69947,29095364,42238672,13143308,NBS
chr17,Bn69948,33606166,46427847,12821681,NBS
chr17,Bn69949,59451435,64730941,5279506,NBS
chr17,Bn69950,64625540,97107760,32482220,NBS
chr17,Bn69951,70245578,79024025,8778447,TN
chr17,Bn69952,55944545,91381200,35436655,TN
chr17,Bn69953,35790171,86871420,51081249,CNL
chr17,Bn69954,87327584,92503875,5176291,RLP
chr17,Bn69955,97605659,98288852,683193,CNL
chr17,Bn69956,60383714,99707649,39323935,NBS
chr17,Bn69957,19866901,42493178,22626277,RLP
chr17,Bn69958,19605242,40762086,21156844,RLK
chr17,Bn69959,15851622,70301224,54449602,NBS
chr17,Bn69960,64957281,90367609,25410328,CN
chr17,Bn69961,2498244,64100056,61601812,NBS
chr17,Bn69962,20322739,82641165,62318426,RLP
chr17,Bn69963,71402616,95517755,24115139,TNL
chr17,Bn69964,68590448,93595406,25004958,CNL
chr17,Bn69965,99684223,99823524,139301,TNL
chr17,Bn69966,44948165,95707393,50759228,RLP
chr17,Bn69967,51745904,54584669,2838765,RLP
chr17,Bn69968,55028717,72347484,17318767,CNL
chr17,Bn69969,45694106,49783294,4089188,NBS
chr17,Bn69970,31166779,89389348,58222569,CN
chr17,Bn69971,71052414,84175155,13122741,NBS
chr17,Bn69972,51397668,66719354,15321686,TN
chr17,Bn69973,25117166,48653228,23536062,RLK
chr17,Bn69974,72682790,88067960,15385170,RLK
chr17,Bn69975,48040673,63036128,14995455,RLP
chr17,Bn69976,32467438,56640965,24173527,TNL
chr17,Bn69977,12046576,77988521,65941945,RLK
chr17,Bn69978,16253631,39215421,22961790,RLP
chr17,Bn69979,95014006,97831845,2817839,NBS
chr17,Bn69980,24454106,54524018,30069912,RLP
chr17,Bn69981,14575942,53360516,38784574,CN
chr17,Bn69982,30066251,51211716,21145465,TNL
chr17,Bn69983,7165698,43692129,36526431,TN
chr17,Bn69984,60443630,79194038,18750408,TNL
chr17,Bn69985,72278302,77509467,5231165,TNL
chr17,Bn69986,41151254,81161967,40010713,TN
chr17,Bn69987,91126004,93501596,2375592,CNL
chr17,Bn69988,16810402,76938090,60127688,RLP
chr17,Bn69989,40121295,42863707,2742412,CNL
chr17,Bn69990,36588907,80387821,43798914,CNL
chr17,Bn69991,79718242,97766321,18048079,RLP
chr17,Bn69992,75631267,92150974,16519707,CN
chr17,Bn69993,1333550,33508374,32174824,TNL
chr17,Bn69994,67977344,86667291,18689947,NBS
chr17,Bn69995,87809488,95136954,7327466,CN
chr17,Bn69996,70444969,90784707,20339738,CN
chr17,Bn69997,60027242,70560240,10532998,RLK
chr17,Bn69998,4120005,27344804,23224799,CN
chr17,Bn69999,3429275,80952502,77523227,TNL
chr17,Bn70000,92020862,99026551,7005689,TNL
chr17,Bn70001,65482946,79128796,13645850,CNL
chr17,Bn70002,96200529,97543244,1342715,CN
chr17,Bn70003,28632446,87727281,59094835,TNL
chr17,Bn70004,89405883,92106311,2700428,NBS
chr17,Bn70005,53305880,58772163,5466283,NBS
chr17,Bn70006,36312648,86612469,50299821,RLK
chr17,Bn70007,59928475,76700692,16772217,CNL
chr17,Bn70008,14437558,20398275,5960717,RLP
chr17,Bn70009,41117420,56811343,15693923,TNL
chr17,Bn70010,22991346,76249210,53257864,RLP
chr17,Bn70011,32858469,51141569,18283100,TNL
chr17,Bn70012,55563992,71717931,16153939,CN
chr17,Bn70013,50966094,74001573,23035479,RLP
chr17,Bn70014,51756087,65561104,13805017,CN
chr17,Bn70015,98458348,98798049,339701,TNL
chr17,Bn70016,48762036,86359806,37597770,TN
chr17,Bn70017,58614136,80130183,21516047,RLP
chr17,Bn70018,85739670,99519739,13780069,RLP
chr17,Bn70019,36929014,48119681,11190667,NBS
chr17,Bn70020,92573411,99165478,6592067,CNL
chr17,Bn70021,96509630,96789650,280020,TN
chr17,Bn70022,92041802,93379436,1337634,CNL
chr17,Bn70023,8184526,71984450,63799924,CNL
chr17,Bn70024,39643566,63907724,24264158,RLP
chr17,Bn70025,37689030,68226536,30537506,RLK
chr17,Bn70026,59760242,70501633,10741391,CN
chr17,Bn70027,7869986,84590333,76720347,CN
chr17,Bn70028,91019898,94713012,3693114,RLP
chr17,Bn70029,3027000,85385252,82358252,NBS
chr17,Bn70030,36684888,47025082,10340194,CNL
chr17,Bn70031,81700257,86270917,4570660,CN
chr17,Bn70032,5619943,82434054,76814111,RLP
chr17,Bn70033,48263662,84123333,35859671,TNL
chr17,Bn70034,35260320,67038255,31777935,TN
chr17,Bn70035,96029406,98625867,2596461,CN
chr17,Bn70036,23922799,36249826,12327027,TN
chr17,Bn70037,26116973,97490172,71373199,NBS
chr17,Bn70038,27201062,80889770,53688708,TNL
chr17,Bn70039,70078446,94290047,24211601,CN
chr17,Bn70040,33994428,91164519,57170091,CN
chr17,Bn70041,95043309,99603185,4559876,CNL
chr17,Bn70042,33001237,38197607,5196370,RLK
chr17,Bn70043,62722444,93908902,31186458,TN
chr17,Bn70044,55039407,87291059,32251652,RLP
chr17,Bn70045,76606041,85843621,9237580,TNL
chr17,Bn70046,10995436,15969777,4974341,TNL
chr17,Bn70047,56975115,96702158,39727043,TN
chr17,Bn70048,81916235,84937054,3020819,CN
chr17,Bn70049,76553950,94999929,18445979,TNL
chr17,Bn70050,36128973,96504381,60375408,RLP
chr17,Bn70051,25637603,54046751,28409148,RLP
chr17,Bn70052,61382940,75664605,14281665,RLK
chr17,Bn70053,56077743,77271279,21193536,CNL
chr17,Bn70054,94246189,94368857,122668,CNL
chr17,Bn70055,25156536,63002993,37846457,CN
chr17,Bn70056,65744742,67038223,1293481,CNL
chr17,Bn70057,63057321,63926942,869621,NBS
chr17,Bn70058,89774981,92431211,2656230,CNL
chr17,Bn70059,52608124,75986652,23378528,TNL
chr17,Bn70060,62389257,75648076,13258819,TN
chr17,Bn70061,76220953,86093601,9872648,CN
chr17,Bn70062,34549424,90646608,56097184,RLP
chr17,Bn70063,97734608,97879692,145084,NBS
chr17,Bn70064,89434725,91095569,1660844,NBS
chr17,Bn70065,26946372,37442823,10496451,CNL
chr17,Bn70066,13388675,26476288,13087613,TNL
chr17,Bn70067,36795124,38219945,1424821,RLK
chr17,Bn70068,59739150,82662606,22923456,CN
chr17,Bn70069,5666984,92343252,86676268,RLK
chr17,Bn70070,42589392,49437856,6848464,CN
chr17,Bn70071,42945357,53780457,10835100,CNL
chr17,Bn70072,57416980,66474889,9057909,RLK
chr17,Bn70073,30331478,67673397,37341919,RLK
chr17,Bn70074,14062463,93767201,79704738,NBS
chr17,Bn70075,63739591,92897165,29157574,RLP
chr17,Bn70076,45747218,94100937,48353719,CN
chr17,Bn70077,87771269,91720619,3949350,CN
chr17,Bn70078,64342832,71025182,6682350,RLK
chr17,Bn70079,59159246,78045331,18886085,TNL
chr17,Bn70080,80097221,82524297,2427076,TNL
chr17,Bn70081,19540677,34580633,15039956,TNL
chr17,Bn70082,7271270,59284980,52013710,CN
chr17,Bn70083,96234426,99089670,2855244,NBS
chr17,Bn70084,18494076,71299555,52805479,RLP
chr17,Bn70085,13814988,66253058,52438070,TNL
chr17,Bn70086,8658283,95781054,87122771,NBS
chr17,Bn70087,29604551,54000034,24395483,TNL
chr17,Bn70088,76882885,87776630,10893745,CNL
chr17,Bn70089,61239634,75869300,14629666,TNL
chr17,Bn70090,49169610,72608147,23438537,TN
chr17,Bn70091,6813100,43322899,36509799,RLK
chr17,Bn70092,98601260,98881064,279804,RLK
chr17,Bn70093,32923972,74777275,41853303,RLP
chr17,Bn70094,50412001,72071421,21659420,TNL
chr17,Bn70095,93125977,93374043,248066,NBS
chr17,Bn70096,67913059,74549431,6636372,CN
chr17,Bn70097,2844309,13101503,10257194,RLK
chr17,Bn70098,49037851,75608012,26570161,NBS
chr17,Bn70099,9815581,50505010,40689429,RLK
chr17,Bn70100,42648301,99462529,56814228,CNL
chr17,Bn70101,36337886,92147543,55809657,RLK
chr17,Bn70102,13131892,85813365,72681473,TNL
chr17,Bn70103,42625689,74379613,31753924,RLK
chr17,Bn70104,31815307,36289454,4474147,CNL
chr17,Bn70105,77849981,90949616,13099635,NBS
chr17,Bn70106,12661332,54610273,41948941,RLP
chr17,Bn70107,32048939,89800306,57751367,RLK
chr17,Bn70108,11403910,48241495,36837585,NBS
chr17,Bn70109,98450210,99933524,1483314,NBS
chr17,Bn70110,72676745,79569568,6892823,NBS
chr17,Bn70111,5459433,99365629,93906196,CNL
chr17,Bn70112,65506645,71938069,6431424,NBS
chr17,Bn70113,87695610,91336118,3640508,CN
chr17,Bn70114,3508737,25751733,22242996,TNL
chr17,Bn70115,13306408,86969747,73663339,NBS
chr17,Bn70116,6815955,51795763,44979808,NBS
chr17,Bn70117,93625183,98537890,4912707,CN
chr17,Bn70118,60071031,79540449,19469418,RLP
chr17,Bn70119,28976384,48355771,19379387,CN
chr17,Bn70120,13464670,45417611,31952941,CNL
chr17,Bn70121,53775451,78863997,25088546,RLK
chr17,Bn70122,48806551,50459105,1652554,RLP
chr17,Bn70123,50563177,78655127,28091950,CN
chr17,Bn70124,2451297,19092780,16641483,RLP
chr17,Bn70125,99087858,99164447,76589,RLP
chr17,Bn70126,57668966,71917858,14248892,TN
chr17,Bn70127,16244914,52527140,36282226,RLK
chr17,Bn70128,20072566,53923007,33850441,CN
chr17,Bn70129,50617956,87081812,36463856,RLP
chr17,Bn70130,66173896,86363666,20189770,CN
chr17,Bn70131,65078628,73079968,8001340,TNL
chr17,Bn70132,15366719,85619065,70252346,CNL
chr17,Bn70133,34211517,56580581,22369064,RLK
chr17,Bn70134,9517103,26384720,16867617,TNL
chr17,Bn70135,33172454,85508003,52335549,TN
chr17,Bn70136,64320203,75423552,11103349,CN
chr17,Bn70137,80108032,99189754,19081722,RLK
chr17,Bn70138,26313535,44706792,18393257,CNL
chr17,Bn70139,7677604,50713027,43035423,NBS
chr17,Bn70140,7701927,95635790,87933863,TN
chr17,Bn70141,26455312,76656556,50201244,RLP
chr17,Bn70142,67924636,76323175,8398539,TNL
chr17,Bn70143,59382661,68743231,9360570,TNL
chr17,Bn70144,13867836,84464675,70596839,NBS
chr17,Bn70145,97399924,97793621,393697,NBS
chr17,Bn70146,34110613,99284097,65173484,RLP
chr17,Bn70147,66050563,82537319,16486756,TNL
chr17,Bn70148,61660849,73649193,11988344,RLK
chr17,Bn70149,83273949,97916658,14642709,CNL
chr17,Bn70150,39545693,50127514,10581821,CN
chr17,Bn70151,44477430,74949554,30472124,CN
chr17,Bn70152,59685974,87149843,27463869,TN
chr17,Bn70153,70243907,95913761,25669854,TNL
chr17,Bn70154,47489142,75531569,28042427,CNL
chr17,Bn70155,46062189,49965730,3903541,TNL
chr17,Bn70156,54799910,92674672,37874762,TNL
chr17,Bn70157,21048656,58830689,37782033,CN
chr17,Bn70158,91537712,99844518,8306806,CNL
chr17,Bn70159,97631023,98490019,858996,CNL
chr17,Bn70160,11362767,38515854,27153087,TN
chr17,Bn70161,64645405,82086910,17441505,TN
chr17,Bn70162,41131179,98485323,57354144,CN
chr17,Bn70163,6741346,11543645,4802299,RLK
chr17,Bn70164,25738488,47997267,22258779,CNL
chr17,Bn70165,3570986,4202855,631869,NBS
chr17,Bn70166,64623384,69669659,5046275,TN
chr17,Bn70167,38753783,99122458,60368675,CNL
chr17,Bn70168,60471524,76800095,16328571,RLP
chr17,Bn70169,59327570,93845495,34517925,TN
chr17,Bn70170,92549029,95539191,2990162,RLK
chr17,Bn70171,42464403,79789872,37325469,TNL
chr17,Bn70172,51580664,61366454,9785790,NBS
chr17,Bn70173,94099313,95787142,1687829,RLK
chr17,Bn70174,20157734,40779963,20622229,CNL
chr17,Bn70175,70011020,98966977,28955957,NBS
chr17,Bn70176,75894059,88646290,12752231,TNL
chr17,Bn70177,18761311,77606829,58845518,RLP
chr17,Bn70178,22255885,78165665,55909780,TNL
chr17,Bn70179,47801836,73879417,26077581,NBS
chr17,Bn70180,14966468,45284490,30318022,NBS
chr17,Bn70181,2672548,5303897,2631349,RLP
chr17,Bn70182,86921671,91433120,4511449,CN
chr17,Bn70183,69527984,70042217,514233,CN
chr17,Bn70184,90025436,98340991,8315555,RLK
chr17,Bn70185,80730778,81906204,1175426,TN
chr17,Bn70186,37265007,86421193,49156186,CNL
chr17,Bn70187,44025120,70616368,26591248,RLP
chr17,Bn70188,69170655,76294969,7124314,RLP
chr17,Bn70189,17250179,92570678,75320499,RLP
chr17,Bn70190,45811462,95731051,49919589,RLK
chr17,Bn70191,78451540,79714627,1263087,RLP
chr17,Bn70192,84693459,85309476,616017,RLK
chr17,Bn70193,40948351,54216924,13268573,TN
chr17,Bn70194,98720636,98963170,242534,RLK
chr17,Bn70195,47293040,94956597,47663557,RLP
chr17,Bn70196,77805435,79886807,2081372,TNL
chr17,Bn70197,7012867,83389088,76376221,RLK
chr17,Bn70198,92247785,92434284,186499,RLP
chr17,Bn70199,10154887,77551551,67396664,CNL
chr17,Bn70200,33165030,89752327,56587297,NBS
chr17,Bn70201,2790447,72008197,69217750,TNL
chr17,Bn70202,12671737,19114368,6442631,RLP
chr17,Bn70203,64742665,80913255,16170590,NBS
chr17,Bn70204,63113646,90347944,27234298,TNL
chr17,Bn70205,95829639,99149529,3319890,TNL
chr17,Bn70206,27628467,36398814,8770347,RLP
chr17,Bn70207,89635927,98838825,9202898,TN
chr17,Bn70208,35630154,57519800,21889646,RLP
chr17,Bn70209,10272245,48610055,38337810,RLK
chr17,Bn70210,1388652,42325378,40936726,RLK
chr17,Bn70211,61995870,72165935,10170065,RLP
chr17,Bn70212,32004698,53835626,21830928,TN
chr17,Bn70213,87938211,93429983,5491772,NBS
chr17,Bn70214,13006453,23573335,10566882,CN
chr17,Bn70215,47389117,56614075,9224958,TN
chr17,Bn70216,10577862,70902036,60324174,NBS
chr17,Bn70217,14535144,21914291,7379147,RLP
chr17,Bn70218,85726619,98396065,12669446,CN
chr17,Bn70219,63697262,68975298,5278036,CN
chr17,Bn70220,33960120,36865289,2905169,RLP
chr17,Bn70221,87737971,90600949,2862978,TNL
chr17,Bn70222,23348950,44544098,21195148,NBS
chr17,Bn70223,89015717,96550550,7534833,CN
chr17,Bn70224,67187544,69735959,2548415,TNL
chr17,Bn70225,21191940,93062228,71870288,TN
chr17,Bn70226,61907964,75513753,13605789,RLP
chr17,Bn70227,53260344,98779095,45518751,CN
chr17,Bn70228,13826889,88049134,74222245,CNL
chr17,Bn70229,49805187,59571579,9766392,RLP
chr17,Bn70230,43671472,81594473,37923001,TNL
chr17,Bn70231,29856906,87754756,57897850,TN
chr17,Bn70232,50883907,74884002,24000095,RLP
chr17,Bn70233,87525827,89039940,1514113,TNL
chr17,Bn70234,96366898,97706049,1339151,CNL
chr17,Bn70235,73283765,81255106,7971341,NBS
chr17,Bn70236,30694059,40017875,9323816,RLK
chr17,Bn70237,19949156,69979030,50029874,NBS
chr17,Bn70238,82193884,95225960,13032076,TN
chr17,Bn70239,51197669,62760377,11562708,TN
chr17,Bn70240,92603414,95482720,2879306,RLK
chr17,Bn70241,80434363,94727898,14293535,RLP
chr17,Bn70242,8532111,85560805,77028694,CN
chr17,Bn70243,48628683,75586375,26957692,TNL
chr17,Bn70244,18408575,90873941,72465366,RLK
chr17,Bn70245,74191832,87884369,13692537,CNL
chr17,Bn70246,83303472,85710542,2407070,CNL
chr17,Bn70247,98057121,98735827,678706,TN
chr17,Bn70248,17257627,63382136,46124509,CNL
chr17,Bn70249,24298552,92761000,68462448,RLK
chr17,Bn70250,75064581,92434561,17369980,TN
chr17,Bn70251,43954197,52115514,8161317,RLK
chr17,Bn70252,93988183,97876155,3887972,CNL
chr17,Bn70253,12446890,88252184,75805294,NBS
chr17,Bn70254,50029075,99945388,49916313,RLK
chr17,Bn70255,11641817,68215733,56573916,TN
chr17,Bn70256,93858337,93952053,93716,RLK
chr17,Bn70257,12148464,81154335,69005871,CNL
chr17,Bn70258,22234966,95876836,73641870,RLK
chr17,Bn70259,62359390,73191590,10832200,CN
chr17,Bn70260,81941270,92230475,10289205,RLP
chr17,Bn70261,58988590,70964423,11975833,RLK
chr17,Bn70262,51593184,83597900,32004716,CN
chr17,Bn70263,6644062,57548356,50904294,RLP
chr17,Bn70264,22193631,61530376,39336745,TNL
chr17,Bn70265,80359956,91388381,11028425,TNL
chr17,Bn70266,29064940,91350995,62286055,CNL
chr17,Bn70267,15984741,98808358,82823617,NBS
chr17,Bn70268,61104532,70854668,9750136,TNL
chr17,Bn70269,41482027,44483250,3001223,NBS
chr17,Bn70270,12867357,35379079,22511722,RLK
chr17,Bn70271,87542908,96900196,9357288,RLK
chr17,Bn70272,83995189,87944172,3948983,RLP
chr17,Bn70273,58624121,83611165,24987044,TNL
chr17,Bn70274,45274119,75641712,30367593,CN
chr17,Bn70275,31948402,66157144,34208742,CNL
chr17,Bn70276,86548541,90690654,4142113,TNL
chr17,Bn70277,95252475,98211827,2959352,CN
chr17,Bn70278,62820865,76858796,14037931,TNL
chr17,Bn70279,7438456,75521114,68082658,RLP
chr17,Bn70280,46450407,98395948,51945541,CN
chr17,Bn70281,37783578,79052416,41268838,TNL
chr17,Bn70282,4863696,38171148,33307452,RLP
chr17,Bn70283,38643724,93105066,54461342,RLP
chr17,Bn70284,15136464,64727382,49590918,CN
chr17,Bn70285,70210722,83771866,13561144,CNL
chr17,Bn70286,15182689,20779922,5597233,CN
chr17,Bn70287,7215494,71756053,64540559,RLP
chr17,Bn70288,46222435,91963494,45741059,NBS
chr17,Bn70289,28182088,29694603,1512515,CNL
chr17,Bn70290,65254754,65519221,264467,TNL
chr17,Bn70291,25288675,83803577,58514902,CN
chr17,Bn70292,87401059,97735310,10334251,RLK
chr17,Bn70293,18776214,83462374,64686160,NBS
chr17,Bn70294,22241084,47119203,24878119,CNL
chr17,Bn70295,20762235,37219469,16457234,CN
chr17,Bn70296,28822926,65041173,36218247,CN
chr17,Bn70297,47090658,94825075,47734417,CNL
chr17,Bn70298,18283498,49238724,30955226,CNL
chr17,Bn70299,44192645,89474769,45282124,TN
chr17,Bn70300,48087642,63038969,14951327,RLK
chr17,Bn70301,58661660,72241142,13579482,TN
chr17,Bn70302,35828292,84709229,48880937,RLK
chr17,Bn70303,57801628,93374734,35573106,CNL
chr17,Bn70304,41560253,71078452,29518199,CNL
chr17,Bn70305,14034894,74279957,60245063,TN
chr17,Bn70306,44204879,83106238,38901359,RLK
chr17,Bn70307,76645008,76990749,345741,CNL
chr17,Bn70308,18078750,31748404,13669654,CN
chr17,Bn70309,38585441,64632177,26046736,NBS
chr17,Bn70310,29445707,65416041,35970334,TNL
chr17,Bn70311,95247881,97368909,2121028,RLP
chr17,Bn70312,11507518,59285820,47778302,CN
chr17,Bn70313,71782638,89431230,17648592,RLP
chr17,Bn70314,40423062,65697350,25274288,CNL
chr17,Bn70315,88748868,89645280,896412,CN
chr17,Bn70316,8951367,16459203,7507836,RLP
chr17,Bn70317,24201268,45441710,21240442,TNL
chr17,Bn70318,2293304,27046314,24753010,TN
chr17,Bn70319,1448603,81574313,80125710,RLK
chr17,Bn70320,57405544,71304625,13899081,RLP
chr17,Bn70321,99050939,99895449,844510,RLK
chr17,Bn70322,13413521,16501190,3087669,RLP
chr17,Bn70323,79098383,83628344,4529961,TNL
chr17,Bn70324,63260895,84419486,21158591,CNL
chr17,Bn70325,81864825,95257035,13392210,RLK
chr17,Bn70326,45868337,85207243,39338906,RLK
chr17,Bn70327,22614973,56461128,33846155,RLK
chr17,Bn70328,34687647,69457046,34769399,TNL
chr17,Bn70329,41716048,70588443,28872395,TN
chr17,Bn70330,36454430,54851461,18397031,RLK
chr17,Bn70331,8363932,74495579,66131647,NBS
chr17,Bn70332,68929781,86365606,17435825,CN
chr17,Bn70333,29132632,58084149,28951517,RLP
chr17,Bn70334,31863080,59974781,28111701,RLK
chr17,Bn70335,35165591,65157834,29992243,RLP
chr17,Bn70336,24568688,59913998,35345310,TNL
chr17,Bn70337,11527356,44044628,32517272,RLP
chr17,Bn70338,34347276,59445421,25098145,TN
chr17,Bn70339,61992692,77301545,15308853,TN
chr17,Bn70340,83219156,87355079,4135923,RLK
chr17,Bn70341,12593624,93674604,81080980,CN
chr17,Bn70342,6643332,69133629,62490297,NBS
chr17,Bn70343,29045271,46366112,17320841,CN
chr17,Bn70344,20888683,96775460,75886777,CN
chr17,Bn70345,93089226,96367122,3277896,TN
chr17,Bn70346,9162996,54825719,45662723,CNL
chr17,Bn70347,58216918,75896784,17679866,TN
chr17,Bn70348,30057786,52216050,22158264,RLP
chr17,Bn70349,61371141,62702300,1331159,CNL
chr17,Bn70350,26576416,43417203,16840787,TNL
chr17,Bn70351,84868987,97788814,12919827,CN
chr17,Bn70352,24657859,73227941,48570082,TNL
chr17,Bn70353,34906322,97010703,62104381,NBS
chr17,Bn70354,40076576,82624106,42547530,RLK
chr17,Bn70355,94899197,96354105,1454908,TNL
chr17,Bn70356,72233126,80132270,7899144,TN
chr17,Bn70357,97285898,97622748,336850,CNL
chr17,Bn70358,99069171,99105488,36317,CNL
chr17,Bn70359,96060782,99761902,3701120,NBS
chr17,Bn70360,11638341,87640975,76002634,NBS
chr17,Bn70361,8358716,74955796,66597080,CN
chr17,Bn70362,20916022,21220202,304180,TN
chr17,Bn70363,39900775,78720119,38819344,RLK
chr17,Bn70364,99802426,99981499,179073,TN
chr17,Bn70365,73562559,94334877,20772318,RLK
chr17,Bn70366,94375946,99874003,5498057,TNL
chr17,Bn70367,96964252,98353605,1389353,RLK
chr17,Bn70368,21341417,61849350,40507933,CNL
chr17,Bn70369,87637167,89877973,2240806,TN
chr17,Bn70370,61848671,76031915,14183244,NBS
chr17,Bn70371,81309622,88969061,7659439,CN
chr17,Bn70372,85556593,90388233,4831640,TN
chr17,Bn70373,58526297,84248183,25721886,CN
chr17,Bn70374,44391495,47586353,3194858,CN
chr17,Bn70375,5076760,49932924,44856164,CN
chr17,Bn70376,78748593,91618513,12869920,RLK
chr17,Bn70377,89964247,94667969,4703722,CNL
chr17,Bn70378,10806793,31715760,20908967,RLK
chr17,Bn70379,77522004,80142273,2620269,CN
chr17,Bn70380,28798581,96590725,67792144,TNL
chr17,Bn70381,9594253,30019374,20425121,CN
chr17,Bn70382,80514728,88008554,7493826,NBS
chr17,Bn70383,61422473,85060327,23637854,TN
chr17,Bn70384,17095923,31510725,14414802,NBS
chr17,Bn70385,9233905,32779411,23545506,CNL
chr17,Bn70386,82843018,90888221,8045203,CNL
chr17,Bn70387,89671175,94680980,5009805,RLP
chr17,Bn70388,50446079,83578672,33132593,NBS
chr17,Bn70389,89918284,91566400,1648116,CN
chr17,Bn70390,1331996,76545795,75213799,CNL
chr17,Bn70391,76473216,81201198,4727982,CN
chr17,Bn70392,93153708,94012299,858591,CN
chr17,Bn70393,53829409,58985413,5156004,TNL
chr17,Bn70394,23124260,78183624,55059364,TN
chr17,Bn70395,10623878,86519901,75896023,TN
chr17,Bn70396,41692546,75794607,34102061,CNL
chr17,Bn70397,46694195,70945588,24251393,TN
chr17,Bn70398,39979714,82156810,42177096,CN
chr17,Bn70399,76624855,92971227,16346372,CN
chr17,Bn70400,45748516,92561167,46812651,CN
chr17,Bn70401,67931212,89239641,21308429,CN
chr17,Bn70402,51730017,56204332,4474315,CNL
chr17,Bn70403,44616008,48043744,3427736,RLK
chr17,Bn70404,48973466,81701576,32728110,RLK
chr17,Bn70405,43471261,94942733,51471472,NBS
chr17,Bn70406,88628384,96031707,7403323,RLK
chr17,Bn70407,52912179,57466444,4554265,RLP
chr17,Bn70408,66113492,80019062,13905570,TN
chr17,Bn70409,26049830,76675445,50625615,TNL
chr17,Bn70410,91091132,99811667,8720535,NBS
chr17,Bn70411,40724242,86482123,45757881,NBS
chr17,Bn70412,95820584,98581718,2761134,NBS
chr17,Bn70413,13750854,95818861,82068007,TNL
chr17,Bn70414,77542504,78288047,745543,RLK
chr17,Bn70415,48276047,97158358,48882311,CN
chr17,Bn70416,27083154,85332425,58249271,CN
chr17,Bn70417,18346239,40252916,21906677,RLK
chr17,Bn70418,36848659,55962655,19113996,RLP
chr17,Bn70419,52632421,71463591,18831170,RLK
chr17,Bn70420,11269113,25319155,14050042,TNL
chr17,Bn70421,32109039,96836271,64727232,TNL
chr17,Bn70422,1766276,40674944,38908668,NBS
chr17,Bn70423,94572791,96873276,2300485,NBS
chr17,Bn70424,79464181,97863478,18399297,TN
chr17,Bn70425,25637783,99260170,73622387,NBS
chr17,Bn70426,35154496,77399662,42245166,TN
chr17,Bn70427,20185851,76745189,56559338,TN
chr17,Bn70428,24807498,97054848,72247350,NBS
chr17,Bn70429,11109861,37909524,26799663,RLK
chr17,Bn70430,62442634,83829194,21386560,RLK
chr17,Bn70431,15859672,35884317,20024645,TNL
chr17,Bn70432,88615013,90604420,1989407,RLP
chr17,Bn70433,51561561,61989642,10428081,TN
chr17,Bn70434,96111644,98475241,2363597,RLK
chr17,Bn70435,78857204,83106367,4249163,RLP
chr17,Bn70436,26802106,91574781,64772675,TNL
chr17,Bn70437,51183838,75482482,24298644,TN
chr17,Bn70438,16676708,86841156,70164448,CNL
chr17,Bn70439,18431238,43599311,25168073,RLK
chr17,Bn70440,5259554,38522990,33263436,NBS
chr17,Bn70441,65886586,74538874,8652288,NBS
chr17,Bn70442,52336473,53316603,980130,TN
chr17,Bn70443,2115562,49524018,47408456,RLK
chr17,Bn70444,7360645,56016548,48655903,TNL
chr17,Bn70445,57923071,70424220,12501149,RLK
chr17,Bn70446,9358081,87956768,78598687,RLP
chr17,Bn70447,25761047,58846011,33084964,TN
chr17,Bn70448,87549248,91851500,4302252,CN
chr17,Bn70449,5020290,85934157,80913867,TN
chr17,Bn70450,21550626,23566881,2016255,RLK
chr17,Bn70451,63711301,86525855,22814554,TN
chr17,Bn70452,48781819,65098655,16316836,RLP
chr17,Bn70453,55155759,96204003,41048244,CNL
chr17,Bn70454,10649743,75894487,65244744,NBS
chr17,Bn70455,34848220,48494603,13646383,CN
chr17,Bn70456,74351069,96206207,21855138,NBS
chr17,Bn70457,1989064,95627290,93638226,CN
chr17,Bn70458,84526238,96704657,12178419,CNL
chr17,Bn70459,3825357,26103203,22277846,RLK
chr17,Bn70460,25104924,74884117,49779193,RLP
chr17,Bn70461,84482957,91478438,6995481,CNL
chr17,Bn70462,29938907,88344999,58406092,NBS
chr17,Bn70463,31158164,82521189,51363025,TNL
chr17,Bn70464,27276448,49796183,22519735,NBS
chr17,Bn70465,62930201,64304925,1374724,CNL
chr17,Bn70466,26568953,34223005,7654052,TNL
chr17,Bn70467,81125313,91178991,10053678,CN
chr17,Bn70468,94820825,99632230,4811405,NBS
chr17,Bn70469,43451135,63900551,20449416,CN
chr17,Bn70470,17736676,54666220,36929544,TNL
chr17,Bn70471,49976895,71080115,21103220,CNL
chr17,Bn70472,23676286,29701029,6024743,CNL
chr17,Bn70473,54370567,62445675,8075108,CN
chr17,Bn70474,84033959,99154182,15120223,CNL
chr17,Bn70475,54549574,97369760,42820186,TN
chr17,Bn70476,69918854,94002671,24083817,CNL
chr17,Bn70477,70796942,75428060,4631118,NBS
chr17,Bn70478,18375711,38829741,20454030,TN
chr17,Bn70479,53675745,82439062,28763317,CN
chr17,Bn70480,21696858,85907619,64210761,RLP
chr17,Bn70481,20195857,90314552,70118695,CNL
chr17,Bn70482,10997989,81240865,70242876,TNL
chr17,Bn70483,65665426,90247616,24582190,NBS
chr17,Bn70484,37031517,65582166,28550649,RLK
chr17,Bn70485,83560891,92963665,9402774,RLK
chr17,Bn70486,55144773,89487132,34342359,RLP
chr17,Bn70487,61518556,95855152,34336596,NBS
chr17,Bn70488,40323097,83362796,43039699,NBS
chr17,Bn70489,32551387,92288482,59737095,NBS
chr17,Bn70490,97032803,97925686,892883,RLK
chr17,Bn70491,18042424,83831017,65788593,RLK
chr17,Bn70492,58417649,95348586,36930937,TN
chr17,Bn70493,98368863,98375842,6979,CNL
chr17,Bn70494,93087469,97692938,4605469,RLP
chr17,Bn70495,21922913,89339809,67416896,RLK
chr17,Bn70496,95252854,99228302,3975448,TNL
chr17,Bn70497,30992225,73003872,42011647,RLK
chr17,Bn70498,14218514,39799569,25581055,RLP
chr17,Bn70499,17815023,82567563,64752540,RLP
chr17,Bn70500,14580478,37919330,23338852,NBS
chr17,Bn70501,64325792,78402376,14076584,TNL
chr17,Bn70502,79100262,85329449,6229187,TNL
chr17,Bn70503,22742017,96141216,73399199,NBS
chr17,Bn70504,11769320,35810563,24041243,RLP
chr17,Bn70505,5940129,58499238,52559109,CNL
chr17,Bn70506,70322287,89428436,19106149,CN
chr17,Bn70507,37631987,84797377,47165390,NBS
chr17,Bn70508,64890755,88979059,24088304,NBS
chr17,Bn70509,21309505,94456804,73147299,TN
chr17,Bn70510,44526285,87129899,42603614,RLP
chr17,Bn70511,20368814,41054751,20685937,NBS
chr17,Bn70512,14217226,23953485,9736259,RLP
chr17,Bn70513,90619123,97450491,6831368,CNL
chr17,Bn70514,18742769,43081246,24338477,TNL
chr17,Bn70515,8496216,51990970,43494754,CNL
chr17,Bn70516,48289406,50546199,2256793,RLK
chr17,Bn70517,57115778,88495736,31379958,TNL
chr17,Bn70518,3875913,97884402,94008489,TNL
chr17,Bn70519,98262096,98562818,300722,CN
chr17,Bn70520,53685289,94616021,40930732,TNL
chr17,Bn70521,92539162,94758233,2219071,CN
chr17,Bn70522,88268093,93402451,5134358,RLP
chr17,Bn70523,78073343,94508858,16435515,CN
chr17,Bn70524,20209987,34165573,13955586,RLP
chr17,Bn70525,71190315,89214944,18024629,RLP
chr17,Bn70526,36612012,83126941,46514929,RLP
chr17,Bn70527,50754009,87516975,36762966,RLP
chr17,Bn70528,92227248,92760246,532998,RLP
chr17,Bn70529,5158404,63768770,58610366,TNL
chr17,Bn70530,22792897,96762921,73970024,RLK
chr17,Bn70531,22442333,57795264,35352931,CN
chr17,Bn70532,46163828,94875636,48711808,TNL
chr17,Bn70533,95430834,96374808,943974,TNL
chr17,Bn70534,88418509,91260616,2842107,RLP
chr17,Bn70535,70865146,79427882,8562736,CNL
chr17,Bn70536,3105490,44225570,41120080,NBS
chr17,Bn70537,57447970,81922583,24474613,RLP
chr17,Bn70538,74064856,74350743,285887,CNL
chr17,Bn70539,19849788,75975426,56125638,RLP
chr17,Bn70540,54888038,90185691,35297653,RLP
chr17,Bn70541,86256085,87896452,1640367,TN
chr17,Bn70542,65470568,69755920,4285352,CN
chr17,Bn70543,58972278,64085490,5113212,TN
chr18,Bn70544,25357464,31030459,5672995,CNL
chr18,Bn70545,70569442,79710929,9141487,TNL
chr18,Bn70546,90846863,94126717,3279854,RLP
chr18,Bn70547,20548450,74397743,53849293,CNL
chr18,Bn70548,28027350,61878393,33851043,RLK
chr18,Bn70549,39374620,98555260,59180640,TN
chr18,Bn70550,43553752,63397796,19844044,TN
chr18,Bn70551,6880433,24036961,17156528,TNL
chr18,Bn70552,59580535,95960187,36379652,RLK
chr18,Bn70553,10325545,72447992,62122447,RLK
chr18,Bn70554,5657370,69346228,63688858,TNL
chr18,Bn70555,61366725,68123821,6757096,TN
chr18,Bn70556,61114575,92272438,31157863,NBS
chr18,Bn70557,6596666,7258917,662251,TN
chr18,Bn70558,9521982,48988647,39466665,CNL
chr18,Bn70559,99702391,99741114,38723,RLP
chr18,Bn70560,53351538,92779303,39427765,RLP
chr18,Bn70561,91756260,96530882,4774622,CN
chr18,Bn70562,79846046,85659940,5813894,NBS
chr18,Bn70563,9763664,19294642,9530978,CNL
chr18,Bn70564,14732556,44913876,30181320,TNL
chr18,Bn70565,39124661,66673153,27548492,CN
chr18,Bn70566,69484164,97295961,27811797,NBS
chr18,Bn70567,5804681,74869449,69064768,NBS
chr18,Bn70568,80656542,91155328,10498786,CN
chr18,Bn70569,85021938,97247344,12225406,CN
chr18,Bn70570,84457299,96513038,12055739,RLP
chr18,Bn70571,81631154,99203211,17572057,NBS
chr18,Bn70572,2202978,65987988,63785010,CNL
chr18,Bn70573,88157191,93758757,5601566,CN
chr18,Bn70574,62839349,67963126,5123777,TN
chr18,Bn70575,88511048,95430481,6919433,TN
chr18,Bn70576,27639615,47390025,19750410,RLK
chr18,Bn70577,59044839,96514432,37469593,TN
chr18,Bn70578,7223044,42891413,35668369,RLK
chr18,Bn70579,70603265,92920921,22317656,RLK
chr18,Bn70580,4158279,59365852,55207573,TNL
chr18,Bn70581,4859838,87144460,82284622,RLK
chr18,Bn70582,16715952,70574821,53858869,TNL
chr18,Bn70583,34824499,42519511,7695012,TNL
chr18,Bn70584,4788883,58003332,53214449,TNL
chr18,Bn70585,94468690,99206522,4737832,RLK
chr18,Bn70586,8827701,59387533,50559832,TN
chr18,Bn70587,20346349,75966401,55620052,RLP
chr18,Bn70588,65508951,69109535,3600584,CN
chr18,Bn70589,97783292,99288897,1505605,TN
chr18,Bn70590,24564355,76528666,51964311,RLP
chr18,Bn70591,16330005,50748818,34418813,TNL
chr18,Bn70592,18383503,61363222,42979719,RLP
chr18,Bn70593,59703036,97656316,37953280,RLK
chr18,Bn70594,56106072,79549985,23443913,RLK
chr18,Bn70595,6900524,65986962,59086438,RLP
chr18,Bn70596,11963951,55394265,43430314,RLP
chr18,Bn70597,28863775,38314316,9450541,TNL
chr18,Bn70598,98178440,99548211,1369771,CNL
chr18,Bn70599,98187468,99605114,1417646,CNL
chr18,Bn70600,77861982,96848995,18987013,NBS
chr18,Bn70601,30237882,78346342,48108460,RLK
chr18,Bn70602,71373276,75147901,3774625,TN
chr18,Bn70603,93364647,99048021,5683374,TN
chr18,Bn70604,2666078,89969165,87303087,TN
chr18,Bn70605,46598704,49839837,3241133,NBS
chr18,Bn70606,73176224,91708220,18531996,TNL
chr18,Bn70607,89172689,98180192,9007503,TN
chr18,Bn70608,80517065,93207142,12690077,RLK
chr18,Bn70609,38967044,59166874,20199830,TN
chr18,Bn70610,73387543,89329242,15941699,TNL
chr18,Bn70611,33569336,50885025,17315689,TNL
chr18,Bn70612,90781333,95097305,4315972,TNL
chr18,Bn70613,70511536,78602164,8090628,CN
chr18,Bn70614,56439707,96666528,40226821,CN
chr18,Bn70615,20935054,40974588,20039534,TN
chr18,Bn70616,80368717,96848201,16479484,RLK
chr18,Bn70617,98375718,98794405,418687,CNL
chr18,Bn70618,44899385,67012704,22113319,CN
chr18,Bn70619,9517493,77582537,68065044,RLP
chr18,Bn70620,65582384,73480825,7898441,CNL
chr18,Bn70621,51515312,60184794,8669482,RLP
chr18,Bn70622,63964146,77306993,13342847,RLK
chr18,Bn70623,75454508,93607842,18153334,RLK
chr18,Bn70624,4012857,4079560,66703,TNL
chr18,Bn70625,77981830,97934615,19952785,NBS
chr18,Bn70626,57329782,80275264,22945482,TNL
chr18,Bn70627,46570112,97943116,51373004,CNL
chr18,Bn70628,4803985,11869182,7065197,RLP
chr18,Bn70629,27515963,48785117,21269154,TNL
chr18,Bn70630,43919679,78049286,34129607,RLP
chr18,Bn70631,73235472,83184615,9949143,TN
chr18,Bn70632,13238484,99121988,85883504,CN
chr18,Bn70633,57514394,78632188,21117794,NBS
chr18,Bn70634,76339827,89332659,12992832,TN
chr18,Bn70635,36189276,51241513,15052237,RLK
chr18,Bn70636,72129942,84455607,12325665,RLK
chr18,Bn70637,25956927,59352895,33395968,CNL
chr18,Bn70638,90668246,97062648,6394402,TN
chr18,Bn70639,30727311,61589422,30862111,RLK
chr18,Bn70640,5090416,18090057,12999641,CN
chr18,Bn70641,97898095,99687208,1789113,RLP
chr18,Bn70642,58048012,61912213,3864201,NBS
chr18,Bn70643,84524985,96210772,11685787,CNL
chr18,Bn70644,8830923,77594208,68763285,RLK
chr18,Bn70645,78890266,94194164,15303898,TN
chr18,Bn70646,54660346,89897487,35237141,NBS
chr18,Bn70647,70831898,83953088,13121190,RLP
chr18,Bn70648,59041436,62498556,3457120,RLP
chr18,Bn70649,78500008,82538751,4038743,CN
chr18,Bn70650,59806883,97808613,38001730,NBS
chr18,Bn70651,94627492,96879661,2252169,CN
chr18,Bn70652,63454680,85937451,22482771,RLP
chr18,Bn70653,1623692,9418918,7795226,RLP
chr18,Bn70654,21942361,64154765,42212404,CN
chr18,Bn70655,44102343,63999840,19897497,RLP
chr18,Bn70656,98425935,99018665,592730,TNL
chr18,Bn70657,95110417,97598733,2488316,NBS
chr18,Bn70658,51911215,75999496,24088281,RLK
chr18,Bn70659,71877834,83980037,12102203,CN
chr18,Bn70660,98575346,98848068,272722,NBS
chr18,Bn70661,92741185,94837181,2095996,TNL
chr18,Bn70662,98010537,99968637,1958100,CNL
chr18,Bn70663,79371381,97353299,17981918,NBS
chr18,Bn70664,73439610,96617027,23177417,CN
chr18,Bn70665,27381124,79401629,52020505,TN
chr18,Bn70666,38774788,63230581,24455793,RLK
chr18,Bn70667,74026833,81013706,6986873,NBS
chr18,Bn70668,3958548,61669749,57711201,RLK
chr18,Bn70669,48091083,58789546,10698463,RLK
chr18,Bn70670,35114840,60442037,25327197,NBS
chr18,Bn70671,98651213,98922267,271054,CN
chr18,Bn70672,41579084,41807448,228364,NBS
chr18,Bn70673,33221628,93155406,59933778,CN
chr18,Bn70674,27098552,67803344,40704792,NBS
chr18,Bn70675,70768350,99773510,29005160,NBS
chr18,Bn70676,63515739,67025741,3510002,RLP
chr18,Bn70677,62621173,91030096,28408923,CNL
chr18,Bn70678,15524735,93838077,78313342,CNL
chr18,Bn70679,45811545,98167526,52355981,RLK
chr18,Bn70680,86845389,97726063,10880674,CNL
chr18,Bn70681,48111159,92052370,43941211,TNL
chr18,Bn70682,60683226,95889789,35206563,CNL
chr18,Bn70683,96681929,99607674,2925745,CN
chr18,Bn70684,11488882,16539816,5050934,NBS
chr18,Bn70685,47417884,51243443,3825559,CNL
chr18,Bn70686,65369516,84628526,19259010,RLP
chr18,Bn70687,81536085,96239217,14703132,RLK
chr18,Bn70688,69310837,99631534,30320697,CNL
chr18,Bn70689,66321353,92731415,26410062,RLK
chr18,Bn70690,65931036,98726389,32795353,TN
chr18,Bn70691,27720662,34006702,6286040,CN
chr18,Bn70692,9037824,42659112,33621288,TN
chr18,Bn70693,97888368,99584073,1695705,TN
chr18,Bn70694,73477610,90695174,17217564,RLP
chr18,Bn70695,97445890,97772894,327004,RLP
chr18,Bn70696,63556783,96603494,33046711,RLP
chr18,Bn70697,60208026,93740187,33532161,RLK
chr18,Bn70698,21383981,72056656,50672675,CNL
chr18,Bn70699,66784072,70163778,3379706,TNL
chr18,Bn70700,49797911,63613068,13815157,RLP
chr18,Bn70701,79487794,89907503,10419709,TN
chr18,Bn70702,38400220,94198475,55798255,NBS
chr18,Bn70703,99716889,99849513,132624,NBS
chr18,Bn70704,35144880,40548588,5403708,RLP
chr18,Bn70705,15662814,52146259,36483445,TN
chr18,Bn70706,53204038,58897838,5693800,RLK
chr18,Bn70707,23996127,56379842,32383715,CN
chr18,Bn70708,12113412,61203139,49089727,RLK
chr18,Bn70709,32783079,66067959,33284880,RLP
chr18,Bn70710,82227986,91892125,9664139,NBS
chr18,Bn70711,10211895,37702001,27490106,TNL
chr18,Bn70712,79133348,91866004,12732656,CN
chr18,Bn70713,83160642,97548940,14388298,TNL
chr18,Bn70714,76010368,87467786,11457418,RLK
chr18,Bn70715,31671796,68766742,37094946,RLK
chr18,Bn70716,52086780,60771418,8684638,TNL
chr18,Bn70717,7230448,80114802,72884354,TN
chr18,Bn70718,89316127,99909068,10592941,TNL
chr18,Bn70719,41249590,61326567,20076977,RLK
chr18,Bn70720,37649064,69257029,31607965,TNL
chr18,Bn70721,43931339,71549681,27618342,RLP
chr18,Bn70722,91923636,92833479,909843,RLK
chr18,Bn70723,26089764,75559115,49469351,CNL
chr18,Bn70724,52259369,73646431,21387062,TN
chr18,Bn70725,2421461,82055318,79633857,TN
chr18,Bn70726,62445053,80027589,17582536,RLK
chr18,Bn70727,87175500,90084058,2908558,TNL
chr18,Bn70728,61273701,75540718,14267017,CNL
chr18,Bn70729,88206116,95777477,7571361,TNL
chr18,Bn70730,81425046,98934594,17509548,TNL
chr18,Bn70731,98873820,99041114,167294,CN
chr18,Bn70732,82582086,88371095,5789009,CNL
chr18,Bn70733,50709042,84346158,33637116,RLK
chr18,Bn70734,19870264,39647404,19777140,TNL
chr18,Bn70735,14350507,50812430,36461923,TN
chr18,Bn70736,63186528,70861360,7674832,CN
chr18,Bn70737,94871121,96766130,1895009,RLP
chr18,Bn70738,17455529,92628933,75173404,RLK
chr18,Bn70739,73265750,87646807,14381057,CN
chr18,Bn70740,30447457,59256464,28809007,CNL
chr18,Bn70741,12722242,45971749,33249507,CN
chr18,Bn70742,36203223,56567775,20364552,CN
chr18,Bn70743,54468181,58798998,4330817,RLP
chr18,Bn70744,17997075,45962759,27965684,TN
chr18,Bn70745,64148281,89540791,25392510,RLK
chr18,Bn70746,44599601,57121802,12522201,TN
chr18,Bn70747,77656652,80267386,2610734,RLK
chr18,Bn70748,1667653,40255884,38588231,NBS
chr18,Bn70749,20899926,38552814,17652888,RLK
chr18,Bn70750,51141181,68272156,17130975,TN
chr18,Bn70751,58450102,83802032,25351930,CN
chr18,Bn70752,98477077,99670727,1193650,TN
chr18,Bn70753,72316287,90424030,18107743,RLP
chr18,Bn70754,55761776,79690362,23928586,CN
chr18,Bn70755,89180180,94977352,5797172,NBS
chr18,Bn70756,25996296,44466025,18469729,TNL
chr18,Bn70757,24066428,80441255,56374827,TNL
chr18,Bn70758,29999370,80356807,50357437,CNL
chr18,Bn70759,94203902,94559608,355706,RLK
chr18,Bn70760,54819502,84466488,29646986,RLK
chr18,Bn70761,56265819,69758795,13492976,RLK
chr18,Bn70762,70797837,78358427,7560590,RLK
chr18,Bn70763,34890982,53056560,18165578,CNL
chr18,Bn70764,41379551,98398156,57018605,CNL
chr18,Bn70765,53704441,90482936,36778495,TNL
chr18,Bn70766,47821417,94918072,47096655,TN
chr18,Bn70767,4264460,31526483,27262023,TN
chr18,Bn70768,60389394,60754454,365060,TN
chr18,Bn70769,1661401,61386488,59725087,CN
chr18,Bn70770,85076434,96977641,11901207,RLP
chr18,Bn70771,67883511,98899021,31015510,TNL
chr18,Bn70772,29293540,84593435,55299895,TNL
chr18,Bn70773,13340153,63671427,50331274,RLP
chr18,Bn70774,12340396,42492080,30151684,RLK
chr18,Bn70775,76078924,88628079,12549155,CNL
chr18,Bn70776,58214852,80245477,22030625,TN
chr18,Bn70777,86335270,96521831,10186561,TNL
chr18,Bn70778,59947672,84322956,24375284,NBS
chr18,Bn70779,95547739,96876372,1328633,TNL
chr18,Bn70780,19837685,28228788,8391103,CN
chr18,Bn70781,79103187,99292068,20188881,TN
chr18,Bn70782,6741606,56944462,50202856,RLP
chr18,Bn70783,51168493,99281144,48112651,NBS
chr18,Bn70784,25781170,30904549,5123379,RLK
chr18,Bn70785,99372656,99921143,548487,TNL
chr18,Bn70786,6899312,50435858,43536546,RLK
chr18,Bn70787,16736013,19961390,3225377,TNL
chr18,Bn70788,38154037,87572688,49418651,CN
chr18,Bn70789,55550437,72353534,16803097,NBS
chr18,Bn70790,43553409,84445692,40892283,RLK
chr18,Bn70791,9719080,96259916,86540836,RLK
chr18,Bn70792,41452477,84982890,43530413,RLP
chr18,Bn70793,16371444,46191379,29819935,TNL
chr18,Bn70794,84163477,90636939,6473462,CNL
chr18,Bn70795,83721252,93134771,9413519,RLP
chr18,Bn70796,90723259,99155423,8432164,CN
chr18,Bn70797,12245071,95032367,82787296,CNL
chr18,Bn70798,16913564,30563436,13649872,CN
chr18,Bn70799,16680809,46084648,29403839,NBS
chr18,Bn70800,76442548,86339821,9897273,NBS
chr18,Bn70801,47294960,96385619,49090659,TN
chr18,Bn70802,46647429,49940063,3292634,TN
chr18,Bn70803,15242804,50477131,35234327,TN
chr18,Bn70804,18062071,48180912,30118841,RLP
chr18,Bn70805,45295326,97514404,52219078,RLP
chr18,Bn70806,29881298,47389792,17508494,RLP
chr18,Bn70807,8173279,55038502,46865223,TN
chr18,Bn70808,23635162,26402488,2767326,RLP
chr18,Bn70809,18438890,53701694,35262804,CNL
chr18,Bn70810,27245706,31409921,4164215,RLP
chr18,Bn70811,67232336,88401030,21168694,RLK
chr18,Bn70812,25903609,63924240,38020631,CN
chr18,Bn70813,83018357,89720767,6702410,CN
chr18,Bn70814,48431993,87103080,38671087,TN
chr18,Bn70815,29851150,95637749,65786599,RLK
chr18,Bn70816,22791432,56539088,33747656,TN
chr18,Bn70817,48837140,76405320,27568180,RLK
chr18,Bn70818,1342297,56759044,55416747,RLK
chr18,Bn70819,50484642,75825984,25341342,TN
chr18,Bn70820,65290233,97385328,32095095,NBS
chr18,Bn70821,64923747,91618278,26694531,RLK
chr18,Bn70822,45762254,62498850,16736596,TN
chr18,Bn70823,27844063,60904986,33060923,NBS
chr18,Bn70824,69906691,98906289,28999598,RLK
chr18,Bn70825,47056415,53293743,6237328,TN
chr18,Bn70826,2256623,41738547,39481924,CN
chr18,Bn70827,26904074,73168327,46264253,NBS
chr18,Bn70828,93108662,99235508,6126846,RLK
chr18,Bn70829,85539074,91245572,5706498,RLK
chr18,Bn70830,32453099,89301139,56848040,TNL
chr18,Bn70831,99476907,99501229,24322,CNL
chr18,Bn70832,26782905,65985332,39202427,RLP
chr18,Bn70833,87218009,95861517,8643508,CN
chr18,Bn70834,14678128,29680059,15001931,RLK
chr18,Bn70835,19814603,91449879,71635276,RLP
chr18,Bn70836,87715640,99464072,11748432,NBS
chr18,Bn70837,47274002,84513809,37239807,CNL
chr18,Bn70838,89713609,99456238,9742629,CN
chr18,Bn70839,38187629,93716633,55529004,TN
chr18,Bn70840,4235383,6994489,2759106,TN
chr18,Bn70841,69845884,83701529,13855645,NBS
chr18,Bn70842,37394421,46656509,9262088,TN
chr18,Bn70843,85967214,94482659,8515445,NBS
chr18,Bn70844,45278848,79329362,34050514,NBS
chr18,Bn70845,93529116,96817311,3288195,RLK
chr18,Bn70846,7116886,27420060,20303174,CN
chr18,Bn70847,86285072,90377837,4092765,TN
chr18,Bn70848,24258365,71210850,46952485,CNL
chr18,Bn70849,6604724,33484134,26879410,TNL
chr18,Bn70850,25153098,44951172,19798074,CN
chr18,Bn70851,94875516,99080408,4204892,NBS
chr18,Bn70852,84151430,87100948,2949518,CNL
chr18,Bn70853,3602763,14572386,10969623,TN
chr18,Bn70854,79762154,86327759,6565605,TN
chr18,Bn70855,60692705,80953901,20261196,CNL
chr18,Bn70856,83066582,88007411,4940829,TNL
chr18,Bn70857,67555691,86274581,18718890,RLK
chr18,Bn70858,4955444,37850350,32894906,RLK
chr18,Bn70859,68551163,97303560,28752397,RLK
chr18,Bn70860,84901309,99814448,14913139,NBS
chr18,Bn70861,54184342,78568940,24384598,TN
chr18,Bn70862,74899773,75107129,207356,NBS
chr18,Bn70863,63677731,72317989,8640258,TN
chr18,Bn70864,35120324,88399619,53279295,CN
chr18,Bn70865,89581542,95043447,5461905,CN
chr18,Bn70866,42656956,51158661,8501705,RLP
chr18,Bn70867,54010563,69168992,15158429,CNL
chr18,Bn70868,72285864,74737602,2451738,CN
chr18,Bn70869,29829231,86064214,56234983,TN
chr18,Bn70870,66247786,75397736,9149950,RLP
chr18,Bn70871,95357748,98495827,3138079,TNL
chr18,Bn70872,89983914,91166923,1183009,RLP
chr18,Bn70873,58073218,96852939,38779721,CN
chr18,Bn70874,19014805,87062105,68047300,NBS
chr18,Bn70875,40543947,99958864,59414917,TN
chr18,Bn70876,45666606,55015270,9348664,TNL
chr18,Bn70877,27578464,98864581,71286117,RLP
chr18,Bn70878,68607296,99042162,30434866,TN
chr18,Bn70879,20232675,98403336,78170661,RLK
chr18,Bn70880,12975889,48846020,35870131,RLK
chr18,Bn70881,59816646,60439282,622636,CN
chr18,Bn70882,33621375,87541116,53919741,NBS
chr18,Bn70883,30945458,48394204,17448746,TNL
chr18,Bn70884,46997756,68105066,21107310,NBS
chr18,Bn70885,70660382,98572168,27911786,TN
chr18,Bn70886,36644572,73731152,37086580,NBS
chr18,Bn70887,20723998,48285063,27561065,NBS
chr18,Bn70888,91446795,99373939,7927144,NBS
chr18,Bn70889,56703099,60202111,3499012,CN
chr18,Bn70890,14836624,98601142,83764518,TN
chr18,Bn70891,24333984,30346393,6012409,CN
chr18,Bn70892,3509987,19397210,15887223,CN
chr18,Bn70893,75861203,96964121,21102918,TNL
chr18,Bn70894,22962231,46194210,23231979,CNL
chr18,Bn70895,75381180,88604579,13223399,TNL
chr18,Bn70896,95422146,97368279,1946133,RLP
chr18,Bn70897,52191694,86801125,34609431,RLK
chr18,Bn70898,15457275,16084749,627474,CNL
chr18,Bn70899,55184198,76983653,21799455,CN
chr18,Bn70900,72366064,81154412,8788348,TNL
chr18,Bn70901,13180480,32257321,19076841,TNL
chr18,Bn70902,28726844,71984664,43257820,CNL
chr18,Bn70903,62694661,84368161,21673500,TN
chr18,Bn70904,24445519,32847363,8401844,RLK
chr18,Bn70905,37264272,95808168,58543896,RLP
chr18,Bn70906,14698689,41573273,26874584,CN
chr18,Bn70907,28811186,75327441,46516255,TNL
chr18,Bn70908,44509474,67673394,23163920,NBS
chr18,Bn70909,72575584,97057345,24481761,RLP
chr18,Bn70910,21636390,83232527,61596137,NBS
chr18,Bn70911,69788563,99686828,29898265,NBS
chr18,Bn70912,38389978,77454270,39064292,CN
chr18,Bn70913,88790390,89553312,762922,RLK
chr18,Bn70914,2328341,97700582,95372241,TN
chr18,Bn70915,78248713,82642817,4394104,CN
chr18,Bn70916,47262495,77518412,30255917,RLK
chr18,Bn70917,31167473,68928652,37761179,RLP
chr18,Bn70918,22102096,37169555,15067459,NBS
chr18,Bn70919,40151320,95414594,55263274,RLK
chr18,Bn70920,71312521,90130256,18817735,RLP
chr18,Bn70921,94742726,95767238,1024512,RLP
chr18,Bn70922,93790353,97889620,4099267,CN
chr18,Bn70923,58451075,93488427,35037352,NBS
chr18,Bn70924,53882584,70750783,16868199,CN
chr18,Bn70925,71138374,76964022,5825648,RLK
chr18,Bn70926,72175773,92280849,20105076,CN
chr18,Bn70927,65373191,70964526,5591335,TN
chr18,Bn70928,30518035,93943497,63425462,TNL
chr18,Bn70929,65407704,86052732,20645028,NBS
chr18,Bn70930,62372401,92263797,29891396,NBS
chr18,Bn70931,97283878,99123414,1839536,TNL
chr18,Bn70932,3217738,94505994,91288256,NBS
chr18,Bn70933,16870652,26490304,9619652,RLK
chr18,Bn70934,67440598,87466816,20026218,TN
chr18,Bn70935,51705820,52952879,1247059,RLK
chr18,Bn70936,18113557,26815167,8701610,NBS
chr18,Bn70937,98295089,98498081,202992,CNL
chr18,Bn70938,50035870,54995702,4959832,CNL
chr18,Bn70939,38483933,73876851,35392918,TN
chr18,Bn70940,51759371,56705969,4946598,RLK
chr18,Bn70941,48948865,51407471,2458606,RLK
chr18,Bn70942,46544680,83994525,37449845,NBS
chr18,Bn70943,39567436,56445695,16878259,TNL
chr18,Bn70944,76733490,91437607,14704117,CNL
chr18,Bn70945,76042174,97750047,21707873,NBS
chr18,Bn70946,36431831,92119949,55688118,CN
chr18,Bn70947,27652904,40051744,12398840,RLK
chr18,Bn70948,62909917,78160204,15250287,NBS
chr18,Bn70949,61739278,72780302,11041024,RLK
chr18,Bn70950,55606205,79194729,23588524,CNL
chr18,Bn70951,51472074,53442904,1970830,NBS
chr18,Bn70952,4785041,80335465,75550424,TNL
chr18,Bn70953,94742590,97862208,3119618,TNL
chr18,Bn70954,25570663,42604669,17034006,RLP
chr18,Bn70955,68070013,80396335,12326322,TNL
chr18,Bn70956,17475179,78092619,60617440,TN
chr18,Bn70957,28204510,62331307,34126797,RLK
chr18,Bn70958,58928409,78166026,19237617,TN
chr18,Bn70959,98019888,98586720,566832,RLP
chr18,Bn70960,54446049,55304521,858472,RLK
chr18,Bn70961,9274151,42474716,33200565,TN
chr18,Bn70962,46587221,61495669,14908448,RLK
chr18,Bn70963,2622489,78074539,75452050,RLP
chr18,Bn70964,41838732,65304974,23466242,RLK
chr18,Bn70965,91141242,95967482,4826240,TNL
chr18,Bn70966,77486758,85636093,8149335,RLP
chr18,Bn70967,57325876,70218335,12892459,TNL
chr18,Bn70968,81920888,96276204,14355316,RLK
chr18,Bn70969,98709556,99591318,881762,TN
chr18,Bn70970,73727738,74814755,1087017,CNL
chr18,Bn70971,90458079,93922463,3464384,RLK
chr18,Bn70972,57616086,74266948,16650862,TN
chr18,Bn70973,79719577,98966141,19246564,NBS
chr18,Bn70974,50773524,66686377,15912853,TNL
chr18,Bn70975,85170319,94149613,8979294,RLK
chr18,Bn70976,88360971,97497128,9136157,RLK
chr18,Bn70977,80100495,90622777,10522282,RLK
chr18,Bn70978,47812095,54531527,6719432,CN
chr18,Bn70979,92251042,95430812,3179770,RLP
chr18,Bn70980,1024885,40659279,39634394,RLK
chr18,Bn70981,93372177,94033362,661185,TN
chr18,Bn70982,53385558,92195705,38810147,RLK
chr18,Bn70983,24434159,83643345,59209186,TNL
chr18,Bn70984,45325008,50993823,5668815,TNL
chr18,Bn70985,55768664,92498277,36729613,TNL
chr18,Bn70986,19568129,79258480,59690351,CN
chr18,Bn70987,13979317,25560509,11581192,TN
chr18,Bn70988,23889883,39642510,15752627,CNL
chr18,Bn70989,47666241,51074868,3408627,TNL
chr18,Bn70990,82478680,85689536,3210856,RLP
chr18,Bn70991,28903700,72741471,43837771,NBS
chr18,Bn70992,3935830,20142005,16206175,CN
chr18,Bn70993,36301657,67404442,31102785,NBS
chr18,Bn70994,50031793,64174546,14142753,CN
chr18,Bn70995,9131335,51434978,42303643,CN
chr18,Bn70996,13035895,28860750,15824855,TNL
chr18,Bn70997,72877463,87669890,14792427,RLK
chr18,Bn70998,54062878,91280375,37217497,RLK
chr18,Bn70999,67519079,92870068,25350989,CNL
chr18,Bn71000,72387869,96808405,24420536,TNL
chr18,Bn71001,76605276,90154858,13549582,NBS
chr18,Bn71002,59271078,92196819,32925741,CN
chr18,Bn71003,65125499,76551391,11425892,RLP
chr18,Bn71004,95939749,99424541,3484792,RLK
chr18,Bn71005,25975205,41066049,15090844,NBS
chr18,Bn71006,64182825,67872530,3689705,TNL
chr18,Bn71007,57324138,94962230,37638092,NBS
chr18,Bn71008,24814271,30941404,6127133,NBS
chr18,Bn71009,58000498,72305396,14304898,CN
chr18,Bn71010,7269275,46152126,38882851,RLK
chr18,Bn71011,85546903,93909289,8362386,TN
chr18,Bn71012,35275604,84539336,49263732,TN
chr18,Bn71013,34130983,59686286,25555303,CNL
chr18,Bn71014,14587528,44841847,30254319,NBS
chr18,Bn71015,49223513,65467813,16244300,RLP
chr18,Bn71016,48331465,86595596,38264131,RLP
chr18,Bn71017,79902708,86640854,6738146,TN
chr18,Bn71018,53519707,92953508,39433801,NBS
chr18,Bn71019,54094246,70556217,16461971,RLP
chr18,Bn71020,37104256,87902893,50798637,NBS
chr18,Bn71021,1890161,28192818,26302657,CN
chr18,Bn71022,78793239,82908251,4115012,RLK
chr18,Bn71023,37139936,68431570,31291634,NBS
chr18,Bn71024,59632809,88337163,28704354,CN
chr18,Bn71025,35597136,76175292,40578156,TNL
chr18,Bn71026,61292013,75123171,13831158,RLP
chr18,Bn71027,16328971,72515222,56186251,TNL
chr18,Bn71028,61220614,79894194,18673580,NBS
chr18,Bn71029,7186260,72020038,64833778,TN
chr18,Bn71030,68940479,82221388,13280909,TNL
chr18,Bn71031,65677686,85942951,20265265,TNL
chr18,Bn71032,50408688,89547794,39139106,TN
chr18,Bn71033,55237174,75244338,20007164,NBS
chr18,Bn71034,66098182,73109737,7011555,NBS
chr18,Bn71035,95755738,96034988,279250,TNL
chr18,Bn71036,87537550,95711629,8174079,RLK
chr18,Bn71037,89976484,98864590,8888106,RLK
chr18,Bn71038,41719911,73510970,31791059,CN
chr18,Bn71039,93177105,94738270,1561165,TNL
chr18,Bn71040,72977635,77053867,4076232,CNL
chr18,Bn71041,16427161,34075800,17648639,CN
chr18,Bn71042,94679365,97928676,3249311,CNL
chr18,Bn71043,86586948,90425257,3838309,RLP
chr18,Bn71044,81298271,84858498,3560227,TNL
chr18,Bn71045,89145170,91443297,2298127,TN
chr18,Bn71046,65361310,66654811,1293501,TN
chr18,Bn71047,14319296,99220401,84901105,RLP
chr18,Bn71048,82377711,89803677,7425966,RLK
chr18,Bn71049,23221977,34139730,10917753,NBS
chr18,Bn71050,47962458,62374058,14411600,TN
chr18,Bn71051,54470323,91071339,36601016,RLP
chr18,Bn71052,80790733,91417996,10627263,NBS
chr18,Bn71053,93633472,94517773,884301,RLP
chr18,Bn71054,13609559,49026101,35416542,TNL
chr18,Bn71055,9402980,67891136,58488156,TN
chr18,Bn71056,44431668,62258088,17826420,TN
chr18,Bn71057,50897333,53924010,3026677,NBS
chr18,Bn71058,20361201,48504917,28143716,RLP
chr18,Bn71059,66833100,89069934,22236834,CN
chr18,Bn71060,70579890,94457653,23877763,CNL
chr18,Bn71061,22578168,54765518,32187350,TNL
chr18,Bn71062,78150935,94394827,16243892,RLK
chr18,Bn71063,56745084,80530421,23785337,RLP
chr18,Bn71064,5242229,14807200,9564971,TN
chr18,Bn71065,94249215,98494058,4244843,TN
chr18,Bn71066,17979140,50360317,32381177,RLK
chr18,Bn71067,46738824,78599129,31860305,CNL
chr18,Bn71068,39031085,57623604,18592519,TN
chr18,Bn71069,77049979,81037937,3987958,TNL
chr18,Bn71070,59437940,84511532,25073592,NBS
chr18,Bn71071,8498805,40732453,32233648,RLK
chr18,Bn71072,98939159,99106777,167618,CNL
chr18,Bn71073,71900793,88657654,16756861,CNL
chr18,Bn71074,87880805,89802616,1921811,RLP
chr18,Bn71075,75702287,93444417,17742130,RLK
chr18,Bn71076,17885491,29585685,11700194,CNL
chr18,Bn71077,28531545,51058026,22526481,NBS
chr18,Bn71078,22101457,98435583,76334126,CNL
chr18,Bn71079,88499852,95809866,7310014,CN
chr18,Bn71080,79142276,94396343,15254067,RLP
chr18,Bn71081,46555769,94047985,47492216,RLP
chr18,Bn71082,74972986,93638501,18665515,RLK
chr18,Bn71083,37998437,38379976,381539,RLK
chr18,Bn71084,13344082,49126693,35782611,CNL
chr18,Bn71085,23212592,36723066,13510474,CN
chr18,Bn71086,50765691,90343046,39577355,TNL
chr18,Bn71087,51520834,82592700,31071866,CN
chr18,Bn71088,73033745,99139936,26106191,CN
chr18,Bn71089,75054646,84690128,9635482,NBS
chr18,Bn71090,10674142,94345413,83671271,TN
chr18,Bn71091,71461608,80770991,9309383,CNL
chr18,Bn71092,41252744,58641516,17388772,NBS
chr18,Bn71093,76399967,94940393,18540426,CNL
chr18,Bn71094,90732214,91157557,425343,RLP
chr18,Bn71095,23857219,55652868,31795649,TNL
chr18,Bn71096,14467962,54460090,39992128,RLP
chr18,Bn71097,92191167,98310507,6119340,NBS
chr18,Bn71098,77791938,88181351,10389413,TN
chr18,Bn71099,3434639,43272837,39838198,TN
chr18,Bn71100,21020942,27105475,6084533,NBS
chr18,Bn71101,7113638,93338875,86225237,CN
chr18,Bn71102,33017357,84836661,51819304,TNL
chr18,Bn71103,5703193,99255988,93552795,CN
chr18,Bn71104,27688347,98464989,70776642,RLP
chr18,Bn71105,75498889,92654421,17155532,TN
chr18,Bn71106,67475161,82691445,15216284,RLK
chr18,Bn71107,97720740,98563731,842991,RLK
chr18,Bn71108,40712227,47540060,6827833,CN
chr18,Bn71109,22796162,31283195,8487033,RLP
chr18,Bn71110,23104409,52123966,29019557,RLP
chr18,Bn71111,91714392,94318488,2604096,CNL
chr18,Bn71112,8303693,53026087,44722394,TN
chr18,Bn71113,92363961,98773161,6409200,RLP
chr18,Bn71114,61966063,67047119,5081056,CNL
chr18,Bn71115,47343797,97713255,50369458,CNL
chr18,Bn71116,71827914,72385507,557593,RLK
chr18,Bn71117,20007974,60394755,40386781,CN
chr18,Bn71118,41441013,60412544,18971531,CNL
chr18,Bn71119,95970645,97451841,1481196,CNL
chr18,Bn71120,69252311,86535492,17283181,RLP
chr18,Bn71121,34102964,95892562,61789598,CN
chr18,Bn71122,10509984,11556675,1046691,RLK
chr18,Bn71123,37753404,72644935,34891531,CNL
chr18,Bn71124,74564755,94935069,20370314,RLK
chr18,Bn71125,79547314,93192423,13645109,TNL
chr18,Bn71126,15562980,47703896,32140916,RLP
chr18,Bn71127,54743004,74507174,19764170,CNL
chr18,Bn71128,75855858,78384384,2528526,RLP
chr18,Bn71129,51443294,86978674,35535380,NBS
chr18,Bn71130,97650664,97700372,49708,TNL
chr18,Bn71131,98873879,99061927,188048,CN
chr18,Bn71132,99501280,99763681,262401,NBS
chr18,Bn71133,87812712,99307612,11494900,RLP
chr18,Bn71134,66909101,95039725,28130624,TNL
chr18,Bn71135,82656114,84259302,1603188,RLK
chr18,Bn71136,52847002,63528285,10681283,NBS
chr18,Bn71137,32462316,82743943,50281627,RLP
chr18,Bn71138,22411513,62334366,39922853,RLP
chr18,Bn71139,31856789,37581635,5724846,RLP
chr18,Bn71140,1254822,1701706,446884,CN
chr18,Bn71141,46944986,71343676,24398690,NBS
chr18,Bn71142,29928314,63022455,33094141,NBS
chr18,Bn71143,17757279,54676244,36918965,RLK
chr18,Bn71144,80100538,96420544,16320006,RLP
chr18,Bn71145,8271754,75014753,66742999,CNL
chr18,Bn71146,54287537,60935908,6648371,CN
chr18,Bn71147,93399008,97137212,3738204,TNL
chr18,Bn71148,84536089,99052300,14516211,RLP
chr18,Bn71149,18858141,26179134,7320993,CNL
chr18,Bn71150,65564735,96705718,31140983,CNL
chr18,Bn71151,7819766,16110682,8290916,RLP
chr18,Bn71152,29963476,37589194,7625718,RLP
chr18,Bn71153,99824287,99910322,86035,RLK
chr18,Bn71154,49115979,80746069,31630090,NBS
chr18,Bn71155,96817105,96922422,105317,RLK
chr18,Bn71156,98257101,99730960,1473859,RLK
chr18,Bn71157,21508833,92045583,70536750,RLP
chr18,Bn71158,87764627,98139421,10374794,NBS
chr18,Bn71159,19617980,99650806,80032826,NBS
chr18,Bn71160,8438016,82322409,73884393,TNL
chr18,Bn71161,34214949,84728589,50513640,CN
chr18,Bn71162,33333885,78326155,44992270,CNL
chr18,Bn71163,83196431,84531098,1334667,TN
chr18,Bn71164,10688448,45087463,34399015,NBS
chr18,Bn71165,17688832,50769431,33080599,RLK
chr18,Bn71166,38225364,97218423,58993059,TN
chr18,Bn71167,31111675,85230672,54118997,NBS
chr18,Bn71168,11550697,24024725,12474028,CNL
chr18,Bn71169,19099877,51965016,32865139,RLK
chr18,Bn71170,52343421,87220157,34876736,CNL
chr18,Bn71171,7275435,99683721,92408286,CNL
chr18,Bn71172,53675486,64705322,11029836,NBS
chr18,Bn71173,52152727,61138723,8985996,RLP
chr18,Bn71174,36964658,67369893,30405235,CNL
chr18,Bn71175,32025424,52752437,20727013,TN
chr18,Bn71176,10645185,99368376,88723191,RLK
chr18,Bn71177,16028103,60874906,44846803,RLK
chr18,Bn71178,69954849,82638154,12683305,RLK
chr18,Bn71179,81832835,84705111,2872276,RLP
chr18,Bn71180,12476968,62069615,49592647,TN
chr18,Bn71181,91886561,97851355,5964794,TNL
chr18,Bn71182,53217228,65657616,12440388,NBS
chr18,Bn71183,31331593,62142401,30810808,CNL
chr18,Bn71184,98177989,98210381,32392,TN
chr18,Bn71185,87441738,95830039,8388301,TN
chr18,Bn71186,30188354,37587206,7398852,CN
chr18,Bn71187,31090492,44822543,13732051,TNL
chr18,Bn71188,90604768,91697897,1093129,TN
chr18,Bn71189,87864465,90543140,2678675,NBS
chr18,Bn71190,78314902,86922732,8607830,CNL
chr18,Bn71191,60835659,64918095,4082436,RLK
chr18,Bn71192,23926658,89739974,65813316,CNL
chr18,Bn71193,32471478,64924042,32452564,RLK
chr18,Bn71194,69210839,85126138,15915299,TN
chr18,Bn71195,52018502,67316903,15298401,RLP
chr18,Bn71196,52224260,87616984,35392724,TNL
chr18,Bn71197,11398329,40204216,28805887,NBS
chr18,Bn71198,31626659,48273491,16646832,TNL
chr18,Bn71199,52933157,88304735,35371578,TN
chr18,Bn71200,39335143,75579439,36244296,CN
chr18,Bn71201,59414928,59918073,503145,RLK
chr18,Bn71202,22591042,29220383,6629341,RLP
chr18,Bn71203,50833507,58941688,8108181,RLK
chr18,Bn71204,65760509,83597266,17836757,CN
chr18,Bn71205,82711256,82753765,42509,NBS
chr18,Bn71206,81273570,86662037,5388467,NBS
chr18,Bn71207,91185603,95959040,4773437,NBS
chr18,Bn71208,35597287,55591360,19994073,TN
chr18,Bn71209,49861883,61809570,11947687,TN
chr18,Bn71210,4119547,28252871,24133324,RLK
chr18,Bn71211,75921499,79689890,3768391,TNL
chr18,Bn71212,4097134,91481232,87384098,TN
chr18,Bn71213,52447774,75401230,22953456,TN
chr18,Bn71214,55457000,95957566,40500566,RLP
chr18,Bn71215,57429910,72407733,14977823,TN
chr18,Bn71216,27416234,79374972,51958738,RLK
chr18,Bn71217,10234520,15395150,5160630,NBS
chr18,Bn71218,88552452,94500863,5948411,RLK
chr18,Bn71219,92564026,95728748,3164722,RLK
chr18,Bn71220,50277395,90215813,39938418,TN
chr18,Bn71221,89509393,90282793,773400,CN
chr18,Bn71222,60568971,96065336,35496365,TNL
chr18,Bn71223,80793708,82720440,1926732,TN
chr18,Bn71224,78835230,93517112,14681882,TNL
chr18,Bn71225,50745569,79503245,28757676,TNL
chr18,Bn71226,54255584,82740765,28485181,TNL
chr18,Bn71227,8483023,52153209,43670186,RLK
chr18,Bn71228,51507378,94174510,42667132,CNL
chr18,Bn71229,15960195,46806591,30846396,RLK
chr18,Bn71230,6713576,28781926,22068350,CNL
chr18,Bn71231,91592311,92906895,1314584,NBS
chr18,Bn71232,82781436,83589539,808103,CN
chr18,Bn71233,99082150,99132737,50587,RLK
chr18,Bn71234,73415309,74732962,1317653,RLP
chr18,Bn71235,63951790,74420778,10468988,CN
chr18,Bn71236,67867589,83130078,15262489,TNL
chr18,Bn71237,35091932,55897318,20805386,CN
chr18,Bn71238,44919325,73539976,28620651,CNL
chr18,Bn71239,5821451,44755876,38934425,CN
chr18,Bn71240,25327534,94658051,69330517,CN
chr18,Bn71241,97371802,99629203,2257401,CN
chr18,Bn71242,31547418,97297353,65749935,TN
chr18,Bn71243,14101568,91012606,76911038,RLP
chr18,Bn71244,99521916,99560829,38913,RLP
chr18,Bn71245,74901068,99820288,24919220,TN
chr18,Bn71246,82400535,89482755,7082220,NBS
chr18,Bn71247,18991298,60486819,41495521,CNL
chr18,Bn71248,19156466,72150985,52994519,CNL
chr18,Bn71249,42245215,53023599,10778384,RLP
chr18,Bn71250,16063068,54902175,38839107,RLP
chr18,Bn71251,64318216,87120257,22802041,RLK
chr18,Bn71252,83077729,91212445,8134716,TN
chr18,Bn71253,96487786,99637170,3149384,TN
chr18,Bn71254,8250744,27022880,18772136,CNL
chr18,Bn71255,98558146,98829130,270984,RLK
chr18,Bn71256,81115330,83333730,2218400,CN
chr18,Bn71257,28488762,90059137,61570375,RLP
chr18,Bn71258,48103125,63362370,15259245,RLK
chr18,Bn71259,26842805,42946143,16103338,CN
chr18,Bn71260,5428631,10474691,5046060,CN
chr18,Bn71261,88922907,94009031,5086124,TNL
chr18,Bn71262,27131334,92968757,65837423,CN
chr18,Bn71263,43328504,87169887,43841383,CNL
chr18,Bn71264,98788720,99633859,845139,CNL
chr18,Bn71265,37585915,62736330,25150415,CNL
chr18,Bn71266,48155779,74056395,25900616,TN
chr18,Bn71267,50661823,86287179,35625356,CN
chr18,Bn71268,1015505,59236027,58220522,TN
chr18,Bn71269,35889451,74475080,38585629,RLP
chr18,Bn71270,22429300,24044580,1615280,RLP
chr18,Bn71271,21874193,48320156,26445963,CNL
chr18,Bn71272,76764264,95436229,18671965,TNL
chr18,Bn71273,55021071,81400256,26379185,RLP
chr18,Bn71274,81302086,90839010,9536924,RLK
chr18,Bn71275,6934070,62552142,55618072,TN
chr18,Bn71276,51985532,70301108,18315576,NBS
chr18,Bn71277,70113303,86220587,16107284,TNL
chr18,Bn71278,75767987,90759611,14991624,TNL
chr18,Bn71279,31225303,81113412,49888109,CNL
chr18,Bn71280,72568695,92410788,19842093,RLP
chr18,Bn71281,5433921,30458503,25024582,TN
chr18,Bn71282,24118067,36622222,12504155,NBS
chr18,Bn71283,89174783,98997844,9823061,RLK
chr18,Bn71284,2700654,15214070,12513416,TNL
chr18,Bn71285,29426839,76082487,46655648,TN
chr18,Bn71286,48135891,67847494,19711603,NBS
chr18,Bn71287,18696134,50874997,32178863,RLK
chr18,Bn71288,69112810,97552497,28439687,CN
chr18,Bn71289,60961884,87095029,26133145,TNL
chr18,Bn71290,93519948,99210454,5690506,RLP
chr18,Bn71291,6599598,41972305,35372707,NBS
chr18,Bn71292,32945495,83188688,50243193,TN
chr18,Bn71293,50831069,65751348,14920279,TN
chr18,Bn71294,82639976,90072424,7432448,CNL
chr18,Bn71295,39274083,53494480,14220397,TNL
chr18,Bn71296,13179241,86716982,73537741,TNL
chr18,Bn71297,55284673,59645593,4360920,CN
chr18,Bn71298,23857479,84788481,60931002,CN
chr18,Bn71299,29330526,63984916,34654390,CN
chr18,Bn71300,66736742,92604303,25867561,CN
chr18,Bn71301,27480287,74663969,47183682,CN
chr18,Bn71302,23281330,66981577,43700247,TNL
chr18,Bn71303,25791340,32878829,7087489,RLK
chr18,Bn71304,35680834,55773830,20092996,CN
chr18,Bn71305,75409395,79584621,4175226,TN
chr18,Bn71306,51844801,93750661,41905860,NBS
chr18,Bn71307,42078662,43635427,1556765,RLK
chr18,Bn71308,2146092,31370431,29224339,RLP
chr18,Bn71309,77866907,88366594,10499687,CNL
chr18,Bn71310,48676164,78127015,29450851,RLP
chr18,Bn71311,70029250,80786029,10756779,TN
chr18,Bn71312,87562884,90560863,2997979,TN
chr18,Bn71313,7713704,69288683,61574979,TNL
chr18,Bn71314,29569254,47228315,17659061,RLK
chr18,Bn71315,51934292,87694144,35759852,TN
chr18,Bn71316,28755810,55247079,26491269,TNL
chr18,Bn71317,86276240,94391697,8115457,TN
chr18,Bn71318,27142521,37442942,10300421,CN
chr18,Bn71319,38894921,41779798,2884877,TN
chr18,Bn71320,47661362,82040380,34379018,RLK
chr18,Bn71321,98866076,99997288,1131212,TN
chr18,Bn71322,54127692,90309510,36181818,TNL
chr18,Bn71323,93019272,95407240,2387968,RLK
chr18,Bn71324,65832945,66506344,673399,RLP
chr18,Bn71325,31879941,39960829,8080888,CNL
chr18,Bn71326,23801831,93071327,69269496,RLP
chr18,Bn71327,57423488,89837064,32413576,TN
chr18,Bn71328,71999838,82495812,10495974,RLP
chr18,Bn71329,67780418,69118146,1337728,TNL
chr18,Bn71330,68204493,95667009,27462516,CN
chr18,Bn71331,86233072,99703830,13470758,RLK
chr18,Bn71332,79447823,99728123,20280300,TNL
chr18,Bn71333,36582066,87790738,51208672,CNL
chr18,Bn71334,35228583,39097659,3869076,CNL
chr18,Bn71335,80491234,91897649,11406415,CN
chr18,Bn71336,31981471,60966450,28984979,CNL
chr18,Bn71337,6579358,24298558,17719200,NBS
chr18,Bn71338,52442713,87812173,35369460,NBS
chr18,Bn71339,44937412,52008317,7070905,CNL
chr18,Bn71340,65105463,87448674,22343211,CN
chr18,Bn71341,17161236,68490616,51329380,RLK
chr18,Bn71342,39461184,56676651,17215467,RLP
chr18,Bn71343,6601638,29272602,22670964,CN
chr18,Bn71344,10633401,29553680,18920279,CNL
chr18,Bn71345,66089967,74474840,8384873,RLK
chr18,Bn71346,46652767,65212727,18559960,CNL
chr18,Bn71347,41801945,58398754,16596809,RLK
chr18,Bn71348,23774315,96835704,73061389,NBS
chr18,Bn71349,54303023,95682656,41379633,TN
chr18,Bn71350,38318016,40316555,1998539,TN
chr18,Bn71351,68137704,83925391,15787687,TNL
chr18,Bn71352,87478351,90693120,3214769,RLP
chr18,Bn71353,17537952,32312329,14774377,NBS
chr18,Bn71354,64957704,71553225,6595521,CNL
chr18,Bn71355,73645807,96225027,22579220,TNL
chr18,Bn71356,29387071,46067846,16680775,RLP
chr18,Bn71357,50609513,70449111,19839598,CNL
chr18,Bn71358,23248954,24102325,853371,CN
chr18,Bn71359,45018197,59194630,14176433,NBS
chr18,Bn71360,54243555,83220656,28977101,NBS
chr18,Bn71361,34348483,99694084,65345601,CNL
chr18,Bn71362,74448726,79160590,4711864,CN
chr18,Bn71363,28300276,50234536,21934260,TN
chr18,Bn71364,98113596,98666446,552850,RLP
chr18,Bn71365,22261803,43649147,21387344,TNL
chr18,Bn71366,46594705,87818527,41223822,TN
chr18,Bn71367,98896014,99353056,457042,RLP
chr18,Bn71368,37725480,71267633,33542153,RLP
chr18,Bn71369,4115002,76774137,72659135,NBS
chr18,Bn71370,61248528,85925138,24676610,NBS
chr18,Bn71371,31477036,61492003,30014967,RLK
chr18,Bn71372,88259240,94589885,6330645,CN
chr18,Bn71373,31840882,47475329,15634447,RLK
chr18,Bn71374,31609920,51998787,20388867,CN
chr18,Bn71375,87832685,92608003,4775318,RLK
chr18,Bn71376,57139369,77607979,20468610,RLK
chr18,Bn71377,54891255,90981647,36090392,RLP
chr18,Bn71378,35796312,73833486,38037174,TNL
chr18,Bn71379,34488123,45404321,10916198,CNL
chr18,Bn71380,84606693,93208830,8602137,CN
chr18,Bn71381,16764569,40488672,23724103,TNL
chr18,Bn71382,76983720,94614311,17630591,RLK
chr18,Bn71383,3601552,16625197,13023645,TN
chr18,Bn71384,19147953,83900016,64752063,RLK
chr18,Bn71385,75879801,89587883,13708082,CN
chr18,Bn71386,77764742,88028371,10263629,RLP
chr18,Bn71387,98066967,99414171,1347204,CNL
chr18,Bn71388,66968863,95133914,28165051,NBS
chr18,Bn71389,4229658,50865110,46635452,TN
chr18,Bn71390,25525013,95066006,69540993,CN
chr18,Bn71391,92941844,97197762,4255918,RLK
chr18,Bn71392,44407859,48304292,3896433,RLK
chr18,Bn71393,69744365,74068917,4324552,TN
chr18,Bn71394,9404359,27176559,17772200,TNL
chr18,Bn71395,86376860,97704451,11327591,TN
chr18,Bn71396,53936684,82368511,28431827,TN
chr18,Bn71397,99731454,99927641,196187,RLP
chr18,Bn71398,91349618,94576706,3227088,RLP
chr18,Bn71399,20891259,33332180,12440921,NBS
chr18,Bn71400,30830845,52296241,21465396,NBS
chr18,Bn71401,1673248,54869761,53196513,RLK
chr18,Bn71402,33759695,62707175,28947480,RLK
chr18,Bn71403,98621175,99898702,1277527,CN
chr18,Bn71404,2728013,98584546,95856533,NBS
chr18,Bn71405,34626299,86600903,51974604,TN
chr18,Bn71406,53866345,95607843,41741498,CNL
chr18,Bn71407,42168009,95158110,52990101,CN
chr18,Bn71408,2741067,71048674,68307607,CN
chr18,Bn71409,49190983,87813625,38622642,TN
chr18,Bn71410,8833529,48054127,39220598,NBS
chr18,Bn71411,63948572,99609324,35660752,TNL
chr18,Bn71412,61751706,67025616,5273910,NBS
chr18,Bn71413,97220840,98092918,872078,TNL
chr18,Bn71414,80770899,97154804,16383905,RLP
chr18,Bn71415,13560572,37462348,23901776,CN
chr18,Bn71416,85867370,89888949,4021579,NBS
chr18,Bn71417,3415965,62177553,58761588,TN
chr18,Bn71418,33543894,91265517,57721623,NBS
chr18,Bn71419,86065014,91408992,5343978,TNL
chr18,Bn71420,80548045,88670750,8122705,CN
chr18,Bn71421,23934491,84158858,60224367,TN
chr18,Bn71422,22897075,91761991,68864916,NBS
chr18,Bn71423,19490075,21987876,2497801,CN
chr18,Bn71424,28787786,88639279,59851493,RLK
chr18,Bn71425,23585985,69555574,45969589,CNL
chr18,Bn71426,96891260,99322720,2431460,CNL
chr18,Bn71427,47942294,79058367,31116073,NBS
chr18,Bn71428,22049770,76123008,54073238,NBS
chr18,Bn71429,9091882,82323901,73232019,CN
chr18,Bn71430,84276173,98266641,13990468,TNL
chr18,Bn71431,96160135,99907510,3747375,CN
chr18,Bn71432,47163426,81034648,33871222,TN
chr18,Bn71433,40513000,90338362,49825362,NBS
chr18,Bn71434,19009533,75685202,56675669,CNL
chr18,Bn71435,31279231,65506339,34227108,TN
chr18,Bn71436,77304617,80722847,3418230,NBS
chr18,Bn71437,33283930,52751528,19467598,RLP
chr18,Bn71438,76467043,80439913,3972870,RLP
chr18,Bn71439,66710898,92930521,26219623,NBS
chr18,Bn71440,20469903,47812840,27342937,TNL
chr18,Bn71441,36762266,71682611,34920345,CNL
chr18,Bn71442,25582600,67575098,41992498,RLK
chr18,Bn71443,86121274,88144350,2023076,RLK
chr18,Bn71444,15616178,69032876,53416698,NBS
chr18,Bn71445,98669163,98871076,201913,TN
chr18,Bn71446,93138152,99743788,6605636,RLK
chr18,Bn71447,45700903,51871027,6170124,CNL
chr18,Bn71448,63740756,88215440,24474684,CNL
chr18,Bn71449,74871050,89139129,14268079,RLK
chr18,Bn71450,16486862,84471183,67984321,RLK
chr18,Bn71451,37111687,40966370,3854683,TNL
chr18,Bn71452,80569898,83479360,2909462,CN
chr18,Bn71453,86010201,92820618,6810417,TNL
chr18,Bn71454,22342942,47613502,25270560,CN
chr18,Bn71455,59777697,91238656,31460959,CNL
chr18,Bn71456,55003417,58886594,3883177,NBS
chr18,Bn71457,14166847,40207831,26040984,TNL
chr18,Bn71458,29400300,65949534,36549234,RLP
chr18,Bn71459,53439016,95644134,42205118,TNL
chr18,Bn71460,64261386,91163713,26902327,RLP
chr18,Bn71461,92557677,95843951,3286274,TNL
chr18,Bn71462,17457250,59193357,41736107,RLK
chr18,Bn71463,41368478,88965008,47596530,RLK
chr18,Bn71464,14391308,31844733,17453425,RLK
chr18,Bn71465,8911735,17999469,9087734,RLP
chr18,Bn71466,88681820,95569735,6887915,TNL
chr18,Bn71467,8209059,13039873,4830814,CNL
chr18,Bn71468,25203154,34985025,9781871,RLK
chr18,Bn71469,92535395,99552272,7016877,NBS
chr18,Bn71470,16318125,95606659,79288534,RLP
chr18,Bn71471,3289564,55918022,52628458,CN
chr18,Bn71472,7071954,69774782,62702828,RLK
chr18,Bn71473,95673151,99502805,3829654,NBS
chr18,Bn71474,5260455,72521169,67260714,CN
chr18,Bn71475,18602598,77761255,59158657,RLP
chr18,Bn71476,74849738,90268505,15418767,TNL
chr18,Bn71477,92061305,96572840,4511535,TNL
chr18,Bn71478,57242981,65601008,8358027,CN
chr18,Bn71479,12243731,99105762,86862031,RLK
chr18,Bn71480,21624779,34911782,13287003,CNL
chr18,Bn71481,16645622,19719881,3074259,RLK
chr18,Bn71482,2522130,34790602,32268472,CN
chr18,Bn71483,18439066,37364278,18925212,RLK
chr18,Bn71484,73836214,85269453,11433239,TN
chr18,Bn71485,34878930,85376569,50497639,TNL
chr18,Bn71486,32590643,87498999,54908356,RLP
chr18,Bn71487,40226842,77354603,37127761,RLK
chr18,Bn71488,23472755,23966969,494214,RLK
chr18,Bn71489,52134855,60347906,8213051,RLK
chr18,Bn71490,5383159,18183680,12800521,CN
chr18,Bn71491,23364644,32975397,9610753,NBS
chr18,Bn71492,52410853,78697126,26286273,RLP
chr18,Bn71493,29266837,40560374,11293537,TNL
chr18,Bn71494,17858096,52919972,35061876,NBS
chr18,Bn71495,9827758,31322247,21494489,RLK
chr18,Bn71496,97653751,99676628,2022877,CN
chr18,Bn71497,73153417,90701626,17548209,CN
chr18,Bn71498,9349514,26335062,16985548,RLK
chr18,Bn71499,4441868,36539122,32097254,TNL
chr18,Bn71500,63319586,81302193,17982607,RLK
chr18,Bn71501,28632276,74059798,45427522,TNL
chr18,Bn71502,25184568,59182425,33997857,TN
chr18,Bn71503,3798049,15877111,12079062,TNL
chr18,Bn71504,68529475,79275829,10746354,RLK
chr18,Bn71505,77681315,84318285,6636970,CN
chr18,Bn71506,2177897,90683642,88505745,RLK
chr18,Bn71507,14662715,16283139,1620424,CN
chr18,Bn71508,70902117,83966138,13064021,CN
chr18,Bn71509,41079352,49170667,8091315,NBS
chr18,Bn71510,57603130,96257033,38653903,CN
chr18,Bn71511,5508963,56437671,50928708,NBS
chr18,Bn71512,18459215,41392804,22933589,RLP
chr18,Bn71513,66503400,92298050,25794650,CNL
chr18,Bn71514,97561758,98250735,688977,CN
chr18,Bn71515,75986604,86838951,10852347,NBS
chr18,Bn71516,96881673,97837673,956000,RLK
chr18,Bn71517,64904508,83514837,18610329,TN
chr18,Bn71518,79610853,91069670,11458817,RLP
chr18,Bn71519,21707048,83416543,61709495,NBS
chr18,Bn71520,97858699,99346114,1487415,RLK
chr18,Bn71521,33741684,64814645,31072961,NBS
chr18,Bn71522,93954667,98600778,4646111,CNL
chr18,Bn71523,78201249,91122180,12920931,CN
chr18,Bn71524,58178149,60399615,2221466,NBS
chr18,Bn71525,28257378,89034645,60777267,TNL
chr18,Bn71526,9184819,68058708,58873889,CNL
chr18,Bn71527,74182300,98530000,24347700,TN
chr18,Bn71528,42183134,44989965,2806831,NBS
chr18,Bn71529,80445673,92334724,11889051,CN
chr18,Bn71530,80157258,84792495,4635237,CN
chr18,Bn71531,2833653,58039855,55206202,RLK
chr18,Bn71532,93974705,97924268,3949563,TNL
chr18,Bn71533,97003874,98940289,1936415,CNL
chr18,Bn71534,45108430,87246223,42137793,TNL
chr18,Bn71535,85422203,88343695,2921492,NBS
chr18,Bn71536,28256577,78410849,50154272,RLP
chr18,Bn71537,39214138,79584460,40370322,CNL
chr18,Bn71538,84186702,87122813,2936111,TNL
chr18,Bn71539,56137426,81329531,25192105,TNL
chr18,Bn71540,50099736,65197700,15097964,TN
chr18,Bn71541,66753277,72665719,5912442,RLK
chr18,Bn71542,69346224,87806834,18460610,TNL
chr18,Bn71543,58040485,69973275,11932790,TN
chr18,Bn71544,70238669,87462797,17224128,CN
chr18,Bn71545,61203707,76304825,15101118,NBS
chr18,Bn71546,61912894,77458375,15545481,RLP
chr18,Bn71547,51856187,67497148,15640961,RLK
chr18,Bn71548,59516384,78940755,19424371,CN
chr18,Bn71549,59194483,71144204,11949721,RLK
chr18,Bn71550,16273990,39970950,23696960,CN
chr18,Bn71551,84136322,89373183,5236861,NBS
chr18,Bn71552,13567503,93456060,79888557,TNL
chr18,Bn71553,35155986,93145907,57989921,RLP
chr18,Bn71554,77133694,88852176,11718482,RLP
chr18,Bn71555,84196187,99944173,15747986,RLP
chr18,Bn71556,3645396,54614553,50969157,TN
chr18,Bn71557,73421499,84180236,10758737,TNL
chr18,Bn71558,83472265,91333414,7861149,CNL
chr18,Bn71559,3618355,79154660,75536305,TNL
chr18,Bn71560,65999793,97077821,31078028,RLP
chr18,Bn71561,95718850,96957555,1238705,TNL
chr18,Bn71562,21173386,45580933,24407547,CN
chr18,Bn71563,62621053,97205120,34584067,RLK
chr18,Bn71564,72313617,72349665,36048,RLP
chr18,Bn71565,51645844,57684820,6038976,CNL
chr18,Bn71566,48912254,88545172,39632918,NBS
chr18,Bn71567,84999468,91048557,6049089,TNL
chr18,Bn71568,58024949,64133842,6108893,RLK
chr18,Bn71569,55436176,80394902,24958726,RLP
chr18,Bn71570,62653156,83616124,20962968,CNL
chr18,Bn71571,84933525,85981901,1048376,RLP
chr18,Bn71572,93014375,93520738,506363,TNL
chr18,Bn71573,88598061,94091148,5493087,NBS
chr18,Bn71574,75070172,91397255,16327083,TN
chr18,Bn71575,64042912,65521203,1478291,CN
chr18,Bn71576,44960959,92900362,47939403,NBS
chr18,Bn71577,22722262,77663692,54941430,TNL
chr18,Bn71578,17834122,38147817,20313695,RLK
chr18,Bn71579,66022062,76319359,10297297,RLP
chr18,Bn71580,16296792,32150704,15853912,CNL
chr18,Bn71581,95960892,99754541,3793649,NBS
chr18,Bn71582,91662798,93991666,2328868,NBS
chr18,Bn71583,76695530,78100532,1405002,RLP
chr18,Bn71584,13370018,22146266,8776248,TN
chr18,Bn71585,80886704,90914162,10027458,TNL
chr18,Bn71586,51261733,91921195,40659462,RLP
chr18,Bn71587,11429430,86869530,75440100,TNL
chr18,Bn71588,20573553,88840059,68266506,RLK
chr18,Bn71589,59593881,90127298,30533417,CNL
chr18,Bn71590,38399116,47935721,9536605,TN
chr18,Bn71591,38410926,80593415,42182489,RLP
chr18,Bn71592,36151336,81741646,45590310,RLK
chr18,Bn71593,94557199,96174324,1617125,CN
chr18,Bn71594,9511576,98236894,88725318,RLP
chr18,Bn71595,78822648,88973326,10150678,CN
chr18,Bn71596,88892400,99007847,10115447,RLP
chr18,Bn71597,96084074,97740876,1656802,CNL
chr18,Bn71598,26976908,47678417,20701509,TNL
chr18,Bn71599,86980397,92522653,5542256,RLK
chr18,Bn71600,34621391,95811761,61190370,CNL
chr18,Bn71601,20219745,84472727,64252982,CN
chr18,Bn71602,11135733,34645453,23509720,TNL
chr18,Bn71603,72555065,76773766,4218701,NBS
chr18,Bn71604,63480085,82214526,18734441,RLP
chr18,Bn71605,48816695,89434162,40617467,RLK
chr18,Bn71606,94748889,96078020,1329131,CN
chr18,Bn71607,79303951,88166141,8862190,CNL
chr18,Bn71608,5361202,65813863,60452661,TNL
chr18,Bn71609,39928895,61071372,21142477,TN
chr18,Bn71610,86205692,90478752,4273060,NBS
chr18,Bn71611,12343027,30116989,17773962,CN
chr18,Bn71612,62572366,80104189,17531823,TNL
chr18,Bn71613,10490706,86922436,76431730,CNL
chr18,Bn71614,22332459,62275649,39943190,RLK
chr18,Bn71615,65346901,92158892,26811991,RLP
chr18,Bn71616,1267615,33541065,32273450,RLP
chr18,Bn71617,38917903,85515641,46597738,CN
chr18,Bn71618,37241853,69323650,32081797,CN
chr18,Bn71619,55028115,59745686,4717571,RLP
chr18,Bn71620,63792303,82950476,19158173,RLP
chr18,Bn71621,51669267,72680344,21011077,CN
chr18,Bn71622,72518514,94965402,22446888,CNL
chr18,Bn71623,67973179,84348260,16375081,RLP
chr18,Bn71624,57464353,62452287,4987934,TN
chr18,Bn71625,81979352,96504447,14525095,RLP
chr18,Bn71626,84974087,88591403,3617316,CNL
chr18,Bn71627,39715252,43779700,4064448,RLP
chr18,Bn71628,72730645,83559188,10828543,NBS
chr18,Bn71629,13515872,54757130,41241258,TNL
chr18,Bn71630,28606318,80842075,52235757,RLP
chr18,Bn71631,42735504,49599055,6863551,NBS
chr18,Bn71632,97966564,99682834,1716270,TNL
chr18,Bn71633,66670590,85787961,19117371,RLP
chr18,Bn71634,48137189,69615637,21478448,TNL
chr18,Bn71635,37198434,76382442,39184008,NBS
chr18,Bn71636,19345005,62961607,43616602,NBS
chr18,Bn71637,79206489,80256801,1050312,CNL
chr18,Bn71638,39630106,66181488,26551382,TN
chr18,Bn71639,43418585,80204239,36785654,CN
chr18,Bn71640,95294769,96696361,1401592,RLP
chr18,Bn71641,34913152,45177882,10264730,TNL
chr18,Bn71642,1589898,59349114,57759216,TNL
chr18,Bn71643,56286802,59352747,3065945,RLK
chr18,Bn71644,19052228,57638010,38585782,CN
chr18,Bn71645,39903929,71629066,31725137,TNL
chr18,Bn71646,43579737,72153120,28573383,TN
chr18,Bn71647,71476163,79289031,7812868,TN
chr18,Bn71648,19002992,57370125,38367133,NBS
chr18,Bn71649,25128387,52427760,27299373,TNL
chr18,Bn71650,87248530,97362297,10113767,RLK
chr18,Bn71651,17674550,33142255,15467705,RLP
chr18,Bn71652,95415407,99195837,3780430,CN
chr18,Bn71653,19008521,29768843,10760322,CN
chr18,Bn71654,36996992,66274574,29277582,TNL
chr18,Bn71655,95338970,96218121,879151,CN
chr18,Bn71656,43432242,61114147,17681905,CN
chr18,Bn71657,75021855,96407556,21385701,RLK
chr18,Bn71658,83513683,98193811,14680128,RLK
chr18,Bn71659,40368047,45845295,5477248,RLP
chr18,Bn71660,29070431,79949492,50879061,TNL
chr18,Bn71661,89258777,95888690,6629913,TNL
chr18,Bn71662,61874258,91763051,29888793,TNL
chr18,Bn71663,87228905,91084615,3855710,CN
chr18,Bn71664,13582413,36518643,22936230,CN
chr18,Bn71665,97113067,99514528,2401461,CN
chr18,Bn71666,47609148,70432184,22823036,CNL
chr18,Bn71667,14189117,24348755,10159638,CNL
chr18,Bn71668,69735979,89677517,19941538,TNL
chr18,Bn71669,86064318,95845938,9781620,CNL
chr18,Bn71670,50743632,96082659,45339027,NBS
chr18,Bn71671,37592576,53339180,15746604,RLP
chr18,Bn71672,69062451,80301187,11238736,TNL
chr18,Bn71673,7801844,25445488,17643644,TN
chr18,Bn71674,40917412,98490679,57573267,NBS
chr18,Bn71675,22531334,34952771,12421437,RLP
chr18,Bn71676,47912329,54002976,6090647,TNL
chr18,Bn71677,61677188,98202417,36525229,RLK
chr18,Bn71678,69386874,84815122,15428248,TNL
chr18,Bn71679,46186920,53197933,7011013,TNL
chr18,Bn71680,33132195,51524669,18392474,TNL
chr18,Bn71681,93932070,98405296,4473226,TNL
chr18,Bn71682,79855533,92953778,13098245,CN
chr18,Bn71683,34405697,72860452,38454755,NBS
chr18,Bn71684,26014959,70788011,44773052,CNL
chr18,Bn71685,59620714,87302592,27681878,CN
chr18,Bn71686,51037361,94685825,43648464,TNL
chr18,Bn71687,59213738,90243104,31029366,TN
chr18,Bn71688,14976788,21142977,6166189,RLK
chr18,Bn71689,79153205,98641104,19487899,TNL
chr18,Bn71690,96261194,99870716,3609522,TNL
chr18,Bn71691,63344902,72951734,9606832,TNL
chr18,Bn71692,81639005,93505141,11866136,TN
chr18,Bn71693,83590901,94899365,11308464,TN
chr18,Bn71694,54422792,89652498,35229706,TN
chr18,Bn71695,80829415,92448174,11618759,TN
chr18,Bn71696,28156635,58582845,30426210,CN
chr18,Bn71697,25390544,51543088,26152544,RLP
chr18,Bn71698,22752244,55566341,32814097,CNL
chr18,Bn71699,88649421,92691392,4041971,TN
chr18,Bn71700,40492358,95930653,55438295,CN
chr18,Bn71701,32079120,69313089,37233969,TN
chr18,Bn71702,51337770,99021558,47683788,RLP
chr18,Bn71703,45513946,71036142,25522196,TN
chr18,Bn71704,62724606,83535681,20811075,RLP
chr18,Bn71705,38088034,92639363,54551329,RLP
chr18,Bn71706,47304656,67579607,20274951,RLP
chr18,Bn71707,83745455,87623650,3878195,TN
chr18,Bn71708,75879055,81563775,5684720,RLP
chr18,Bn71709,55594847,81275319,25680472,TN
chr18,Bn71710,75769999,88158855,12388856,RLP
chr18,Bn71711,72943114,92535532,19592418,NBS
chr18,Bn71712,35979419,60928545,24949126,CN
chr18,Bn71713,69822022,99665022,29843000,RLK
chr18,Bn71714,98429605,99371884,942279,RLK
chr18,Bn71715,87957638,97892814,9935176,TN
chr18,Bn71716,59081959,68185133,9103174,RLK
chr18,Bn71717,46578937,71654009,25075072,RLK
chr18,Bn71718,96521140,97526217,1005077,NBS
chr18,Bn71719,37130041,41845362,4715321,NBS
chr18,Bn71720,74253410,77349262,3095852,TNL
chr18,Bn71721,47463894,78238097,30774203,RLP
chr18,Bn71722,87992583,92867577,4874994,TN
chr18,Bn71723,19811799,79932260,60120461,RLK
chr18,Bn71724,32633229,94566843,61933614,RLK
chr18,Bn71725,46302325,69898432,23596107,CNL
chr18,Bn71726,75086001,81198377,6112376,RLP
chr18,Bn71727,70450202,89551498,19101296,RLK
chr18,Bn71728,66175006,84375783,18200777,NBS
chr18,Bn71729,29630663,97098490,67467827,NBS
chr18,Bn71730,55040586,77056674,22016088,TNL
chr18,Bn71731,65233887,74118177,8884290,TN
chr18,Bn71732,74085186,79699439,5614253,TN
chr18,Bn71733,80946721,96841052,15894331,TN
chr18,Bn71734,82332482,95321397,12988915,TNL
chr18,Bn71735,28693874,61856635,33162761,RLP
chr18,Bn71736,27047700,91882404,64834704,RLK
chr18,Bn71737,94890059,98463428,3573369,RLK
chr18,Bn71738,57302761,61126987,3824226,TNL
chr18,Bn71739,83461263,92880384,9419121,RLK
chr18,Bn71740,95696926,98970703,3273777,CNL
chr18,Bn71741,63339490,65944519,2605029,TN
chr18,Bn71742,12849902,18810810,5960908,TNL
chr18,Bn71743,14486765,41381309,26894544,CNL
chr18,Bn71744,54722277,60808109,6085832,NBS
chr18,Bn71745,62182925,81189115,19006190,NBS
chr18,Bn71746,10946231,20253266,9307035,CNL
chr18,Bn71747,78901028,94044454,15143426,RLK
chr18,Bn71748,92136138,93784056,1647918,RLP
chr18,Bn71749,70321404,99160477,28839073,RLP
chr18,Bn71750,30760510,96459219,65698709,NBS
chr18,Bn71751,86384774,90137512,3752738,RLP
chr18,Bn71752,71640280,95488588,23848308,NBS
chr18,Bn71753,54185936,94774925,40588989,CNL
chr18,Bn71754,54772746,80219803,25447057,TNL
chr18,Bn71755,47199016,92026583,44827567,TNL
chr18,Bn71756,64602887,83887430,19284543,RLP
chr18,Bn71757,91623033,98004568,6381535,NBS
chr18,Bn71758,45610204,78369594,32759390,TNL
chr18,Bn71759,40714241,86350281,45636040,RLK
chr18,Bn71760,83260254,93173779,9913525,RLK
chr18,Bn71761,4191191,74384728,70193537,TNL
chr18,Bn71762,55578799,90332301,34753502,TNL
chr18,Bn71763,9803352,31007152,21203800,RLK
chr18,Bn71764,52975287,89360057,36384770,NBS
chr18,Bn71765,3991890,92701876,88709986,TN
chr18,Bn71766,28345482,85500540,57155058,CNL
chr18,Bn71767,67815340,79294625,11479285,RLP
chr18,Bn71768,43995146,59298633,15303487,CNL
chr18,Bn71769,96456379,97348615,892236,RLP
chr18,Bn71770,62946187,85611244,22665057,CNL
chr18,Bn71771,46343815,81469944,35126129,TN
chr18,Bn71772,11560589,93166728,81606139,CNL
chr18,Bn71773,64698280,82169514,17471234,TNL
chr18,Bn71774,85448215,98328047,12879832,TN
chr18,Bn71775,50023767,78795563,28771796,TN
chr18,Bn71776,20788703,34552962,13764259,RLP
chr18,Bn71777,41049438,55891487,14842049,CN
chr18,Bn71778,53077791,75832134,22754343,NBS
chr18,Bn71779,16927267,71858847,54931580,RLP
chr18,Bn71780,62392111,64512805,2120694,TN
chr18,Bn71781,30772469,31993570,1221101,TNL
chr18,Bn71782,13128978,27381463,14252485,CNL
chr18,Bn71783,71596730,72844449,1247719,RLK
chr18,Bn71784,99056038,99693812,637774,CNL
chr18,Bn71785,34195590,50238994,16043404,RLK
chr18,Bn71786,39904624,88822814,48918190,RLP
chr18,Bn71787,71978481,76069577,4091096,RLK
chr18,Bn71788,85559696,92927884,7368188,RLP
chr18,Bn71789,95647431,97091770,1444339,TNL
chr18,Bn71790,43474995,73511326,30036331,TN
chr18,Bn71791,51972233,98715338,46743105,NBS
chr18,Bn71792,83337414,95295638,11958224,TN
chr18,Bn71793,64057394,85675195,21617801,NBS
chr18,Bn71794,13387436,67160578,53773142,NBS
chr18,Bn71795,26978856,59317254,32338398,TNL
chr18,Bn71796,5252799,88093171,82840372,CN
chr18,Bn71797,77050630,91071608,14020978,RLP
chr18,Bn71798,56038297,88607182,32568885,TNL
chr18,Bn71799,45635270,62043695,16408425,CN
chr18,Bn71800,2652039,36866395,34214356,TNL
chr18,Bn71801,25865568,68596002,42730434,CN
chr18,Bn71802,85347987,90265538,4917551,CNL
chr18,Bn71803,21632252,22448518,816266,RLK
chr18,Bn71804,3365735,26083076,22717341,RLP
chr18,Bn71805,55037990,56964288,1926298,CN
chr18,Bn71806,64133386,77119125,12985739,CN
chr18,Bn71807,20217186,72411275,52194089,CN
chr18,Bn71808,26254935,89447542,63192607,CNL
chr18,Bn71809,65842645,86005156,20162511,RLK
chr18,Bn71810,73197941,99408820,26210879,CN
chr18,Bn71811,56075857,91473593,35397736,TNL
chr18,Bn71812,37411667,81294134,43882467,NBS
chr18,Bn71813,33471193,62450096,28978903,TN
chr18,Bn71814,57006739,57974121,967382,CN
chr18,Bn71815,27780407,56055024,28274617,RLP
chr18,Bn71816,70176943,84048633,13871690,TNL
chr18,Bn71817,47621152,77793426,30172274,RLK
chr18,Bn71818,22226481,35721141,13494660,NBS
chr18,Bn71819,74774250,96275265,21501015,TNL
chr18,Bn71820,95195702,95611724,416022,TNL
chr18,Bn71821,19244519,97589158,78344639,RLP
chr18,Bn71822,16003474,19353969,3350495,TN
chr18,Bn71823,88579723,94744503,6164780,TNL
chr18,Bn71824,12169999,16667444,4497445,RLP
chr18,Bn71825,32865938,58304787,25438849,NBS
chr18,Bn71826,39591376,83897646,44306270,RLK
chr18,Bn71827,93020230,96899043,3878813,RLK
chr18,Bn71828,88568501,98970249,10401748,RLK
chr18,Bn71829,35711400,58967685,23256285,RLK
chr18,Bn71830,78941642,90781876,11840234,RLP
chr18,Bn71831,55827712,70955019,15127307,NBS
chr18,Bn71832,82921070,96151597,13230527,TN
chr18,Bn71833,63822991,81016017,17193026,RLP
chr18,Bn71834,17939343,44181878,26242535,NBS
chr18,Bn71835,18945325,59457711,40512386,CN
chr18,Bn71836,68420359,92063532,23643173,RLK
chr18,Bn71837,23142843,94181373,71038530,RLP
chr18,Bn71838,23246606,52554652,29308046,TNL
chr18,Bn71839,20615858,37203095,16587237,NBS
chr18,Bn71840,72320161,76549167,4229006,CN
chr18,Bn71841,50945919,98555321,47609402,CNL
chr18,Bn71842,9115819,17886306,8770487,RLK
chr18,Bn71843,4771053,42659862,37888809,CNL
chr18,Bn71844,7299552,41697437,34397885,CNL
chr18,Bn71845,95994470,97563598,1569128,TNL
chr18,Bn71846,54523743,60340310,5816567,CNL
chr18,Bn71847,3293795,43602487,40308692,NBS
chr18,Bn71848,48309175,74592980,26283805,RLK
chr18,Bn71849,3220662,33551424,30330762,NBS
chr18,Bn71850,2581857,9134157,6552300,RLP
chr18,Bn71851,64450229,93586687,29136458,NBS
chr18,Bn71852,22388052,49625972,27237920,CNL
chr18,Bn71853,51000477,92153720,41153243,TN
chr18,Bn71854,31879067,61422652,29543585,RLP
chr18,Bn71855,69890523,76640731,6750208,RLP
chr18,Bn71856,30864886,46266546,15401660,NBS
chr18,Bn71857,51697112,60841901,9144789,RLP
chr18,Bn71858,33355755,84258727,50902972,TN
chr18,Bn71859,59205734,92681733,33475999,TN
chr18,Bn71860,4306950,88863282,84556332,CNL
chr18,Bn71861,6610587,11719541,5108954,CN
chr18,Bn71862,3015683,77921330,74905647,TN
chr18,Bn71863,68318619,74743907,6425288,CN
chr18,Bn71864,11000192,60134756,49134564,NBS
chr18,Bn71865,23428363,36717881,13289518,RLK
chr18,Bn71866,66803344,70439071,3635727,RLP
chr18,Bn71867,13436776,57132107,43695331,CN
chr18,Bn71868,52072403,68733767,16661364,CN
chr18,Bn71869,55362631,95529336,40166705,RLP
chr18,Bn71870,5510270,21658382,16148112,CNL
chr18,Bn71871,62396944,97122565,34725621,NBS
chr18,Bn71872,18923291,73929926,55006635,TNL
chr18,Bn71873,32077111,47267266,15190155,NBS
chr18,Bn71874,17918515,19888755,1970240,RLP
chr18,Bn71875,16771741,92148594,75376853,CNL
chr18,Bn71876,82471020,97856420,15385400,TN
chr18,Bn71877,10593704,46149613,35555909,RLK
chr18,Bn71878,89761946,94679014,4917068,CNL
chr18,Bn71879,49712820,51597876,1885056,TNL
chr18,Bn71880,42727008,82786789,40059781,RLK
chr18,Bn71881,44419324,69762303,25342979,CNL
chr18,Bn71882,4743144,84925873,80182729,NBS
chr18,Bn71883,35624001,81923563,46299562,RLP
chr18,Bn71884,60715982,83858367,23142385,NBS
chr18,Bn71885,46427337,89808086,43380749,RLK
chr18,Bn71886,86118802,98745738,12626936,TNL
chr18,Bn71887,74845396,79731900,4886504,NBS
chr18,Bn71888,65959541,71509049,5549508,CN
chr18,Bn71889,97227098,98441584,1214486,RLK
chr18,Bn71890,87843350,98840462,10997112,NBS
chr18,Bn71891,34171977,39592025,5420048,RLK
chr18,Bn71892,22142143,83156790,61014647,RLP
chr18,Bn71893,39133485,88715352,49581867,CNL
chr18,Bn71894,3624361,89085361,85461000,CN
chr18,Bn71895,11540139,57512725,45972586,CN
chr18,Bn71896,75721967,93610041,17888074,TN
chr18,Bn71897,28054404,87640844,59586440,RLP
chr18,Bn71898,65863503,95607195,29743692,CN
chr18,Bn71899,40813039,49207125,8394086,CNL
chr18,Bn71900,90193584,94901081,4707497,NBS
chr18,Bn71901,69174914,82085584,12910670,CNL
chr18,Bn71902,37000875,60901269,23900394,RLK
chr18,Bn71903,56661033,60603303,3942270,RLP
chr18,Bn71904,49342896,62241329,12898433,CNL
chr18,Bn71905,48939635,62884766,13945131,CNL
chr18,Bn71906,58315295,65407282,7091987,CN
chr18,Bn71907,84875899,97697159,12821260,RLK
chr18,Bn71908,9571755,30608928,21037173,NBS
chr18,Bn71909,33136448,66019705,32883257,CN
chr18,Bn71910,56653622,64492063,7838441,CNL
chr18,Bn71911,32785281,93928818,61143537,RLK
chr18,Bn71912,8232359,52456447,44224088,CNL
chr18,Bn71913,12116254,77115418,64999164,RLK
chr18,Bn71914,75966620,96007056,20040436,RLK
chr18,Bn71915,58412485,95332371,36919886,TNL
chr18,Bn71916,8680604,87382516,78701912,RLK
chr18,Bn71917,21398811,29159816,7761005,RLP
chr18,Bn71918,27773306,66506929,38733623,CN
chr18,Bn71919,97109319,97282379,173060,RLK
chr18,Bn71920,82820368,89918501,7098133,NBS
chr18,Bn71921,56083678,88472136,32388458,CN
chr18,Bn71922,14261419,25569720,11308301,CNL
chr18,Bn71923,80712982,94341327,13628345,RLP
chr18,Bn71924,68517739,72073070,3555331,CNL
chr18,Bn71925,3494750,40669125,37174375,CN
chr18,Bn71926,98706132,98905376,199244,RLK
chr18,Bn71927,61918063,79694341,17776278,RLK
chr18,Bn71928,71425880,88264810,16838930,CNL
chr18,Bn71929,97132964,99314874,2181910,TN
chr18,Bn71930,60125585,79631648,19506063,TNL
chr18,Bn71931,39493537,98601818,59108281,RLK
chr18,Bn71932,72911551,97515533,24603982,NBS
chr18,Bn71933,37234469,84428559,47194090,NBS
chr18,Bn71934,20745077,69052800,48307723,TN
chr18,Bn71935,40946264,89797981,48851717,TNL
chr18,Bn71936,55133147,83720107,28586960,CNL
chr18,Bn71937,83198192,96912370,13714178,TN
chr18,Bn71938,65243914,86527825,21283911,NBS
chr18,Bn71939,7989151,8395088,405937,RLP
chr18,Bn71940,43818123,92601441,48783318,NBS
chr18,Bn71941,54819462,89737285,34917823,CN
chr18,Bn71942,51081381,86839599,35758218,RLK
chr18,Bn71943,31173206,83252224,52079018,RLK
chr18,Bn71944,74838963,97119019,22280056,CN
chr18,Bn71945,48158584,54248617,6090033,CNL
chr18,Bn71946,3110979,53659672,50548693,TN
chr18,Bn71947,40457944,52713210,12255266,TN
chr18,Bn71948,58790213,76865800,18075587,RLK
chr18,Bn71949,40761262,79373594,38612332,RLK
chr18,Bn71950,79265086,93201478,13936392,TN
chr18,Bn71951,32382642,70124579,37741937,TN
chr18,Bn71952,85004326,88214857,3210531,CNL
chr18,Bn71953,37481166,53989953,16508787,TN
chr18,Bn71954,60618673,67892157,7273484,NBS
chr18,Bn71955,39920936,68916673,28995737,RLK
chr18,Bn71956,74156625,98276571,24119946,CNL
chr18,Bn71957,74336674,83417915,9081241,RLP
chr18,Bn71958,21279771,96834993,75555222,CN
chr18,Bn71959,8623378,60172747,51549369,TN
chr18,Bn71960,60720479,61333297,612818,TNL
chr18,Bn71961,8067610,68462973,60395363,CNL
chr18,Bn71962,91836067,98971381,7135314,RLK
chr18,Bn71963,79230611,99074880,19844269,RLP
chr18,Bn71964,59662465,78464731,18802266,CNL
chr18,Bn71965,53481230,56055753,2574523,CN
chr18,Bn71966,2735691,7823101,5087410,CN
chr18,Bn71967,18183662,99828988,81645326,CN
chr18,Bn71968,61369811,63276538,1906727,RLP
chr18,Bn71969,35869866,41068977,5199111,NBS
chr18,Bn71970,53674485,74619394,20944909,RLK
chr18,Bn71971,90084634,95946519,5861885,RLK
chr18,Bn71972,74742428,79909733,5167305,RLP
chr18,Bn71973,17689043,53150069,35461026,TN
chr18,Bn71974,38205135,59123972,20918837,CN
chr18,Bn71975,38727164,44918674,6191510,RLK
chr18,Bn71976,70052303,71097268,1044965,RLP
chr18,Bn71977,91418399,96269865,4851466,RLK
chr18,Bn71978,11155428,96057176,84901748,NBS
chr18,Bn71979,84834138,86296289,1462151,TN
chr18,Bn71980,27999842,59861162,31861320,RLP
chr18,Bn71981,10983479,31474267,20490788,RLP
chr18,Bn71982,94730244,95597604,867360,CNL
chr18,Bn71983,26297885,99525159,73227274,TNL
chr18,Bn71984,7143721,77407068,70263347,CNL
chr18,Bn71985,8196196,40747546,32551350,RLP
chr18,Bn71986,30414933,39266729,8851796,CNL
chr18,Bn71987,56458605,67523363,11064758,CNL
chr18,Bn71988,87188522,97804479,10615957,TN
chr18,Bn71989,40267187,83075107,42807920,RLP
chr18,Bn71990,19466689,93222895,73756206,TNL
chr18,Bn71991,83879091,85199130,1320039,CN
chr18,Bn71992,74012966,86018828,12005862,TN
chr18,Bn71993,75104688,80809070,5704382,TN
chr18,Bn71994,42304061,75096693,32792632,CN
chr18,Bn71995,22702395,73320427,50618032,TN
chr18,Bn71996,71005545,74954497,3948952,CNL
chr18,Bn71997,64892079,75667539,10775460,CNL
chr18,Bn71998,77605340,88420044,10814704,CN
chr18,Bn71999,37062121,56728433,19666312,RLK
chr18,Bn72000,88143213,98889973,10746760,CN
chr18,Bn72001,21044365,54416785,33372420,CN
chr18,Bn72002,81071020,85362503,4291483,TN
chr18,Bn72003,82564176,87265346,4701170,RLK
chr18,Bn72004,86163631,88977608,2813977,TN
chr18,Bn72005,24859033,70298837,45439804,TN
chr18,Bn72006,15751801,30173934,14422133,NBS
chr18,Bn72007,60778087,88786892,28008805,CN
chr18,Bn72008,8548555,64699649,56151094,CNL
chr18,Bn72009,57562670,75340951,17778281,RLP
chr18,Bn72010,34765234,98079491,63314257,NBS
chr18,Bn72011,19728904,94301797,74572893,NBS
chr18,Bn72012,74176035,99582561,25406526,CNL
chr18,Bn72013,38352035,65457465,27105430,CNL
chr18,Bn72014,61993916,62899531,905615,CN
chr18,Bn72015,34839921,50669604,15829683,TN
chr18,Bn72016,2832835,96449805,93616970,TNL
chr18,Bn72017,77976742,82431838,4455096,NBS
chr18,Bn72018,61585972,97512930,35926958,RLK
chr18,Bn72019,22949820,69725531,46775711,NBS
chr18,Bn72020,27709002,54495152,26786150,CN
chr18,Bn72021,67265692,70882084,3616392,RLP
chr18,Bn72022,28446884,59936068,31489184,TN
chr18,Bn72023,61133592,69894589,8760997,TN
chr18,Bn72024,82392820,83123467,730647,TN
chr18,Bn72025,73639896,90416610,16776714,NBS
chr18,Bn72026,24018519,46277964,22259445,NBS
chr18,Bn72027,55384017,74082848,18698831,CN
chr18,Bn72028,83372506,87677308,4304802,CN
chr18,Bn72029,25235812,98517919,73282107,RLK
chr18,Bn72030,41747795,86396911,44649116,RLP
chr18,Bn72031,82516831,91718691,9201860,RLP
chr18,Bn72032,9925031,50770706,40845675,RLK
chr18,Bn72033,24056437,90522105,66465668,TNL
chr18,Bn72034,2900989,11394380,8493391,CNL
chr18,Bn72035,9013837,9557164,543327,RLP
chr18,Bn72036,82735367,97951497,15216130,NBS
chr18,Bn72037,20551938,72806712,52254774,TNL
chr18,Bn72038,76089157,97618045,21528888,RLP
chr18,Bn72039,84647362,97479041,12831679,TN
chr18,Bn72040,65135269,74720936,9585667,TNL
chr18,Bn72041,88847484,97530795,8683311,RLP
chr18,Bn72042,42060938,44625738,2564800,TNL
chr18,Bn72043,14181168,58731942,44550774,TN
chr18,Bn72044,63684920,97672711,33987791,RLP
chr18,Bn72045,81002673,99466676,18464003,CNL
chr18,Bn72046,14216077,18933613,4717536,CN
chr18,Bn72047,96088766,98443831,2355065,RLK
chr18,Bn72048,95016874,96787883,1771009,TNL
chr18,Bn72049,20675776,69031163,48355387,RLK
chr18,Bn72050,19170779,25587308,6416529,CN
chr18,Bn72051,72640441,93059861,20419420,TNL
chr18,Bn72052,69267727,72052142,2784415,RLK
chr18,Bn72053,89958288,90682245,723957,CNL
chr18,Bn72054,34855196,47693398,12838202,CN
chr18,Bn72055,73403811,83220572,9816761,RLK
chr18,Bn72056,27455255,85492847,58037592,TNL
chr18,Bn72057,37035589,99975243,62939654,CNL
chr18,Bn72058,9472439,65092031,55619592,NBS
chr18,Bn72059,90003603,91672938,1669335,NBS
chr18,Bn72060,83160723,85531534,2370811,RLK
chr18,Bn72061,18579009,87354003,68774994,TNL
chr18,Bn72062,98453524,98783005,329481,CN
chr18,Bn72063,11599142,89242692,77643550,TNL
chr18,Bn72064,75050782,92291830,17241048,CN
chr18,Bn72065,27727084,72298055,44570971,RLK
chr18,Bn72066,6690991,25951771,19260780,CN
chr18,Bn72067,42573050,55650618,13077568,CN
chr18,Bn72068,55626741,78386326,22759585,RLP
chr18,Bn72069,5545503,53653678,48108175,TNL
chr18,Bn72070,10758082,83766791,73008709,TN
chr18,Bn72071,55969352,98366772,42397420,RLK
chr18,Bn72072,18460909,91721918,73261009,RLK
chr18,Bn72073,29273381,30987924,1714543,TN
chr18,Bn72074,52427149,97369840,44942691,TNL
chr18,Bn72075,90437416,93236446,2799030,RLK
chr18,Bn72076,67878173,68602930,724757,RLP
chr18,Bn72077,31569832,62949874,31380042,CNL
chr18,Bn72078,76853370,84350657,7497287,CNL
chr18,Bn72079,72473014,74708892,2235878,RLP
chr18,Bn72080,16771540,82776788,66005248,RLK
chr18,Bn72081,59499498,75038113,15538615,RLK
chr18,Bn72082,97230800,99506838,2276038,TNL
chr18,Bn72083,53919608,91973873,38054265,TN
chr18,Bn72084,44435103,90541790,46106687,RLP
chr18,Bn72085,83588312,85393494,1805182,TN
chr18,Bn72086,60694235,62785308,2091073,TNL
chr18,Bn72087,96983693,98948922,1965229,TN
chr18,Bn72088,50726911,75174834,24447923,TN
chr18,Bn72089,77483047,98616285,21133238,RLK
chr18,Bn72090,5513040,98522512,93009472,CNL
chr18,Bn72091,46182272,54039764,7857492,TN
chr18,Bn72092,81561191,90354836,8793645,RLK
chr18,Bn72093,65082960,92090270,27007310,RLK
chr18,Bn72094,77791610,98359323,20567713,RLP
chr18,Bn72095,82071280,96839189,14767909,RLP
chr18,Bn72096,40801027,96810390,56009363,RLK
chr18,Bn72097,41753066,72832454,31079388,CN
chr18,Bn72098,60126932,63654590,3527658,CN
chr18,Bn72099,75645307,87970151,12324844,CN
chr18,Bn72100,75856284,83328351,7472067,RLK
chr18,Bn72101,61395248,77392378,15997130,CN
chr18,Bn72102,3899560,85224273,81324713,CN
chr18,Bn72103,16163871,99764275,83600404,TN
chr18,Bn72104,1335532,95239305,93903773,RLP
chr18,Bn72105,90887817,98854176,7966359,TNL
chr18,Bn72106,81956805,88690956,6734151,CN
chr18,Bn72107,15637497,45929120,30291623,RLP
chr18,Bn72108,62377536,84378691,22001155,CN
chr18,Bn72109,29599264,92304187,62704923,NBS
chr18,Bn72110,43731700,57224408,13492708,TN
chr18,Bn72111,47455932,52504003,5048071,CNL
chr18,Bn72112,40446960,53358033,12911073,NBS
chr18,Bn72113,56430950,57807593,1376643,CN
chr18,Bn72114,69280638,93165007,23884369,NBS
chr18,Bn72115,96037869,97969297,1931428,TNL
chr18,Bn72116,87919276,99398640,11479364,TNL
chr18,Bn72117,40330810,47076660,6745850,NBS
chr18,Bn72118,48308943,96401047,48092104,CN
chr18,Bn72119,19722810,77308100,57585290,CN
chr18,Bn72120,29545018,39237472,9692454,CN
chr18,Bn72121,17540221,21501112,3960891,TN
chr18,Bn72122,39435882,55349943,15914061,RLK
chr18,Bn72123,31080046,71399791,40319745,TN
chr18,Bn72124,80034005,86209745,6175740,TN
chr18,Bn72125,76920149,89662561,12742412,TNL
chr18,Bn72126,48266648,67263364,18996716,CNL
chr18,Bn72127,65552994,81277789,15724795,NBS
chr18,Bn72128,45271333,65560043,20288710,TN
chr18,Bn72129,50757187,76207701,25450514,TNL
chr18,Bn72130,82791306,92627912,9836606,CN
chr18,Bn72131,35143323,77724536,42581213,TN
chr18,Bn72132,76391964,90482472,14090508,NBS
chr18,Bn72133,43420721,99975827,56555106,NBS
chr18,Bn72134,49638067,72266699,22628632,TN
chr18,Bn72135,20962867,25421133,4458266,RLP
chr18,Bn72136,71068790,89052847,17984057,TNL
chr18,Bn72137,62958719,71551755,8593036,RLP
chr18,Bn72138,24976264,66158562,41182298,RLP
chr18,Bn72139,34224151,48171424,13947273,CNL
chr18,Bn72140,59300311,68153389,8853078,RLK
chr18,Bn72141,80441208,89007271,8566063,TNL
chr18,Bn72142,29605763,42526836,12921073,NBS
chr18,Bn72143,54522324,80447009,25924685,NBS
chr18,Bn72144,5785678,61300169,55514491,CNL
chr18,Bn72145,1276289,28699774,27423485,CN
chr18,Bn72146,76347398,95662637,19315239,TN
chr18,Bn72147,90993141,94474194,3481053,RLP
chr18,Bn72148,40328006,91345731,51017725,RLK
chr18,Bn72149,66384356,79173776,12789420,TNL
chr18,Bn72150,94601999,98680679,4078680,TN
chr18,Bn72151,10768006,63674864,52906858,RLK
chr18,Bn72152,59074771,84670057,25595286,TN
chr18,Bn72153,11952003,43378578,31426575,RLP
chr18,Bn72154,40264330,72926290,32661960,RLK
chr18,Bn72155,25712411,61814335,36101924,NBS
chr18,Bn72156,3182214,82691361,79509147,CNL
chr18,Bn72157,11486927,95938086,84451159,CNL
chr18,Bn72158,1433851,46458891,45025040,CNL
chr18,Bn72159,10460342,47746846,37286504,CNL
chr18,Bn72160,75267169,77727554,2460385,TN
chr18,Bn72161,98675176,98752014,76838,NBS
chr18,Bn72162,71900162,99653685,27753523,TN
chr18,Bn72163,66161979,75306358,9144379,RLP
chr18,Bn72164,54293193,54377471,84278,CN
chr18,Bn72165,40602975,91243740,50640765,NBS
chr18,Bn72166,20208096,88500649,68292553,TN
chr18,Bn72167,86068769,86161369,92600,RLK
chr18,Bn72168,50913942,51051192,137250,NBS
chr18,Bn72169,97903861,99310759,1406898,TN
chr18,Bn72170,78676492,92944468,14267976,TNL
chr18,Bn72171,96226550,98191029,1964479,CN
chr18,Bn72172,42509222,75207447,32698225,CN
chr18,Bn72173,94078613,95270210,1191597,CNL
chr18,Bn72174,18967351,94961290,75993939,NBS
chr18,Bn72175,4177763,17459809,13282046,TN
chr18,Bn72176,71972697,82139706,10167009,CN
chr18,Bn72177,34650123,59045883,24395760,TNL
chr18,Bn72178,42137553,83976569,41839016,NBS
chr18,Bn72179,56324170,67865236,11541066,TNL
chr18,Bn72180,57516886,67356935,9840049,RLP
chr18,Bn72181,80022541,93819167,13796626,TNL
chr18,Bn72182,87690505,87839199,148694,TN
chr18,Bn72183,59200565,94666785,35466220,CNL
chr18,Bn72184,89197917,93025131,3827214,NBS
chr18,Bn72185,92970676,98322313,5351637,NBS
chr18,Bn72186,63185699,98619861,35434162,NBS
chr18,Bn72187,78353084,84705295,6352211,TNL
chr18,Bn72188,94890737,98558499,3667762,TNL
chr18,Bn72189,14328522,70018793,55690271,NBS
chr18,Bn72190,14388299,48736477,34348178,RLK
chr18,Bn72191,29898053,34677949,4779896,RLK
chr18,Bn72192,68189412,72922491,4733079,NBS
chr18,Bn72193,19278441,54272570,34994129,TN
chr18,Bn72194,20103970,24901612,4797642,CN
chr18,Bn72195,30565228,72499031,41933803,CN
chr18,Bn72196,53189950,59402760,6212810,RLK
chr18,Bn72197,12426444,98162514,85736070,RLP
chr18,Bn72198,14831664,96867199,82035535,TNL
chr18,Bn72199,10127783,59939032,49811249,CN
chr18,Bn72200,30887315,83599797,52712482,NBS
chr18,Bn72201,52520751,71938031,19417280,TN
chr18,Bn72202,81069497,83495702,2426205,RLP
chr18,Bn72203,21497789,78057051,56559262,RLP
chr18,Bn72204,84402593,95010746,10608153,TNL
chr18,Bn72205,19777752,35803833,16026081,TN
chr18,Bn72206,12187480,84264031,72076551,NBS
chr18,Bn72207,52040472,64068829,12028357,RLK
chr18,Bn72208,41184428,64094987,22910559,RLK
chr18,Bn72209,29496975,86426242,56929267,TNL
chr18,Bn72210,72742157,83438603,10696446,CN
chr18,Bn72211,99978710,99978869,159,CNL
chr18,Bn72212,43283529,53124138,9840609,TN
chr18,Bn72213,61608193,83356900,21748707,CNL
chr18,Bn72214,6585181,28502391,21917210,RLK
chr18,Bn72215,62148194,76126278,13978084,RLP
chr18,Bn72216,82069609,94600614,12531005,TNL
chr18,Bn72217,64780485,76678043,11897558,RLK
chr18,Bn72218,20013435,42146442,22133007,TNL
chr18,Bn72219,80329515,87441836,7112321,CN
chr18,Bn72220,25545938,78410738,52864800,TN
chr18,Bn72221,26157603,85815062,59657459,TNL
chr18,Bn72222,92426579,94397497,1970918,NBS
chr18,Bn72223,23206970,33554334,10347364,RLK
chr18,Bn72224,97367233,98403720,1036487,RLK
chr18,Bn72225,39823254,42326532,2503278,RLP
chr18,Bn72226,13705975,58772013,45066038,TN
chr18,Bn72227,37986661,42627767,4641106,NBS
chr18,Bn72228,8482163,79814076,71331913,RLK
chr18,Bn72229,90414886,97583615,7168729,CN
chr18,Bn72230,66762817,92940305,26177488,RLP
chr18,Bn72231,7475023,65019715,57544692,CN
chr18,Bn72232,81760387,84304409,2544022,NBS
chr18,Bn72233,98920034,99785215,865181,NBS
chr18,Bn72234,97639834,99488861,1849027,TNL
chr18,Bn72235,30170355,89233663,59063308,RLP
chr18,Bn72236,88650017,96857397,8207380,RLP
chr18,Bn72237,96165298,97737717,1572419,TN
chr18,Bn72238,57360718,93847883,36487165,CN
chr18,Bn72239,9810819,66171068,56360249,NBS
chr18,Bn72240,20283420,32281260,11997840,CN
chr18,Bn72241,44209200,75848529,31639329,NBS
chr18,Bn72242,87832372,97944803,10112431,RLP
chr18,Bn72243,55542837,64089696,8546859,RLK
chr18,Bn72244,64157647,74455161,10297514,CNL
chr18,Bn72245,95130446,97412326,2281880,CNL
chr18,Bn72246,40332075,93176290,52844215,TNL
chr18,Bn72247,40209066,54460134,14251068,CN
chr18,Bn72248,7649216,88774785,81125569,NBS
chr18,Bn72249,40280736,45294488,5013752,CNL
chr18,Bn72250,4332884,70287106,65954222,RLK
chr18,Bn72251,60391047,77940495,17549448,TNL
chr18,Bn72252,93466791,99683312,6216521,RLK
chr18,Bn72253,8001211,85053271,77052060,NBS
chr18,Bn72254,2971148,22923268,19952120,CNL
chr18,Bn72255,52101564,54921208,2819644,TN
chr18,Bn72256,27473883,56534596,29060713,CN
chr18,Bn72257,24840501,89596197,64755696,NBS
chr18,Bn72258,37263047,89738580,52475533,TNL
chr18,Bn72259,92347749,96108006,3760257,RLP
chr18,Bn72260,56186077,90117504,33931427,TNL
chr18,Bn72261,51995720,74277123,22281403,CN
chr18,Bn72262,84225476,84821295,595819,NBS
chr18,Bn72263,17741256,69342912,51601656,CNL
chr18,Bn72264,76649605,90792061,14142456,TNL
chr18,Bn72265,98145635,98880379,734744,TN
chr18,Bn72266,50496723,78285745,27789022,TNL
chr18,Bn72267,97654666,98721518,1066852,RLP
chr18,Bn72268,91110890,95387432,4276542,NBS
chr18,Bn72269,23220969,24703855,1482886,RLP
chr18,Bn72270,67394065,99155666,31761601,CNL
chr18,Bn72271,20050686,53969468,33918782,RLK
chr18,Bn72272,27989804,32141324,4151520,TNL
chr18,Bn72273,15375957,57728642,42352685,CNL
chr18,Bn72274,86793775,91462520,4668745,RLK
chr18,Bn72275,13508894,37092638,23583744,RLK
chr18,Bn72276,44129704,59664878,15535174,CNL
chr18,Bn72277,32158346,92597693,60439347,CNL
chr18,Bn72278,20444421,88529549,68085128,TNL
chr18,Bn72279,26519056,60304861,33785805,CN
chr18,Bn72280,76278309,93774597,17496288,CN
chr18,Bn72281,51788338,80438951,28650613,TNL
chr18,Bn72282,21066239,98110957,77044718,TNL
chr18,Bn72283,64972132,92174470,27202338,CNL
chr18,Bn72284,38520045,83124014,44603969,TN
chr18,Bn72285,2193883,82940176,80746293,RLK
chr18,Bn72286,88991206,92474971,3483765,NBS
chr18,Bn72287,80659179,80796264,137085,NBS
chr18,Bn72288,72292042,80317476,8025434,RLK
chr18,Bn72289,83445043,83978346,533303,TN
chr18,Bn72290,8177258,56891766,48714508,TNL
chr18,Bn72291,93980993,99353171,5372178,CN
chr18,Bn72292,90803703,98378090,7574387,TN
chr18,Bn72293,59960040,82347203,22387163,NBS
chr18,Bn72294,67904503,92107987,24203484,RLK
chr18,Bn72295,42111577,60004604,17893027,RLK
chr18,Bn72296,74930587,99150721,24220134,NBS
chr18,Bn72297,52575300,77844312,25269012,TNL
chr18,Bn72298,98426057,99500073,1074016,NBS
chr18,Bn72299,5494616,49901736,44407120,CN
chr18,Bn72300,44680772,96140951,51460179,TN
chr18,Bn72301,13124891,16676441,3551550,CNL
chr18,Bn72302,98045562,98914331,868769,NBS
chr18,Bn72303,65808944,74407845,8598901,CN
chr18,Bn72304,52718924,87231437,34512513,TN
chr18,Bn72305,14828191,61547494,46719303,NBS
chr18,Bn72306,31137714,62208824,31071110,RLP
chr18,Bn72307,6781983,26750196,19968213,TNL
chr18,Bn72308,54245717,91377933,37132216,TNL
chr18,Bn72309,93751872,98034860,4282988,RLP
chr18,Bn72310,48831469,57683372,8851903,CNL
chr18,Bn72311,20560618,95237950,74677332,CN
chr18,Bn72312,16210569,76983463,60772894,CN
chr18,Bn72313,67359851,94563534,27203683,CNL
chr18,Bn72314,78327186,80852308,2525122,CN
chr18,Bn72315,26464352,72601836,46137484,TN
chr18,Bn72316,83361488,87159081,3797593,NBS
chr18,Bn72317,69726100,77176422,7450322,TN
chr18,Bn72318,69663375,87175481,17512106,RLP
chr18,Bn72319,95107746,99100313,3992567,RLP
chr18,Bn72320,54194572,57568438,3373866,CN
chr18,Bn72321,47322044,66024607,18702563,TN
chr18,Bn72322,36135752,87188889,51053137,CN
chr18,Bn72323,37171400,37898484,727084,RLP
chr18,Bn72324,15899251,76542575,60643324,TN
chr18,Bn72325,17155862,90597412,73441550,CN
chr18,Bn72326,83385566,97274040,13888474,TNL
chr18,Bn72327,54617651,84702367,30084716,CN
chr18,Bn72328,91669459,97855854,6186395,RLK
chr18,Bn72329,51168287,82586893,31418606,RLK
chr18,Bn72330,4025773,8304923,4279150,NBS
chr18,Bn72331,5701486,27281232,21579746,RLK
chr18,Bn72332,55910817,98551971,42641154,NBS
chr18,Bn72333,47172661,89910970,42738309,TN
chr18,Bn72334,8743078,42971998,34228920,RLK
chr18,Bn72335,85232658,85946422,713764,TN
chr18,Bn72336,8298686,32288231,23989545,TN
chr18,Bn72337,13361615,37070160,23708545,NBS
chr18,Bn72338,32428813,80212580,47783767,CN
chr18,Bn72339,7043578,70357172,63313594,TNL
chr18,Bn72340,88748468,91438911,2690443,CN
chr18,Bn72341,99773024,99903129,130105,CN
chr18,Bn72342,64987745,74713414,9725669,CN
chr18,Bn72343,31401246,93483316,62082070,RLK
chr18,Bn72344,32317033,92085128,59768095,CN
chr18,Bn72345,82997216,91558923,8561707,TN
chr18,Bn72346,8646620,11770820,3124200,TN
chr18,Bn72347,72582821,79054889,6472068,TN
chr18,Bn72348,15990161,32452476,16462315,TNL
chr18,Bn72349,33360011,40066596,6706585,NBS
chr18,Bn72350,37414870,63624132,26209262,RLP
chr18,Bn72351,44260550,95860426,51599876,CN
chr18,Bn72352,56879338,81249685,24370347,TNL
chr18,Bn72353,57102144,66051344,8949200,TNL
chr18,Bn72354,17169363,46061846,28892483,RLK
chr18,Bn72355,96310992,97196142,885150,NBS
chr18,Bn72356,21167900,92156656,70988756,CN
chr18,Bn72357,32556879,76712513,44155634,RLP
chr18,Bn72358,99463131,99930415,467284,TNL
chr18,Bn72359,15121372,42182019,27060647,TNL
chr18,Bn72360,98721322,99898314,1176992,RLP
chr18,Bn72361,1847712,41141195,39293483,TNL
chr18,Bn72362,19936945,31706283,11769338,RLK
chr18,Bn72363,9516901,93874022,84357121,CNL
chr18,Bn72364,30561488,38017171,7455683,CNL
chr18,Bn72365,47130914,87119865,39988951,CN
chr18,Bn72366,11680919,97194496,85513577,RLK
chr18,Bn72367,87711798,96968360,9256562,RLP
chr18,Bn72368,54874986,92940068,38065082,CN
chr18,Bn72369,75193685,85919166,10725481,CN
chr18,Bn72370,80442072,93437242,12995170,RLP
chr18,Bn72371,52933089,59392431,6459342,RLK
chr18,Bn72372,80190602,92106366,11915764,RLP
chr18,Bn72373,24945881,78919416,53973535,RLK
chr18,Bn72374,45296303,64208634,18912331,RLP
chr18,Bn72375,38836177,82058325,43222148,TNL
chr18,Bn72376,50692283,73245530,22553247,NBS
chr18,Bn72377,29309204,86293094,56983890,CNL
chr18,Bn72378,61080623,78329777,17249154,TNL
chr18,Bn72379,99325935,99487664,161729,CN
chr18,Bn72380,74598730,77586642,2987912,TN
chr18,Bn72381,63795338,74478496,10683158,RLK
chr18,Bn72382,78555602,92919223,14363621,CN
chr18,Bn72383,29247403,79511384,50263981,TN
chr18,Bn72384,63234508,80364423,17129915,CN
chr18,Bn72385,99504960,99915652,410692,RLP
chr18,Bn72386,50036966,95039487,45002521,CNL
chr18,Bn72387,11238127,49153579,37915452,RLP
chr18,Bn72388,80386778,92535045,12148267,TN
chr18,Bn72389,80008473,87844409,7835936,CNL
chr18,Bn72390,16603311,37406334,20803023,RLP
chr18,Bn72391,65855567,97784720,31929153,TNL
chr18,Bn72392,30979710,47051647,16071937,NBS
chr18,Bn72393,64498755,86992014,22493259,CN
chr18,Bn72394,20732965,51428526,30695561,NBS
chr18,Bn72395,25715127,85731686,60016559,CN
chr18,Bn72396,32505935,53059695,20553760,CN
chr18,Bn72397,37444338,69180200,31735862,TNL
chr18,Bn72398,80927534,94714946,13787412,CNL
chr18,Bn72399,1119379,61574199,60454820,CNL
chr18,Bn72400,27604110,88512899,60908789,CNL
chr18,Bn72401,2374402,63712027,61337625,RLK
chr18,Bn72402,15397577,53618760,38221183,TNL
chr18,Bn72403,40000201,43628762,3628561,TNL
chr18,Bn72404,19411419,76239873,56828454,TN
chr18,Bn72405,25494586,59613053,34118467,TN
chr18,Bn72406,85981569,90369701,4388132,RLK
chr18,Bn72407,57128850,96857100,39728250,NBS
chr18,Bn72408,96221636,99592725,3371089,CN
chr18,Bn72409,29838718,73308352,43469634,RLP
chr18,Bn72410,78294059,81811884,3517825,TNL
chr18,Bn72411,73815442,79289499,5474057,TN
chr18,Bn72412,44017086,86939511,42922425,TN
chr18,Bn72413,66856294,77070979,10214685,CNL
chr18,Bn72414,51364266,93875804,42511538,TNL
chr18,Bn72415,76487401,91846083,15358682,CNL
chr18,Bn72416,32298734,74087606,41788872,RLK
chr18,Bn72417,13349647,44569305,31219658,RLP
chr18,Bn72418,64545717,76474690,11928973,CN
chr18,Bn72419,1145399,45100427,43955028,RLP
chr18,Bn72420,96999386,97993796,994410,RLK
chr18,Bn72421,61026529,72054599,11028070,NBS
chr18,Bn72422,17894485,33803327,15908842,RLK
chr18,Bn72423,24406576,48644806,24238230,CNL
chr18,Bn72424,99858834,99979633,120799,RLP
chr18,Bn72425,30698663,34707842,4009179,NBS
chr18,Bn72426,66908144,77159557,10251413,CNL
chr18,Bn72427,95558507,97722559,2164052,RLK
chr18,Bn72428,35654318,55647515,19993197,CNL
chr18,Bn72429,28496829,96366188,67869359,RLP
chr18,Bn72430,12699199,14853809,2154610,TN
chr18,Bn72431,33599990,81464092,47864102,CN
chr18,Bn72432,29954614,94178288,64223674,RLK
chr18,Bn72433,56141641,79332549,23190908,TN
chr18,Bn72434,34795972,99300618,64504646,RLK
chr18,Bn72435,72044980,92409060,20364080,TNL
chr18,Bn72436,56676122,74888133,18212011,CN
chr18,Bn72437,24086312,46745427,22659115,CNL
chr18,Bn72438,93335348,97050224,3714876,RLP
chr18,Bn72439,79089142,94021979,14932837,NBS
chr18,Bn72440,56647769,60921644,4273875,TN
chr18,Bn72441,40268940,49544927,9275987,RLP
chr18,Bn72442,60829786,79892494,19062708,TNL
chr18,Bn72443,20743507,73824725,53081218,RLK
chr18,Bn72444,63255938,72787317,9531379,TNL
chr18,Bn72445,21013259,81948139,60934880,RLP
chr18,Bn72446,12252284,62190718,49938434,CNL
chr18,Bn72447,30061789,74136049,44074260,CN
chr18,Bn72448,94975054,97626160,2651106,RLP
chr18,Bn72449,56588395,98070846,41482451,CNL
chr18,Bn72450,58666864,81071944,22405080,RLK
chr18,Bn72451,86030802,89532907,3502105,TNL
chr18,Bn72452,20149367,31319858,11170491,NBS
chr18,Bn72453,1002377,28754148,27751771,NBS
chr18,Bn72454,2108904,97856791,95747887,TN
chr18,Bn72455,70713169,91484354,20771185,CNL
chr18,Bn72456,24351219,40289532,15938313,CN
chr18,Bn72457,32070571,42786974,10716403,TNL
chr18,Bn72458,92358809,96325349,3966540,RLK
chr18,Bn72459,64433665,67880920,3447255,TN
chr18,Bn72460,97840723,99790811,1950088,TNL
chr18,Bn72461,82242152,93498666,11256514,TN
chr18,Bn72462,84623510,94312733,9689223,CN
chr18,Bn72463,45087005,81884227,36797222,RLK
chr18,Bn72464,77288711,95167404,17878693,NBS
chr18,Bn72465,67070367,87822208,20751841,RLK
chr18,Bn72466,55028059,84693052,29664993,RLK
chr18,Bn72467,72462538,99288021,26825483,TN
chr18,Bn72468,97898418,98922096,1023678,CN
chr18,Bn72469,10467048,17033329,6566281,NBS
chr18,Bn72470,40219242,96926267,56707025,TN
chr18,Bn72471,90846721,91098228,251507,CN
chr18,Bn72472,5635005,31882866,26247861,CN
chr18,Bn72473,78500973,93394056,14893083,CN
chr18,Bn72474,44182176,50987254,6805078,RLK
chr18,Bn72475,32958976,34408707,1449731,CN
chr18,Bn72476,21866203,36600040,14733837,TN
chr18,Bn72477,73820632,74145965,325333,TNL
chr18,Bn72478,51385967,53837901,2451934,NBS
chr18,Bn72479,64867556,85181210,20313654,RLK
chr18,Bn72480,34574584,62998847,28424263,TNL
chr18,Bn72481,77074255,92372881,15298626,CNL
chr18,Bn72482,69126801,96652401,27525600,RLK
chr18,Bn72483,90065672,98483989,8418317,CN
chr18,Bn72484,30902141,51209968,20307827,RLP
chr18,Bn72485,40226815,93603929,53377114,RLK
chr18,Bn72486,29881062,69967565,40086503,CN
chr18,Bn72487,32575177,76292970,43717793,RLK
chr18,Bn72488,74342799,89926917,15584118,NBS
chr18,Bn72489,81383193,81810925,427732,TNL
chr18,Bn72490,81103800,86379706,5275906,CN
chr18,Bn72491,14578736,48758878,34180142,RLK
chr18,Bn72492,35390633,57479642,22089009,CNL
chr18,Bn72493,36573244,41663934,5090690,TNL
chr18,Bn72494,57429741,76032441,18602700,CNL
chr18,Bn72495,10312972,63796311,53483339,TNL
chr18,Bn72496,4701826,27485919,22784093,NBS
chr18,Bn72497,71785479,86038088,14252609,CN
chr18,Bn72498,40039352,88910951,48871599,RLK
chr18,Bn72499,54613788,56046812,1433024,NBS
chr18,Bn72500,34456680,59722110,25265430,RLP
chr18,Bn72501,72971767,90297584,17325817,RLP
chr18,Bn72502,22888071,23607143,719072,TN
chr18,Bn72503,16534144,73940528,57406384,RLK
chr18,Bn72504,5026997,86993866,81966869,CN
chr18,Bn72505,97392162,98383072,990910,TN
chr18,Bn72506,96465844,98360632,1894788,TNL
chr18,Bn72507,21049080,77588396,56539316,NBS
chr18,Bn72508,39879565,63111295,23231730,RLK
chr18,Bn72509,91618801,96366982,4748181,TN
chr18,Bn72510,67249112,82072721,14823609,TN
chr18,Bn72511,29995953,35924594,5928641,CNL
chr18,Bn72512,91904805,96287943,4383138,NBS
chr18,Bn72513,35477339,57939336,22461997,TNL
chr18,Bn72514,83088231,87713286,4625055,TN
chr18,Bn72515,80626137,83209042,2582905,NBS
chr18,Bn72516,34768577,88931481,54162904,CN
chr18,Bn72517,30059831,50924322,20864491,RLK
chr18,Bn72518,35551898,41718558,6166660,NBS
chr18,Bn72519,32412279,76029263,43616984,NBS
chr18,Bn72520,13348944,87221618,73872674,RLK
chr18,Bn72521,51328667,62218125,10889458,TN
chr18,Bn72522,4560155,21108866,16548711,NBS
chr18,Bn72523,35439781,36570968,1131187,TN
chr18,Bn72524,13692173,41264010,27571837,RLK
chr18,Bn72525,92175139,94180801,2005662,CNL
chr18,Bn72526,20483010,81116269,60633259,RLP
chr18,Bn72527,39038115,63509195,24471080,RLP
chr18,Bn72528,20308257,57101323,36793066,RLP
chr18,Bn72529,29468066,60676704,31208638,TNL
chr18,Bn72530,37273560,90205680,52932120,TN
chr18,Bn72531,60657705,92142115,31484410,TN
chr18,Bn72532,74427616,81310974,6883358,RLK
chr18,Bn72533,58289883,98199195,39909312,CNL
chr18,Bn72534,79485971,90908659,11422688,RLK
chr18,Bn72535,75704624,83934923,8230299,RLP
chr18,Bn72536,8290801,84260748,75969947,CNL
chr18,Bn72537,23071035,65253300,42182265,RLP
chr18,Bn72538,76321695,99885632,23563937,TN
chr18,Bn72539,45503959,64852448,19348489,CNL
chr18,Bn72540,28489305,69164712,40675407,TN
chr18,Bn72541,86181280,98758836,12577556,RLP
chr18,Bn72542,44962407,54763613,9801206,NBS
chr18,Bn72543,71150808,80175607,9024799,TNL
chr18,Bn72544,37591670,73089067,35497397,TN
chr18,Bn72545,82384484,89869609,7485125,RLP
chr18,Bn72546,66716752,96454508,29737756,RLK
chr18,Bn72547,13948929,77766548,63817619,RLK
chr18,Bn72548,18258064,40777054,22518990,TN
chr18,Bn72549,67727261,87699317,19972056,NBS
chr18,Bn72550,41549121,86693571,45144450,NBS
chr18,Bn72551,50836968,64375071,13538103,TNL
chr18,Bn72552,1541021,87129047,85588026,TN
chr18,Bn72553,76230871,78535432,2304561,RLK
chr18,Bn72554,4045242,25673468,21628226,RLK
chr18,Bn72555,28971539,34910195,5938656,NBS
chr18,Bn72556,53884725,64663826,10779101,NBS
chr18,Bn72557,47029009,78440285,31411276,NBS
chr18,Bn72558,12513165,50554589,38041424,NBS
chr18,Bn72559,86779366,91337204,4557838,RLK
chr18,Bn72560,20830661,25071493,4240832,TN
chr18,Bn72561,63946048,91928669,27982621,RLK
chr18,Bn72562,75271135,76939458,1668323,TN
chr18,Bn72563,53303721,66705024,13401303,CNL
chr18,Bn72564,29195575,90170506,60974931,CNL
chr18,Bn72565,70183299,94921225,24737926,NBS
chr18,Bn72566,67506032,69824753,2318721,RLK
chr18,Bn72567,2711306,28693668,25982362,RLP
chr18,Bn72568,57449555,93744444,36294889,TNL
chr18,Bn72569,15613945,58533912,42919967,CN
chr18,Bn72570,96596014,98710050,2114036,CNL
chr18,Bn72571,97666912,98084698,417786,TN
chr18,Bn72572,85037179,97419924,12382745,TN
chr18,Bn72573,27609418,36355928,8746510,RLP
chr18,Bn72574,60719261,65198721,4479460,RLP
chr18,Bn72575,42924118,49855509,6931391,TN
chr18,Bn72576,4164015,69569262,65405247,TNL
chr18,Bn72577,35163701,93075650,57911949,TNL
chr18,Bn72578,74181558,98184810,24003252,RLP
chr18,Bn72579,1964780,49004960,47040180,RLP
chr18,Bn72580,98828317,99979654,1151337,TNL
chr18,Bn72581,15085762,22466374,7380612,TN
chr18,Bn72582,80602993,92943092,12340099,TNL
chr18,Bn72583,67397441,81866994,14469553,RLK
chr18,Bn72584,67628187,70226680,2598493,TN
chr18,Bn72585,41274035,57326872,16052837,NBS
chr18,Bn72586,24196134,60247696,36051562,RLK
chr18,Bn72587,13107623,34898936,21791313,CNL
chr18,Bn72588,19111507,40772871,21661364,CN
chr18,Bn72589,43744396,47140324,3395928,RLP
chr18,Bn72590,56244462,69980242,13735780,CNL
chr18,Bn72591,3167494,40742135,37574641,CN
chr18,Bn72592,31198001,67573354,36375353,RLK
chr18,Bn72593,49526695,77926773,28400078,CNL
chr18,Bn72594,6911943,94827784,87915841,CN
chr18,Bn72595,65143922,83514672,18370750,TN
chr18,Bn72596,97161819,97195295,33476,CNL
chr18,Bn72597,87008448,87109639,101191,CNL
chr18,Bn72598,9673919,66274216,56600297,NBS
chr18,Bn72599,50219535,91258450,41038915,CNL
chr18,Bn72600,14239077,54591597,40352520,RLK
chr18,Bn72601,59957297,63742512,3785215,CN
chr18,Bn72602,48608258,94276343,45668085,RLP
chr18,Bn72603,69007146,89130288,20123142,NBS
chr18,Bn72604,14732284,98391256,83658972,CNL
chr18,Bn72605,55464915,58431688,2966773,CN
chr18,Bn72606,18085576,79854716,61769140,TNL
chr18,Bn72607,55839283,56569856,730573,RLK
chr18,Bn72608,97947652,99336458,1388806,RLP
chr18,Bn72609,3054074,41469934,38415860,CNL
chr18,Bn72610,89246915,99251344,10004429,TN
chr18,Bn72611,97122721,97628857,506136,TN
chr18,Bn72612,67670153,99100071,31429918,RLP
chr18,Bn72613,23199348,81575530,58376182,TNL
chr18,Bn72614,50634383,92014223,41379840,RLP
chr18,Bn72615,89324826,96456958,7132132,RLP
chr18,Bn72616,93325914,97967246,4641332,CNL
chr18,Bn72617,26357290,50249209,23891919,CNL
chr18,Bn72618,90301588,99394657,9093069,TNL
chr18,Bn72619,83158544,99107850,15949306,RLK
chr18,Bn72620,89471049,97590157,8119108,NBS
chr18,Bn72621,29292094,76934279,47642185,NBS
chr18,Bn72622,5180166,32040787,26860621,TN
chr18,Bn72623,56040979,80525589,24484610,TN
chr18,Bn72624,28547898,87888217,59340319,TNL
chr18,Bn72625,56735339,78230850,21495511,CNL
chr18,Bn72626,86599742,92054354,5454612,CN
chr18,Bn72627,60542490,62749745,2207255,TNL
chr18,Bn72628,78026648,90419879,12393231,TNL
chr18,Bn72629,47236533,98265200,51028667,CNL
chr18,Bn72630,48797466,97999099,49201633,TN
chr18,Bn72631,91991006,95992052,4001046,TNL
chr18,Bn72632,41657508,95296701,53639193,TN
chr18,Bn72633,54538430,54646946,108516,RLP
chr18,Bn72634,49083518,92931713,43848195,RLP
chr18,Bn72635,83377204,97124586,13747382,TNL
chr18,Bn72636,6314993,47055725,40740732,RLK
chr18,Bn72637,62140626,91447349,29306723,CNL
chr18,Bn72638,48162316,48602836,440520,TN
chr18,Bn72639,91892458,94805673,2913215,CN
chr18,Bn72640,74148431,77793214,3644783,NBS
chr18,Bn72641,5890844,40951259,35060415,NBS
chr18,Bn72642,1265814,52287587,51021773,CNL
chr18,Bn72643,23454390,37947892,14493502,RLP
chr18,Bn72644,4356066,27651814,23295748,NBS
chr18,Bn72645,56855454,87265960,30410506,NBS
chr18,Bn72646,38055572,99439548,61383976,CN
chr18,Bn72647,62161012,99191884,37030872,TN
chr18,Bn72648,9413350,77819120,68405770,CN
chr18,Bn72649,7337995,34460904,27122909,TN
chr18,Bn72650,48894006,80107057,31213051,RLK
chr18,Bn72651,96715170,98906862,2191692,NBS
chr18,Bn72652,43344024,72044285,28700261,RLP
chr18,Bn72653,83792102,92821300,9029198,CN
chr18,Bn72654,22267169,65917959,43650790,RLP
chr18,Bn72655,66096088,96230214,30134126,TN
chr18,Bn72656,90037688,94103851,4066163,TN
chr18,Bn72657,12437160,23296671,10859511,RLP
chr18,Bn72658,40861594,58232790,17371196,NBS
chr18,Bn72659,17256532,38452465,21195933,NBS
chr18,Bn72660,73033132,91122211,18089079,TNL
chr18,Bn72661,42471594,51769331,9297737,CNL
chr18,Bn72662,61664047,91320238,29656191,CNL
chr18,Bn72663,99597154,99646482,49328,CN
chr18,Bn72664,37656291,85498436,47842145,RLP
chr18,Bn72665,49499336,79814124,30314788,CN
chr18,Bn72666,77925971,88381663,10455692,TNL
chr18,Bn72667,16700526,34236004,17535478,NBS
chr18,Bn72668,84695965,96655137,11959172,RLK
chr18,Bn72669,41805739,53729735,11923996,NBS
chr18,Bn72670,24608089,65554545,40946456,CN
chr18,Bn72671,61383950,88776863,27392913,TNL
chr18,Bn72672,54996455,90719302,35722847,RLP
chr18,Bn72673,83950477,99654313,15703836,NBS
chr18,Bn72674,9975432,86901738,76926306,NBS
chr18,Bn72675,64609614,68130131,3520517,TNL
chr18,Bn72676,45336064,89309482,43973418,RLK
chr18,Bn72677,24276032,94362977,70086945,CNL
chr18,Bn72678,55150752,96780163,41629411,TNL
chr18,Bn72679,81257768,82755447,1497679,NBS
chr18,Bn72680,54371615,78406621,24035006,NBS
chr18,Bn72681,42586386,45633945,3047559,CN
chr18,Bn72682,12900707,36307111,23406404,RLK
chr18,Bn72683,16442932,27853255,11410323,TNL
chr18,Bn72684,49705803,60281178,10575375,TNL
chr18,Bn72685,69980758,95833076,25852318,TN
chr18,Bn72686,7243543,38753053,31509510,CN
chr18,Bn72687,94269585,99844699,5575114,TNL
chr18,Bn72688,11700133,26524890,14824757,TN
chr18,Bn72689,24486448,39977049,15490601,TNL
chr18,Bn72690,30363815,97472318,67108503,RLP
chr18,Bn72691,91401710,93032904,1631194,CN
chr18,Bn72692,73714049,80395392,6681343,TNL
chr18,Bn72693,73010503,93861954,20851451,CNL
chr18,Bn72694,59169267,95239936,36070669,RLP
chr18,Bn72695,43343184,60207498,16864314,CNL
chr18,Bn72696,25856286,72825320,46969034,NBS
chr18,Bn72697,37788980,82444060,44655080,TN
chr18,Bn72698,33286146,36845849,3559703,CN
chr18,Bn72699,30797623,67445153,36647530,RLP
chr18,Bn72700,40920188,74660430,33740242,NBS
chr18,Bn72701,32302050,75608490,43306440,NBS
chr18,Bn72702,86754085,98332329,11578244,RLP
chr18,Bn72703,40199428,97291035,57091607,RLP
chr18,Bn72704,97857320,99895714,2038394,TNL
chr18,Bn72705,13447913,93672128,80224215,RLK
chr18,Bn72706,29685570,39224574,9539004,NBS
chr18,Bn72707,72487750,75704353,3216603,RLK
chr18,Bn72708,85336074,99638241,14302167,NBS
chr18,Bn72709,55669847,93666980,37997133,CN
chr18,Bn72710,87035179,91791424,4756245,CN
chr18,Bn72711,34189159,67379945,33190786,CNL
chr18,Bn72712,16411812,38400272,21988460,NBS
chr18,Bn72713,39567239,96424206,56856967,NBS
chr18,Bn72714,20166321,85292621,65126300,CNL
chr18,Bn72715,65638423,87118157,21479734,TNL
chr18,Bn72716,69784579,83296819,13512240,TNL
chr18,Bn72717,99246962,99672251,425289,CN
chr18,Bn72718,95857708,98332325,2474617,TNL
chr18,Bn72719,71426198,81635309,10209111,NBS
chr18,Bn72720,7832761,17582373,9749612,RLK
chr18,Bn72721,13140892,17228238,4087346,CN
chr18,Bn72722,38495923,58927326,20431403,RLP
chr18,Bn72723,46849002,57045393,10196391,RLP
chr18,Bn72724,85023717,98882756,13859039,TN
chr18,Bn72725,15306635,15695008,388373,CN
chr18,Bn72726,97276240,98273108,996868,RLP
chr18,Bn72727,78491429,99034601,20543172,NBS
chr18,Bn72728,77950257,87855011,9904754,NBS
chr18,Bn72729,38741834,98135171,59393337,NBS
chr18,Bn72730,40517489,63788289,23270800,TNL
chr18,Bn72731,75258542,95266055,20007513,TNL
chr18,Bn72732,54941116,69589199,14648083,RLP
chr18,Bn72733,8714173,92172104,83457931,CN
chr18,Bn72734,8967617,99653817,90686200,TN
chr18,Bn72735,82105370,94272616,12167246,TN
chr18,Bn72736,32446946,42678722,10231776,CNL
chr18,Bn72737,81352907,88306253,6953346,TN
chr18,Bn72738,98168689,99508474,1339785,CNL
chr18,Bn72739,56195299,69445377,13250078,RLK
chr18,Bn72740,94548704,94661361,112657,RLP
chr18,Bn72741,64442015,67931598,3489583,RLP
chr18,Bn72742,57769412,90811914,33042502,CNL
chr18,Bn72743,66775913,71480177,4704264,NBS
chr18,Bn72744,86127336,86715250,587914,CN
chr18,Bn72745,22015428,71579755,49564327,CN
chr18,Bn72746,41010926,87207026,46196100,RLP
chr18,Bn72747,67493344,86113793,18620449,TN
chr18,Bn72748,70956649,79602604,8645955,RLP
chr18,Bn72749,58986179,60129557,1143378,TN
chr18,Bn72750,16092235,99787493,83695258,RLP
chr18,Bn72751,62007966,74728331,12720365,NBS
chr18,Bn72752,87971645,93674787,5703142,RLP
chr18,Bn72753,88616293,91873944,3257651,CNL
chr18,Bn72754,42619999,85502051,42882052,RLP
chr18,Bn72755,81903786,92189087,10285301,CNL
chr18,Bn72756,30203383,41128598,10925215,RLP
chr18,Bn72757,97112215,97290538,178323,RLK
chr18,Bn72758,89981523,95879304,5897781,NBS
chr18,Bn72759,2328681,44613071,42284390,TNL
chr18,Bn72760,85136044,90232285,5096241,CNL
chr18,Bn72761,84611279,85261756,650477,CNL
chr18,Bn72762,26252745,33102042,6849297,NBS
chr18,Bn72763,1882175,5853514,3971339,CN
chr18,Bn72764,83935590,85263825,1328235,CNL
chr18,Bn72765,11382360,23510387,12128027,RLK
chr18,Bn72766,81614825,88846525,7231700,RLK
chr18,Bn72767,27615884,53101871,25485987,RLK
chr18,Bn72768,70639907,92186706,21546799,TN
chr18,Bn72769,25879918,62288665,36408747,TN
chr18,Bn72770,88355460,92989827,4634367,TN
chr18,Bn72771,62792446,71119342,8326896,CN
chr18,Bn72772,74865945,97964583,23098638,CNL
chr18,Bn72773,20969548,95982656,75013108,CNL
chr18,Bn72774,44820061,57969563,13149502,CNL
chr18,Bn72775,43464534,60456364,16991830,TNL
chr18,Bn72776,53678568,74487351,20808783,CNL
chr18,Bn72777,10886220,40596982,29710762,TNL
chr18,Bn72778,67009074,79793487,12784413,CN
chr18,Bn72779,23870363,68034714,44164351,RLP
chr18,Bn72780,85421470,91678060,6256590,RLP
chr18,Bn72781,35695108,55290190,19595082,TN
chr18,Bn72782,39828800,49428960,9600160,CN
chr18,Bn72783,88401783,99045594,10643811,CN
chr18,Bn72784,15694168,88251592,72557424,RLK
chr18,Bn72785,42951941,46321368,3369427,TN
chr18,Bn72786,73582968,85838723,12255755,CN
chr18,Bn72787,57710633,96295170,38584537,CNL
chr18,Bn72788,30227122,91206180,60979058,CN
chr18,Bn72789,27008998,47584727,20575729,TN
chr18,Bn72790,1660312,44373820,42713508,NBS
chr18,Bn72791,10841575,20611465,9769890,TNL
chr18,Bn72792,54529598,71042908,16513310,CN
chr18,Bn72793,67957737,83225357,15267620,RLP
chr18,Bn72794,26475742,76124772,49649030,RLK
chr18,Bn72795,32371320,40839989,8468669,NBS
chr18,Bn72796,51849329,67872181,16022852,RLP
chr18,Bn72797,38103972,53695788,15591816,CNL
chr18,Bn72798,23232131,67187570,43955439,CN
chr18,Bn72799,23229411,58014229,34784818,CN
chr18,Bn72800,69211927,92063937,22852010,CN
chr18,Bn72801,69146489,93103845,23957356,CNL
chr18,Bn72802,6580885,11057264,4476379,RLK
chr18,Bn72803,29001008,80419695,51418687,CN
chr18,Bn72804,52897007,72131286,19234279,CN
chr18,Bn72805,96449341,97715316,1265975,CN
chr18,Bn72806,28842943,34962567,6119624,RLK
chr18,Bn72807,88332559,98728503,10395944,CNL
chr18,Bn72808,81117217,97419849,16302632,RLK
chr18,Bn72809,84218378,97552617,13334239,TNL
chr18,Bn72810,84078122,99132822,15054700,CN
chr18,Bn72811,46725453,83211282,36485829,CNL
chr18,Bn72812,21411936,22378930,966994,NBS
chr18,Bn72813,86788186,89829644,3041458,TNL
chr18,Bn72814,14783864,25536861,10752997,CN
chr18,Bn72815,1010536,80058212,79047676,CNL
chr18,Bn72816,26610201,53264514,26654313,CNL
chr18,Bn72817,42075834,72281414,30205580,TNL
chr18,Bn72818,59993058,87516870,27523812,TN
chr18,Bn72819,63964954,71114407,7149453,NBS
chr18,Bn72820,78619140,80021259,1402119,NBS
chr18,Bn72821,16921328,81222670,64301342,RLP
chr18,Bn72822,84112424,89976302,5863878,TN
chr18,Bn72823,70879409,90894005,20014596,TNL
chr18,Bn72824,21989878,28621182,6631304,RLK
chr18,Bn72825,25454838,50589554,25134716,CNL
chr18,Bn72826,39829178,84755329,44926151,TN
chr18,Bn72827,48064614,87350151,39285537,TN
chr18,Bn72828,48305963,78578901,30272938,RLK
chr18,Bn72829,60273977,71254205,10980228,RLP
chr18,Bn72830,32206556,61008044,28801488,CN
chr18,Bn72831,60034791,83908359,23873568,NBS
chr18,Bn72832,72243263,87588230,15344967,CNL
chr18,Bn72833,85205631,88356511,3150880,RLK
chr18,Bn72834,83607013,86114081,2507068,TNL
chr18,Bn72835,99581160,99787528,206368,CNL
chr18,Bn72836,96617284,97051703,434419,RLP
chr18,Bn72837,30770558,53245802,22475244,CNL
chr18,Bn72838,22054676,83671184,61616508,TNL
chr18,Bn72839,55226178,84232213,29006035,CN
chr18,Bn72840,77721510,84016185,6294675,TNL
chr18,Bn72841,45951081,96744808,50793727,TNL
chr18,Bn72842,72352284,82095832,9743548,RLP
chr18,Bn72843,18440003,69851828,51411825,CNL
chr18,Bn72844,37159359,46970425,9811066,NBS
chr18,Bn72845,10479634,44792642,34313008,TN
chr18,Bn72846,76214612,97298529,21083917,TNL
chr18,Bn72847,35417398,57541796,22124398,NBS
chr18,Bn72848,17625970,76732825,59106855,RLK
chr18,Bn72849,95592703,99709855,4117152,RLP
chr18,Bn72850,92488653,92540231,51578,TN
chr18,Bn72851,61447804,87212321,25764517,RLK
chr18,Bn72852,55926203,67560100,11633897,RLP
chr18,Bn72853,40767986,92990868,52222882,CN
chr18,Bn72854,42457255,99137278,56680023,RLK
chr18,Bn72855,25882454,73952276,48069822,RLP
chr18,Bn72856,5076291,89456248,84379957,CN
chr18,Bn72857,97036470,98211435,1174965,TNL
chr18,Bn72858,68612705,99215646,30602941,RLK
chr18,Bn72859,38164699,97231712,59067013,CN
chr18,Bn72860,84700466,86218760,1518294,TNL
chr18,Bn72861,97251845,98857281,1605436,CNL
chr18,Bn72862,99125991,99683675,557684,RLK
chr18,Bn72863,67436698,90854108,23417410,CN
chr18,Bn72864,68723731,79236672,10512941,RLK
chr18,Bn72865,3814816,33770886,29956070,TNL
chr18,Bn72866,44279444,86194885,41915441,TNL
chr18,Bn72867,89843300,90428492,585192,CNL
chr18,Bn72868,43941639,49202271,5260632,RLP
chr18,Bn72869,59186653,94157515,34970862,TNL
chr18,Bn72870,28116579,99973839,71857260,TNL
chr18,Bn72871,73900858,89272228,15371370,RLP
chr18,Bn72872,2522156,87767413,85245257,RLP
chr18,Bn72873,30816985,65594181,34777196,RLK
chr18,Bn72874,58598135,93825719,35227584,CNL
chr18,Bn72875,60831076,80346232,19515156,CNL
chr18,Bn72876,13406881,91232649,77825768,RLP
chr18,Bn72877,82313942,98379606,16065664,NBS
chr18,Bn72878,59504088,63004184,3500096,NBS
chr18,Bn72879,84083668,91332065,7248397,TNL
chr18,Bn72880,46165935,80298969,34133034,RLP
chr18,Bn72881,34122181,99916517,65794336,RLK
chr18,Bn72882,63682444,80833843,17151399,NBS
chr18,Bn72883,30346887,63983521,33636634,RLK
chr18,Bn72884,60317870,74773673,14455803,TNL
chr18,Bn72885,46836649,53029673,6193024,CNL
chr18,Bn72886,11114794,89949041,78834247,CN
chr18,Bn72887,59015823,96787816,37771993,CN
chr18,Bn72888,61139438,83215673,22076235,TN
chr18,Bn72889,19600108,62667142,43067034,TN
chr18,Bn72890,38454958,53362275,14907317,CNL
chr18,Bn72891,46284839,81179707,34894868,NBS
chr18,Bn72892,95159322,97571362,2412040,CN
chr18,Bn72893,44627347,68392692,23765345,NBS
chr18,Bn72894,70425472,92336137,21910665,TN
chr18,Bn72895,41854939,52480417,10625478,NBS
chr18,Bn72896,1309630,48270554,46960924,CNL
chr18,Bn72897,51023202,52489778,1466576,RLP
chr18,Bn72898,82755511,93470181,10714670,TN
chr18,Bn72899,83476788,93640109,10163321,CN
chr18,Bn72900,73952742,85325287,11372545,RLK
chr18,Bn72901,69958296,99289226,29330930,TN
chr18,Bn72902,10429890,84627611,74197721,CN
chr18,Bn72903,89951529,98466057,8514528,CN
chr18,Bn72904,73519345,86927367,13408022,TN
chr18,Bn72905,3881274,65271961,61390687,RLK
chr18,Bn72906,33278878,43488884,10210006,RLP
chr18,Bn72907,18316643,38526607,20209964,TNL
chr18,Bn72908,38103179,46329636,8226457,CN
chr18,Bn72909,6560974,89969777,83408803,TNL
chr18,Bn72910,79633590,94631564,14997974,TNL
chr18,Bn72911,54693403,98244370,43550967,RLP
chr18,Bn72912,54920818,92062914,37142096,RLK
chr18,Bn72913,24286930,69835633,45548703,TNL
chr18,Bn72914,85032220,97340300,12308080,TN
chr18,Bn72915,76376965,95311885,18934920,CNL
chr18,Bn72916,68322079,88160693,19838614,CNL
chr18,Bn72917,27449336,54201507,26752171,CNL
chr18,Bn72918,84494094,92573586,8079492,TN
chr18,Bn72919,80027045,87484026,7456981,NBS
chr18,Bn72920,74794152,93114876,18320724,TN
chr18,Bn72921,36248331,69260084,33011753,CNL
chr18,Bn72922,73976944,82849253,8872309,RLP
chr18,Bn72923,47617918,67370450,19752532,NBS
chr18,Bn72924,56853620,58750240,1896620,RLK
chr18,Bn72925,88072191,97294320,9222129,NBS
chr18,Bn72926,59907160,61210206,1303046,CN
chr18,Bn72927,80150101,92148502,11998401,RLK
chr18,Bn72928,75901388,95667135,19765747,NBS
chr18,Bn72929,47659510,97177824,49518314,TNL
chr18,Bn72930,62048246,84848691,22800445,RLP
chr18,Bn72931,74735569,95056899,20321330,CN
chr18,Bn72932,34918914,83228208,48309294,TN
chr18,Bn72933,30854640,41412207,10557567,TN
chr18,Bn72934,39721571,96053281,56331710,TNL
chr18,Bn72935,92490452,96567574,4077122,RLK
chr18,Bn72936,26822242,66453672,39631430,TNL
chr18,Bn72937,34771625,55995117,21223492,RLP
chr18,Bn72938,64255255,86833048,22577793,CN
chr18,Bn72939,56110977,73353329,17242352,CN
chr18,Bn72940,75398991,92370682,16971691,NBS
chr18,Bn72941,31153067,73048759,41895692,NBS
chr18,Bn72942,57000932,83679476,26678544,TNL
chr18,Bn72943,85332045,98318086,12986041,TN
chr18,Bn72944,59823201,92598666,32775465,TN
chr18,Bn72945,69225400,85787397,16561997,CN
chr18,Bn72946,29620330,97005383,67385053,TN
chr18,Bn72947,58525960,94484380,35958420,CNL
chr18,Bn72948,82276472,99675386,17398914,TN
chr18,Bn72949,27963464,72106898,44143434,TNL
chr18,Bn72950,35798620,98900986,63102366,TNL
chr18,Bn72951,26114125,46579253,20465128,TNL
chr18,Bn72952,64088512,75003108,10914596,NBS
chr18,Bn72953,53103081,92771005,39667924,NBS
chr18,Bn72954,2931452,71095284,68163832,CN
chr18,Bn72955,23963953,83585738,59621785,CNL
chr18,Bn72956,66800441,95038120,28237679,TN
chr18,Bn72957,53016591,96701946,43685355,RLK
chr18,Bn72958,56414703,75356381,18941678,RLK
chr18,Bn72959,97465367,99824272,2358905,TN
chr18,Bn72960,24530548,71366958,46836410,NBS
chr18,Bn72961,46926050,49817041,2890991,CNL
chr18,Bn72962,20480523,45088551,24608028,RLK
chr18,Bn72963,65644258,91309331,25665073,TN
chr18,Bn72964,15095712,93447669,78351957,CN
chr18,Bn72965,16961166,88938459,71977293,RLP
chr18,Bn72966,76514088,77379747,865659,CNL
chr18,Bn72967,70064703,92855863,22791160,TNL
chr18,Bn72968,20817541,65735773,44918232,TN
chr18,Bn72969,18253379,60540594,42287215,RLK
chr18,Bn72970,15535228,58702278,43167050,TNL
chr18,Bn72971,44353144,91767655,47414511,TNL
chr18,Bn72972,6703868,82158942,75455074,NBS
chr18,Bn72973,44701708,82415609,37713901,TNL
chr18,Bn72974,56571498,76181396,19609898,RLP
chr18,Bn72975,8305510,43736262,35430752,CNL
chr18,Bn72976,56378692,86624210,30245518,TNL
chr18,Bn72977,59563452,89596965,30033513,CNL
chr18,Bn72978,26708188,83074017,56365829,RLP
chr18,Bn72979,1125884,28803087,27677203,CN
chr18,Bn72980,40120393,63685185,23564792,TNL
chr18,Bn72981,52390368,72201356,19810988,TN
chr18,Bn72982,60581841,95259313,34677472,NBS
chr18,Bn72983,96391755,99065920,2674165,TN
chr18,Bn72984,95884193,96632613,748420,TN
chr18,Bn72985,97101298,97920625,819327,TNL
chr18,Bn72986,63439028,94612523,31173495,RLP
chr18,Bn72987,95502379,98511730,3009351,CN
chr18,Bn72988,72620191,74331888,1711697,TN
chr18,Bn72989,1392807,61593614,60200807,NBS
chr18,Bn72990,94970615,95324835,354220,TNL
chr18,Bn72991,20943114,65870437,44927323,TN
chr18,Bn72992,53709201,55039057,1329856,TNL
chr18,Bn72993,14566516,52812610,38246094,CN
chr18,Bn72994,80695863,82431389,1735526,RLP
chr18,Bn72995,36508538,40096974,3588436,RLK
chr18,Bn72996,7057609,91035453,83977844,TNL
chr18,Bn72997,23465975,94183943,70717968,NBS
chr18,Bn72998,44910780,73856666,28945886,TN
chr18,Bn72999,33942215,49361893,15419678,CN
chr18,Bn73000,15715752,68353065,52637313,RLP
chr18,Bn73001,67371796,75101529,7729733,CNL
chr18,Bn73002,34045625,68126776,34081151,CNL
chr18,Bn73003,35163653,97083494,61919841,RLP
chr18,Bn73004,71656408,71883570,227162,CNL
chr18,Bn73005,63796350,67274899,3478549,RLP
chr18,Bn73006,53880656,88627162,34746506,RLP
chr18,Bn73007,48697536,73316286,24618750,TNL
chr18,Bn73008,56747349,90040237,33292888,TNL
chr18,Bn73009,27464166,69864991,42400825,CNL
chr18,Bn73010,25964763,76254733,50289970,NBS
chr18,Bn73011,78420137,89433781,11013644,TNL
chr18,Bn73012,62968581,89159606,26191025,TN
chr18,Bn73013,5967446,13405091,7437645,TNL
chr18,Bn73014,62792663,74028609,11235946,RLK
chr18,Bn73015,75379591,76302264,922673,TNL
chr18,Bn73016,84238782,85013312,774530,TNL
chr18,Bn73017,31251491,94328527,63077036,TNL
chr18,Bn73018,51193870,83810953,32617083,TNL
chr18,Bn73019,54556396,77373540,22817144,RLK
chr18,Bn73020,97589102,97709281,120179,RLP
chr18,Bn73021,96601017,99726262,3125245,CNL
chr18,Bn73022,59219017,78539873,19320856,RLP
chr18,Bn73023,83489962,96921026,13431064,TN
chr18,Bn73024,52626761,98974030,46347269,TNL
chr18,Bn73025,16575609,76352165,59776556,TNL
chr18,Bn73026,23402231,34409085,11006854,TNL
chr18,Bn73027,43694653,53379670,9685017,TNL
chr18,Bn73028,88358491,97280662,8922171,TNL
chr18,Bn73029,77964744,84093860,6129116,TNL
chr18,Bn73030,67048984,68282684,1233700,CN
chr18,Bn73031,87138561,93199712,6061151,CNL
chr18,Bn73032,75873126,97918635,22045509,RLK
chr18,Bn73033,88322695,97197836,8875141,NBS
chr18,Bn73034,24238648,61997176,37758528,CNL
chr18,Bn73035,67848655,84689581,16840926,RLP
chr18,Bn73036,24163311,47325631,23162320,TN
chr18,Bn73037,43962046,71483876,27521830,NBS
chr18,Bn73038,43898714,72331951,28433237,TN
chr18,Bn73039,99765796,99887337,121541,RLK
chr18,Bn73040,82470632,84843694,2373062,NBS
chr18,Bn73041,18828285,95435729,76607444,CNL
chr18,Bn73042,40678038,41372542,694504,TN
chr18,Bn73043,67506630,85073161,17566531,RLK
chr18,Bn73044,93152842,99602791,6449949,CN
chr18,Bn73045,56501048,62095109,5594061,CNL
chr18,Bn73046,64046561,93984417,29937856,TNL
chr18,Bn73047,21357323,38934022,17576699,TN
chr18,Bn73048,74421282,89834388,15413106,RLK
chr18,Bn73049,50460882,71229837,20768955,TNL
chr18,Bn73050,44249896,45894121,1644225,CN
chr18,Bn73051,16717753,55830771,39113018,TNL
chr18,Bn73052,85454553,86847137,1392584,RLP
chr18,Bn73053,24258222,73155700,48897478,RLK
chr18,Bn73054,70373295,97148020,26774725,TN
chr18,Bn73055,21176130,27876127,6699997,CNL
chr18,Bn73056,1492679,87852989,86360310,TN
chr18,Bn73057,32010870,87205203,55194333,RLP
chr18,Bn73058,69702020,76380193,6678173,NBS
chr18,Bn73059,42724634,93843529,51118895,RLK
chr18,Bn73060,34399979,55350445,20950466,RLP
chr18,Bn73061,30318350,37638329,7319979,TN
chr18,Bn73062,26420734,80471357,54050623,RLP
chr18,Bn73063,7730146,43373353,35643207,RLK
chr18,Bn73064,19137331,94156062,75018731,RLP
chr18,Bn73065,18764249,25110309,6346060,RLK
chr18,Bn73066,74756289,83354512,8598223,NBS
chr18,Bn73067,23571772,28141619,4569847,TN
chr18,Bn73068,75385698,89902915,14517217,TN
chr18,Bn73069,34194466,60931938,26737472,RLK
chr18,Bn73070,57227758,98227328,40999570,NBS
chr18,Bn73071,79855374,97793356,17937982,TNL
chr18,Bn73072,15140446,26538857,11398411,RLK
chr18,Bn73073,16172958,29028717,12855759,RLP
chr18,Bn73074,47190737,82390123,35199386,RLK
chr18,Bn73075,51732610,97959416,46226806,RLK
chr18,Bn73076,18679852,94668425,75988573,TNL
chr18,Bn73077,15752522,89710906,73958384,RLK
chr18,Bn73078,79955834,91154422,11198588,TNL
chr18,Bn73079,34692018,76545006,41852988,CNL
chr18,Bn73080,13688545,36736241,23047696,TN
chr18,Bn73081,44233455,71811669,27578214,NBS
chr18,Bn73082,59216460,98749797,39533337,NBS
chr18,Bn73083,40962324,89428514,48466190,CN
chr18,Bn73084,83082465,86216702,3134237,RLP
chr18,Bn73085,27860539,65155225,37294686,NBS
chr18,Bn73086,49679592,76986506,27306914,RLP
chr18,Bn73087,62587416,76715666,14128250,TNL
chr18,Bn73088,48867497,84365178,35497681,NBS
chr18,Bn73089,58456164,90912964,32456800,RLP
chr18,Bn73090,9641517,71051271,61409754,CN
chr18,Bn73091,44178987,57994480,13815493,CN
chr18,Bn73092,84203248,93167231,8963983,RLK
chr18,Bn73093,57573374,93259283,35685909,CNL
chr18,Bn73094,16538412,42636263,26097851,TN
chr18,Bn73095,18568635,84906493,66337858,CN
chr18,Bn73096,71281954,75355723,4073769,RLK
chr18,Bn73097,97382096,99763958,2381862,CNL
chr18,Bn73098,61688224,71526062,9837838,TN
chr18,Bn73099,15159028,58066741,42907713,RLK
chr18,Bn73100,32372285,87000851,54628566,TNL
chr18,Bn73101,90943537,91386355,442818,RLK
chr18,Bn73102,64728201,68680313,3952112,CNL
chr18,Bn73103,65101806,86496576,21394770,RLK
chr18,Bn73104,31079007,74715511,43636504,TNL
chr18,Bn73105,29561385,62179370,32617985,CN
chr18,Bn73106,64607015,95312257,30705242,RLP
chr18,Bn73107,22873382,68284643,45411261,TN
chr18,Bn73108,24392559,77006496,52613937,RLP
chr18,Bn73109,74689413,89914575,15225162,CN
chr18,Bn73110,84617911,99128264,14510353,TNL
chr18,Bn73111,80424360,83014723,2590363,TNL
chr18,Bn73112,19379017,99547603,80168586,RLK
chr18,Bn73113,90399470,93104656,2705186,CN
chr18,Bn73114,70655757,99384753,28728996,CNL
chr18,Bn73115,78180474,83873765,5693291,RLK
chr18,Bn73116,92568194,92982283,414089,CNL
chr18,Bn73117,23027676,62182639,39154963,CNL
chr18,Bn73118,42870328,88131160,45260832,TN
chr18,Bn73119,31052843,92221706,61168863,TNL
chr18,Bn73120,8954639,9435709,481070,CNL
chr18,Bn73121,57714774,80167430,22452656,RLP
chr18,Bn73122,68320858,86773347,18452489,NBS
chr18,Bn73123,10494858,83188131,72693273,CN
chr18,Bn73124,65294081,95898718,30604637,NBS
chr18,Bn73125,40366242,75814572,35448330,TN
chr18,Bn73126,67272430,73754988,6482558,RLK
chr18,Bn73127,82536367,97051153,14514786,TN
chr18,Bn73128,75205298,90023850,14818552,TNL
chr18,Bn73129,15738833,50707794,34968961,TN
chr18,Bn73130,95976808,96889896,913088,NBS
chr18,Bn73131,56001014,62845130,6844116,CN
chr18,Bn73132,2605061,33726339,31121278,CN
chr18,Bn73133,20461618,95069168,74607550,CNL
chr18,Bn73134,55143512,85821971,30678459,TN
chr18,Bn73135,54022462,74013097,19990635,TN
chr18,Bn73136,42007880,78019632,36011752,NBS
chr18,Bn73137,81040824,94840526,13799702,CN
chr18,Bn73138,77188508,89006918,11818410,RLP
chr18,Bn73139,74982734,80771522,5788788,NBS
chr18,Bn73140,5310319,52657317,47346998,RLP
chr18,Bn73141,24542450,35633917,11091467,CN
chr18,Bn73142,10982534,38947513,27964979,TNL
chr18,Bn73143,38659761,59139029,20479268,RLP
chr18,Bn73144,2080867,27945808,25864941,RLP
chr18,Bn73145,37570578,67359443,29788865,RLP
chr18,Bn73146,89216297,95128979,5912682,RLK
chr18,Bn73147,25079172,60643432,35564260,CNL
chr18,Bn73148,95629526,98815145,3185619,RLP
chr18,Bn73149,60699603,94001756,33302153,TNL
chr18,Bn73150,7724362,64652457,56928095,RLK
chr18,Bn73151,22415441,69427695,47012254,RLP
chr18,Bn73152,98299720,98677118,377398,RLP
chr18,Bn73153,69906788,87481572,17574784,TN
chr18,Bn73154,48365928,90327586,41961658,NBS
chr18,Bn73155,64851208,77154597,12303389,RLK
chr18,Bn73156,22047265,63510960,41463695,RLP
chr18,Bn73157,16091257,89143077,73051820,RLK
chr18,Bn73158,50273678,57682692,7409014,TNL
chr18,Bn73159,57930885,79141882,21210997,RLP
chr18,Bn73160,67887362,71963605,4076243,NBS
chr18,Bn73161,50845624,66403733,15558109,RLP
chr18,Bn73162,99829981,99899808,69827,TNL
chr18,Bn73163,83162435,92869141,9706706,RLP
chr18,Bn73164,79551481,85218104,5666623,RLK
chr18,Bn73165,82813590,83430462,616872,TN
chr18,Bn73166,31176004,38721782,7545778,RLP
chr18,Bn73167,34671286,67442103,32770817,CN
chr18,Bn73168,38853970,80257102,41403132,RLK
chr18,Bn73169,48344616,84504899,36160283,CNL
chr18,Bn73170,18028256,72968810,54940554,RLK
chr18,Bn73171,6397317,15536266,9138949,CN
chr18,Bn73172,81905623,97934633,16029010,CNL
chr18,Bn73173,18806988,72544655,53737667,TN
chr18,Bn73174,58731514,70567812,11836298,CNL
chr18,Bn73175,39030303,84577269,45546966,RLP
chr18,Bn73176,56072427,89781781,33709354,RLK
chr18,Bn73177,43780621,58299389,14518768,RLK
chr18,Bn73178,96341654,96595291,253637,RLK
chr18,Bn73179,65229546,91738348,26508802,RLK
chr18,Bn73180,80813151,90147683,9334532,CNL
chr18,Bn73181,51484648,82757939,31273291,TN
chr18,Bn73182,54595740,76803386,22207646,RLK
chr18,Bn73183,13728381,49319488,35591107,NBS
chr18,Bn73184,75838584,85284665,9446081,TN
chr18,Bn73185,6574017,76564819,69990802,RLP
chr18,Bn73186,74293865,84791031,10497166,CNL
chr18,Bn73187,55029273,71069101,16039828,NBS
chr18,Bn73188,35051454,98599325,63547871,RLK
chr18,Bn73189,98000355,98994843,994488,RLK
chr18,Bn73190,10259718,73452796,63193078,RLP
chr18,Bn73191,16389960,24949334,8559374,RLP
chr18,Bn73192,62861891,92535910,29674019,TN
chr18,Bn73193,97981905,98489998,508093,NBS
chr18,Bn73194,2539261,95669749,93130488,RLP
chr18,Bn73195,72417777,96666380,24248603,CNL
chr18,Bn73196,71717101,92511845,20794744,RLK
chr18,Bn73197,57701725,87559245,29857520,RLK
chr18,Bn73198,47471720,70530163,23058443,RLP
chr18,Bn73199,77203969,78725966,1521997,TNL
chr18,Bn73200,25935580,87862525,61926945,CNL
chr18,Bn73201,64335808,67156712,2820904,CN
chr18,Bn73202,8612760,57779191,49166431,RLP
chr18,Bn73203,74939399,75323567,384168,CNL
chr18,Bn73204,94995605,96347111,1351506,RLP
chr18,Bn73205,89250092,93236350,3986258,RLK
chr18,Bn73206,69528368,73468487,3940119,CN
chr18,Bn73207,21316445,31147610,9831165,TNL
chr18,Bn73208,40871814,63899661,23027847,TNL
chr18,Bn73209,91602257,91760358,158101,RLP
chr18,Bn73210,87249897,93370795,6120898,RLP
chr18,Bn73211,93966257,98495900,4529643,TNL
chr18,Bn73212,31609340,74414118,42804778,NBS
chr18,Bn73213,59937355,78494571,18557216,CN
chr18,Bn73214,38606771,55448076,16841305,RLK
chr18,Bn73215,52114179,84787149,32672970,TN
chr18,Bn73216,6421334,82151192,75729858,CN
chr18,Bn73217,30481980,57848563,27366583,RLP
chr18,Bn73218,40371695,78529303,38157608,CNL
chr18,Bn73219,57178469,71368435,14189966,RLP
chr18,Bn73220,97994639,99707675,1713036,NBS
chr18,Bn73221,93764192,98995988,5231796,TNL
chr18,Bn73222,83012630,85862025,2849395,TNL
chr18,Bn73223,33482688,80401455,46918767,CNL
chr18,Bn73224,77544552,79775907,2231355,RLK
chr18,Bn73225,58880453,75412650,16532197,NBS
chr18,Bn73226,33578734,75752399,42173665,TNL
chr18,Bn73227,3490936,47063851,43572915,TN
chr18,Bn73228,6613607,19387459,12773852,NBS
chr18,Bn73229,69256150,79714593,10458443,CNL
chr18,Bn73230,37172376,67341259,30168883,TN
chr18,Bn73231,88213130,94768477,6555347,RLP
chr18,Bn73232,91185780,94228962,3043182,CN
chr18,Bn73233,44171998,94871669,50699671,TN
chr18,Bn73234,78330297,78518958,188661,RLP
chr18,Bn73235,55542967,63250912,7707945,NBS
chr18,Bn73236,14411465,54761924,40350459,CN
chr18,Bn73237,92703359,95184057,2480698,RLK
chr18,Bn73238,7432364,53640469,46208105,TNL
chr18,Bn73239,62206690,93566360,31359670,NBS
chr18,Bn73240,7161578,16558837,9397259,NBS
chr18,Bn73241,84569396,85960712,1391316,NBS
chr18,Bn73242,95250741,96944273,1693532,CNL
chr18,Bn73243,18579930,97360087,78780157,RLK
chr18,Bn73244,80603728,85592127,4988399,TN
chr18,Bn73245,62970659,72760909,9790250,TNL
chr18,Bn73246,50076058,62199889,12123831,TNL
chr18,Bn73247,95458198,98363227,2905029,TN
chr18,Bn73248,2809339,70864395,68055056,RLK
chr18,Bn73249,78911533,89200603,10289070,RLP
chr18,Bn73250,36648062,53543116,16895054,TNL
chr18,Bn73251,31613208,37913961,6300753,TN
chr18,Bn73252,78324947,96118631,17793684,TNL
chr18,Bn73253,20980920,89083404,68102484,CNL
chr18,Bn73254,43615050,52911955,9296905,CNL
chr18,Bn73255,31089820,73122574,42032754,RLK
chr18,Bn73256,80662781,84326312,3663531,RLK
chr18,Bn73257,75892294,92266934,16374640,CNL
chr18,Bn73258,76551328,87086173,10534845,TN
chr18,Bn73259,15238605,28949706,13711101,CNL
chr18,Bn73260,13332107,90424936,77092829,TN
chr18,Bn73261,15221375,84355263,69133888,NBS
chr18,Bn73262,83325390,97575895,14250505,TN
chr18,Bn73263,96761054,97931488,1170434,CN
chr18,Bn73264,11497192,52577371,41080179,CNL
chr18,Bn73265,30829268,75231539,44402271,CNL
chr18,Bn73266,5831350,57834870,52003520,CNL
chr18,Bn73267,9407304,37529446,28122142,NBS
chr18,Bn73268,82703636,98235914,15532278,RLP
chr18,Bn73269,82678728,96929242,14250514,CNL
chr18,Bn73270,3151443,72401920,69250477,TN
chr18,Bn73271,61427672,65209321,3781649,TNL
chr18,Bn73272,46637032,47220797,583765,TN
chr18,Bn73273,95876825,95957519,80694,TN
chr18,Bn73274,71146810,99490165,28343355,NBS
chr18,Bn73275,95221503,98112958,2891455,RLP
chr18,Bn73276,42472520,59537186,17064666,RLP
chr18,Bn73277,20457788,45727018,25269230,TNL
chr18,Bn73278,17845888,63741022,45895134,RLP
chr18,Bn73279,30346592,45924879,15578287,CN
chr18,Bn73280,22864037,74725564,51861527,RLK
chr18,Bn73281,1232209,62860764,61628555,CN
chr18,Bn73282,30981123,62043454,31062331,CN
chr18,Bn73283,5338860,37830316,32491456,RLK
chr18,Bn73284,7757649,34000935,26243286,TNL
chr18,Bn73285,78401162,93192087,14790925,RLK
chr18,Bn73286,18453622,55343612,36889990,CNL
chr18,Bn73287,83060652,97206127,14145475,RLK
chr18,Bn73288,57160192,95508216,38348024,CN
chr18,Bn73289,35762443,69987269,34224826,CN
chr18,Bn73290,8394072,55762875,47368803,RLK
chr18,Bn73291,77152678,80245033,3092355,CNL
chr18,Bn73292,90830317,91720977,890660,TN
chr18,Bn73293,51152319,79257950,28105631,CNL
chr18,Bn73294,53772293,59417728,5645435,CN
chr18,Bn73295,28215980,50740234,22524254,TNL
chr18,Bn73296,86740083,90665613,3925530,CN
chr18,Bn73297,72377206,74612439,2235233,CN
chr18,Bn73298,51003400,53362082,2358682,TN
chr18,Bn73299,11525181,98730561,87205380,RLP
chr18,Bn73300,72750734,86669057,13918323,RLP
chr18,Bn73301,41225944,85206324,43980380,RLK
chr18,Bn73302,28939297,77625280,48685983,TNL
chr18,Bn73303,11515729,42700479,31184750,CNL
chr18,Bn73304,24234315,97053596,72819281,CN
chr18,Bn73305,7439657,40201964,32762307,CN
chr18,Bn73306,51459257,79551548,28092291,CNL
chr18,Bn73307,56919060,58110883,1191823,TNL
chr18,Bn73308,86393140,90597664,4204524,TNL
chr18,Bn73309,39435514,55497309,16061795,CN
chr18,Bn73310,11221693,83263036,72041343,CNL
chr18,Bn73311,53806215,87675110,33868895,CN
chr18,Bn73312,7724263,95229124,87504861,RLP
chr18,Bn73313,26541231,31545118,5003887,RLK
chr18,Bn73314,5561972,55136690,49574718,CNL
chr18,Bn73315,73193713,76868612,3674899,CNL
chr18,Bn73316,15851748,27991361,12139613,CN
chr18,Bn73317,73303142,78175070,4871928,CNL
chr18,Bn73318,73884521,94389253,20504732,RLK
chr18,Bn73319,91543847,98124531,6580684,CN
chr18,Bn73320,26119613,63346762,37227149,RLK
chr18,Bn73321,82138808,85259750,3120942,TNL
chr18,Bn73322,48128322,72786191,24657869,RLK
chr18,Bn73323,74931877,82932547,8000670,NBS
chr18,Bn73324,83065951,99321095,16255144,TN
chr18,Bn73325,88933378,99037425,10104047,TN
chr18,Bn73326,69055475,78912103,9856628,RLP
chr18,Bn73327,71028634,97835683,26807049,TNL
chr18,Bn73328,1222038,13724341,12502303,RLP
chr18,Bn73329,99187694,99222874,35180,RLK
chr18,Bn73330,76156581,96625768,20469187,TNL
chr18,Bn73331,98515209,99999995,1484786,TN
chr18,Bn73332,51644125,99304368,47660243,RLP
chr18,Bn73333,45749006,90735318,44986312,TN
chr18,Bn73334,93382130,93762735,380605,CNL
chr18,Bn73335,12221291,54466069,42244778,TN
chr18,Bn73336,42400201,92826078,50425877,TNL
chr18,Bn73337,72774433,89047836,16273403,CN
chr18,Bn73338,25759250,46435280,20676030,RLP
chr18,Bn73339,2694638,23505216,20810578,RLK
chr18,Bn73340,79277035,97575077,18298042,RLP
chr18,Bn73341,66536325,72775206,6238881,TNL
chr18,Bn73342,66283933,99241050,32957117,CN
chr18,Bn73343,75660694,77010651,1349957,TN
chr18,Bn73344,97865428,99820476,1955048,CN
chr18,Bn73345,83756972,89368635,5611663,CNL
chr18,Bn73346,25032342,79811483,54779141,CN
chr18,Bn73347,97921366,99287647,1366281,CN
chr18,Bn73348,55366587,72675549,17308962,TN
chr18,Bn73349,57182336,85772906,28590570,TNL
chr18,Bn73350,47400236,78985574,31585338,CN
chr18,Bn73351,46224999,94958287,48733288,TN
chr18,Bn73352,29467300,36684303,7217003,RLP
chr18,Bn73353,42068380,67515300,25446920,RLK
chr18,Bn73354,57989465,63820473,5831008,RLP
chr18,Bn73355,63393374,88524636,25131262,TN
chr18,Bn73356,93944175,98089267,4145092,NBS
chr18,Bn73357,25378461,32778944,7400483,CN
chr18,Bn73358,51848117,94760981,42912864,TNL
chr18,Bn73359,27800820,78755494,50954674,RLK
chr18,Bn73360,94462876,99858627,5395751,CNL
chr18,Bn73361,84930290,94279835,9349545,CN
chr18,Bn73362,76674013,88612229,11938216,RLK
chr18,Bn73363,36783007,38222168,1439161,RLP
chr18,Bn73364,90427330,93649287,3221957,NBS
chr18,Bn73365,29711865,51249280,21537415,TN
chr18,Bn73366,36944054,44080733,7136679,TN
chr18,Bn73367,67934694,89347696,21413002,TN
chr18,Bn73368,56171749,59842370,3670621,CNL
chr18,Bn73369,9152631,36821818,27669187,RLK
chr18,Bn73370,55075401,68094284,13018883,CN
chr18,Bn73371,72382330,96774732,24392402,NBS
chr18,Bn73372,1354436,82331188,80976752,NBS
chr18,Bn73373,35269511,88727722,53458211,CN
chr18,Bn73374,50766399,87973718,37207319,CNL
chr18,Bn73375,45694342,56745793,11051451,CN
chr18,Bn73376,24061226,60681218,36619992,TNL
chr18,Bn73377,82412038,86171520,3759482,NBS
chr18,Bn73378,73779687,96587403,22807716,CN
chr18,Bn73379,42555717,84599348,42043631,RLP
chr18,Bn73380,20823813,32317154,11493341,TN
chr18,Bn73381,50476855,63946116,13469261,NBS
chr18,Bn73382,67929254,85757447,17828193,TNL
chr18,Bn73383,38500333,85264484,46764151,TN
chr18,Bn73384,76669769,99962279,23292510,CNL
chr18,Bn73385,36056234,49246479,13190245,NBS
chr18,Bn73386,15301614,52817145,37515531,TN
chr18,Bn73387,29144813,80239638,51094825,NBS
chr18,Bn73388,52693271,65459720,12766449,NBS
chr18,Bn73389,33742331,56386084,22643753,RLK
chr18,Bn73390,84611243,98326674,13715431,TN
chr18,Bn73391,74590712,90793374,16202662,TNL
chr18,Bn73392,88443977,98263314,9819337,NBS
chr18,Bn73393,66489517,71982321,5492804,TNL
chr18,Bn73394,37563860,60625750,23061890,RLK
chr18,Bn73395,81255453,93849590,12594137,TN
chr18,Bn73396,20054164,98104408,78050244,RLP
chr18,Bn73397,4284367,48378116,44093749,TN
chr18,Bn73398,17780416,44988020,27207604,RLK
chr18,Bn73399,6010218,57059161,51048943,NBS
chr18,Bn73400,20380409,76393617,56013208,NBS
chr18,Bn73401,87858721,96181527,8322806,TN
chr18,Bn73402,47993589,60207675,12214086,TN
chr18,Bn73403,49475754,85001649,35525895,TNL
chr18,Bn73404,12266358,42647987,30381629,TNL
chr18,Bn73405,62901742,92577794,29676052,RLP
chr18,Bn73406,58528153,65734415,7206262,RLK
chr18,Bn73407,92785394,98303266,5517872,TNL
chr18,Bn73408,9268995,76522099,67253104,RLP
chr18,Bn73409,9940623,13145619,3204996,CNL
chr18,Bn73410,60049123,64189169,4140046,NBS
chr18,Bn73411,60156212,89120101,28963889,CN
chr18,Bn73412,6093430,7702932,1609502,RLK
chr18,Bn73413,28762326,64417396,35655070,NBS
chr18,Bn73414,46694380,98195437,51501057,TNL
chr18,Bn73415,23931390,88384566,64453176,TN
chr18,Bn73416,49855642,62428346,12572704,CNL
chr18,Bn73417,10987852,98816442,87828590,NBS
chr18,Bn73418,89901589,92241530,2339941,CN
chr18,Bn73419,27935262,76145610,48210348,CN
chr18,Bn73420,84255823,86204558,1948735,RLK
chr18,Bn73421,58033544,64972243,6938699,NBS
chr18,Bn73422,27054371,90908355,63853984,CNL
chr18,Bn73423,13912623,79280216,65367593,NBS
chr18,Bn73424,83513232,89102717,5589485,RLP
chr18,Bn73425,94771356,98850916,4079560,RLK
chr18,Bn73426,72479133,86945123,14465990,RLP
chr18,Bn73427,48893952,90758118,41864166,CNL
chr18,Bn73428,27676941,60061415,32384474,CN
chr18,Bn73429,96282593,97814506,1531913,RLP
chr18,Bn73430,39543508,89317340,49773832,TN
chr18,Bn73431,41838620,50176282,8337662,TNL
chr18,Bn73432,57591888,58552806,960918,CN
chr18,Bn73433,90298081,90308148,10067,TN
chr18,Bn73434,31476153,55869635,24393482,RLK
chr18,Bn73435,80767100,98643994,17876894,RLK
chr18,Bn73436,58589821,68700292,10110471,TN
chr18,Bn73437,60244650,76881809,16637159,CN
chr18,Bn73438,25986381,30276148,4289767,CN
chr18,Bn73439,61437800,64178173,2740373,TN
chr18,Bn73440,6387594,83460971,77073377,TNL
chr18,Bn73441,42251384,55347463,13096079,CN
chr18,Bn73442,50432311,69378642,18946331,CNL
chr18,Bn73443,86591172,95401282,8810110,TN
chr18,Bn73444,89528474,90937932,1409458,RLK
chr18,Bn73445,20235195,42771948,22536753,CNL
chr18,Bn73446,63508571,94216358,30707787,TN
chr18,Bn73447,80634339,97643901,17009562,CNL
chr18,Bn73448,71917642,97686976,25769334,NBS
chr18,Bn73449,1324945,48522813,47197868,CNL
chr18,Bn73450,46810203,54084798,7274595,TN
chr18,Bn73451,79669755,86026646,6356891,CNL
chr18,Bn73452,94319456,96707922,2388466,RLP
chr18,Bn73453,45924142,56425787,10501645,RLK
chr18,Bn73454,96038247,98546566,2508319,CNL
chr18,Bn73455,6227913,11896349,5668436,NBS
chr18,Bn73456,67582425,83369912,15787487,CNL
chr18,Bn73457,88507667,90155199,1647532,RLP
chr18,Bn73458,28948495,90205138,61256643,NBS
chr18,Bn73459,61000494,76170348,15169854,CN
chr18,Bn73460,3116128,14828951,11712823,TNL
chr18,Bn73461,86660688,89410684,2749996,CNL
chr18,Bn73462,32341497,33322024,980527,TN
chr18,Bn73463,91714446,97949459,6235013,RLK
chr18,Bn73464,79552368,91732338,12179970,TN
chr18,Bn73465,21983523,66834836,44851313,NBS
chr18,Bn73466,27596754,37630148,10033394,TN
chr18,Bn73467,9265522,29416956,20151434,RLP
chr18,Bn73468,80353809,91489119,11135310,CN
chr18,Bn73469,6723652,19683907,12960255,TNL
chr18,Bn73470,60635839,87614814,26978975,CN
chr18,Bn73471,15279291,51195874,35916583,CN
chr18,Bn73472,32778454,64491343,31712889,RLP
chr18,Bn73473,78468888,99694239,21225351,RLP
chr18,Bn73474,69861373,78540862,8679489,NBS
chr18,Bn73475,5680813,47005299,41324486,CNL
chr18,Bn73476,9084624,40951170,31866546,RLK
chr18,Bn73477,77190466,95246920,18056454,RLP
chr18,Bn73478,88322937,90194805,1871868,RLP
chr18,Bn73479,34119715,48080767,13961052,CN
chr18,Bn73480,4642161,56074259,51432098,NBS
chr18,Bn73481,49713430,98452019,48738589,NBS
chr18,Bn73482,22337737,86492410,64154673,CNL
chr18,Bn73483,11256407,89430624,78174217,RLK
chr18,Bn73484,29691907,64873973,35182066,CNL
chr18,Bn73485,26546278,31657353,5111075,TNL
chr18,Bn73486,34203246,83906164,49702918,TNL
chr18,Bn73487,24664214,29713591,5049377,TN
chr18,Bn73488,82136361,97806281,15669920,NBS
chr18,Bn73489,35160478,49784072,14623594,RLP
chr18,Bn73490,12953514,70611441,57657927,RLK
chr18,Bn73491,70616071,73699448,3083377,CN
chr18,Bn73492,22731617,49777708,27046091,CNL
chr18,Bn73493,48473061,70845012,22371951,TN
chr18,Bn73494,64703514,95834974,31131460,CN
chr18,Bn73495,51501295,74630336,23129041,CN
chr18,Bn73496,36743079,41237382,4494303,RLK
chr18,Bn73497,50433298,60820808,10387510,TNL
chr18,Bn73498,58164478,72940979,14776501,RLP
chr18,Bn73499,45879476,86759252,40879776,TN
chr18,Bn73500,49336170,87018314,37682144,TN
chr18,Bn73501,97441337,98203885,762548,TN
chr18,Bn73502,68699389,84087444,15388055,RLK
chr18,Bn73503,46946265,73380298,26434033,TN
chr18,Bn73504,21143671,87395034,66251363,TNL
chr18,Bn73505,43012428,95171400,52158972,RLP
chr18,Bn73506,53335621,63514261,10178640,NBS
chr18,Bn73507,57417230,82422507,25005277,CN
chr18,Bn73508,9900906,63467941,53567035,TN
chr18,Bn73509,82738038,97320281,14582243,CNL
chr18,Bn73510,7787640,36693259,28905619,CN
chr18,Bn73511,5261353,72600927,67339574,CN
chr18,Bn73512,93459328,93915983,456655,TNL
chr18,Bn73513,43964336,57293485,13329149,CNL
chr18,Bn73514,86546212,99480658,12934446,NBS
chr18,Bn73515,49196625,70285971,21089346,CNL
chr18,Bn73516,13039317,75203863,62164546,RLP
chr18,Bn73517,3398157,85094628,81696471,RLP
chr18,Bn73518,75626787,88504184,12877397,CNL
chr18,Bn73519,20284865,56737888,36453023,RLK
chr18,Bn73520,92520512,99342253,6821741,TNL
chr18,Bn73521,75709246,97477980,21768734,RLK
chr18,Bn73522,22840471,58360675,35520204,RLK
chr18,Bn73523,51150455,69286304,18135849,RLK
chr18,Bn73524,17622389,22664898,5042509,TNL
chr18,Bn73525,15995869,46223586,30227717,NBS
chr18,Bn73526,94811048,95452062,641014,RLP
chr18,Bn73527,50316117,78251754,27935637,RLK
chr18,Bn73528,23504630,27433496,3928866,CNL
chr18,Bn73529,36264777,86972005,50707228,NBS
chr18,Bn73530,3015487,77904909,74889422,RLP
chr18,Bn73531,81491784,87430110,5938326,TNL
chr18,Bn73532,99783347,99823990,40643,CNL
chr18,Bn73533,86717200,95297399,8580199,TN
chr18,Bn73534,39380931,94353882,54972951,RLP
chr18,Bn73535,20576040,48621137,28045097,CNL
chr18,Bn73536,31881515,52166553,20285038,TN
chr18,Bn73537,42265215,72959926,30694711,RLP
chr18,Bn73538,37840141,71366139,33525998,CNL
chr18,Bn73539,53271952,82650187,29378235,RLP
chr18,Bn73540,85676335,95137647,9461312,NBS
chr18,Bn73541,29486437,63171184,33684747,RLP
chr18,Bn73542,20543734,53344286,32800552,TN
chr18,Bn73543,77437652,94181552,16743900,NBS
chr18,Bn73544,17516691,34906294,17389603,TNL
chr18,Bn73545,43102044,57850046,14748002,TN
chr18,Bn73546,96943857,97032182,88325,CN
chr18,Bn73547,43920620,79789832,35869212,TNL
chr18,Bn73548,99499727,99755535,255808,NBS
chr18,Bn73549,68346629,81798466,13451837,TN
chr18,Bn73550,88564914,89176377,611463,CNL
chr18,Bn73551,50634230,82165484,31531254,RLP
chr18,Bn73552,84285445,92305056,8019611,TNL
chr18,Bn73553,74253007,81883303,7630296,TN
chr18,Bn73554,69157709,93752819,24595110,RLK
chr18,Bn73555,24738154,28970303,4232149,TNL
chr18,Bn73556,21084226,70423552,49339326,CNL
chr18,Bn73557,86825443,93842173,7016730,TN
chr18,Bn73558,72436441,82286725,9850284,NBS
chr18,Bn73559,11785914,61139464,49353550,TN
chr18,Bn73560,90520814,90770242,249428,CNL
chr18,Bn73561,8287506,37402822,29115316,TNL
chr18,Bn73562,53292321,74677242,21384921,RLK
chr18,Bn73563,79274401,96411970,17137569,RLP
chr18,Bn73564,4832844,55607875,50775031,NBS
chr18,Bn73565,18928247,85876203,66947956,CN
chr18,Bn73566,64584680,71270206,6685526,CN
chr18,Bn73567,75473448,83964731,8491283,TNL
chr18,Bn73568,14771852,67072228,52300376,CNL
chr18,Bn73569,58759337,80628172,21868835,NBS
chr18,Bn73570,87408687,94547012,7138325,TN
chr18,Bn73571,9812226,47857512,38045286,NBS
chr18,Bn73572,58104403,75534459,17430056,RLP
chr18,Bn73573,60190805,81855312,21664507,CN
chr18,Bn73574,40512906,75843534,35330628,TN
chr18,Bn73575,49429358,53928246,4498888,RLP
chr18,Bn73576,71273203,72847744,1574541,RLK
chr18,Bn73577,84272031,90861223,6589192,CNL
chr18,Bn73578,32856701,38396275,5539574,TNL
chr18,Bn73579,84631095,92217177,7586082,CN
chr18,Bn73580,12122000,76496650,64374650,CNL
chr18,Bn73581,3960352,75803071,71842719,RLK
chr18,Bn73582,1928063,99985389,98057326,NBS
chr18,Bn73583,6497306,29922115,23424809,CNL
chr18,Bn73584,52363038,62382986,10019948,CN
chr18,Bn73585,29204329,65408057,36203728,CNL
chr18,Bn73586,30464417,94499151,64034734,NBS
chr18,Bn73587,13167128,22572725,9405597,TN
chr18,Bn73588,94053294,99535726,5482432,TNL
chr18,Bn73589,57978395,71758565,13780170,NBS
chr18,Bn73590,97115075,99506875,2391800,TNL
chr18,Bn73591,3771286,16833369,13062083,NBS
chr18,Bn73592,45828319,57713167,11884848,RLP
chr18,Bn73593,78780078,89559906,10779828,RLP
chr18,Bn73594,86162454,90525595,4363141,RLP
chr18,Bn73595,86426228,91955021,5528793,RLP
chr18,Bn73596,12435112,24218492,11783380,RLP
chr18,Bn73597,21430979,53228002,31797023,RLP
chr18,Bn73598,4663845,77672892,73009047,CN
chr18,Bn73599,75504154,92364101,16859947,CN
chr18,Bn73600,72725578,83283625,10558047,CN
chr18,Bn73601,21967649,37458228,15490579,CN
chr18,Bn73602,80411587,91675701,11264114,RLK
chr18,Bn73603,96303287,98016915,1713628,NBS
chr18,Bn73604,76289613,92488195,16198582,RLP
chr18,Bn73605,61456568,89719973,28263405,TNL
chr18,Bn73606,52702535,62280578,9578043,NBS
chr18,Bn73607,77232935,98454110,21221175,NBS
chr18,Bn73608,16830250,27682969,10852719,TNL
chr18,Bn73609,28250988,33373637,5122649,RLP
chr18,Bn73610,26447055,73930891,47483836,RLP
chr18,Bn73611,20124009,70641787,50517778,TNL
chr18,Bn73612,86853748,90620055,3766307,TN
chr18,Bn73613,99067840,99408201,340361,TNL
chr18,Bn73614,99019612,99259526,239914,TNL
chr18,Bn73615,46543617,76402164,29858547,NBS
chr18,Bn73616,10148273,66103871,55955598,TNL
chr18,Bn73617,41087837,73341992,32254155,TNL
chr18,Bn73618,51199941,86684579,35484638,CN
chr18,Bn73619,18669220,78950735,60281515,NBS
chr18,Bn73620,68900252,74528567,5628315,NBS
chr18,Bn73621,59873386,61627313,1753927,RLP
chr18,Bn73622,19364227,72525789,53161562,TN
chr18,Bn73623,68983876,72487533,3503657,CNL
chr18,Bn73624,10886724,98579739,87693015,CNL
chr18,Bn73625,73239843,85381078,12141235,RLK
chr18,Bn73626,36321707,40876056,4554349,NBS
chr18,Bn73627,3856624,44631376,40774752,RLP
chr18,Bn73628,21660630,63792378,42131748,CN
chr18,Bn73629,67819527,98929603,31110076,CN
chr18,Bn73630,41315650,42808756,1493106,CN
chr18,Bn73631,38956410,52596756,13640346,RLP
chr18,Bn73632,19793018,66320055,46527037,CNL
chr18,Bn73633,31242392,40159690,8917298,TNL
chr18,Bn73634,36080952,94122845,58041893,CNL
chr18,Bn73635,49607647,74101981,24494334,NBS
chr18,Bn73636,31528189,99780706,68252517,CNL
chr18,Bn73637,29351775,33406536,4054761,RLP
chr18,Bn73638,66953685,77011633,10057948,NBS
chr18,Bn73639,67773687,75096665,7322978,RLK
chr18,Bn73640,79292531,85318804,6026273,TN
chr18,Bn73641,15873147,66555912,50682765,NBS
chr18,Bn73642,77377180,88324757,10947577,TN
chr18,Bn73643,71129165,84385667,13256502,NBS
chr18,Bn73644,45923522,48830686,2907164,CNL
chr18,Bn73645,44775615,74603789,29828174,NBS
chr18,Bn73646,6245639,21439267,15193628,CNL
chr18,Bn73647,43929908,96170645,52240737,TNL
chr18,Bn73648,65941582,94638319,28696737,TN
chr18,Bn73649,94670081,95569388,899307,RLP
chr18,Bn73650,92724005,99541703,6817698,TNL
chr18,Bn73651,50179054,93274842,43095788,RLK
chr18,Bn73652,83440337,90955337,7515000,RLP
chr18,Bn73653,45914642,72576197,26661555,RLP
chr18,Bn73654,85627320,91639040,6011720,CN
chr18,Bn73655,27805591,30921818,3116227,CN
chr18,Bn73656,80803395,83698401,2895006,CN
chr18,Bn73657,74370803,86974771,12603968,RLK
chr18,Bn73658,80867866,97801558,16933692,CNL
chr18,Bn73659,8049625,26951712,18902087,CN
chr18,Bn73660,10916536,14586702,3670166,TNL
chr18,Bn73661,66869421,91715612,24846191,RLK
chr18,Bn73662,78192933,88617326,10424393,CNL
chr18,Bn73663,33251342,43541444,10290102,TNL
chr18,Bn73664,40800198,69795229,28995031,RLP
chr18,Bn73665,69435516,69773478,337962,TNL
chr18,Bn73666,74190517,77927702,3737185,TN
chr18,Bn73667,77297723,92120043,14822320,CNL
chr18,Bn73668,48736269,91936149,43199880,TN
chr18,Bn73669,53188535,70369341,17180806,TN
chr18,Bn73670,89690577,97724041,8033464,RLP
chr18,Bn73671,74184110,91431129,17247019,TNL
chr18,Bn73672,98314822,99300542,985720,CN
chr18,Bn73673,20052850,21454370,1401520,RLP
chr18,Bn73674,17109716,48217585,31107869,CNL
chr18,Bn73675,27190323,44804065,17613742,NBS
chr18,Bn73676,56432753,68439935,12007182,TNL
chr18,Bn73677,52327359,69006320,16678961,CNL
chr18,Bn73678,70187710,74527840,4340130,TNL
chr18,Bn73679,91867542,92464766,597224,NBS
chr18,Bn73680,26610426,67837018,41226592,RLK
chr18,Bn73681,73146417,74282806,1136389,NBS
chr18,Bn73682,99040078,99169806,129728,NBS
chr18,Bn73683,55618302,67271669,11653367,RLK
chr18,Bn73684,33754291,94387637,60633346,CNL
chr18,Bn73685,72558194,91009484,18451290,RLK
chr18,Bn73686,40920186,98619343,57699157,TN
chr18,Bn73687,40396746,91992498,51595752,RLK
chr18,Bn73688,20112177,97696765,77584588,TN
chr18,Bn73689,94569406,95437620,868214,CNL
chr18,Bn73690,25887675,30355836,4468161,RLP
chr18,Bn73691,41051900,97419224,56367324,TN
chr18,Bn73692,14288583,68073816,53785233,CNL
chr18,Bn73693,44447391,94492481,50045090,RLP
chr18,Bn73694,30638407,99734849,69096442,TN
chr18,Bn73695,51205988,54130248,2924260,CNL
chr18,Bn73696,4885360,9594953,4709593,RLP
chr18,Bn73697,39408246,69423410,30015164,NBS
chr18,Bn73698,90812991,99596899,8783908,CNL
chr18,Bn73699,40454876,67698050,27243174,RLK
chr18,Bn73700,2854314,11297282,8442968,TNL
chr18,Bn73701,1144352,73526966,72382614,NBS
chr18,Bn73702,77649269,93960625,16311356,CNL
chr18,Bn73703,41230439,79238435,38007996,RLP
chr18,Bn73704,48052804,83294851,35242047,RLK
chr18,Bn73705,38094892,41023039,2928147,RLK
chr18,Bn73706,71716930,91921931,20205001,TN
chr18,Bn73707,80170558,82568833,2398275,TNL
chr18,Bn73708,91896013,98478951,6582938,RLK
chr18,Bn73709,56786637,99848868,43062231,TNL
chr18,Bn73710,10251201,17909219,7658018,CN
chr18,Bn73711,80046240,93856284,13810044,CN
chr18,Bn73712,73323294,73426127,102833,TN
chr18,Bn73713,6578642,41173963,34595321,TN
chr18,Bn73714,76706760,83216174,6509414,CNL
chr18,Bn73715,71522746,82064662,10541916,TN
chr18,Bn73716,17908136,40243141,22335005,TN
chr18,Bn73717,51994500,62082731,10088231,TN
chr18,Bn73718,43602902,66374033,22771131,TN
chr18,Bn73719,40698895,67263993,26565098,CN
chr18,Bn73720,85589262,90010117,4420855,NBS
chr18,Bn73721,58420885,61836696,3415811,RLK
chr18,Bn73722,1722480,79257497,77535017,CNL
chr18,Bn73723,56721857,85849761,29127904,TN
chr18,Bn73724,86988717,96872189,9883472,TN
chr18,Bn73725,80604191,87827827,7223636,CNL
chr18,Bn73726,75182377,93874964,18692587,CN
chr18,Bn73727,1590192,49027755,47437563,TN
chr18,Bn73728,2547396,30787443,28240047,TN
chr18,Bn73729,41213106,50509824,9296718,TN
chr18,Bn73730,66191321,69929097,3737776,CNL
chr18,Bn73731,38292341,93244234,54951893,CN
chr18,Bn73732,46939499,82054528,35115029,CNL
chr18,Bn73733,53971019,83592717,29621698,TN
chr18,Bn73734,85919330,89271540,3352210,NBS
chr18,Bn73735,85885172,90067706,4182534,NBS
chr18,Bn73736,42229998,66666918,24436920,TN
chr18,Bn73737,57813663,91443220,33629557,TNL
chr18,Bn73738,30900682,45854387,14953705,CN
chr18,Bn73739,58275719,98490548,40214829,RLK
chr18,Bn73740,94814455,95766992,952537,TN
chr18,Bn73741,87957272,91335001,3377729,RLP
chr18,Bn73742,60815644,76536594,15720950,RLK
chr18,Bn73743,80027189,96702381,16675192,NBS
chr18,Bn73744,76781872,83925864,7143992,RLK
chr18,Bn73745,80912896,88593739,7680843,RLP
chr18,Bn73746,87860819,96395789,8534970,RLP
chr18,Bn73747,79995847,96079606,16083759,NBS
chr18,Bn73748,89247972,99850138,10602166,TNL
chr18,Bn73749,78932326,87431583,8499257,TNL
chr18,Bn73750,45513300,69899913,24386613,RLK
chr18,Bn73751,95760562,97037041,1276479,CN
chr18,Bn73752,22987961,25283825,2295864,CN
chr18,Bn73753,3779776,95340886,91561110,TNL
chr18,Bn73754,81870823,89656138,7785315,TN
chr18,Bn73755,81892378,84479712,2587334,TN
chr18,Bn73756,63100638,78070217,14969579,TNL
chr18,Bn73757,44359719,97982801,53623082,CN
chr18,Bn73758,80195343,80586242,390899,RLK
chr18,Bn73759,65891799,81367061,15475262,RLK
chr18,Bn73760,2802310,92532569,89730259,TN
chr18,Bn73761,57250180,65577979,8327799,RLK
chr18,Bn73762,98161757,98351317,189560,NBS
chr18,Bn73763,80246052,93234709,12988657,CN
chr18,Bn73764,64021147,66927109,2905962,TN
chr18,Bn73765,26570088,90137925,63567837,NBS
chr18,Bn73766,69108715,87599558,18490843,RLP
chr18,Bn73767,88497868,89500324,1002456,RLP
chr18,Bn73768,31053681,71834496,40780815,RLP
chr18,Bn73769,15075764,37729886,22654122,RLP
chr18,Bn73770,20639694,71898368,51258674,RLP
chr18,Bn73771,53869994,60956842,7086848,NBS
chr18,Bn73772,97235471,99226428,1990957,TNL
chr18,Bn73773,23256959,29370497,6113538,CNL
chr18,Bn73774,18204391,52017678,33813287,NBS
chr18,Bn73775,18923409,85980995,67057586,CN
chr18,Bn73776,65064248,99612544,34548296,CNL
chr18,Bn73777,18872918,31427229,12554311,CN
chr18,Bn73778,13278617,93873237,80594620,CNL
chr18,Bn73779,60525369,82960370,22435001,TN
chr18,Bn73780,51646517,51668655,22138,NBS
chr18,Bn73781,94188451,99162566,4974115,CNL
chr18,Bn73782,20978669,46880733,25902064,RLP
chr18,Bn73783,26383925,52806629,26422704,NBS
chr18,Bn73784,63479995,67811740,4331745,TN
chr18,Bn73785,10939225,36149989,25210764,TNL
chr18,Bn73786,55800466,64666475,8866009,RLK
chr18,Bn73787,96688559,98774640,2086081,RLP
chr18,Bn73788,25105489,95578754,70473265,CNL
chr18,Bn73789,73980771,84692864,10712093,TN
chr18,Bn73790,92879311,93657693,778382,CN
chr18,Bn73791,13451520,34092063,20640543,RLP
chr18,Bn73792,15970226,95077946,79107720,RLP
chr18,Bn73793,39592084,49188772,9596688,TNL
chr18,Bn73794,18179104,57110018,38930914,CN
chr18,Bn73795,80534755,91168456,10633701,CNL
chr18,Bn73796,15887761,76795860,60908099,RLK
chr18,Bn73797,26291289,47052180,20760891,TN
chr18,Bn73798,23331892,70341774,47009882,RLP
chr18,Bn73799,49809721,60773395,10963674,TNL
chr18,Bn73800,70250872,88085642,17834770,RLP
chr18,Bn73801,2481978,91318302,88836324,CNL
chr18,Bn73802,77109530,81736376,4626846,RLK
chr18,Bn73803,74529187,87698278,13169091,RLK
chr18,Bn73804,68748976,78951973,10202997,CN
chr18,Bn73805,5066951,70109942,65042991,RLK
chr18,Bn73806,37667557,90915241,53247684,RLK
chr18,Bn73807,18103781,96267167,78163386,TNL
chr18,Bn73808,51400701,85238264,33837563,CNL
chr18,Bn73809,52906554,78493950,25587396,NBS
chr18,Bn73810,52816448,93171337,40354889,TNL
chr18,Bn73811,13803773,89336407,75532634,RLK
chr18,Bn73812,17209457,21635427,4425970,CN
chr18,Bn73813,58727273,61094473,2367200,CN
chr18,Bn73814,36152193,42914978,6762785,TN
chr18,Bn73815,11453326,85271751,73818425,NBS
chr18,Bn73816,91714397,92879000,1164603,RLK
chr18,Bn73817,78607180,97493458,18886278,RLK
chr18,Bn73818,41606548,66013818,24407270,RLK
chr18,Bn73819,21644679,70333682,48689003,RLP
chr18,Bn73820,94235376,99744217,5508841,NBS
chr18,Bn73821,62909025,96662707,33753682,CNL
chr18,Bn73822,29022046,65924675,36902629,TNL
chr18,Bn73823,51392407,78885086,27492679,NBS
chr18,Bn73824,2092713,59722854,57630141,NBS
chr18,Bn73825,47765065,53512010,5746945,NBS
chr18,Bn73826,37050441,62244512,25194071,CNL
chr18,Bn73827,44786896,99635517,54848621,CN
chr18,Bn73828,59940778,88624011,28683233,CNL
chr18,Bn73829,53359189,85492378,32133189,TN
chr18,Bn73830,51538971,59810852,8271881,CN
chr18,Bn73831,20240217,58471070,38230853,TN
chr18,Bn73832,84155902,93714755,9558853,TNL
chr18,Bn73833,47069258,64823095,17753837,CNL
chr18,Bn73834,74778452,99472530,24694078,NBS
chr18,Bn73835,74810324,98078281,23267957,CNL
chr18,Bn73836,39155935,55665863,16509928,NBS
chr18,Bn73837,16581301,79154444,62573143,RLK
chr18,Bn73838,46144628,73399905,27255277,RLK
chr18,Bn73839,23714956,66030201,42315245,TN
chr18,Bn73840,28428994,98591801,70162807,RLP
chr18,Bn73841,21416273,72828199,51411926,TNL
chr18,Bn73842,31268077,75895823,44627746,TN
chr18,Bn73843,61381396,78193965,16812569,CN
chr18,Bn73844,46872519,60065570,13193051,TNL
chr18,Bn73845,27098216,28956529,1858313,RLK
chr18,Bn73846,33999986,64401788,30401802,CNL
chr18,Bn73847,38290525,90664129,52373604,TNL
chr18,Bn73848,20389817,80987680,60597863,CN
chr18,Bn73849,37848604,85213821,47365217,TNL
chr18,Bn73850,18639205,22824238,4185033,CN
chr18,Bn73851,66419136,93451056,27031920,CN
chr18,Bn73852,53918608,97626714,43708106,NBS
chr18,Bn73853,11043642,37363127,26319485,TNL
chr18,Bn73854,35098038,39623203,4525165,TNL
chr18,Bn73855,98855117,99789700,934583,NBS
chr18,Bn73856,84058132,94499398,10441266,TN
chr18,Bn73857,41530438,72404526,30874088,RLP
chr18,Bn73858,28149940,37225190,9075250,NBS
chr18,Bn73859,13336588,74815330,61478742,CNL
chr18,Bn73860,94240980,95501333,1260353,TN
chr18,Bn73861,48589319,58477502,9888183,TNL
chr18,Bn73862,52446734,73012650,20565916,NBS
chr18,Bn73863,40741172,51795542,11054370,TN
chr18,Bn73864,97573571,98158164,584593,TNL
chr18,Bn73865,2689118,17202265,14513147,RLP
chr18,Bn73866,96777075,97569077,792002,NBS
chr18,Bn73867,94486597,97431516,2944919,TN
chr18,Bn73868,99157037,99723887,566850,CN
chr18,Bn73869,24245107,95538798,71293691,TN
chr18,Bn73870,55317855,56079745,761890,CN
chr18,Bn73871,64127570,90927347,26799777,TN
chr18,Bn73872,22156991,55063396,32906405,RLK
chr18,Bn73873,45793003,71731393,25938390,TNL
chr18,Bn73874,50995326,66597061,15601735,TN
chr18,Bn73875,85358488,92649251,7290763,CN
chr18,Bn73876,22295916,90920352,68624436,TN
chr18,Bn73877,21384978,68906457,47521479,RLK
chr18,Bn73878,34426258,99509701,65083443,TNL
chr18,Bn73879,34501775,36000541,1498766,CN
chr18,Bn73880,36691951,60701635,24009684,NBS
chr18,Bn73881,70693782,92123027,21429245,TN
chr18,Bn73882,88139361,94959630,6820269,NBS
chr18,Bn73883,32360714,65672980,33312266,RLK
chr18,Bn73884,85922444,99428353,13505909,TN
chr18,Bn73885,5216133,13572569,8356436,NBS
chr18,Bn73886,25721229,62327254,36606025,CNL
chr18,Bn73887,71914199,80258469,8344270,NBS
chr18,Bn73888,9370865,30558084,21187219,TN
chr18,Bn73889,2681765,89123158,86441393,CNL
chr18,Bn73890,64772000,76472951,11700951,CNL
chr18,Bn73891,4200215,18001967,13801752,NBS
chr18,Bn73892,99279212,99906654,627442,RLK
chr18,Bn73893,80630639,99925684,19295045,NBS
chr18,Bn73894,17382192,47402332,30020140,CNL
chr18,Bn73895,17779103,88156869,70377766,CN
chr18,Bn73896,78014381,87512216,9497835,TNL
chr18,Bn73897,51207620,51677462,469842,TNL
chr18,Bn73898,35044535,56531958,21487423,NBS
chr18,Bn73899,47086971,95154951,48067980,CN
chr18,Bn73900,28195589,60853329,32657740,TNL
chr18,Bn73901,48177092,65324867,17147775,NBS
chr18,Bn73902,59185689,64284799,5099110,RLK
chr18,Bn73903,27869598,90106224,62236626,TNL
chr18,Bn73904,80969397,94619125,13649728,TNL
chr18,Bn73905,70981018,84309024,13328006,CNL
chr18,Bn73906,61874495,92988860,31114365,CNL
chr18,Bn73907,66010886,79728247,13717361,RLK
chr18,Bn73908,34751531,74923510,40171979,NBS
chr18,Bn73909,70936670,98358828,27422158,RLP
chr18,Bn73910,55714928,77165266,21450338,RLK
chr18,Bn73911,27426184,44241829,16815645,TNL
chr18,Bn73912,40158924,88430640,48271716,CNL
chr18,Bn73913,15712404,26762071,11049667,RLP
chr18,Bn73914,65827086,92264667,26437581,NBS
chr18,Bn73915,25691610,48168052,22476442,RLK
chr18,Bn73916,91360074,91583744,223670,TN
chr18,Bn73917,88211184,91852378,3641194,TN
chr18,Bn73918,51722725,93858541,42135816,CN
chr18,Bn73919,85256752,95055794,9799042,RLP
chr18,Bn73920,23793456,78257006,54463550,TN
chr18,Bn73921,23514568,80059514,56544946,CNL
chr18,Bn73922,60335948,89644321,29308373,CNL
chr18,Bn73923,64262051,94908653,30646602,TNL
chr18,Bn73924,98525568,99797944,1272376,NBS
chr18,Bn73925,10855446,61761397,50905951,TNL
chr18,Bn73926,82161124,83646328,1485204,CNL
chr18,Bn73927,46167652,51454161,5286509,TNL
chr18,Bn73928,72352723,94337833,21985110,NBS
chr18,Bn73929,98689948,99713128,1023180,TN
chr18,Bn73930,5957447,67553496,61596049,TN
chr18,Bn73931,52238921,80410694,28171773,TN
chr18,Bn73932,2812969,90164699,87351730,TNL
chr18,Bn73933,88903190,90822149,1918959,RLP
chr18,Bn73934,18119052,41596849,23477797,TN
chr18,Bn73935,76859920,85983672,9123752,RLP
chr18,Bn73936,13797139,80101722,66304583,TN
chr18,Bn73937,17440704,75968649,58527945,CN
chr18,Bn73938,96966268,98393432,1427164,TN
chr18,Bn73939,86713957,93470067,6756110,CN
chr18,Bn73940,32150983,47812172,15661189,RLK
chr18,Bn73941,65195352,74154872,8959520,TN
chr18,Bn73942,2377087,89921839,87544752,TN
chr18,Bn73943,94891235,97167597,2276362,TN
chr18,Bn73944,90707221,99509111,8801890,NBS
chr18,Bn73945,87078471,99129407,12050936,CN
chr18,Bn73946,4220247,82498702,78278455,RLP
chr18,Bn73947,83954646,89698868,5744222,CNL
chr18,Bn73948,6413359,91516962,85103603,TNL
chr18,Bn73949,18072581,68855209,50782628,CN
chr18,Bn73950,88738147,93928896,5190749,NBS
chr18,Bn73951,88929278,97573586,8644308,TN
chr18,Bn73952,68306599,95664564,27357965,CNL
chr18,Bn73953,57186216,62727273,5541057,RLP
chr18,Bn73954,33824860,84339939,50515079,NBS
chr18,Bn73955,11487603,97059220,85571617,NBS
chr18,Bn73956,51885669,58577164,6691495,RLK
chr18,Bn73957,5832367,25109779,19277412,CNL
chr18,Bn73958,54297475,94298779,40001304,RLP
chr18,Bn73959,64482775,81164198,16681423,CN
chr18,Bn73960,57752790,93809727,36056937,TNL
chr18,Bn73961,49202166,85186801,35984635,CN
chr18,Bn73962,34618276,57994712,23376436,NBS
chr18,Bn73963,68244300,92608602,24364302,RLK
chr18,Bn73964,38745308,82590011,43844703,CN
chr18,Bn73965,82086025,88764685,6678660,RLK
chr18,Bn73966,56457577,92798242,36340665,RLK
chr18,Bn73967,94954461,95987651,1033190,NBS
chr18,Bn73968,20611140,54952509,34341369,RLP
chr18,Bn73969,97073277,98892577,1819300,TNL
chr18,Bn73970,54580288,58764072,4183784,TNL
chr18,Bn73971,65879870,79738353,13858483,NBS
chr18,Bn73972,85492025,98768539,13276514,CNL
chr18,Bn73973,69364110,95500831,26136721,TNL
chr18,Bn73974,93306190,93442768,136578,CN
chr18,Bn73975,58262403,58311244,48841,RLK
chr18,Bn73976,83610964,90695236,7084272,CN
chr18,Bn73977,39792413,69857156,30064743,CN
chr18,Bn73978,77651344,97504755,19853411,NBS
chr18,Bn73979,71570147,98011136,26440989,CNL
chr18,Bn73980,64047105,77896511,13849406,CN
chr18,Bn73981,13150033,35583757,22433724,CN
chr18,Bn73982,45932232,88694418,42762186,RLP
chr18,Bn73983,5506772,40783087,35276315,CN
chr18,Bn73984,97702099,98874514,1172415,RLK
chr18,Bn73985,23482118,51281903,27799785,CNL
chr18,Bn73986,38794333,77402896,38608563,TNL
chr18,Bn73987,55772561,94113729,38341168,RLK
chr18,Bn73988,63443623,87860622,24416999,CN
chr18,Bn73989,82153231,96642539,14489308,RLP
chr18,Bn73990,57134803,62663357,5528554,CNL
chr18,Bn73991,95840557,98144300,2303743,TN
chr18,Bn73992,54952604,61891035,6938431,NBS
chr18,Bn73993,15329474,72696828,57367354,RLP
chr18,Bn73994,59511591,64158906,4647315,RLP
chr18,Bn73995,86385800,88187031,1801231,TNL
chr18,Bn73996,29769481,42310942,12541461,CN
chr18,Bn73997,55388903,62267975,6879072,RLK
chr18,Bn73998,25468662,35159977,9691315,NBS
chr18,Bn73999,78103274,80995026,2891752,RLK
chr18,Bn74000,53829688,73645081,19815393,RLK
chr18,Bn74001,91872188,97050320,5178132,NBS
chr18,Bn74002,99149608,99852354,702746,TN
chr18,Bn74003,52699328,62523074,9823746,RLP
chr18,Bn74004,14477949,95914853,81436904,CNL
chr18,Bn74005,30057198,71392464,41335266,NBS
chr18,Bn74006,11899686,52329826,40430140,RLP
chr18,Bn74007,25675912,53117171,27441259,TN
chr18,Bn74008,86890766,93276371,6385605,RLK
chr18,Bn74009,24236260,49680272,25444012,CNL
chr18,Bn74010,48082699,96847115,48764416,TN
chr18,Bn74011,44644175,46043346,1399171,NBS
chr18,Bn74012,92004535,93631685,1627150,RLK
chr18,Bn74013,30564865,76934068,46369203,TNL
chr18,Bn74014,43529263,98331409,54802146,TNL
chr18,Bn74015,75494119,91399969,15905850,CN
chr18,Bn74016,65446885,71972096,6525211,RLK
chr18,Bn74017,8342244,26019005,17676761,RLK
chr18,Bn74018,38677528,42682502,4004974,CN
chr18,Bn74019,33303376,54313317,21009941,CN
chr18,Bn74020,26951583,63241708,36290125,CNL
chr18,Bn74021,97171625,98073200,901575,TNL
chr18,Bn74022,84782788,90671180,5888392,NBS
chr18,Bn74023,67196202,70364865,3168663,CNL
chr18,Bn74024,47995849,75309063,27313214,RLP
chr18,Bn74025,27115942,61994369,34878427,RLP
chr18,Bn74026,16673600,63566915,46893315,CNL
chr18,Bn74027,48618338,64684849,16066511,RLK
chr18,Bn74028,19593787,64084117,44490330,RLP
chr18,Bn74029,20270665,37247380,16976715,CNL
chr18,Bn74030,54050510,81390781,27340271,RLK
chr18,Bn74031,54349501,82270650,27921149,CNL
chr18,Bn74032,14188312,69148920,54960608,NBS
chr18,Bn74033,60576260,64074533,3498273,RLK
chr18,Bn74034,50290392,63331504,13041112,RLK
chr18,Bn74035,40717423,94367969,53650546,TN
chr18,Bn74036,59373701,84588965,25215264,CN
chr18,Bn74037,38254768,67710893,29456125,RLP
chr18,Bn74038,36551004,83637032,47086028,NBS
chr18,Bn74039,72518808,85163173,12644365,CNL
chr18,Bn74040,61404072,80642558,19238486,TNL
chr18,Bn74041,33751550,83937666,50186116,NBS
chr18,Bn74042,99185263,99906926,721663,RLK
chr18,Bn74043,82909775,82956701,46926,NBS
chr18,Bn74044,5536780,25764019,20227239,RLK
chr18,Bn74045,86512429,92492572,5980143,RLK
chr18,Bn74046,71353529,79439881,8086352,RLP
chr18,Bn74047,78357860,80714508,2356648,NBS
chr18,Bn74048,59788634,91406949,31618315,CN
chr18,Bn74049,58298778,79756428,21457650,RLK
chr18,Bn74050,60257643,86319417,26061774,CN
chr18,Bn74051,45520416,52285965,6765549,CNL
chr18,Bn74052,37132167,82482633,45350466,NBS
chr18,Bn74053,94316981,96612632,2295651,RLK
chr18,Bn74054,43853221,79218240,35365019,CNL
chr18,Bn74055,39809712,45961187,6151475,RLP
chr18,Bn74056,12437390,81174084,68736694,RLK
chr18,Bn74057,99515199,99980105,464906,NBS
chr18,Bn74058,77728930,97506285,19777355,NBS
chr18,Bn74059,81999997,86164507,4164510,CN
chr18,Bn74060,61028037,99210229,38182192,CNL
chr18,Bn74061,68973185,92171481,23198296,RLP
chr18,Bn74062,20743488,38700397,17956909,NBS
chr18,Bn74063,31172602,74543878,43371276,TN
chr18,Bn74064,56856067,93962672,37106605,TN
chr18,Bn74065,89473662,98645289,9171627,TNL
chr18,Bn74066,37241564,71297080,34055516,CNL
chr18,Bn74067,73022432,84497603,11475171,TN
chr18,Bn74068,16103093,48820969,32717876,TNL
chr18,Bn74069,90564900,94866534,4301634,TN
chr18,Bn74070,66638303,80258586,13620283,CNL
chr18,Bn74071,34217208,87453299,53236091,RLP
chr18,Bn74072,14924028,48225235,33301207,CN
chr18,Bn74073,79068390,87773328,8704938,RLP
chr18,Bn74074,37477689,91055518,53577829,CN
chr18,Bn74075,99144821,99647639,502818,TN
chr18,Bn74076,93249529,96712405,3462876,TN
chr18,Bn74077,75246610,79228399,3981789,RLK
chr18,Bn74078,19300265,67557443,48257178,NBS
chr18,Bn74079,31666686,66217261,34550575,NBS
chr18,Bn74080,29855941,58881682,29025741,RLP
chr18,Bn74081,78802738,99407024,20604286,NBS
chr18,Bn74082,73905354,90798753,16893399,NBS
chr18,Bn74083,15565554,69014192,53448638,CN
chr18,Bn74084,39610410,82004784,42394374,RLP
chr18,Bn74085,12887551,54628175,41740624,TN
chr18,Bn74086,75544832,96068662,20523830,CNL
chr18,Bn74087,84665553,87805122,3139569,TNL
chr18,Bn74088,41525735,61534290,20008555,TNL
chr18,Bn74089,59364884,77919659,18554775,RLK
chr18,Bn74090,45754575,73080075,27325500,RLK
chr18,Bn74091,73858070,90395495,16537425,CNL
chr18,Bn74092,99175504,99472808,297304,CNL
chr18,Bn74093,32256557,43010359,10753802,TNL
chr18,Bn74094,35093175,80450997,45357822,NBS
chr18,Bn74095,78790460,86288005,7497545,CN
chr18,Bn74096,57727160,93944740,36217580,TNL
chr18,Bn74097,65826708,93065269,27238561,CNL
chr18,Bn74098,36692242,90140077,53447835,CNL
chr18,Bn74099,50861518,59410264,8548746,RLK
chr18,Bn74100,86940466,94090842,7150376,TN
chr18,Bn74101,9889642,54900647,45011005,TNL
chr18,Bn74102,68297757,79335616,11037859,TNL
chr18,Bn74103,2936618,43262155,40325537,CN
chr18,Bn74104,88713284,88872283,158999,TN
chr18,Bn74105,80443298,86512800,6069502,CNL
chr18,Bn74106,78607570,93144247,14536677,NBS
chr18,Bn74107,83950625,95205611,11254986,RLK
chr18,Bn74108,35170962,68229570,33058608,NBS
chr18,Bn74109,54130557,72046810,17916253,NBS
chr18,Bn74110,85038475,93423274,8384799,RLP
chr18,Bn74111,49988074,91229524,41241450,CN
chr18,Bn74112,13296304,93195677,79899373,CN
chr18,Bn74113,54754480,84006999,29252519,TN
chr18,Bn74114,49908354,98335395,48427041,RLP
chr18,Bn74115,92273103,93613346,1340243,CNL
chr18,Bn74116,4565893,64527684,59961791,CNL
chr18,Bn74117,13820002,52447742,38627740,RLP
chr18,Bn74118,89682703,91734573,2051870,TN
chr18,Bn74119,71025275,77266001,6240726,TN
chr18,Bn74120,83100893,83670077,569184,TN
chr18,Bn74121,54485586,58545590,4060004,CNL
chr18,Bn74122,91527211,92529333,1002122,RLP
chr18,Bn74123,95712192,97538292,1826100,RLK
chr18,Bn74124,64172870,99240798,35067928,NBS
chr18,Bn74125,16285729,21491156,5205427,RLP
chr18,Bn74126,99779825,99984852,205027,CNL
chr18,Bn74127,78860122,97244021,18383899,RLK
chr18,Bn74128,32901435,63668793,30767358,TNL
chr18,Bn74129,40078297,58489693,18411396,NBS
chr18,Bn74130,27257296,70557415,43300119,NBS
chr18,Bn74131,1007511,41843433,40835922,NBS
chr18,Bn74132,57246353,83375064,26128711,CNL
chr18,Bn74133,30541167,92492538,61951371,NBS
chr18,Bn74134,80304008,80329701,25693,TN
chr18,Bn74135,89367269,97516637,8149368,RLK
chr18,Bn74136,97219145,98596896,1377751,RLP
chr18,Bn74137,32514023,46579862,14065839,TNL
chr18,Bn74138,96060671,98449796,2389125,RLP
chr18,Bn74139,70370440,98443469,28073029,RLP
chr18,Bn74140,90229649,91863696,1634047,TN
chr18,Bn74141,66661438,70507508,3846070,RLK
chr18,Bn74142,60723916,76107557,15383641,CNL
chr18,Bn74143,96034402,96681718,647316,RLP
chr18,Bn74144,4963942,21696465,16732523,CN
chr18,Bn74145,9105371,55807386,46702015,CN
chr18,Bn74146,55058641,96874563,41815922,RLP
chr18,Bn74147,30431046,82417611,51986565,CNL
chr18,Bn74148,71057316,95421362,24364046,RLP
chr18,Bn74149,21594051,42927455,21333404,CN
chr18,Bn74150,11001664,71942035,60940371,NBS
chr18,Bn74151,33158549,42072109,8913560,TN
chr18,Bn74152,94890934,94909487,18553,CNL
chr18,Bn74153,42792232,46436874,3644642,TN
chr18,Bn74154,85856702,95936604,10079902,CNL
chr18,Bn74155,90884436,92152558,1268122,TN
chr18,Bn74156,93526002,99276001,5749999,NBS
chr18,Bn74157,94769107,97348816,2579709,RLK
chr18,Bn74158,18503104,24376546,5873442,RLP
chr18,Bn74159,18306324,48167045,29860721,CNL
chr18,Bn74160,44359564,46409399,2049835,NBS
chr18,Bn74161,95743452,99231096,3487644,TNL
chr18,Bn74162,63532650,99998865,36466215,RLP
chr18,Bn74163,90667577,96355854,5688277,RLP
chr18,Bn74164,81823782,93016894,11193112,CN
chr18,Bn74165,56939075,81024938,24085863,RLP
chr18,Bn74166,53899629,98284743,44385114,CN
chr18,Bn74167,40676275,74690646,34014371,TN
chr18,Bn74168,41961237,64971569,23010332,RLP
chr18,Bn74169,26735050,42540976,15805926,RLK
chr18,Bn74170,8170108,42914799,34744691,CN
chr18,Bn74171,31358789,96065462,64706673,TN
chr18,Bn74172,38359285,44263672,5904387,TNL
chr18,Bn74173,19669517,27339320,7669803,TN
chr18,Bn74174,90683500,95870327,5186827,RLP
chr18,Bn74175,87472742,99014150,11541408,TN
chr18,Bn74176,36297985,49018832,12720847,NBS
chr18,Bn74177,83716142,97617434,13901292,CNL
chr18,Bn74178,9477146,89191554,79714408,CN
chr18,Bn74179,89735714,92547084,2811370,TN
chr18,Bn74180,83759089,89666973,5907884,TNL
chr18,Bn74181,9006257,14640077,5633820,CNL
chr18,Bn74182,13907520,80241156,66333636,RLK
chr18,Bn74183,77163342,86635786,9472444,CNL
chr18,Bn74184,73988657,84542949,10554292,TN
chr18,Bn74185,27627756,30466434,2838678,CNL
chr18,Bn74186,51156761,75260840,24104079,RLP
chr18,Bn74187,71444017,80331746,8887729,CN
chr18,Bn74188,93459255,95388805,1929550,RLK
chr18,Bn74189,13217219,16058215,2840996,RLK
chr18,Bn74190,55384981,63649850,8264869,RLP
chr18,Bn74191,82240597,88604278,6363681,CNL
chr18,Bn74192,78812445,97896485,19084040,TNL
chr18,Bn74193,20437831,40429828,19991997,RLP
chr18,Bn74194,82082724,93306512,11223788,TNL
chr18,Bn74195,82278897,88103774,5824877,NBS
chr18,Bn74196,18488374,64259845,45771471,NBS
chr18,Bn74197,6035876,22359950,16324074,CNL
chr18,Bn74198,94882709,98535257,3652548,RLP
chr18,Bn74199,46436911,61652270,15215359,RLP
chr18,Bn74200,14816222,22354222,7538000,RLP
chr18,Bn74201,91195849,99457959,8262110,TN
chr18,Bn74202,19675238,49544494,29869256,CNL
chr18,Bn74203,86865241,90723039,3857798,TN
chr18,Bn74204,23842293,38946043,15103750,CN
chr18,Bn74205,23501236,62097707,38596471,TN
chr18,Bn74206,15755400,95356358,79600958,CNL
chr18,Bn74207,20576382,25272012,4695630,RLK
chr18,Bn74208,12710957,68018550,55307593,TNL
chr18,Bn74209,29763752,87651313,57887561,RLP
chr18,Bn74210,81579288,97509977,15930689,CN
chr18,Bn74211,18732384,52173334,33440950,NBS
chr18,Bn74212,15572714,95325375,79752661,NBS
chr18,Bn74213,45218294,48705756,3487462,RLK
chr18,Bn74214,16256499,70113269,53856770,TN
chr18,Bn74215,94198943,98805001,4606058,RLP
chr18,Bn74216,82681005,97166236,14485231,NBS
chr18,Bn74217,64022229,73650186,9627957,CN
chr18,Bn74218,40634439,90677010,50042571,TNL
chr18,Bn74219,26444824,80781011,54336187,CNL
chr18,Bn74220,78398905,93709287,15310382,CN
chr18,Bn74221,30321196,38771357,8450161,TN
chr18,Bn74222,23409224,73007260,49598036,RLK
chr18,Bn74223,48435045,91587872,43152827,TN
chr18,Bn74224,5502417,78315300,72812883,CNL
chr18,Bn74225,67522589,90440895,22918306,RLP
chr18,Bn74226,2616811,42272346,39655535,TN
chr18,Bn74227,21318695,36603006,15284311,TN
chr18,Bn74228,56951804,65152835,8201031,NBS
chr18,Bn74229,15292473,85031981,69739508,CN
chr18,Bn74230,24187882,35136179,10948297,CNL
chr18,Bn74231,18081863,63727150,45645287,RLP
chr18,Bn74232,14087887,17156163,3068276,CNL
chr18,Bn74233,46024060,84722759,38698699,CNL
chr18,Bn74234,20496084,39079140,18583056,CNL
chr18,Bn74235,20913485,96977956,76064471,TN
chr18,Bn74236,35843413,42062975,6219562,RLK
chr18,Bn74237,64517514,92605958,28088444,TN
chr18,Bn74238,98445105,99044249,599144,CNL
chr18,Bn74239,91161907,96580222,5418315,NBS
chr18,Bn74240,36238785,63173642,26934857,RLP
chr18,Bn74241,84399724,92716434,8316710,CN
chr18,Bn74242,42466036,90028937,47562901,RLP
chr18,Bn74243,8898011,17178611,8280600,TNL
chr18,Bn74244,17211692,36931342,19719650,CNL
chr18,Bn74245,10450278,18803793,8353515,CN
chr18,Bn74246,72703172,77484780,4781608,TNL
chr18,Bn74247,46140646,85172992,39032346,TN
chr18,Bn74248,62479091,93716790,31237699,NBS
chr18,Bn74249,56992810,65132124,8139314,CNL
chr18,Bn74250,36356912,92465391,56108479,TN
chr18,Bn74251,83559649,97627145,14067496,TNL
chr18,Bn74252,69146728,77944711,8797983,TNL
chr18,Bn74253,12547459,52238529,39691070,CN
chr18,Bn74254,43764015,44018037,254022,TN
chr18,Bn74255,91204408,98105074,6900666,NBS
chr18,Bn74256,45804789,92575210,46770421,CNL
chr18,Bn74257,83556454,93186461,9630007,RLK
chr18,Bn74258,10939925,13980410,3040485,TNL
chr18,Bn74259,99690026,99967565,277539,RLK
chr18,Bn74260,29087933,90304908,61216975,TNL
chr18,Bn74261,38738216,43540761,4802545,CN
chr18,Bn74262,85511748,87428681,1916933,RLK
chr18,Bn74263,49372905,80326187,30953282,CNL
chr18,Bn74264,90514069,90939825,425756,TN
chr18,Bn74265,96439534,98759109,2319575,CN
chr18,Bn74266,48665937,52995344,4329407,CNL
chr18,Bn74267,93462223,99146608,5684385,RLK
chr18,Bn74268,42206985,56299469,14092484,TN
chr18,Bn74269,11154361,28337159,17182798,RLP
chr18,Bn74270,13845462,67675664,53830202,NBS
chr18,Bn74271,50183475,75578638,25395163,CN
chr18,Bn74272,78320517,80096436,1775919,TN
chr18,Bn74273,1459515,66698039,65238524,CNL
chr18,Bn74274,79801115,94411186,14610071,TN
chr18,Bn74275,25147676,98232772,73085096,CNL
chr18,Bn74276,47965650,55114957,7149307,TN
chr18,Bn74277,49695024,59152028,9457004,CN
chr18,Bn74278,3669518,23584356,19914838,RLK
chr18,Bn74279,75186724,76395564,1208840,NBS
chr18,Bn74280,84456819,97066070,12609251,TNL
chr18,Bn74281,54484377,84471051,29986674,TN
chr18,Bn74282,86133728,95898821,9765093,TNL
chr18,Bn74283,40400585,85546445,45145860,TNL
chr18,Bn74284,90982850,91969546,986696,RLP
chr18,Bn74285,48592560,80193587,31601027,RLK
chr18,Bn74286,86499614,91136322,4636708,RLP
chr18,Bn74287,89506438,92495101,2988663,TN
chr18,Bn74288,17262946,87065157,69802211,RLK
chr18,Bn74289,38888228,47899548,9011320,TN
chr18,Bn74290,46075713,77080574,31004861,RLK
chr18,Bn74291,23251213,31850307,8599094,TNL
chr18,Bn74292,6837259,53479291,46642032,CNL
chr18,Bn74293,93655962,97389694,3733732,NBS
chr18,Bn74294,70750992,71973870,1222878,CNL
chr18,Bn74295,56665744,66729395,10063651,TNL
chr18,Bn74296,61627240,65614564,3987324,RLP
chr18,Bn74297,84406786,95670710,11263924,TNL
chr18,Bn74298,18326285,62125581,43799296,CN
chr18,Bn74299,65034842,70531072,5496230,TNL
chr18,Bn74300,10527457,46424983,35897526,TN
chr18,Bn74301,28513832,55982808,27468976,CNL
chr18,Bn74302,9565298,16130346,6565048,CN
chr18,Bn74303,61845399,85871388,24025989,CNL
chr18,Bn74304,51693544,98043355,46349811,TN
chr18,Bn74305,67686939,90363276,22676337,RLP
chr18,Bn74306,91478383,97216007,5737624,TNL
chr18,Bn74307,50893601,53831361,2937760,TN
chr18,Bn74308,44840945,88281250,43440305,NBS
chr18,Bn74309,56536480,75295932,18759452,RLK
chr18,Bn74310,88904242,96450692,7546450,TN
chr18,Bn74311,32993711,46933251,13939540,RLK
chr18,Bn74312,94246924,99175909,4928985,CN
chr18,Bn74313,26646767,30110069,3463302,CN
chr18,Bn74314,7896260,14549726,6653466,RLP
chr18,Bn74315,85951526,87512722,1561196,TNL
chr18,Bn74316,57381775,57657961,276186,CN
chr18,Bn74317,18140997,48962697,30821700,RLP
chr18,Bn74318,81337570,84524102,3186532,CNL
chr18,Bn74319,39440530,87737156,48296626,RLK
chr18,Bn74320,68548022,73228802,4680780,RLK
chr18,Bn74321,4376464,43101133,38724669,TNL
chr18,Bn74322,44627208,67874224,23247016,CNL
chr18,Bn74323,5326572,5962417,635845,RLK
chr18,Bn74324,55711759,83114297,27402538,RLP
chr18,Bn74325,4208182,53132193,48924011,TN
chr18,Bn74326,34674031,70082916,35408885,TN
chr18,Bn74327,95596125,96381703,785578,RLK
chr18,Bn74328,97303334,98470470,1167136,TN
chr18,Bn74329,43942699,47538348,3595649,RLK
chr18,Bn74330,62833039,93471357,30638318,TN
chr18,Bn74331,83104164,92940283,9836119,RLK
chr18,Bn74332,70832991,78668793,7835802,CN
chr18,Bn74333,59399646,76237245,16837599,RLP
chr18,Bn74334,68517001,95644140,27127139,NBS
chr18,Bn74335,77982176,87806631,9824455,TNL
chr18,Bn74336,35873314,81989560,46116246,TNL
chr18,Bn74337,99170292,99806688,636396,RLP
chr18,Bn74338,8085398,13962148,5876750,RLK
chr18,Bn74339,63050191,85442280,22392089,CN
chr18,Bn74340,45794971,58000990,12206019,NBS
chr18,Bn74341,70955844,85379860,14424016,TNL
chr18,Bn74342,44627918,57441745,12813827,NBS
chr18,Bn74343,12354725,32970454,20615729,CNL
chr18,Bn74344,49656494,95117888,45461394,NBS
chr18,Bn74345,99804969,99936358,131389,TNL
chr18,Bn74346,45905245,81993244,36087999,NBS
chr18,Bn74347,60930480,83293810,22363330,CNL
chr18,Bn74348,97875455,99160680,1285225,NBS
chr18,Bn74349,26201584,98997974,72796390,TN
chr18,Bn74350,17027834,80116768,63088934,RLK
chr18,Bn74351,56855069,81973357,25118288,TN
chr18,Bn74352,39680160,54904026,15223866,TNL
chr18,Bn74353,70331442,89663202,19331760,CNL
chr18,Bn74354,21845186,38879931,17034745,CN
chr18,Bn74355,40156837,58646793,18489956,TNL
chr18,Bn74356,27471734,87629664,60157930,CN
chr18,Bn74357,72120869,78388677,6267808,CNL
chr18,Bn74358,70884979,94377334,23492355,TN
chr18,Bn74359,11395040,81001589,69606549,CN
chr18,Bn74360,31690403,84870727,53180324,TNL
chr18,Bn74361,74599910,97477715,22877805,RLP
chr18,Bn74362,55382987,61874546,6491559,CNL
chr18,Bn74363,36586431,57168472,20582041,CNL
chr18,Bn74364,18592537,69385785,50793248,RLK
chr18,Bn74365,47109043,54874085,7765042,RLK
chr18,Bn74366,90983207,99122099,8138892,RLK
chr18,Bn74367,2343363,71483638,69140275,NBS
chr18,Bn74368,75337729,97053487,21715758,RLK
chr18,Bn74369,42133568,62141476,20007908,RLP
chr18,Bn74370,74597911,84614252,10016341,RLP
chr18,Bn74371,57036315,59578438,2542123,TNL
chr18,Bn74372,91160435,95346708,4186273,RLP
chr18,Bn74373,32668964,42771872,10102908,CN
chr18,Bn74374,87086512,97504482,10417970,RLK
chr18,Bn74375,68288487,82023953,13735466,CN
chr18,Bn74376,78109513,94947562,16838049,TN
chr18,Bn74377,55861659,70077447,14215788,CN
chr18,Bn74378,63312450,91700083,28387633,TN
chr18,Bn74379,74752912,94183944,19431032,TN
chr18,Bn74380,96781194,96811929,30735,RLK
chr18,Bn74381,59548170,76515439,16967269,TNL
chr18,Bn74382,69973766,71549922,1576156,RLP
chr18,Bn74383,16843028,39603150,22760122,TN
chr18,Bn74384,78162328,79737210,1574882,TN
chr18,Bn74385,98949477,99680612,731135,TNL
chr18,Bn74386,58443664,93843793,35400129,CN
chr18,Bn74387,31652029,91489835,59837806,TN
chr18,Bn74388,87735627,95891084,8155457,CNL
chr18,Bn74389,2436398,11675289,9238891,NBS
chr18,Bn74390,14212296,17717814,3505518,TN
chr18,Bn74391,96828977,98476962,1647985,RLP
chr18,Bn74392,73132102,84017507,10885405,CN
chr18,Bn74393,9416544,56278788,46862244,NBS
chr18,Bn74394,97030613,99065688,2035075,CN
chr18,Bn74395,30554443,74164103,43609660,RLK
chr18,Bn74396,55913165,96415458,40502293,NBS
chr18,Bn74397,40090015,64088365,23998350,TN
chr18,Bn74398,97537552,98818583,1281031,RLP
chr18,Bn74399,53173270,75563653,22390383,CNL
chr18,Bn74400,18246492,50981266,32734774,NBS
chr18,Bn74401,38105707,80593724,42488017,RLK
chr18,Bn74402,32271752,50369650,18097898,CN
chr18,Bn74403,48116042,90640993,42524951,CN
chr18,Bn74404,15938335,63861129,47922794,TN
chr18,Bn74405,44964043,60790789,15826746,TNL
chr18,Bn74406,90672547,97421963,6749416,CN
chr18,Bn74407,75203233,82798344,7595111,TN
chr18,Bn74408,98678114,99437466,759352,CNL
chr18,Bn74409,48831801,65371841,16540040,NBS
chr18,Bn74410,94580357,98477445,3897088,RLP
chr18,Bn74411,17904538,57891712,39987174,NBS
chr18,Bn74412,21353148,22192510,839362,CN
chr18,Bn74413,85629238,97316921,11687683,CNL
chr18,Bn74414,59829472,77055757,17226285,NBS
chr18,Bn74415,35933603,94656295,58722692,CN
chr18,Bn74416,83622507,99558071,15935564,NBS
chr18,Bn74417,27363798,54289735,26925937,NBS
chr18,Bn74418,89533389,97184316,7650927,TN
chr18,Bn74419,45933311,94409562,48476251,RLK
chr18,Bn74420,96701187,98724701,2023514,NBS
chr18,Bn74421,25616189,61430904,35814715,TNL
chr18,Bn74422,38373315,85917262,47543947,RLK
chr18,Bn74423,23118587,95335661,72217074,TN
chr18,Bn74424,61651687,98798531,37146844,CN
chr18,Bn74425,40512760,97584548,57071788,RLK
chr18,Bn74426,63065761,97083527,34017766,TN
chr18,Bn74427,30378315,43544233,13165918,RLP
chr18,Bn74428,38951093,51546039,12594946,TN
chr18,Bn74429,39344413,59555884,20211471,TN
chr18,Bn74430,74597349,87787012,13189663,TN
chr18,Bn74431,76347984,95773870,19425886,TNL
chr18,Bn74432,74849133,99731758,24882625,NBS
chr18,Bn74433,10098139,30716836,20618697,RLP
chr18,Bn74434,42582949,63139227,20556278,RLK
chr18,Bn74435,66911002,76913283,10002281,TN
chr18,Bn74436,8883125,65234576,56351451,RLK
chr18,Bn74437,87492663,92215697,4723034,TN
chr18,Bn74438,76358725,94669514,18310789,TN
chr18,Bn74439,55474065,62863870,7389805,TN
chr18,Bn74440,91214073,94414241,3200168,TN
chr18,Bn74441,12074901,99871594,87796693,NBS
chr18,Bn74442,94123317,99307534,5184217,RLK
chr18,Bn74443,38612358,84598560,45986202,RLK
chr18,Bn74444,10101050,15129394,5028344,CNL
chr18,Bn74445,71579091,72450198,871107,CNL
chr18,Bn74446,69164477,87359758,18195281,TNL
chr18,Bn74447,27759280,51382761,23623481,TN
chr18,Bn74448,18221532,27083633,8862101,NBS
chr18,Bn74449,87061031,96987355,9926324,RLK
chr18,Bn74450,3145474,44838404,41692930,CNL
chr18,Bn74451,27514268,78353001,50838733,CN
chr18,Bn74452,79809351,83742293,3932942,CN
chr18,Bn74453,83726179,87496163,3769984,RLP
chr18,Bn74454,77437794,88575884,11138090,CN
chr18,Bn74455,9544877,20390457,10845580,RLK
chr18,Bn74456,68617449,81185923,12568474,RLP
chr18,Bn74457,52428667,56315521,3886854,CN
chr18,Bn74458,57802352,84066168,26263816,CN
chr18,Bn74459,58526357,67656848,9130491,CNL
chr18,Bn74460,29276581,86167786,56891205,CNL
chr18,Bn74461,26078300,92625625,66547325,TNL
chr18,Bn74462,62988209,97528099,34539890,RLP
chr18,Bn74463,26368386,39022371,12653985,TN
chr18,Bn74464,82613950,89066187,6452237,NBS
chr18,Bn74465,29247593,62756879,33509286,RLK
chr18,Bn74466,18553588,58617727,40064139,CN
chr18,Bn74467,57022673,66554345,9531672,NBS
chr18,Bn74468,78653087,96134268,17481181,TN
chr18,Bn74469,5115627,58092048,52976421,RLP
chr18,Bn74470,45061194,46445566,1384372,NBS
chr18,Bn74471,72300891,76781334,4480443,RLK
chr18,Bn74472,1470192,25124949,23654757,CNL
chr18,Bn74473,15977355,81396184,65418829,RLK
chr18,Bn74474,9697327,87394244,77696917,RLK
chr18,Bn74475,1467001,14147417,12680416,TN
chr18,Bn74476,39414123,75763958,36349835,TN
chr18,Bn74477,45963403,95746815,49783412,RLK
chr18,Bn74478,17742102,50053429,32311327,CNL
chr18,Bn74479,33289113,70006580,36717467,TNL
chr18,Bn74480,57906053,69249515,11343462,RLK
chr18,Bn74481,89490757,89603316,112559,RLP
chr18,Bn74482,61921431,79650572,17729141,CN
chr18,Bn74483,16660486,97394721,80734235,TNL
chr18,Bn74484,73278921,91247373,17968452,CN
chr18,Bn74485,68452745,82632015,14179270,NBS
chr18,Bn74486,33454354,93299809,59845455,CN
chr18,Bn74487,94932857,98122527,3189670,RLK
chr18,Bn74488,90584556,95593196,5008640,RLK
chr18,Bn74489,52918441,87346003,34427562,TN
chr18,Bn74490,84384939,99202255,14817316,CN
chr18,Bn74491,51371698,57731829,6360131,TN
chr18,Bn74492,59320471,65408311,6087840,TNL
chr18,Bn74493,79534122,95693677,16159555,RLP
chr18,Bn74494,76509622,98021216,21511594,NBS
chr18,Bn74495,17925975,45071355,27145380,NBS
chr18,Bn74496,57354985,94905578,37550593,RLP
chr18,Bn74497,12092938,25190080,13097142,CNL
chr18,Bn74498,90032164,99728654,9696490,CNL
chr18,Bn74499,23580496,78364205,54783709,RLK
chr18,Bn74500,60708790,89823814,29115024,TNL
chr18,Bn74501,2865054,18558923,15693869,TN
chr18,Bn74502,2741631,27000139,24258508,CNL
chr18,Bn74503,93285321,96822749,3537428,RLP
chr18,Bn74504,30855807,51414686,20558879,RLP
chr18,Bn74505,20519067,61390651,40871584,TNL
chr18,Bn74506,51775238,83873869,32098631,NBS
chr18,Bn74507,24077154,34630060,10552906,TN
chr18,Bn74508,40877180,72080366,31203186,NBS
chr18,Bn74509,65383111,92178973,26795862,RLK
chr18,Bn74510,92961357,97157564,4196207,TNL
chr18,Bn74511,40237873,51194091,10956218,NBS
chr18,Bn74512,21104580,61921533,40816953,CNL
chr18,Bn74513,12733334,13220433,487099,TN
chr18,Bn74514,17000230,90017080,73016850,TNL
chr18,Bn74515,80584768,96506070,15921302,CN
chr18,Bn74516,59004323,75878901,16874578,NBS
chr18,Bn74517,83161336,86982347,3821011,CNL
chr18,Bn74518,93589333,94685590,1096257,TN
chr18,Bn74519,47160607,68641017,21480410,TNL
chr18,Bn74520,93775601,94970033,1194432,RLP
chr18,Bn74521,71999236,88817019,16817783,RLP
chr18,Bn74522,6501690,8253103,1751413,TNL
chr18,Bn74523,44107910,62839833,18731923,CN
chr18,Bn74524,26554823,32583394,6028571,TNL
chr18,Bn74525,6229125,59795092,53565967,CNL
chr18,Bn74526,4339084,72840545,68501461,TN
chr18,Bn74527,12736112,73857728,61121616,RLK
chr18,Bn74528,6668229,36097718,29429489,CNL
chr18,Bn74529,99265757,99279821,14064,RLK
chr18,Bn74530,70248098,74990885,4742787,CN
chr18,Bn74531,6649418,99105358,92455940,TNL
chr18,Bn74532,2604529,29384375,26779846,NBS
chr18,Bn74533,2657690,94878600,92220910,NBS
chr18,Bn74534,79651908,85867739,6215831,CNL
chr18,Bn74535,33877719,45474871,11597152,TNL
chr18,Bn74536,82634447,93727652,11093205,CN
chr18,Bn74537,16849343,74216288,57366945,RLK
chr18,Bn74538,87160165,99019480,11859315,TNL
chr18,Bn74539,8611725,44856306,36244581,RLK
chr18,Bn74540,2973541,94727035,91753494,TNL
chr18,Bn74541,51277425,84465257,33187832,RLP
chr18,Bn74542,52689392,81410825,28721433,RLK
chr18,Bn74543,78663961,91365269,12701308,CNL
chr18,Bn74544,6170238,65966891,59796653,RLK
chr18,Bn74545,99928749,99994965,66216,NBS
chr18,Bn74546,93124243,93312092,187849,RLP
chr18,Bn74547,44465962,78037244,33571282,RLK
chr18,Bn74548,15862494,75146495,59284001,RLK
chr18,Bn74549,85818207,87991423,2173216,TNL
chr18,Bn74550,19626854,68578060,48951206,CNL
chr18,Bn74551,42834364,43410616,576252,RLP
chr18,Bn74552,23763991,88045304,64281313,CN
chr18,Bn74553,10010989,22380955,12369966,CN
chr18,Bn74554,10231075,74311533,64080458,RLK
chr18,Bn74555,91347828,94194356,2846528,RLP
chr18,Bn74556,37294491,52103021,14808530,CN
chr18,Bn74557,19170854,75867690,56696836,CNL
chr18,Bn74558,9753489,57466310,47712821,NBS
chr18,Bn74559,9676019,46207645,36531626,CNL
chr18,Bn74560,73554832,77120814,3565982,RLP
chr18,Bn74561,98011136,99210339,1199203,NBS
chr18,Bn74562,15427216,16313768,886552,CN
chr18,Bn74563,73672447,91709355,18036908,NBS
chr18,Bn74564,11031488,89498966,78467478,NBS
chr18,Bn74565,38202370,49843436,11641066,RLK
chr18,Bn74566,57423243,88846479,31423236,TNL
chr18,Bn74567,93453871,99712181,6258310,NBS
chr18,Bn74568,57092723,63132930,6040207,NBS
chr18,Bn74569,41282130,72829596,31547466,RLK
chr18,Bn74570,33073517,52065271,18991754,CNL
chr18,Bn74571,89607162,89790430,183268,NBS
chr18,Bn74572,80087536,85610514,5522978,CN
chr18,Bn74573,25567349,47188561,21621212,RLP
chr18,Bn74574,36578046,45876581,9298535,RLP
chr18,Bn74575,35061805,89859602,54797797,RLK
chr18,Bn74576,37173159,51484194,14311035,TNL
chr18,Bn74577,10236207,27146272,16910065,TN
chr18,Bn74578,32832501,72020776,39188275,NBS
chr18,Bn74579,86212143,98415054,12202911,CN
chr18,Bn74580,59201772,62624809,3423037,TN
chr18,Bn74581,18211815,62089831,43878016,TNL
chr18,Bn74582,3491588,9755577,6263989,NBS
chr18,Bn74583,35618750,54979294,19360544,CNL
chr18,Bn74584,59131359,92169252,33037893,RLK
chr18,Bn74585,35196643,90689635,55492992,NBS
chr18,Bn74586,84094016,97753522,13659506,CNL
chr18,Bn74587,12511613,63115537,50603924,TNL
chr18,Bn74588,96162328,97442063,1279735,RLP
chr18,Bn74589,9851114,14170235,4319121,CN
chr18,Bn74590,25015503,82469188,57453685,NBS
chr18,Bn74591,12440172,99696557,87256385,RLP
chr18,Bn74592,66674703,72852877,6178174,CN
chr18,Bn74593,53979502,56473024,2493522,RLP
chr18,Bn74594,42573515,96892054,54318539,RLP
chr18,Bn74595,80090052,82755949,2665897,RLP
chr18,Bn74596,55453447,93730530,38277083,RLK
chr18,Bn74597,44217498,65441194,21223696,TNL
chr18,Bn74598,95621176,96776487,1155311,TN
chr18,Bn74599,74444304,95347049,20902745,CN
chr18,Bn74600,32468998,79780729,47311731,TNL
chr18,Bn74601,54630370,91391706,36761336,TNL
chr18,Bn74602,85144015,92419300,7275285,NBS
chr18,Bn74603,10002054,56538077,46536023,CN
chr18,Bn74604,21983522,94040900,72057378,TN
chr18,Bn74605,22003155,51141457,29138302,RLK
chr18,Bn74606,98436821,99493833,1057012,TNL
chr18,Bn74607,15778780,77222252,61443472,CNL
chr18,Bn74608,6758995,69398612,62639617,NBS
chr18,Bn74609,15340162,44839042,29498880,CNL
chr18,Bn74610,65974658,72540212,6565554,RLK
chr18,Bn74611,12586650,94965979,82379329,CN
chr18,Bn74612,67782911,81051018,13268107,RLP
chr18,Bn74613,75034154,75857420,823266,TNL
chr18,Bn74614,63723728,81293658,17569930,NBS
chr18,Bn74615,48472102,91041303,42569201,CN
chr18,Bn74616,36938687,68740290,31801603,RLK
chr18,Bn74617,70022427,83845314,13822887,RLK
chr18,Bn74618,58187680,74057870,15870190,CN
chr18,Bn74619,26722157,36179954,9457797,NBS
chr18,Bn74620,67088071,76901001,9812930,NBS
chr18,Bn74621,13674899,72014655,58339756,RLK
chr18,Bn74622,80650508,85325552,4675044,NBS
chr18,Bn74623,8928950,90004819,81075869,CN
chr18,Bn74624,91108544,97379870,6271326,RLP
chr18,Bn74625,42433057,64003127,21570070,TNL
chr18,Bn74626,32239267,49715753,17476486,TN
chr18,Bn74627,45428910,47282712,1853802,TN
chr18,Bn74628,64134965,99940081,35805116,TN
chr18,Bn74629,38955797,65909223,26953426,TNL
chr18,Bn74630,63070303,92013764,28943461,TNL
chr18,Bn74631,50918050,87402344,36484294,TNL
chr18,Bn74632,27055966,48694749,21638783,TN
chr18,Bn74633,83678070,92118481,8440411,RLP
chr18,Bn74634,91255468,98498417,7242949,NBS
chr18,Bn74635,75343968,94135532,18791564,CN
chr18,Bn74636,30159897,92706087,62546190,NBS
chr18,Bn74637,1116044,90675450,89559406,TNL
chr18,Bn74638,83377494,83394714,17220,RLP
chr18,Bn74639,14120004,47527994,33407990,CNL
chr18,Bn74640,26765875,28674258,1908383,RLK
chr18,Bn74641,54100401,67997121,13896720,RLP
chr18,Bn74642,87557835,98420529,10862694,TN
chr18,Bn74643,90071090,95152644,5081554,TN
chr18,Bn74644,57134334,82106049,24971715,TN
chr18,Bn74645,97739635,98460294,720659,CNL
chr18,Bn74646,74365526,76498286,2132760,CN
chr18,Bn74647,11412607,16998571,5585964,CNL
chr18,Bn74648,44962294,65219970,20257676,NBS
chr18,Bn74649,73212582,94317730,21105148,RLP
chr18,Bn74650,70496301,77654588,7158287,CNL
chr18,Bn74651,81487698,91588385,10100687,RLP
chr18,Bn74652,70749074,74310899,3561825,RLK
chr18,Bn74653,25784047,26535812,751765,RLK
chr18,Bn74654,73242793,99515494,26272701,TN
chr18,Bn74655,35156423,95177137,60020714,TN
chr18,Bn74656,11039118,81976680,70937562,TN
chr18,Bn74657,23262873,85606669,62343796,NBS
chr18,Bn74658,12219384,28788277,16568893,RLK
chr18,Bn74659,3183278,44825995,41642717,CN
chr18,Bn74660,99429081,99728071,298990,TN
chr18,Bn74661,81951682,92998735,11047053,CNL
chr18,Bn74662,49073957,95257865,46183908,RLK
chr18,Bn74663,1819460,97028027,95208567,NBS
chr18,Bn74664,70765592,73643899,2878307,TN
chr18,Bn74665,26245026,73465050,47220024,TN
chr18,Bn74666,84133542,97726760,13593218,RLP
chr18,Bn74667,32572519,80342421,47769902,CN
chr18,Bn74668,21316442,65408336,44091894,TNL
chr18,Bn74669,10503395,51240255,40736860,RLP
chr18,Bn74670,13169219,16220329,3051110,TNL
chr18,Bn74671,29370782,67230485,37859703,RLK
chr18,Bn74672,94052064,96729556,2677492,TN
chr18,Bn74673,8129112,37021995,28892883,TNL
chr18,Bn74674,70246203,95937208,25691005,CN
chr18,Bn74675,97150546,99254149,2103603,NBS
chr18,Bn74676,49899997,84383190,34483193,TN
chr18,Bn74677,64953251,91282485,26329234,RLP
chr18,Bn74678,18013791,78957066,60943275,TN
chr18,Bn74679,2881574,61893478,59011904,CN
chr18,Bn74680,55337182,67198075,11860893,CN
chr18,Bn74681,83718029,97527267,13809238,CNL
chr18,Bn74682,36758817,87200158,50441341,NBS
chr18,Bn74683,8278344,77282809,69004465,TNL
chr18,Bn74684,43849329,99624122,55774793,RLK
chr18,Bn74685,89550178,93624833,4074655,CNL
chr18,Bn74686,36834999,70040310,33205311,TN
chr18,Bn74687,80779808,89069772,8289964,TN
chr18,Bn74688,34095884,72994348,38898464,NBS
chr18,Bn74689,80882369,80941355,58986,TNL
chr18,Bn74690,61900957,75592980,13692023,TNL
chr18,Bn74691,91607312,99831330,8224018,RLK
chr18,Bn74692,94310495,98181788,3871293,NBS
chr18,Bn74693,38370054,56371528,18001474,TN
chr18,Bn74694,61633957,84386463,22752506,RLP
chr18,Bn74695,69697827,82345209,12647382,RLK
chr18,Bn74696,16900706,29002188,12101482,TNL
chr18,Bn74697,32269773,75100070,42830297,CNL
chr18,Bn74698,65390142,98629911,33239769,TNL
chr18,Bn74699,63858777,82403885,18545108,CNL
chr18,Bn74700,30831219,44212430,13381211,TNL
chr18,Bn74701,98454681,99851820,1397139,CN
chr18,Bn74702,17632097,17974986,342889,CN
chr18,Bn74703,7528012,95820679,88292667,NBS
chr18,Bn74704,46809966,65811494,19001528,NBS
chr18,Bn74705,46351052,99101295,52750243,CN
chr18,Bn74706,95672900,99530182,3857282,NBS
chr18,Bn74707,32338671,34192362,1853691,CN
chr18,Bn74708,91938696,99815337,7876641,CNL
chr18,Bn74709,11116166,92641832,81525666,TN
chr18,Bn74710,51674865,59278365,7603500,NBS
chr18,Bn74711,70363045,87575953,17212908,NBS
chr18,Bn74712,98264736,99375880,1111144,NBS
chr18,Bn74713,40273525,57429674,17156149,TN
chr18,Bn74714,56291647,62866723,6575076,RLP
chr18,Bn74715,98207616,99138787,931171,CN
chr18,Bn74716,37146379,48211881,11065502,NBS
chr18,Bn74717,68964852,89932766,20967914,RLP
chr18,Bn74718,71749319,91970482,20221163,RLK
chr18,Bn74719,49182328,83607216,34424888,RLK
chr18,Bn74720,22781500,77867250,55085750,TNL
chr18,Bn74721,11933635,30975606,19041971,NBS
chr18,Bn74722,17856766,18872377,1015611,RLP
chr18,Bn74723,57416217,73873103,16456886,RLK
chr18,Bn74724,5853082,13846730,7993648,TN
chr18,Bn74725,6468715,93406757,86938042,TN
chr18,Bn74726,16170672,63264128,47093456,TNL
chr18,Bn74727,38203820,60046785,21842965,TNL
chr18,Bn74728,33050800,83268838,50218038,TNL
chr18,Bn74729,62599520,65670469,3070949,TN
chr18,Bn74730,47059268,71793377,24734109,CNL
chr18,Bn74731,33846940,90451683,56604743,NBS
chr18,Bn74732,94210296,94600191,389895,RLK
chr18,Bn74733,54272776,91230931,36958155,TNL
chr18,Bn74734,1610235,92596467,90986232,CN
chr18,Bn74735,76343486,85973099,9629613,RLK
chr18,Bn74736,18800558,59865252,41064694,NBS
chr18,Bn74737,4133230,27570002,23436772,RLK
chr18,Bn74738,91292940,96252536,4959596,CNL
chr18,Bn74739,67854905,78198134,10343229,CNL
chr18,Bn74740,19218060,48465807,29247747,CNL
chr18,Bn74741,43066246,54465395,11399149,RLK
chr18,Bn74742,38084424,89061361,50976937,TN
chr18,Bn74743,59784779,68891827,9107048,CN
chr18,Bn74744,90351790,96536966,6185176,TN
chr18,Bn74745,93149052,97126318,3977266,CN
chr18,Bn74746,4434329,65070726,60636397,NBS
chr18,Bn74747,9143767,97344451,88200684,TN
chr18,Bn74748,14176270,48830011,34653741,CNL
chr18,Bn74749,96145145,99814235,3669090,NBS
chr18,Bn74750,83364426,99295838,15931412,TN
chr18,Bn74751,7614961,24564819,16949858,RLP
chr18,Bn74752,8662604,8697154,34550,RLK
chr18,Bn74753,3441662,59850374,56408712,CN
chr18,Bn74754,33091819,99979049,66887230,TNL
chr18,Bn74755,10310484,91977126,81666642,CN
chr18,Bn74756,96590338,99835530,3245192,NBS
chr18,Bn74757,21634782,83851632,62216850,TN
chr18,Bn74758,63412719,89371656,25958937,RLK
chr18,Bn74759,87861335,91409114,3547779,TN
chr18,Bn74760,32411984,87071376,54659392,TN
chr18,Bn74761,63674611,81727181,18052570,RLK
chr18,Bn74762,46726930,69839234,23112304,TNL
chr18,Bn74763,76889575,95039254,18149679,CN
chr18,Bn74764,73511917,76639406,3127489,TNL
chr18,Bn74765,74197429,74515422,317993,CN
chr18,Bn74766,98578411,99740522,1162111,NBS
chr18,Bn74767,79449355,84823288,5373933,RLP
chr18,Bn74768,29569323,94614490,65045167,CNL
chr18,Bn74769,48605898,59148669,10542771,RLP
chr18,Bn74770,69316619,86731489,17414870,TN
chr18,Bn74771,14886499,58422960,43536461,TNL
chr18,Bn74772,58174965,63019038,4844073,NBS
chr18,Bn74773,36722789,82347948,45625159,CNL
chr18,Bn74774,36669686,68410824,31741138,RLP
chr18,Bn74775,60266622,87891321,27624699,CN
chr18,Bn74776,26497036,66896332,40399296,RLP
chr18,Bn74777,4988537,26996325,22007788,TN
chr18,Bn74778,41909892,62625486,20715594,NBS
chr18,Bn74779,73325624,74584935,1259311,RLP
chr18,Bn74780,49861677,57363875,7502198,RLP
chr18,Bn74781,82027906,90446077,8418171,TN
chr18,Bn74782,13028086,19057713,6029627,CN
chr18,Bn74783,90336732,94386532,4049800,TN
chr18,Bn74784,14225032,44414905,30189873,TN
chr18,Bn74785,97200795,99311442,2110647,TNL
chr18,Bn74786,10600172,49685292,39085120,TNL
chr18,Bn74787,77895857,86778600,8882743,TNL
chr18,Bn74788,97512814,98644196,1131382,CNL
chr18,Bn74789,41371513,83655489,42283976,RLP
chr18,Bn74790,55143884,76262653,21118769,NBS
chr18,Bn74791,64807060,95155594,30348534,NBS
chr18,Bn74792,84469129,94212889,9743760,CN
chr18,Bn74793,54698669,66206607,11507938,CN
chr18,Bn74794,41727221,43798774,2071553,RLK
chr18,Bn74795,28246677,70088085,41841408,RLK
chr18,Bn74796,85206241,99376965,14170724,CNL
chr18,Bn74797,51051969,63028665,11976696,NBS
chr18,Bn74798,48742652,57170349,8427697,CNL
chr18,Bn74799,38599646,61248368,22648722,NBS
chr18,Bn74800,3313031,8593953,5280922,CN
chr18,Bn74801,28144891,40316723,12171832,CNL
chr18,Bn74802,31091583,86161724,55070141,RLP
chr18,Bn74803,4294865,86077239,81782374,CNL
chr18,Bn74804,42804813,71892385,29087572,TN
chr18,Bn74805,93000644,98701509,5700865,TN
chr18,Bn74806,78249198,87341273,9092075,CN
chr18,Bn74807,90916206,93527914,2611708,CN
chr18,Bn74808,21314969,65389699,44074730,TN
chr18,Bn74809,51700260,58053223,6352963,RLP
chr18,Bn74810,73390218,99248147,25857929,RLP
chr18,Bn74811,35185736,43144884,7959148,CN
chr18,Bn74812,85154728,95290862,10136134,RLK
chr18,Bn74813,21859881,36688447,14828566,NBS
chr18,Bn74814,56619501,74835277,18215776,RLK
chr18,Bn74815,74138512,90274669,16136157,CN
chr18,Bn74816,74367659,93449658,19081999,CN
chr18,Bn74817,45142040,73195253,28053213,RLP
chr18,Bn74818,24591428,77190896,52599468,RLK
chr18,Bn74819,30054577,52539109,22484532,RLK
chr18,Bn74820,73574039,78618105,5044066,CN
chr18,Bn74821,69539304,80601125,11061821,CN
chr18,Bn74822,95892501,96968726,1076225,TNL
chr18,Bn74823,26349282,38908942,12559660,RLK
chr18,Bn74824,67191348,97187028,29995680,TN
chr18,Bn74825,23238360,48722430,25484070,CN
chr18,Bn74826,70017958,73002661,2984703,NBS
chr18,Bn74827,23842647,60703933,36861286,RLP
chr18,Bn74828,68808914,95992780,27183866,CN
chr18,Bn74829,91374862,91668243,293381,RLP
chr18,Bn74830,97063559,98419709,1356150,TNL
chr18,Bn74831,89747748,93993332,4245584,RLP
chr18,Bn74832,12408215,50979332,38571117,NBS
chr18,Bn74833,98517569,98983255,465686,RLP
chr18,Bn74834,99112833,99674775,561942,TNL
chr18,Bn74835,80031724,94570620,14538896,RLP
chr18,Bn74836,72640967,78387093,5746126,RLP
chr18,Bn74837,93090143,95680201,2590058,TNL
chr18,Bn74838,91041812,92963243,1921431,CNL
chr18,Bn74839,47254885,65844794,18589909,RLK
chr18,Bn74840,53059251,60587202,7527951,RLP
chr18,Bn74841,80300891,96092579,15791688,RLK
chr18,Bn74842,42610660,53067829,10457169,NBS
chr18,Bn74843,98688073,98901756,213683,RLP
chr18,Bn74844,30081663,96328154,66246491,CN
chr18,Bn74845,80164268,83208983,3044715,RLK
chr18,Bn74846,67210072,97878662,30668590,TN
chr18,Bn74847,32691151,76538066,43846915,CNL
chr18,Bn74848,73470319,84463928,10993609,TN
chr18,Bn74849,71131694,81037751,9906057,RLK
chr18,Bn74850,8339576,70152677,61813101,RLK
chr18,Bn74851,65341625,96510858,31169233,TN
chr18,Bn74852,70710996,93270281,22559285,CN
chr18,Bn74853,27200867,65554129,38353262,RLP
chr18,Bn74854,46669821,75127608,28457787,RLK
chr18,Bn74855,26502051,62122573,35620522,NBS
chr18,Bn74856,20366088,35367929,15001841,TN
chr18,Bn74857,43485534,51205465,7719931,RLP
chr18,Bn74858,39997470,79361366,39363896,RLK
chr18,Bn74859,67768379,89532367,21763988,TNL
chr18,Bn74860,92842088,96568715,3726627,NBS
chr18,Bn74861,66247606,86910944,20663338,CN
chr18,Bn74862,12722146,53679544,40957398,TNL
chr18,Bn74863,48788968,95639516,46850548,NBS
chr18,Bn74864,34101205,83962689,49861484,RLP
chr18,Bn74865,31518560,71282773,39764213,TN
chr18,Bn74866,47095997,83768373,36672376,CNL
chr18,Bn74867,32557504,98088416,65530912,RLP
chr18,Bn74868,69963286,79767303,9804017,TNL
chr18,Bn74869,69581341,90371064,20789723,TNL
chr18,Bn74870,73009759,81513900,8504141,RLP
chr18,Bn74871,66992477,92557197,25564720,NBS
chr18,Bn74872,93956215,99265650,5309435,NBS
chr18,Bn74873,98734328,99562161,827833,RLP
chr18,Bn74874,37565293,86581015,49015722,CNL
chr18,Bn74875,21908617,62540872,40632255,TNL
chr18,Bn74876,75682634,93988107,18305473,TN
chr18,Bn74877,40013244,95720589,55707345,CN
chr18,Bn74878,32298419,48673154,16374735,CN
chr18,Bn74879,89154182,99079689,9925507,CNL
chr18,Bn74880,50434683,63433874,12999191,TNL
chr18,Bn74881,54620420,79549756,24929336,TN
chr18,Bn74882,31244626,86611293,55366667,TNL
chr18,Bn74883,47054369,98499596,51445227,TNL
chr18,Bn74884,42518482,72972260,30453778,TN
chr18,Bn74885,47847175,72022750,24175575,TNL
chr18,Bn74886,91809037,98550025,6740988,RLP
chr18,Bn74887,26671141,66466291,39795150,TNL
chr18,Bn74888,91864625,92211066,346441,RLK
chr18,Bn74889,48994400,89192939,40198539,TN
chr18,Bn74890,16765858,93051663,76285805,NBS
chr18,Bn74891,14686025,26823009,12136984,CN
chr18,Bn74892,63282321,88744493,25462172,TN
chr18,Bn74893,36056230,74667546,38611316,CN
chr18,Bn74894,99694049,99787525,93476,CNL
chr18,Bn74895,66497217,95328845,28831628,CN
chr18,Bn74896,59793912,69954004,10160092,RLK
chr18,Bn74897,37822585,75986789,38164204,CNL
chr18,Bn74898,58034461,81312082,23277621,RLK
chr18,Bn74899,17025832,89386056,72360224,CN
chr18,Bn74900,43677095,87336901,43659806,TNL
chr18,Bn74901,8202791,29402629,21199838,RLP
chr18,Bn74902,68076820,75205674,7128854,NBS
chr18,Bn74903,62186128,76451680,14265552,RLP
chr18,Bn74904,45292851,72406951,27114100,RLP
chr18,Bn74905,55770542,83675700,27905158,TNL
chr18,Bn74906,47194393,65048212,17853819,CN
chr18,Bn74907,97784844,99932831,2147987,TN
chr18,Bn74908,27553850,53952014,26398164,RLP
chr18,Bn74909,66756353,88551177,21794824,TN
chr18,Bn74910,27961692,82107987,54146295,TNL
chr18,Bn74911,11537907,48912993,37375086,TN
chr18,Bn74912,24341245,30912838,6571593,TNL
chr18,Bn74913,23365644,77044539,53678895,NBS
chr18,Bn74914,46643401,81096253,34452852,TN
chr18,Bn74915,57762863,71643965,13881102,RLK
chr18,Bn74916,91008507,96938525,5930018,CN
chr18,Bn74917,55094293,68243740,13149447,TNL
chr18,Bn74918,36355242,88374986,52019744,CN
chr18,Bn74919,70776069,71029295,253226,CN
chr18,Bn74920,29720773,69085023,39364250,TNL
chr18,Bn74921,87292317,99069446,11777129,RLP
chr18,Bn74922,43778398,64052481,20274083,RLK
chr18,Bn74923,87919508,91843085,3923577,NBS
chr18,Bn74924,22755466,46844155,24088689,TN
chr18,Bn74925,19599528,66211954,46612426,CNL
chr18,Bn74926,7338600,51773270,44434670,CN
chr18,Bn74927,4259872,74589280,70329408,RLP
chr18,Bn74928,39683694,46868054,7184360,TN
chr18,Bn74929,59067372,99356343,40288971,CNL
chr18,Bn74930,81216428,98170533,16954105,TN
chr18,Bn74931,93932819,94306310,373491,CN
chr18,Bn74932,31745818,33575742,1829924,CNL
chr18,Bn74933,58629368,76185703,17556335,CNL
chr18,Bn74934,46175486,94485095,48309609,NBS
chr18,Bn74935,1815606,42908465,41092859,CN
chr18,Bn74936,17143096,74272484,57129388,TN
chr18,Bn74937,11941405,90789496,78848091,RLP
chr18,Bn74938,63993867,64023628,29761,RLP
chr18,Bn74939,49219321,85005204,35785883,CN
chr18,Bn74940,52902746,83869706,30966960,CN
chr18,Bn74941,94018010,99577284,5559274,CNL
chr18,Bn74942,89720377,99641388,9921011,CNL
chr18,Bn74943,26311312,92269958,65958646,CN
chr18,Bn74944,46248171,93681643,47433472,TN
chr18,Bn74945,13499733,99075958,85576225,RLP
chr18,Bn74946,61142893,75889378,14746485,NBS
chr18,Bn74947,32845017,76583357,43738340,TNL
chr18,Bn74948,6707943,67052524,60344581,RLK
chr18,Bn74949,86691377,95228342,8536965,RLK
chr18,Bn74950,62751111,95299423,32548312,CNL
chr18,Bn74951,80535143,98078368,17543225,TN
chr18,Bn74952,16827310,62406692,45579382,NBS
chr18,Bn74953,48397647,81392246,32994599,NBS
chr18,Bn74954,6358925,16730806,10371881,CN
chr18,Bn74955,6777010,69134974,62357964,TN
chr18,Bn74956,82942050,94366326,11424276,NBS
chr18,Bn74957,60883239,81558121,20674882,RLK
chr18,Bn74958,70146522,88050989,17904467,RLK
chr18,Bn74959,99052733,99813119,760386,RLP
chr18,Bn74960,55887065,89535247,33648182,CN
chr18,Bn74961,21241775,85233759,63991984,TNL
chr18,Bn74962,56364907,83842308,27477401,TN
chr18,Bn74963,18200301,69614600,51414299,NBS
chr18,Bn74964,25527437,82744290,57216853,TN
chr18,Bn74965,25028753,93738429,68709676,CNL
chr18,Bn74966,44867130,57457342,12590212,RLP
chr18,Bn74967,3256816,10670117,7413301,TNL
chr18,Bn74968,43794638,69286868,25492230,CN
chr18,Bn74969,64888224,98924944,34036720,CNL
chr18,Bn74970,43440326,51119121,7678795,NBS
chr18,Bn74971,86333524,92799077,6465553,TN
chr18,Bn74972,27739646,86269023,58529377,CN
chr18,Bn74973,65844924,86372983,20528059,TN
chr18,Bn74974,20530174,80260852,59730678,RLK
chr18,Bn74975,89060508,93317595,4257087,RLP
chr18,Bn74976,29075459,44480525,15405066,NBS
chr18,Bn74977,11256260,77693040,66436780,TNL
chr18,Bn74978,74441356,95848891,21407535,RLP
chr18,Bn74979,76235635,92482681,16247046,TNL
chr18,Bn74980,22569581,72672224,50102643,RLK
chr18,Bn74981,93917438,98365506,4448068,CN
chr18,Bn74982,74764445,82851323,8086878,CNL
chr18,Bn74983,38681715,89388653,50706938,CN
chr18,Bn74984,2689966,60696720,58006754,NBS
chr18,Bn74985,49660640,62033973,12373333,TN
chr18,Bn74986,28766220,29226647,460427,TNL
chr18,Bn74987,14811481,71911041,57099560,CNL
chr18,Bn74988,92509455,96108557,3599102,NBS
chr18,Bn74989,37638465,65186648,27548183,CNL
chr18,Bn74990,35940720,59395683,23454963,TN
chr18,Bn74991,94900207,96618278,1718071,NBS
chr18,Bn74992,45355401,67283198,21927797,RLK
chr18,Bn74993,68338932,73814342,5475410,CN
chr18,Bn74994,41358501,86831187,45472686,RLK
chr18,Bn74995,2446335,39430508,36984173,RLK
chr18,Bn74996,91162947,98750517,7587570,CN
chr18,Bn74997,84683202,95300409,10617207,CN
chr18,Bn74998,91421241,98365835,6944594,TNL
chr18,Bn74999,40132231,88345710,48213479,TNL
chr18,Bn75000,74048638,74986302,937664,TN
chr18,Bn75001,35442718,79817687,44374969,NBS
chr18,Bn75002,91141508,98964078,7822570,CN
chr18,Bn75003,30484204,32913718,2429514,CNL
chr18,Bn75004,9885655,24133197,14247542,CNL
chr18,Bn75005,62993719,84055962,21062243,NBS
chr18,Bn75006,43661356,78930929,35269573,TNL
chr18,Bn75007,90959525,96257787,5298262,CN
chr18,Bn75008,85012628,99305235,14292607,RLK
chr18,Bn75009,82776843,85418468,2641625,RLK
chr18,Bn75010,14715103,58804541,44089438,CNL
chr18,Bn75011,52582028,85736824,33154796,CN
chr18,Bn75012,81648674,85505489,3856815,RLK
chr18,Bn75013,84698123,97342449,12644326,NBS
chr18,Bn75014,68075198,68822676,747478,CN
chr18,Bn75015,65336339,73544115,8207776,TN
chr18,Bn75016,54585254,72571082,17985828,CNL
chr18,Bn75017,39515465,74150853,34635388,TN
chr18,Bn75018,79806219,89135498,9329279,CN
chr18,Bn75019,61295208,96651387,35356179,CN
chr18,Bn75020,75637932,88698509,13060577,CN
chr18,Bn75021,5353993,9633384,4279391,RLP
chr18,Bn75022,29541697,85862998,56321301,CNL
chr18,Bn75023,27522053,43862203,16340150,RLK
chr18,Bn75024,19752865,57888367,38135502,TN
chr18,Bn75025,46416441,84225319,37808878,NBS
chr18,Bn75026,24872689,66504327,41631638,CNL
chr18,Bn75027,51056662,61661598,10604936,RLK
chr18,Bn75028,28390873,32576734,4185861,CNL
chr18,Bn75029,11920362,77657668,65737306,CN
chr18,Bn75030,81862796,85294171,3431375,CNL
chr18,Bn75031,62719227,80268098,17548871,TNL
chr18,Bn75032,42365709,54122632,11756923,RLP
chr18,Bn75033,18542758,23195258,4652500,RLK
chr18,Bn75034,70057095,77696901,7639806,CN
chr18,Bn75035,87082684,88293539,1210855,CN
chr18,Bn75036,70047982,83316095,13268113,TNL
chr18,Bn75037,77228427,83500962,6272535,NBS
chr18,Bn75038,47246150,56759071,9512921,CNL
chr18,Bn75039,18098203,49646076,31547873,CN
chr18,Bn75040,30726354,56372942,25646588,TN
chr18,Bn75041,2576093,44626675,42050582,RLK
chr18,Bn75042,35632885,50504087,14871202,TN
chr18,Bn75043,45931263,65897550,19966287,TNL
chr18,Bn75044,62319549,98684061,36364512,CNL
chr18,Bn75045,39101430,68309298,29207868,TN
chr18,Bn75046,94026053,99650182,5624129,RLP
chr18,Bn75047,34381186,36837729,2456543,RLP
chr18,Bn75048,38439006,40190736,1751730,CN
chr18,Bn75049,39597644,51934615,12336971,NBS
chr18,Bn75050,20781592,63718024,42936432,TNL
chr18,Bn75051,89409731,98790951,9381220,CNL
chr18,Bn75052,67177345,72475407,5298062,TN
chr18,Bn75053,10245538,42567785,32322247,TNL
chr18,Bn75054,10674759,68990262,58315503,RLP
chr18,Bn75055,44753594,50030133,5276539,RLK
chr18,Bn75056,86224338,87863747,1639409,CNL
chr18,Bn75057,75916265,87047930,11131665,RLP
chr18,Bn75058,91348916,93265591,1916675,CN
chr18,Bn75059,13710787,25183921,11473134,NBS
chr18,Bn75060,85142502,94010211,8867709,RLP
chr18,Bn75061,78244221,97698349,19454128,CNL
chr18,Bn75062,63057383,90640170,27582787,NBS
chr18,Bn75063,47300175,47531195,231020,CNL
chr18,Bn75064,73436143,86078235,12642092,RLK
chr18,Bn75065,18319184,35958110,17638926,CN
chr18,Bn75066,69949450,81669116,11719666,RLP
chr18,Bn75067,56254778,93659868,37405090,CNL
chr18,Bn75068,16187599,81650937,65463338,RLK
chr18,Bn75069,59334857,73895043,14560186,RLP
chr18,Bn75070,17830426,99424955,81594529,CN
chr18,Bn75071,95095466,96583983,1488517,RLK
chr18,Bn75072,40574433,80506333,39931900,NBS
chr18,Bn75073,20329335,86129927,65800592,RLK
chr18,Bn75074,38412507,78206181,39793674,RLP
chr18,Bn75075,39566553,58406548,18839995,CN
chr18,Bn75076,36221337,54521578,18300241,CNL
chr18,Bn75077,27462364,42576925,15114561,TNL
chr18,Bn75078,10227081,14317210,4090129,CN
chr18,Bn75079,65585893,72992253,7406360,TNL
chr18,Bn75080,9739377,88960900,79221523,RLK
chr18,Bn75081,71373035,76931294,5558259,CNL
chr18,Bn75082,42311943,84361366,42049423,CN
chr18,Bn75083,54506538,98293036,43786498,RLK
chr18,Bn75084,12185326,71795645,59610319,RLK
chr18,Bn75085,92264180,92821478,557298,TN
chr18,Bn75086,71929917,90827261,18897344,TNL
chr18,Bn75087,6133184,94771310,88638126,TNL
chr18,Bn75088,50891839,64294108,13402269,RLK
chr18,Bn75089,39268502,82109771,42841269,RLK
chr18,Bn75090,17281715,37427194,20145479,TNL
chr18,Bn75091,87511573,91792728,4281155,CN
chr18,Bn75092,81267965,87809275,6541310,TNL
chr18,Bn75093,96376263,99820469,3444206,RLK
chr18,Bn75094,26309954,29634399,3324445,TNL
chr18,Bn75095,41554508,59453228,17898720,TN
chr18,Bn75096,47459792,86087303,38627511,CN
chr18,Bn75097,36517903,64402621,27884718,TN
chr18,Bn75098,13115495,79463861,66348366,TN
chr18,Bn75099,3811294,47031114,43219820,TN
chr18,Bn75100,56209942,85001753,28791811,CNL
chr18,Bn75101,61902765,81505291,19602526,TN
chr18,Bn75102,3807173,93020361,89213188,RLP
chr18,Bn75103,72206698,75858391,3651693,TNL
chr18,Bn75104,18243265,75788707,57545442,TNL
chr18,Bn75105,28139576,66475066,38335490,RLP
chr18,Bn75106,55687078,84356320,28669242,CNL
chr18,Bn75107,77864554,98764815,20900261,RLP
chr18,Bn75108,27556132,59233874,31677742,TN
chr18,Bn75109,53474546,80248110,26773564,CN
chr18,Bn75110,46423404,52494368,6070964,RLP
chr18,Bn75111,20532134,98876911,78344777,CN
chr18,Bn75112,76033490,82476833,6443343,RLK
chr18,Bn75113,55066205,74103221,19037016,CN
chr18,Bn75114,3921679,44085673,40163994,CN
chr18,Bn75115,58429932,92841492,34411560,RLK
chr18,Bn75116,31286354,85850456,54564102,CNL
chr18,Bn75117,4419157,59256950,54837793,CN
chr18,Bn75118,43123778,58505603,15381825,CNL
chr18,Bn75119,73916357,74054665,138308,NBS
chr18,Bn75120,75734081,98114870,22380789,TNL
chr18,Bn75121,99561548,99901757,340209,RLP
chr18,Bn75122,37560943,39865531,2304588,TNL
chr18,Bn75123,53562456,68362815,14800359,CN
chr18,Bn75124,61191904,92624481,31432577,TNL
chr18,Bn75125,72275953,87064719,14788766,TNL
chr18,Bn75126,89197562,95145723,5948161,TN
chr18,Bn75127,6898246,28843995,21945749,RLP
chr18,Bn75128,48803530,70900709,22097179,TN
chr18,Bn75129,46386372,51100664,4714292,RLP
chr18,Bn75130,58917572,77789486,18871914,TNL
chr18,Bn75131,30077924,36460917,6382993,TN
chr18,Bn75132,81553336,94481245,12927909,TN
chr18,Bn75133,35626663,64438594,28811931,CN
chr18,Bn75134,49655857,93387767,43731910,RLK
chr18,Bn75135,42481254,54266725,11785471,TN
chr18,Bn75136,10743404,31779554,21036150,CNL
chr18,Bn75137,2640540,22997297,20356757,TN
chr18,Bn75138,11421755,61096093,49674338,TN
chr18,Bn75139,99087833,99667937,580104,TNL
chr18,Bn75140,75447068,83402569,7955501,RLK
chr18,Bn75141,65533670,80920127,15386457,CN
chr18,Bn75142,8381825,41803938,33422113,TN
chr18,Bn75143,21550180,48635202,27085022,RLK
chr18,Bn75144,87424286,93850983,6426697,CN
chr18,Bn75145,54351480,63124078,8772598,TN
chr18,Bn75146,10218994,15640624,5421630,TNL
chr18,Bn75147,39111914,49321093,10209179,RLP
chr18,Bn75148,34263801,85747721,51483920,NBS
chr18,Bn75149,7572037,45006099,37434062,RLK
chr18,Bn75150,79925307,82353711,2428404,TN
chr18,Bn75151,98440941,99089012,648071,NBS
chr18,Bn75152,41815833,42117543,301710,CNL
chr18,Bn75153,47641902,91266139,43624237,CNL
chr18,Bn75154,4192975,87963889,83770914,NBS
chr18,Bn75155,55534668,95077842,39543174,NBS
chr18,Bn75156,99085076,99488782,403706,TNL
chr18,Bn75157,99067925,99758239,690314,TN
chr18,Bn75158,8857338,35420893,26563555,RLP
chr18,Bn75159,17685121,18281521,596400,RLK
chr18,Bn75160,5689444,25522178,19832734,RLK
chr18,Bn75161,89729062,90571834,842772,NBS
chr18,Bn75162,35535477,60988990,25453513,CN
chr18,Bn75163,66446465,96659991,30213526,RLP
chr18,Bn75164,93369535,97802969,4433434,TNL
chr18,Bn75165,10657264,42817021,32159757,CNL
chr18,Bn75166,86186028,98953001,12766973,NBS
chr18,Bn75167,66592705,85004091,18411386,NBS
chr18,Bn75168,87283981,96148026,8864045,RLK
chr18,Bn75169,33751674,57422726,23671052,TNL
chr18,Bn75170,68828924,80164958,11336034,TN
chr18,Bn75171,11354527,91661796,80307269,CN
chr18,Bn75172,76776819,81206862,4430043,CNL
chr18,Bn75173,49116466,92095829,42979363,CN
chr18,Bn75174,38555195,65422081,26866886,TN
chr18,Bn75175,53379189,70311912,16932723,RLP
chr18,Bn75176,97973826,99953368,1979542,CNL
chr18,Bn75177,22721663,33570616,10848953,CN
chr18,Bn75178,15254406,68514521,53260115,RLK
chr18,Bn75179,29678453,41386212,11707759,TN
chr18,Bn75180,12717786,26866520,14148734,CN
chr18,Bn75181,88232494,95290474,7057980,NBS
chr18,Bn75182,38141525,92993843,54852318,TNL
chr18,Bn75183,74232968,84158487,9925519,RLK
chr18,Bn75184,14088989,14504406,415417,CNL
chr18,Bn75185,99589873,99653521,63648,RLP
chr18,Bn75186,15117709,78198764,63081055,CNL
chr18,Bn75187,47445958,97741577,50295619,RLK
chr18,Bn75188,59250686,71282632,12031946,TN
chr18,Bn75189,89505830,95194148,5688318,TNL
chr18,Bn75190,7279433,81084112,73804679,TN
chr18,Bn75191,14402644,69290013,54887369,RLK
chr18,Bn75192,75144323,90864925,15720602,NBS
chr18,Bn75193,29393569,70630037,41236468,TNL
chr18,Bn75194,39955609,97946115,57990506,NBS
chr18,Bn75195,59320291,80912932,21592641,RLK
chr18,Bn75196,57882516,63413733,5531217,RLK
chr18,Bn75197,23964588,52353958,28389370,CNL
chr18,Bn75198,5947418,55863195,49915777,CNL
chr18,Bn75199,83870731,94240529,10369798,NBS
chr18,Bn75200,94859195,95164866,305671,TNL
chr18,Bn75201,75054627,81913741,6859114,CN
chr18,Bn75202,63104959,73776606,10671647,RLP
chr18,Bn75203,49350320,89926894,40576574,CN
chr18,Bn75204,65517635,83647170,18129535,RLK
chr18,Bn75205,53181576,83145083,29963507,CNL
chr18,Bn75206,53072288,93264833,40192545,CN
chr18,Bn75207,85494392,92787412,7293020,NBS
chr18,Bn75208,60804855,87165971,26361116,RLK
chr18,Bn75209,78078683,88398216,10319533,TNL
chr18,Bn75210,17404495,20435308,3030813,CN
chr18,Bn75211,90629652,95572046,4942394,TN
chr18,Bn75212,29348221,74682196,45333975,CN
chr18,Bn75213,49929328,60964386,11035058,TNL
chr18,Bn75214,70130204,96510555,26380351,RLK
chr18,Bn75215,51992271,82988599,30996328,TNL
chr18,Bn75216,67590275,77899645,10309370,RLP
chr18,Bn75217,31825713,84618928,52793215,TNL
chr18,Bn75218,29411758,48340259,18928501,CNL
chr18,Bn75219,80721518,99201408,18479890,CN
chr18,Bn75220,35187643,55875764,20688121,CNL
chr18,Bn75221,44862564,53664918,8802354,TNL
chr18,Bn75222,6139525,77866162,71726637,RLK
chr18,Bn75223,52587019,74032931,21445912,CNL
chr18,Bn75224,71647930,78427004,6779074,RLP
chr18,Bn75225,36336919,98233747,61896828,NBS
chr18,Bn75226,71454074,73606546,2152472,RLK
chr18,Bn75227,78408204,81046847,2638643,NBS
chr18,Bn75228,23724505,26720109,2995604,NBS
chr18,Bn75229,89935812,99758848,9823036,TN
chr18,Bn75230,84066490,90672937,6606447,RLK
chr18,Bn75231,33820113,40464801,6644688,TNL
chr18,Bn75232,72115212,96061564,23946352,CN
chr18,Bn75233,38783744,56217741,17433997,NBS
chr18,Bn75234,47767202,66376104,18608902,TN
chr18,Bn75235,7038087,49797945,42759858,CNL
chr18,Bn75236,76976554,91817150,14840596,RLP
chr18,Bn75237,85039609,96583648,11544039,NBS
chr18,Bn75238,71634183,72904969,1270786,TNL
chr18,Bn75239,12508441,67881087,55372646,CNL
chr18,Bn75240,92345348,95129163,2783815,TN
chr18,Bn75241,42332805,85536542,43203737,NBS
chr18,Bn75242,22242722,35500878,13258156,NBS
chr18,Bn75243,13352527,49359253,36006726,CNL
chr18,Bn75244,62271690,72239782,9968092,CN
chr18,Bn75245,84329889,94322963,9993074,NBS
chr18,Bn75246,81886101,86519583,4633482,CN
chr18,Bn75247,25567490,32839000,7271510,TNL
chr18,Bn75248,79841023,87851242,8010219,RLK
chr18,Bn75249,6290694,80182608,73891914,RLP
chr18,Bn75250,31117621,80463989,49346368,RLK
chr18,Bn75251,82269530,85457146,3187616,RLK
chr18,Bn75252,44202537,51397351,7194814,NBS
chr18,Bn75253,16252376,49840509,33588133,NBS
chr18,Bn75254,20829324,84594531,63765207,NBS
chr18,Bn75255,17601675,43997285,26395610,CN
chr18,Bn75256,74822578,95325402,20502824,CNL
chr18,Bn75257,24622224,86688777,62066553,RLK
chr18,Bn75258,56345992,57584457,1238465,CN
chr18,Bn75259,36941797,76988551,40046754,RLP
chr18,Bn75260,52446749,83389500,30942751,TN
chr18,Bn75261,49761474,62310629,12549155,TNL
chr18,Bn75262,16250731,33377982,17127251,CN
chr18,Bn75263,71850236,99368465,27518229,CNL
chr18,Bn75264,61017164,96001366,34984202,TN
chr18,Bn75265,50272298,86720487,36448189,TNL
chr18,Bn75266,81682944,94955751,13272807,CNL
chr18,Bn75267,23440116,66438203,42998087,RLP
chr18,Bn75268,2218302,17526708,15308406,NBS
chr18,Bn75269,16464149,60789640,44325491,RLP
chr18,Bn75270,69849670,97402320,27552650,CN
chr18,Bn75271,97596254,99050060,1453806,TN
chr18,Bn75272,27319486,53468293,26148807,CNL
chr18,Bn75273,82943661,97277923,14334262,RLP
chr18,Bn75274,25267776,70085166,44817390,RLK
chr18,Bn75275,57509645,90810094,33300449,CNL
chr18,Bn75276,38588891,39892493,1303602,RLK
chr18,Bn75277,38539841,86981517,48441676,TNL
chr18,Bn75278,65207382,91775790,26568408,TNL
chr18,Bn75279,45774086,97739294,51965208,RLK
chr18,Bn75280,79973433,84417010,4443577,CN
chr18,Bn75281,49488734,93969590,44480856,CN
chr18,Bn75282,17866275,33902336,16036061,NBS
chr18,Bn75283,62631171,93262535,30631364,RLK
chr18,Bn75284,65633737,71703711,6069974,TNL
chr18,Bn75285,90132042,92384347,2252305,CNL
chr18,Bn75286,44572272,89733908,45161636,RLP
chr18,Bn75287,12121294,94787130,82665836,RLP
chr18,Bn75288,69765423,85955038,16189615,TNL
chr18,Bn75289,61556623,76019074,14462451,CNL
chr18,Bn75290,93191210,93811966,620756,RLP
chr18,Bn75291,95308243,99055425,3747182,CN
chr18,Bn75292,72986749,82604238,9617489,RLP
chr18,Bn75293,32020759,85661717,53640958,NBS
chr18,Bn75294,95746257,97178299,1432042,CN
chr18,Bn75295,20240046,96168677,75928631,RLP
chr18,Bn75296,42155019,77582475,35427456,TN
chr18,Bn75297,37936931,87305989,49369058,RLK
chr18,Bn75298,60383183,94758471,34375288,CNL
chr18,Bn75299,80243470,82820918,2577448,TNL
chr18,Bn75300,20958186,82612903,61654717,TN
chr18,Bn75301,24086546,56171150,32084604,CNL
chr18,Bn75302,68757404,74101913,5344509,RLK
chr18,Bn75303,32721027,40993503,8272476,NBS
chr18,Bn75304,96410135,96486595,76460,TNL
chr18,Bn75305,26601719,89993313,63391594,RLK
chr18,Bn75306,29249685,70778509,41528824,RLP
chr18,Bn75307,13941510,81589495,67647985,RLK
chr18,Bn75308,46260107,69360295,23100188,RLP
chr18,Bn75309,1711668,30989455,29277787,TNL
chr18,Bn75310,64169121,97277902,33108781,CN
chr18,Bn75311,29230857,80058766,50827909,RLP
chr18,Bn75312,77636752,79465697,1828945,RLK
chr18,Bn75313,97025136,99608860,2583724,TNL
chr18,Bn75314,93242895,93561549,318654,RLK
chr18,Bn75315,39330806,77049232,37718426,NBS
chr18,Bn75316,31747011,83047854,51300843,CN
chr18,Bn75317,99581259,99792396,211137,RLP
chr18,Bn75318,12345585,46151173,33805588,CNL
chr18,Bn75319,25424286,32142162,6717876,NBS
chr18,Bn75320,45931392,68744154,22812762,RLK
chr18,Bn75321,8858803,21528170,12669367,RLK
chr18,Bn75322,1490802,68422073,66931271,NBS
chr18,Bn75323,30880053,79565685,48685632,NBS
chr18,Bn75324,71578779,80579053,9000274,TN
chr18,Bn75325,65280322,68752645,3472323,RLK
chr18,Bn75326,63977282,91373780,27396498,CNL
chr18,Bn75327,75186667,87508859,12322192,CNL
chr18,Bn75328,78505164,91234271,12729107,RLK
chr18,Bn75329,72915992,78312880,5396888,CN
chr18,Bn75330,65238987,72859822,7620835,RLK
chr18,Bn75331,93124179,98637026,5512847,TN
chr18,Bn75332,74732870,99806682,25073812,TNL
chr18,Bn75333,18489570,66401260,47911690,CN
chr18,Bn75334,40544244,95244431,54700187,TNL
chr18,Bn75335,44351503,93024343,48672840,RLK
chr18,Bn75336,18084237,89001696,70917459,TN
chr18,Bn75337,69390693,69726358,335665,TNL
chr18,Bn75338,3909786,99852254,95942468,TN
chr18,Bn75339,24759024,30670611,5911587,TNL
chr18,Bn75340,97287127,97825815,538688,NBS
chr18,Bn75341,17511176,34633707,17122531,NBS
chr18,Bn75342,94483893,98790280,4306387,CN
chr18,Bn75343,17650693,40941043,23290350,RLK
chr18,Bn75344,68748639,96314765,27566126,RLK
chr18,Bn75345,75712110,81620056,5907946,NBS
chr18,Bn75346,53379501,84050898,30671397,CNL
chr18,Bn75347,45528540,62486987,16958447,RLK
chr18,Bn75348,48113219,77989249,29876030,CNL
chr18,Bn75349,14340396,83802304,69461908,RLK
chr18,Bn75350,63102023,90733263,27631240,TNL
chr18,Bn75351,36103064,81989860,45886796,TNL
chr18,Bn75352,41156535,61527802,20371267,NBS
chr18,Bn75353,42307092,74822981,32515889,RLK
chr18,Bn75354,47026373,62541118,15514745,TN
chr18,Bn75355,97223632,99029689,1806057,TN
chr18,Bn75356,51927370,77183957,25256587,RLP
chr18,Bn75357,87497249,93592631,6095382,TN
chr18,Bn75358,48795127,57725760,8930633,RLK
chr18,Bn75359,8722322,53714595,44992273,CNL
chr18,Bn75360,63638884,79839904,16201020,TN
chr18,Bn75361,16475255,36326775,19851520,CN
chr18,Bn75362,78310379,94411640,16101261,RLP
chr18,Bn75363,26298939,28266341,1967402,CN
chr18,Bn75364,25808572,75122546,49313974,RLK
chr18,Bn75365,82244952,88437858,6192906,NBS
chr18,Bn75366,92815023,98552996,5737973,CNL
chr18,Bn75367,86849080,90821471,3972391,RLP
chr18,Bn75368,71759607,83224338,11464731,TN
chr18,Bn75369,25738011,49243416,23505405,RLP
chr18,Bn75370,23302994,76749178,53446184,TN
chr18,Bn75371,51974694,98603277,46628583,TN
chr18,Bn75372,27634895,63819998,36185103,RLK
chr18,Bn75373,57284660,70117505,12832845,RLP
chr18,Bn75374,44736787,70681535,25944748,TN
chr18,Bn75375,32704834,96701759,63996925,TNL
chr18,Bn75376,36075277,53016998,16941721,NBS
chr18,Bn75377,82027005,89457025,7430020,TN
chr18,Bn75378,79799162,95196175,15397013,RLK
chr18,Bn75379,42375224,54931700,12556476,CNL
chr18,Bn75380,95613255,96671279,1058024,TN
chr18,Bn75381,1376604,16045054,14668450,RLK
chr18,Bn75382,15300006,71237929,55937923,RLP
chr18,Bn75383,40424779,89902558,49477779,TN
chr18,Bn75384,77305004,89225390,11920386,RLP
chr18,Bn75385,44657742,71543564,26885822,TN
chr18,Bn75386,85251871,88359219,3107348,CNL
chr18,Bn75387,42440134,54229212,11789078,NBS
chr18,Bn75388,97618264,98348135,729871,TNL
chr18,Bn75389,48197403,89727258,41529855,TNL
chr18,Bn75390,55111003,58290723,3179720,TN
chr18,Bn75391,21209030,37050721,15841691,TNL
chr18,Bn75392,86653469,99861654,13208185,NBS
chr18,Bn75393,50015660,52827240,2811580,RLK
chr18,Bn75394,46121190,91010303,44889113,NBS
chr18,Bn75395,13633958,45227356,31593398,TNL
chr18,Bn75396,13009752,14551565,1541813,TNL
chr18,Bn75397,10269957,43786276,33516319,TNL
chr18,Bn75398,80893936,88016494,7122558,TN
chr18,Bn75399,57852641,72710493,14857852,RLP
chr18,Bn75400,19471832,46428235,26956403,TN
chr18,Bn75401,33833442,38204034,4370592,TNL
chr18,Bn75402,75574301,95831151,20256850,CNL
chr18,Bn75403,93606679,96532142,2925463,TNL
chr18,Bn75404,66437500,76878147,10440647,CN
chr18,Bn75405,80235644,82354001,2118357,TNL
chr18,Bn75406,33767372,75738381,41971009,NBS
chr18,Bn75407,81832141,96159096,14326955,TNL
chr18,Bn75408,20533192,42734712,22201520,RLK
chr18,Bn75409,25207366,36759675,11552309,TN
chr18,Bn75410,95771601,97424944,1653343,RLP
chr18,Bn75411,49755542,94994702,45239160,TNL
chr18,Bn75412,1555334,49405358,47850024,RLK
chr18,Bn75413,94949748,98956045,4006297,CN
chr18,Bn75414,28664025,40028186,11364161,CNL
chr18,Bn75415,81889231,88486023,6596792,CNL
chr18,Bn75416,48170896,94977939,46807043,CN
chr18,Bn75417,12277163,30290448,18013285,TNL
chr18,Bn75418,2733270,40630841,37897571,CNL
chr18,Bn75419,30979656,59409089,28429433,NBS
chr18,Bn75420,47421157,77562402,30141245,TN
chr18,Bn75421,95618941,98814843,3195902,CN
chr18,Bn75422,59377512,60686729,1309217,TN
chr18,Bn75423,99330464,99731564,401100,RLK
chr18,Bn75424,4411184,69009639,64598455,TN
chr18,Bn75425,52003128,83548033,31544905,RLK
chr18,Bn75426,60593490,67465745,6872255,NBS
chr18,Bn75427,67013668,75602445,8588777,CNL
chr18,Bn75428,45865534,99310974,53445440,CN
chr18,Bn75429,74074976,98155368,24080392,TNL
chr18,Bn75430,73142634,92051158,18908524,CN
chr18,Bn75431,90806743,96789358,5982615,CNL
chr18,Bn75432,23339457,95714907,72375450,TN
chr18,Bn75433,85271013,96350724,11079711,TNL
chr18,Bn75434,66860349,89715523,22855174,NBS
chr18,Bn75435,28348896,59031112,30682216,RLK
chr18,Bn75436,51458393,62453372,10994979,CN
chr18,Bn75437,65930957,86552336,20621379,TNL
chr18,Bn75438,99656149,99940832,284683,CN
chr18,Bn75439,48125525,62258939,14133414,TNL
chr18,Bn75440,54998475,70541377,15542902,NBS
chr18,Bn75441,18651832,78839409,60187577,CN
chr18,Bn75442,88968001,90125680,1157679,RLP
chr18,Bn75443,57927091,72317752,14390661,TNL
chr18,Bn75444,69938215,91675856,21737641,RLP
chr18,Bn75445,46740752,57307443,10566691,CNL
chr18,Bn75446,76486888,85384179,8897291,TN
chr18,Bn75447,10867785,65260311,54392526,TNL
chr18,Bn75448,21617375,40553417,18936042,TN
chr18,Bn75449,25669222,75030816,49361594,RLP
chr18,Bn75450,96076994,97523829,1446835,CN
chr18,Bn75451,55482182,93429318,37947136,CN
chr18,Bn75452,25471510,50573835,25102325,TNL
chr18,Bn75453,55421050,97706977,42285927,CNL
chr18,Bn75454,37242262,66916230,29673968,RLK
chr18,Bn75455,8310742,13944831,5634089,CN
chr18,Bn75456,60691981,96235806,35543825,TN
chr18,Bn75457,80349364,98274882,17925518,CNL
chr18,Bn75458,13640423,22924238,9283815,TNL
chr18,Bn75459,51323727,76852506,25528779,RLK
chr18,Bn75460,24972771,69471598,44498827,TNL
chr18,Bn75461,34217095,99963081,65745986,TN
chr18,Bn75462,95472773,99450120,3977347,CN
chr18,Bn75463,25088966,47946265,22857299,CNL
chr18,Bn75464,8768731,98087689,89318958,CN
chr18,Bn75465,11483156,16115393,4632237,NBS
chr18,Bn75466,56525452,98575996,42050544,NBS
chr18,Bn75467,76034132,77581651,1547519,RLP
chr18,Bn75468,51102309,70575901,19473592,RLK
chr18,Bn75469,58326604,77266780,18940176,CN
chr18,Bn75470,49482299,98647866,49165567,RLP
chr18,Bn75471,55944454,99111274,43166820,TNL
chr18,Bn75472,56574981,63531340,6956359,TNL
chr18,Bn75473,57803935,97920720,40116785,RLK
chr18,Bn75474,24690839,98812804,74121965,CNL
chr18,Bn75475,42084574,98604792,56520218,RLK
chr18,Bn75476,45017765,71020804,26003039,NBS
chr18,Bn75477,26557293,60443184,33885891,NBS
chr18,Bn75478,68364253,96394911,28030658,RLK
chr18,Bn75479,13130776,97321020,84190244,RLK
chr18,Bn75480,40054897,98467524,58412627,RLP
chr18,Bn75481,23108005,74641404,51533399,RLP
chr18,Bn75482,77576100,99693694,22117594,RLK
chr18,Bn75483,16847509,68217973,51370464,RLP
chr18,Bn75484,3237234,33152732,29915498,TNL
chr18,Bn75485,39183978,68804436,29620458,TNL
chr18,Bn75486,88124575,89603393,1478818,NBS
chr18,Bn75487,98325754,99185386,859632,CNL
chr18,Bn75488,42956600,86859536,43902936,TN
chr18,Bn75489,92897716,93423511,525795,RLK
chr18,Bn75490,35727578,49776693,14049115,TNL
chr18,Bn75491,78399567,99884443,21484876,RLK
chr18,Bn75492,14233735,22710398,8476663,CN
chr18,Bn75493,97087768,97425476,337708,CN
chr18,Bn75494,77016965,81064478,4047513,NBS
chr18,Bn75495,76114046,79188873,3074827,CN
chr18,Bn75496,11133815,16729026,5595211,NBS
chr18,Bn75497,85287559,93297369,8009810,NBS
chr18,Bn75498,25698419,41438718,15740299,CNL
chr18,Bn75499,96689710,99559693,2869983,TN
chr18,Bn75500,66709910,76925152,10215242,NBS
chr18,Bn75501,82074205,87824809,5750604,TN
chr18,Bn75502,85501390,94676456,9175066,CN
chr18,Bn75503,92751608,97501319,4749711,RLK
chr18,Bn75504,94733967,99111351,4377384,TN
chr18,Bn75505,76061687,80687289,4625602,CNL
chr18,Bn75506,73408136,87638096,14229960,CN
chr18,Bn75507,22523242,36539159,14015917,TN
chr18,Bn75508,48645032,59351783,10706751,RLP
chr18,Bn75509,71559700,90490223,18930523,TNL
chr18,Bn75510,86628825,98139978,11511153,TN
chr18,Bn75511,16375062,17500912,1125850,NBS
chr18,Bn75512,4249739,54814819,50565080,NBS
chr18,Bn75513,72998734,88207159,15208425,TNL
chr18,Bn75514,16402638,69325766,52923128,CN
chr18,Bn75515,57570942,66488930,8917988,RLP
chr18,Bn75516,53605128,58757698,5152570,RLP
chr18,Bn75517,59068780,79052005,19983225,RLK
chr18,Bn75518,80971667,98382303,17410636,NBS
chr18,Bn75519,48473131,71475535,23002404,RLK
chr18,Bn75520,29879663,99512606,69632943,RLK
chr18,Bn75521,85829996,97191460,11361464,RLK
chr18,Bn75522,74883822,92887744,18003922,CNL
chr18,Bn75523,58128414,96995091,38866677,RLK
chr18,Bn75524,82131139,94328851,12197712,TN
chr18,Bn75525,2947333,94036911,91089578,RLK
chr18,Bn75526,55261113,62333268,7072155,RLP
chr18,Bn75527,1809752,74924957,73115205,RLP
chr18,Bn75528,47036583,75717930,28681347,RLP
chr18,Bn75529,92389524,97783375,5393851,CN
chr18,Bn75530,11976304,94816422,82840118,CNL
chr18,Bn75531,64189917,68413221,4223304,RLP
chr18,Bn75532,87295727,92981905,5686178,TN
chr18,Bn75533,5069289,80771043,75701754,NBS
chr18,Bn75534,1917817,8574374,6656557,TNL
chr18,Bn75535,20103342,31931266,11827924,CN
chr18,Bn75536,75827071,78173878,2346807,CNL
chr18,Bn75537,28264907,66998793,38733886,CNL
chr18,Bn75538,9354406,71501555,62147149,RLP
chr18,Bn75539,46671589,65506955,18835366,TN
chr18,Bn75540,78712951,94487717,15774766,NBS
chr18,Bn75541,88823214,93526091,4702877,RLK
chr18,Bn75542,64188039,72676568,8488529,CN
chr18,Bn75543,28265662,75210749,46945087,NBS
chr18,Bn75544,74748424,81926443,7178019,RLK
chr18,Bn75545,91347811,96962950,5615139,CNL
chr18,Bn75546,55027531,64600368,9572837,CN
chr18,Bn75547,75026501,80403102,5376601,TN
chr18,Bn75548,53390729,93765591,40374862,CNL
chr18,Bn75549,47224175,61445156,14220981,RLP
chr18,Bn75550,2062886,91425956,89363070,CN
chr18,Bn75551,82677773,96135482,13457709,TN
chr18,Bn75552,98339714,98367155,27441,TNL
chr18,Bn75553,75254404,90013544,14759140,RLP
chr18,Bn75554,33198313,56678116,23479803,NBS
chr18,Bn75555,39428413,99672041,60243628,CN
chr18,Bn75556,3829951,45134324,41304373,CNL
chr18,Bn75557,53095211,59291870,6196659,CN
chr18,Bn75558,10177615,52036092,41858477,TNL
chr18,Bn75559,98480018,99013614,533596,CNL
chr18,Bn75560,69660705,85184884,15524179,NBS
chr18,Bn75561,50815225,89148410,38333185,NBS
chr18,Bn75562,20624647,60556477,39931830,CN
chr18,Bn75563,77889178,91831215,13942037,TNL
chr18,Bn75564,76847582,92267281,15419699,NBS
chr18,Bn75565,64474877,90061873,25586996,TNL
chr18,Bn75566,81594412,93026946,11432534,NBS
chr18,Bn75567,64344796,65172940,828144,RLP
chr18,Bn75568,19377268,28058377,8681109,TN
chr18,Bn75569,35941052,90137550,54196498,CNL
chr18,Bn75570,42993772,47557378,4563606,TN
chr18,Bn75571,34574186,73387970,38813784,NBS
chr18,Bn75572,19390516,88745771,69355255,NBS
chr18,Bn75573,71385512,79725652,8340140,NBS
chr18,Bn75574,36843153,80693386,43850233,RLK
chr18,Bn75575,73198104,75663455,2465351,CN
chr18,Bn75576,94233383,97251787,3018404,RLP
chr18,Bn75577,3851711,79929322,76077611,RLP
chr18,Bn75578,7326380,58787804,51461424,TN
chr18,Bn75579,2633997,67456133,64822136,TNL
chr18,Bn75580,23501998,63990626,40488628,RLK
chr18,Bn75581,3148372,11788301,8639929,RLK
chr18,Bn75582,96255524,99584825,3329301,RLP
chr18,Bn75583,66362414,91811643,25449229,RLP
chr18,Bn75584,6844325,78044862,71200537,CN
chr18,Bn75585,90500630,97235282,6734652,RLP
chr18,Bn75586,98114967,98746382,631415,TNL
chr18,Bn75587,56582302,95138819,38556517,CN
chr18,Bn75588,11061737,94204974,83143237,CN
chr18,Bn75589,22749856,24562544,1812688,TNL
chr18,Bn75590,36572267,45374928,8802661,NBS
chr18,Bn75591,32370467,78242639,45872172,CNL
chr18,Bn75592,54972394,93308585,38336191,NBS
chr18,Bn75593,78446672,81271683,2825011,TN
chr18,Bn75594,76780228,78871316,2091088,TN
chr18,Bn75595,70151594,86455164,16303570,TN
chr18,Bn75596,63185362,77508865,14323503,NBS
chr18,Bn75597,96177874,99823618,3645744,TNL
chr18,Bn75598,98613620,99455078,841458,RLK
chr18,Bn75599,12162349,42124263,29961914,TN
chr18,Bn75600,39880192,71922239,32042047,CNL
chr18,Bn75601,92771106,97499536,4728430,CN
chr18,Bn75602,54857092,86662270,31805178,TNL
chr18,Bn75603,86664109,99254878,12590769,TN
chr18,Bn75604,63670436,78892382,15221946,RLK
chr18,Bn75605,66815488,70780333,3964845,TNL
chr18,Bn75606,91766858,96878086,5111228,RLK
chr18,Bn75607,85601747,93122022,7520275,CN
chr18,Bn75608,73030211,97809788,24779577,CNL
chr18,Bn75609,12041096,79258966,67217870,CN
chr18,Bn75610,22302844,58795813,36492969,RLP
chr18,Bn75611,24241770,71169976,46928206,CNL
chr18,Bn75612,71534789,86346456,14811667,TNL
chr18,Bn75613,4607452,53574839,48967387,RLK
chr18,Bn75614,80400481,87856922,7456441,CNL
chr18,Bn75615,9940222,83198676,73258454,TN
chr18,Bn75616,43331270,95698475,52367205,NBS
chr18,Bn75617,38981102,85790324,46809222,NBS
chr18,Bn75618,82647862,87483315,4835453,TNL
chr18,Bn75619,87625136,97057049,9431913,TN
chr18,Bn75620,64234940,81783029,17548089,NBS
chr18,Bn75621,15911018,49824795,33913777,CN
chr18,Bn75622,64360298,65071809,711511,RLP
chr18,Bn75623,40852427,99448992,58596565,NBS
chr18,Bn75624,51598794,61706137,10107343,TN
chr18,Bn75625,65462332,93324943,27862611,TN
chr18,Bn75626,56070308,81679403,25609095,CN
chr18,Bn75627,69196377,78481692,9285315,TN
chr18,Bn75628,45530034,48069497,2539463,TNL
chr18,Bn75629,30084803,41390273,11305470,RLP
chr18,Bn75630,18804718,30509923,11705205,CN
chr18,Bn75631,94389865,97597331,3207466,CNL
chr18,Bn75632,8510623,54846420,46335797,NBS
chr18,Bn75633,46773418,89351846,42578428,NBS
chr18,Bn75634,37524428,52964292,15439864,NBS
chr18,Bn75635,60986040,85212317,24226277,TNL
chr18,Bn75636,88256330,93847845,5591515,NBS
chr18,Bn75637,28503606,44452483,15948877,TNL
chr18,Bn75638,8195291,32076333,23881042,CNL
chr18,Bn75639,78418424,89972769,11554345,RLP
chr18,Bn75640,45836695,81445465,35608770,CN
chr18,Bn75641,59087234,77905332,18818098,CN
chr18,Bn75642,62836728,93140193,30303465,NBS
chr18,Bn75643,58928122,75201053,16272931,CNL
chr18,Bn75644,97421308,99200990,1779682,TN
chr18,Bn75645,22691182,75325836,52634654,CNL
chr18,Bn75646,72100478,89223465,17122987,RLK
chr18,Bn75647,80761704,95194514,14432810,NBS
chr18,Bn75648,94906110,96483797,1577687,TN
chr18,Bn75649,75053057,79381764,4328707,CN
chr18,Bn75650,88683271,97142355,8459084,NBS
chr18,Bn75651,45232245,85793272,40561027,CN
chr18,Bn75652,53722379,80398771,26676392,CNL
chr18,Bn75653,7505781,34114671,26608890,CNL
chr18,Bn75654,80159051,98821025,18661974,NBS
chr18,Bn75655,15322837,89909663,74586826,RLK
chr18,Bn75656,20630865,51264588,30633723,RLP
chr18,Bn75657,4544282,70618531,66074249,CN
chr18,Bn75658,19435516,88463566,69028050,RLK
chr18,Bn75659,40318021,49908579,9590558,CNL
chr18,Bn75660,41262810,52306527,11043717,TN
chr18,Bn75661,54337023,63552976,9215953,TNL
chr18,Bn75662,54145814,82193789,28047975,TN
chr18,Bn75663,65165986,83326659,18160673,RLK
chr18,Bn75664,52344099,70778171,18434072,TN
chr18,Bn75665,16748828,53628760,36879932,NBS
chr18,Bn75666,5867242,66550124,60682882,CN
chr18,Bn75667,52244952,83269953,31025001,RLP
chr18,Bn75668,64319041,69840532,5521491,CN
chr18,Bn75669,67296467,92125118,24828651,RLK
chr18,Bn75670,6738730,64851855,58113125,TNL
chr18,Bn75671,81320369,81803898,483529,RLK
chr18,Bn75672,84283142,92059100,7775958,TN
chr18,Bn75673,74960806,88722379,13761573,RLP
chr18,Bn75674,15565271,98733300,83168029,TN
chr18,Bn75675,95532865,98923497,3390632,CNL
chr18,Bn75676,21325037,50935939,29610902,RLP
chr18,Bn75677,13000080,32298610,19298530,RLP
chr18,Bn75678,65778017,75323040,9545023,CN
chr18,Bn75679,44129295,66307732,22178437,CNL
chr18,Bn75680,17037162,29027365,11990203,NBS
chr18,Bn75681,33964439,93240005,59275566,RLP
chr18,Bn75682,79978383,91750810,11772427,CN
chr18,Bn75683,42509767,84625039,42115272,NBS
chr18,Bn75684,60856895,64423253,3566358,NBS
chr18,Bn75685,72018192,95344365,23326173,CN
chr18,Bn75686,65868553,95314003,29445450,RLK
chr18,Bn75687,60823534,96110999,35287465,RLK
chr18,Bn75688,58361293,79370439,21009146,NBS
chr18,Bn75689,34165293,90095785,55930492,CN
chr18,Bn75690,6787218,20166771,13379553,RLK
chr18,Bn75691,53370312,86606698,33236386,TNL
chr18,Bn75692,23253752,25323541,2069789,RLP
chr18,Bn75693,90867069,97727457,6860388,NBS
chr18,Bn75694,62073023,84472083,22399060,RLP
chr18,Bn75695,44231209,91942498,47711289,CNL
chr18,Bn75696,44861535,86464742,41603207,RLK
chr18,Bn75697,71024158,83095220,12071062,CN
chr18,Bn75698,14932564,52365498,37432934,RLK
chr18,Bn75699,16784487,76321762,59537275,TN
chr18,Bn75700,23095115,29728363,6633248,RLK
chr18,Bn75701,54673697,69162749,14489052,NBS
chr18,Bn75702,33888764,83046247,49157483,CNL
chr18,Bn75703,74436999,85452469,11015470,RLP
chr18,Bn75704,87453935,94033664,6579729,TN
chr18,Bn75705,19577874,37262715,17684841,RLP
chr18,Bn75706,53816950,79471550,25654600,TNL
chr18,Bn75707,70954964,84924214,13969250,CN
chr18,Bn75708,5121238,21116240,15995002,TN
chr18,Bn75709,16798338,46698797,29900459,TN
chr18,Bn75710,74974625,94791019,19816394,CN
chr18,Bn75711,54714953,81150983,26436030,TN
chr18,Bn75712,57326021,89922511,32596490,TNL
chr18,Bn75713,51635828,54887022,3251194,NBS
chr18,Bn75714,63427995,97147927,33719932,TNL
chr18,Bn75715,84004720,96714128,12709408,CN
chr18,Bn75716,28543138,87646646,59103508,TNL
chr18,Bn75717,14953522,42877898,27924376,RLK
chr18,Bn75718,33375911,96386611,63010700,TN
chr18,Bn75719,90120783,92551616,2430833,CNL
chr18,Bn75720,56495183,63974622,7479439,CNL
chr18,Bn75721,27599061,88406518,60807457,RLK
chr18,Bn75722,29950575,75938643,45988068,CNL
chr18,Bn75723,42930031,75930028,32999997,CNL
chr18,Bn75724,19694139,65731269,46037130,TNL
chr18,Bn75725,58898631,89149819,30251188,CNL
chr18,Bn75726,79429099,82296798,2867699,RLK
chr18,Bn75727,77408741,90784610,13375869,TNL
chr18,Bn75728,40416186,79577750,39161564,TN
chr18,Bn75729,7552747,13397932,5845185,TNL
chr18,Bn75730,53903346,59112951,5209605,RLK
chr18,Bn75731,32804807,68568955,35764148,RLP
chr18,Bn75732,21723199,73141459,51418260,TNL
chr18,Bn75733,30670279,99898488,69228209,CN
chr18,Bn75734,2768341,90896614,88128273,CNL
chr18,Bn75735,80799017,81399954,600937,TN
chr18,Bn75736,31569542,65139673,33570131,CN
chr18,Bn75737,44540186,66239654,21699468,RLP
chr18,Bn75738,69516992,88473929,18956937,TN
chr18,Bn75739,60915579,70573143,9657564,CNL
chr18,Bn75740,36994657,41692967,4698310,RLK
chr18,Bn75741,47157264,70308231,23150967,TNL
chr18,Bn75742,75350317,80287990,4937673,TN
chr18,Bn75743,89785544,98693693,8908149,CN
chr18,Bn75744,53549183,71158449,17609266,CN
chr18,Bn75745,34855068,43777219,8922151,TNL
chr18,Bn75746,96043965,96353362,309397,CNL
chr18,Bn75747,11621888,55379850,43757962,TN
chr18,Bn75748,77778568,98894062,21115494,CNL
chr18,Bn75749,71537930,76797130,5259200,RLK
chr18,Bn75750,4659865,55547775,50887910,TNL
chr18,Bn75751,93948092,99750323,5802231,RLK
chr18,Bn75752,78354699,99901944,21547245,CNL
chr18,Bn75753,12686748,38621109,25934361,RLK
chr18,Bn75754,61428965,95114582,33685617,TN
chr18,Bn75755,91372140,95588890,4216750,NBS
chr18,Bn75756,74747317,78176864,3429547,CNL
chr18,Bn75757,44454987,73927639,29472652,RLP
chr18,Bn75758,5787088,89557611,83770523,CN
chr18,Bn75759,4941531,34500039,29558508,CNL
chr18,Bn75760,63769971,74493504,10723533,RLP
chr18,Bn75761,52942311,73113042,20170731,RLP
chr18,Bn75762,13588685,54964716,41376031,RLP
chr18,Bn75763,13570979,89916723,76345744,RLK
chr18,Bn75764,58459305,73956387,15497082,CN
chr18,Bn75765,73189079,87588575,14399496,TNL
chr18,Bn75766,76288402,77897301,1608899,CN
chr18,Bn75767,17381489,24821965,7440476,TN
chr18,Bn75768,43472681,64686219,21213538,RLP
chr18,Bn75769,78662566,93354429,14691863,TNL
chr18,Bn75770,10749829,41121083,30371254,NBS
chr18,Bn75771,82110864,92568578,10457714,TN
chr18,Bn75772,41645967,59387663,17741696,CNL
chr18,Bn75773,5622130,63638268,58016138,RLP
chr18,Bn75774,81529204,91794399,10265195,TNL
chr18,Bn75775,47029072,58036724,11007652,RLK
chr18,Bn75776,39921502,89141498,49219996,RLK
chr18,Bn75777,50271769,78604293,28332524,RLK
chr18,Bn75778,7352359,88001334,80648975,TNL
chr18,Bn75779,58947367,73282407,14335040,RLK
chr18,Bn75780,93875123,94509864,634741,TNL
chr18,Bn75781,12844818,67311114,54466296,NBS
chr18,Bn75782,96641432,98175139,1533707,CNL
chr18,Bn75783,6718598,29047871,22329273,RLK
chr18,Bn75784,89646600,93425008,3778408,RLK
chr18,Bn75785,49212635,97237793,48025158,CNL
chr18,Bn75786,27657623,78326404,50668781,CNL
chr18,Bn75787,51763572,79892552,28128980,TNL
chr18,Bn75788,75154616,99982955,24828339,CN
chr18,Bn75789,93732996,96929257,3196261,RLP
chr18,Bn75790,18678599,50529667,31851068,RLK
chr18,Bn75791,44556025,99340957,54784932,RLK
chr18,Bn75792,19915370,59583577,39668207,NBS
chr18,Bn75793,54318400,90516166,36197766,CN
chr18,Bn75794,22677002,81556607,58879605,TN
chr18,Bn75795,83016362,94993709,11977347,CN
chr18,Bn75796,4264431,66392508,62128077,NBS
chr18,Bn75797,53717442,71542061,17824619,RLP
chr18,Bn75798,10852113,60179500,49327387,CN
chr18,Bn75799,48665204,83608933,34943729,TNL
chr18,Bn75800,16950537,66624150,49673613,RLP
chr18,Bn75801,1352978,94485254,93132276,RLP
chr18,Bn75802,74968305,86659318,11691013,CN
chr18,Bn75803,21833359,27784745,5951386,TN
chr18,Bn75804,46194616,48507371,2312755,TNL
chr18,Bn75805,69345341,78520354,9175013,NBS
chr18,Bn75806,55953943,65571320,9617377,NBS
chr18,Bn75807,31664255,92879405,61215150,CNL
chr18,Bn75808,75213369,77912299,2698930,RLP
chr18,Bn75809,16284605,24208253,7923648,TNL
chr18,Bn75810,98516263,99163394,647131,CNL
chr18,Bn75811,27967204,75089271,47122067,TN
chr18,Bn75812,67071923,80577381,13505458,CN
chr18,Bn75813,49981483,87556671,37575188,NBS
chr18,Bn75814,32095639,84145082,52049443,CN
chr18,Bn75815,23809058,53911318,30102260,CNL
chr18,Bn75816,93553774,96354289,2800515,CN
chr18,Bn75817,15764345,66432745,50668400,TN
chr18,Bn75818,81454582,83204763,1750181,RLK
chr18,Bn75819,90035252,90675234,639982,CN
chr18,Bn75820,13158814,85182806,72023992,RLP
chr18,Bn75821,61000353,79825182,18824829,NBS
chr18,Bn75822,93963647,99475080,5511433,NBS
chr18,Bn75823,55934119,84763629,28829510,CNL
chr18,Bn75824,73133685,98033514,24899829,RLK
chr18,Bn75825,96610889,99124719,2513830,RLP
chr18,Bn75826,65329187,74316912,8987725,RLP
chr18,Bn75827,21504436,42658105,21153669,TNL
chr18,Bn75828,94782737,99744637,4961900,CN
chr18,Bn75829,37628608,99901550,62272942,TN
chr18,Bn75830,73359350,76742097,3382747,RLP
chr18,Bn75831,29063298,89294657,60231359,CNL
chr18,Bn75832,47904097,94588613,46684516,RLP
chr18,Bn75833,3743861,73646052,69902191,CN
chr18,Bn75834,80991483,89145042,8153559,CNL
chr18,Bn75835,46348919,59682032,13333113,RLK
chr18,Bn75836,14165872,33236309,19070437,TN
chr18,Bn75837,21069448,40462385,19392937,CNL
chr18,Bn75838,73679968,93395419,19715451,CN
chr18,Bn75839,35156198,36980393,1824195,NBS
chr18,Bn75840,45721411,54321473,8600062,TN
chr18,Bn75841,65859394,89580858,23721464,CN
chr18,Bn75842,76993621,91686115,14692494,RLK
chr18,Bn75843,53385782,77870494,24484712,NBS
chr18,Bn75844,77437502,91278067,13840565,TN
chr18,Bn75845,73840478,78525191,4684713,TN
chr18,Bn75846,5134623,30732781,25598158,RLK
chr18,Bn75847,42759778,92403232,49643454,RLP
chr18,Bn75848,61581234,92701232,31119998,NBS
chr18,Bn75849,64499954,99495769,34995815,CNL
chr18,Bn75850,86833453,94325511,7492058,TNL
chr18,Bn75851,61088043,73033469,11945426,NBS
chr18,Bn75852,13580648,15949616,2368968,NBS
chr18,Bn75853,40676238,60379927,19703689,RLK
chr18,Bn75854,57239424,63285150,6045726,RLK
chr18,Bn75855,28939623,84332354,55392731,RLP
chr18,Bn75856,69207395,88950181,19742786,RLK
chr18,Bn75857,95465178,98814136,3348958,RLK
chr18,Bn75858,8402543,20156564,11754021,CN
chr18,Bn75859,10214694,29808576,19593882,CNL
chr18,Bn75860,1905279,52340957,50435678,RLP
chr18,Bn75861,37079146,60869860,23790714,CN
chr18,Bn75862,85664133,93518528,7854395,TNL
chr18,Bn75863,8764554,32409197,23644643,RLP
chr18,Bn75864,87263862,97551268,10287406,CNL
chr18,Bn75865,79457350,89156446,9699096,RLP
chr18,Bn75866,80097704,87810011,7712307,TN
chr18,Bn75867,28286419,98587876,70301457,TNL
chr18,Bn75868,73667534,91144458,17476924,NBS
chr18,Bn75869,84074201,93765831,9691630,NBS
chr18,Bn75870,24052485,57706341,33653856,TN
chr18,Bn75871,49979185,70763811,20784626,TNL
chr18,Bn75872,18199470,29046042,10846572,NBS
chr18,Bn75873,58586418,68493269,9906851,RLP
chr18,Bn75874,83690507,93294399,9603892,RLP
chr18,Bn75875,44214806,81988392,37773586,RLP
chr18,Bn75876,73097001,94521299,21424298,RLK
chr18,Bn75877,65811362,80503872,14692510,CNL
chr18,Bn75878,22506348,77268170,54761822,CNL
chr18,Bn75879,46421681,57590705,11169024,CNL
chr18,Bn75880,30219499,69678502,39459003,CN
chr18,Bn75881,78053694,91724705,13671011,RLP
chr18,Bn75882,99883606,99946556,62950,NBS
chr18,Bn75883,17987287,44623526,26636239,TN
chr18,Bn75884,7574975,90948136,83373161,RLP
chr18,Bn75885,79416294,88821822,9405528,CNL
chr18,Bn75886,5603084,43588274,37985190,TNL
chr18,Bn75887,25953337,94637548,68684211,TNL
chr18,Bn75888,77562366,96947259,19384893,RLK
chr18,Bn75889,62470650,86591022,24120372,TNL
chr18,Bn75890,36324068,36393767,69699,RLP
chr18,Bn75891,99771310,99866140,94830,RLK
chr18,Bn75892,49633496,73034658,23401162,CNL
chr18,Bn75893,28329335,86790722,58461387,NBS
chr18,Bn75894,71116213,87064033,15947820,TNL
chr18,Bn75895,60052912,84729790,24676878,RLP
chr18,Bn75896,91567718,97271731,5704013,CNL
chr18,Bn75897,79079469,98301761,19222292,NBS
chr18,Bn75898,89816063,97759296,7943233,CN
chr18,Bn75899,23401012,96339908,72938896,NBS
chr18,Bn75900,91025688,94921503,3895815,TNL
chr18,Bn75901,23164445,47276345,24111900,CN
chr18,Bn75902,10526706,36534524,26007818,RLP
chr18,Bn75903,64127356,98524011,34396655,RLP
chr18,Bn75904,40074197,84391032,44316835,NBS
chr18,Bn75905,58805276,73655017,14849741,TN
chr18,Bn75906,48985028,97555304,48570276,CN
chr18,Bn75907,52543093,70877353,18334260,RLP
chr18,Bn75908,91734159,96172217,4438058,CN
chr18,Bn75909,68737596,96048109,27310513,NBS
chr18,Bn75910,3966878,48387747,44420869,CN
chr18,Bn75911,38886877,50818946,11932069,RLP
chr18,Bn75912,54329293,86480942,32151649,CNL
chr18,Bn75913,84922575,97832072,12909497,CN
chr18,Bn75914,64742644,69981893,5239249,TN
chr18,Bn75915,30704589,69059927,38355338,RLK
chr18,Bn75916,53879247,61320275,7441028,RLK
chr18,Bn75917,94045176,94443757,398581,RLP
chr18,Bn75918,81102140,86206386,5104246,RLK
chr18,Bn75919,66897271,96153781,29256510,TNL
chr18,Bn75920,47820707,60555075,12734368,TN
chr18,Bn75921,41508699,58648945,17140246,TN
chr18,Bn75922,97260213,97317228,57015,RLP
chr18,Bn75923,61507275,61798782,291507,CN
chr18,Bn75924,99143433,99594160,450727,CNL
chr18,Bn75925,90849986,98883441,8033455,TN
chr18,Bn75926,84117605,87714658,3597053,NBS
chr18,Bn75927,60953533,90354020,29400487,RLP
chr18,Bn75928,92502539,94747033,2244494,TNL
chr18,Bn75929,90107619,90860955,753336,TN
chr18,Bn75930,34101376,61196991,27095615,RLP
chr18,Bn75931,92095386,97710541,5615155,RLK
chr18,Bn75932,1498622,60352671,58854049,RLK
chr18,Bn75933,10742310,46837266,36094956,NBS
chr18,Bn75934,83080629,92601368,9520739,TN
chr18,Bn75935,88652861,95809035,7156174,RLP
chr18,Bn75936,91288978,99739673,8450695,NBS
chr18,Bn75937,8788433,81537863,72749430,TN
chr18,Bn75938,29069129,58211167,29142038,NBS
chr18,Bn75939,45051803,85702764,40650961,RLK
chr18,Bn75940,54349637,94094595,39744958,RLP
chr18,Bn75941,68090899,82010923,13920024,RLP
chr18,Bn75942,96273138,97492217,1219079,CNL
chr18,Bn75943,15403892,15454411,50519,RLK
chr18,Bn75944,91112752,96222005,5109253,CN
chr18,Bn75945,64390395,96164972,31774577,RLP
chr18,Bn75946,33376025,47721915,14345890,CNL
chr18,Bn75947,56079507,96553532,40474025,RLP
chr18,Bn75948,17232891,52036796,34803905,NBS
chr18,Bn75949,23405737,44629848,21224111,NBS
chr18,Bn75950,4759820,14379969,9620149,RLP
chr18,Bn75951,16892132,49015173,32123041,CN
chr18,Bn75952,57315726,58068156,752430,CNL
chr18,Bn75953,35939401,96937764,60998363,TN
chr18,Bn75954,93386671,96446174,3059503,RLK
chr18,Bn75955,39433493,88245442,48811949,RLK
chr18,Bn75956,37504593,89501584,51996991,CNL
chr18,Bn75957,32461680,94508897,62047217,NBS
chr18,Bn75958,25290579,94750925,69460346,RLK
chr18,Bn75959,2037175,8003888,5966713,TNL
chr18,Bn75960,81674405,82101877,427472,RLP
chr18,Bn75961,20742148,85700803,64958655,RLK
chr18,Bn75962,12342152,58150763,45808611,TN
chr18,Bn75963,98719504,99140893,421389,RLK
chr18,Bn75964,83713898,97618791,13904893,NBS
chr18,Bn75965,34837256,74104286,39267030,TN
chr18,Bn75966,88761927,91013260,2251333,CN
chr18,Bn75967,75819966,85587949,9767983,NBS
chr18,Bn75968,7008160,87502492,80494332,TNL
chr18,Bn75969,77648309,87778888,10130579,NBS
chr18,Bn75970,85779877,96807263,11027386,CNL
chr18,Bn75971,17042522,36249054,19206532,CNL
chr18,Bn75972,29944589,62896978,32952389,TNL
chr18,Bn75973,76585595,90595230,14009635,NBS
chr18,Bn75974,47655724,56717756,9062032,TN
chr18,Bn75975,53054050,60253801,7199751,CN
chr18,Bn75976,34001983,81624663,47622680,CN
chr18,Bn75977,65444632,87528319,22083687,CN
chr18,Bn75978,74455131,96260281,21805150,RLP
chr18,Bn75979,55659059,70201350,14542291,CNL
chr18,Bn75980,74173478,89805558,15632080,CNL
chr18,Bn75981,35566787,66603486,31036699,RLK
chr18,Bn75982,74898213,97003091,22104878,CNL
chr18,Bn75983,37602607,59928132,22325525,TNL
chr18,Bn75984,63467518,96359895,32892377,NBS
chr18,Bn75985,66508918,69293544,2784626,CNL
chr18,Bn75986,40849532,84864487,44014955,CN
chr18,Bn75987,4436676,76940433,72503757,CNL
chr18,Bn75988,17761536,50711252,32949716,TN
chr18,Bn75989,23710613,95929510,72218897,NBS
chr18,Bn75990,14536349,94625557,80089208,RLP
chr18,Bn75991,75503356,78544276,3040920,RLP
chr18,Bn75992,53990028,63594358,9604330,TN
chr18,Bn75993,31015674,44903428,13887754,RLK
chr18,Bn75994,84013859,84792567,778708,TNL
chr18,Bn75995,40546951,61889057,21342106,TN
chr18,Bn75996,55987792,58042484,2054692,RLK
chr18,Bn75997,42124710,47299841,5175131,TN
chr18,Bn75998,35066394,68348535,33282141,RLK
chr18,Bn75999,32515627,69588515,37072888,TNL
chr18,Bn76000,47585304,65504526,17919222,TN
chr18,Bn76001,96173577,99180946,3007369,NBS
chr18,Bn76002,28266293,95967568,67701275,NBS
chr18,Bn76003,55882875,75096384,19213509,RLK
chr18,Bn76004,66967298,93169915,26202617,RLP
chr18,Bn76005,45645196,69420958,23775762,RLK
chr18,Bn76006,64046729,84103120,20056391,TNL
chr18,Bn76007,46174090,85951053,39776963,CNL
chr18,Bn76008,56045137,96289293,40244156,CNL
chr18,Bn76009,10687647,18977162,8289515,CNL
chr18,Bn76010,11259852,99719538,88459686,TNL
chr18,Bn76011,81681872,87787647,6105775,NBS
chr18,Bn76012,43018302,56457360,13439058,TN
chr18,Bn76013,26688086,47517747,20829661,TN
chr18,Bn76014,15726532,36675972,20949440,TN
chr18,Bn76015,82731510,93992393,11260883,RLP
chr18,Bn76016,52186174,80216224,28030050,CN
chr18,Bn76017,43738613,64065242,20326629,CNL
chr18,Bn76018,54658499,58140651,3482152,CN
chr18,Bn76019,44123165,90502251,46379086,TN
chr18,Bn76020,45138408,54135611,8997203,RLP
chr18,Bn76021,27474932,56313441,28838509,TNL
chr18,Bn76022,15725568,18592464,2866896,TN
chr18,Bn76023,6601205,10207041,3605836,TNL
chr18,Bn76024,43336517,69927658,26591141,NBS
chr18,Bn76025,36945757,79390358,42444601,CNL
chr18,Bn76026,73829081,79063733,5234652,TNL
chr18,Bn76027,16715287,97062549,80347262,TN
chr18,Bn76028,1452860,62887990,61435130,TN
chr18,Bn76029,89779473,95558367,5778894,TNL
chr18,Bn76030,96575446,97455745,880299,TN
chr18,Bn76031,26709021,52754365,26045344,RLK
chr18,Bn76032,67278946,79050032,11771086,RLK
chr18,Bn76033,46967050,89754076,42787026,NBS
chr18,Bn76034,58356801,85697866,27341065,CN
chr18,Bn76035,27930625,87263605,59332980,RLP
chr18,Bn76036,30758788,94556737,63797949,RLK
chr18,Bn76037,59818437,93373650,33555213,CN
chr18,Bn76038,70523606,82405063,11881457,TNL
chr18,Bn76039,56705446,76373208,19667762,RLP
chr18,Bn76040,6045121,13914820,7869699,TN
chr18,Bn76041,59302410,95454790,36152380,TN
chr18,Bn76042,52655967,77187844,24531877,TNL
chr18,Bn76043,57486353,58260910,774557,RLK
chr18,Bn76044,79179057,83200150,4021093,NBS
chr18,Bn76045,67020049,89575159,22555110,CNL
chr18,Bn76046,39584966,43403753,3818787,CN
chr18,Bn76047,26282648,61985337,35702689,TN
chr18,Bn76048,74658860,75653424,994564,NBS
chr18,Bn76049,43833220,65134154,21300934,NBS
chr18,Bn76050,15530681,40868297,25337616,TN
chr18,Bn76051,40463176,45643277,5180101,CNL
chr18,Bn76052,9859492,79816689,69957197,CNL
chr18,Bn76053,34665178,57594006,22928828,NBS
chr18,Bn76054,27999572,43707067,15707495,TNL
chr18,Bn76055,65725741,87238689,21512948,CNL
chr18,Bn76056,59059714,99241743,40182029,RLP
chr18,Bn76057,28654020,91256994,62602974,RLP
chr18,Bn76058,5190453,26557501,21367048,RLK
chr18,Bn76059,55083571,65168081,10084510,CNL
chr18,Bn76060,30391808,73185975,42794167,TNL
chr18,Bn76061,54080516,86049625,31969109,RLP
chr18,Bn76062,45191667,96165367,50973700,NBS
chr18,Bn76063,78648561,92479447,13830886,TN
chr18,Bn76064,37940939,68116490,30175551,TNL
chr18,Bn76065,43927640,96029379,52101739,CN
chr18,Bn76066,92372676,93787119,1414443,TN
chr18,Bn76067,5242648,60209602,54966954,CNL
chr18,Bn76068,8694988,79996248,71301260,TNL
chr18,Bn76069,88435413,92650149,4214736,TNL
chr18,Bn76070,77936928,96906562,18969634,RLK
chr18,Bn76071,3783889,70158491,66374602,CNL
chr18,Bn76072,70998644,98317450,27318806,TN
chr18,Bn76073,10881058,47687126,36806068,CN
chr18,Bn76074,35080937,88149347,53068410,NBS
chr18,Bn76075,94731368,98881167,4149799,TN
chr18,Bn76076,10345400,59542073,49196673,NBS
chr18,Bn76077,37684340,97497237,59812897,CNL
chr18,Bn76078,67363101,73592602,6229501,TN
chr18,Bn76079,1780266,54441635,52661369,TN
chr18,Bn76080,52692845,89227545,36534700,TN
chr18,Bn76081,63003112,77625042,14621930,CN
chr18,Bn76082,56119364,87332181,31212817,CN
chr18,Bn76083,82404852,93967087,11562235,CNL
chr18,Bn76084,13673733,18290301,4616568,TN
chr18,Bn76085,10231706,59711176,49479470,RLK
chr18,Bn76086,18211613,60963184,42751571,CNL
chr18,Bn76087,84026144,85099655,1073511,NBS
chr18,Bn76088,2287995,58709639,56421644,RLK
chr18,Bn76089,80015933,96552843,16536910,TN
chr18,Bn76090,63941859,94635241,30693382,RLP
chr18,Bn76091,40582900,91123446,50540546,CNL
chr18,Bn76092,72483729,73767137,1283408,RLK
chr18,Bn76093,49936508,81500517,31564009,TN
chr18,Bn76094,12359081,31042085,18683004,CN
chr18,Bn76095,11038660,28213394,17174734,CNL
chr18,Bn76096,83061762,86703532,3641770,TN
chr18,Bn76097,96309998,99779909,3469911,NBS
chr18,Bn76098,13742483,43548711,29806228,TNL
chr18,Bn76099,26241112,27301628,1060516,TNL
chr18,Bn76100,56596500,89878008,33281508,RLP
chr18,Bn76101,13544158,23552648,10008490,NBS
chr18,Bn76102,30964997,56146126,25181129,CNL
chr18,Bn76103,71214105,95202014,23987909,CNL
chr18,Bn76104,74293791,78182326,3888535,NBS
chr18,Bn76105,86677670,93838187,7160517,CN
chr18,Bn76106,23290932,86921288,63630356,CN
chr18,Bn76107,50164513,93954106,43789593,CNL
chr18,Bn76108,16206206,53205100,36998894,NBS
chr18,Bn76109,57742670,89046540,31303870,CN
chr18,Bn76110,41697624,54150192,12452568,NBS
chr18,Bn76111,7886414,88743323,80856909,TNL
chr18,Bn76112,62816093,98187051,35370958,TNL
chr18,Bn76113,50289482,72319208,22029726,RLP
chr18,Bn76114,89490504,90987036,1496532,NBS
chr18,Bn76115,28209620,93892783,65683163,NBS
chr18,Bn76116,97843213,98568808,725595,NBS
chr18,Bn76117,12322303,92242144,79919841,TNL
chr18,Bn76118,74088050,97195208,23107158,RLP
chr18,Bn76119,53325272,86980829,33655557,CNL
chr18,Bn76120,11424935,54117133,42692198,CN
chr18,Bn76121,64114389,86945331,22830942,CN
chr18,Bn76122,32096264,46187276,14091012,CN
chr18,Bn76123,38432057,64966852,26534795,RLP
chr18,Bn76124,95930421,98328251,2397830,NBS
chr18,Bn76125,63489391,96828156,33338765,RLP
chr18,Bn76126,33662405,48616306,14953901,CN
chr18,Bn76127,9205303,97596216,88390913,TN
chr18,Bn76128,36089075,51513033,15423958,CN
chr18,Bn76129,56207475,84718970,28511495,CN
chr18,Bn76130,97807919,99324977,1517058,CNL
chr18,Bn76131,8118195,81292388,73174193,TN
chr18,Bn76132,46876020,82976886,36100866,TNL
chr18,Bn76133,65825975,69373372,3547397,RLP
chr18,Bn76134,70133149,75639456,5506307,RLK
chr18,Bn76135,57187416,67944138,10756722,TNL
chr18,Bn76136,42906935,49146805,6239870,RLP
chr18,Bn76137,95021004,96823262,1802258,RLK
chr18,Bn76138,14297726,14377113,79387,NBS
chr18,Bn76139,48352300,79481346,31129046,CNL
chr18,Bn76140,38155551,90270215,52114664,NBS
chr18,Bn76141,36175852,64513818,28337966,RLK
chr18,Bn76142,90396613,92299668,1903055,NBS
chr18,Bn76143,78516350,91578084,13061734,CNL
chr18,Bn76144,87325657,98618949,11293292,NBS
chr18,Bn76145,71771732,85772604,14000872,CN
chr18,Bn76146,93916858,99971805,6054947,RLP
chr18,Bn76147,7983782,11877973,3894191,TN
chr18,Bn76148,64856868,98003782,33146914,CN
chr18,Bn76149,11217522,72018872,60801350,CNL
chr18,Bn76150,96472372,99243250,2770878,CNL
chr18,Bn76151,98219656,99124174,904518,CN
chr18,Bn76152,35253087,49389841,14136754,CNL
chr18,Bn76153,62099882,69913428,7813546,NBS
chr18,Bn76154,45532302,47789105,2256803,NBS
chr18,Bn76155,62557315,71757691,9200376,RLP
chr18,Bn76156,21496689,38821463,17324774,NBS
chr18,Bn76157,63735422,83516243,19780821,RLK
chr18,Bn76158,81567271,83989480,2422209,NBS
chr18,Bn76159,69370428,81337975,11967547,TN
chr18,Bn76160,14425998,83883274,69457276,TNL
chr18,Bn76161,68284461,99725440,31440979,CN
chr18,Bn76162,80113743,89930088,9816345,NBS
chr18,Bn76163,84787060,90915185,6128125,CN
chr18,Bn76164,97715693,98838508,1122815,RLK
chr18,Bn76165,5995981,75341792,69345811,RLP
chr18,Bn76166,83644582,98065771,14421189,CN
chr18,Bn76167,53474132,53891942,417810,TNL
chr18,Bn76168,91647616,99730181,8082565,RLK
chr18,Bn76169,68409829,80693788,12283959,TNL
chr18,Bn76170,2361831,15876317,13514486,CN
chr18,Bn76171,44570602,68412485,23841883,RLP
chr18,Bn76172,31528955,90842951,59313996,CNL
chr18,Bn76173,51030031,86817822,35787791,CN
chr18,Bn76174,85085608,98700017,13614409,CNL
chr18,Bn76175,82676452,98156621,15480169,TNL
chr18,Bn76176,94477112,99241795,4764683,TNL
chr18,Bn76177,2735163,36744743,34009580,RLK
chr18,Bn76178,62296292,92667789,30371497,RLP
chr18,Bn76179,64887346,78381299,13493953,TN
chr18,Bn76180,82237026,97688781,15451755,TN
chr18,Bn76181,68311613,89954039,21642426,TN
chr18,Bn76182,81008324,99590428,18582104,NBS
chr18,Bn76183,21649372,38298934,16649562,CNL
chr18,Bn76184,16858366,20130605,3272239,CN
chr18,Bn76185,60962024,78637341,17675317,CN
chr18,Bn76186,15338972,62153577,46814605,NBS
chr18,Bn76187,64021226,87803214,23781988,NBS
chr18,Bn76188,99511423,99765190,253767,TN
chr18,Bn76189,82483346,86571783,4088437,RLP
chr18,Bn76190,13857448,40352388,26494940,TNL
chr18,Bn76191,30540003,64729748,34189745,RLP
chr18,Bn76192,86959074,90905172,3946098,CN
chr18,Bn76193,71836471,96324739,24488268,RLP
chr18,Bn76194,20101262,71328156,51226894,NBS
chr18,Bn76195,36113724,70567417,34453693,CNL
chr18,Bn76196,35334601,61509783,26175182,RLP
chr18,Bn76197,48422663,89947333,41524670,TNL
chr18,Bn76198,63633157,66463372,2830215,CNL
chr18,Bn76199,34231772,75565731,41333959,NBS
chr18,Bn76200,58278691,65047140,6768449,RLP
chr18,Bn76201,72763802,97175591,24411789,RLP
chr18,Bn76202,82706655,83883317,1176662,RLP
chr18,Bn76203,15445779,42457911,27012132,TNL
chr18,Bn76204,45366986,74666720,29299734,CNL
chr18,Bn76205,83204899,97523561,14318662,RLP
chr18,Bn76206,52825193,60926751,8101558,CN
chr18,Bn76207,25158657,63757249,38598592,NBS
chr18,Bn76208,97386763,98801462,1414699,RLK
chr18,Bn76209,26226485,36617917,10391432,CN
chr18,Bn76210,38006419,59739627,21733208,CNL
chr18,Bn76211,80367406,85663407,5296001,CN
chr18,Bn76212,69376214,96341129,26964915,RLP
chr18,Bn76213,26529233,94855428,68326195,CN
chr18,Bn76214,9687204,67217918,57530714,TN
chr18,Bn76215,92699423,98511048,5811625,NBS
chr18,Bn76216,48160273,88878337,40718064,TN
chr18,Bn76217,73791655,81997880,8206225,CNL
chr18,Bn76218,58693484,71823400,13129916,RLK
chr18,Bn76219,70864616,87203467,16338851,CN
chr18,Bn76220,27313804,30803991,3490187,TNL
chr18,Bn76221,11452735,69953359,58500624,RLP
chr18,Bn76222,61634000,76618417,14984417,NBS
chr18,Bn76223,28405681,92333540,63927859,NBS
chr18,Bn76224,26524526,93239966,66715440,TN
chr18,Bn76225,72381417,82808622,10427205,RLK
chr18,Bn76226,22327717,86716808,64389091,NBS
chr18,Bn76227,48255036,82377238,34122202,TN
chr18,Bn76228,38622278,92028363,53406085,CNL
chr18,Bn76229,15143163,86704841,71561678,RLP
chr18,Bn76230,32772971,67816663,35043692,TNL
chr18,Bn76231,20391892,26611134,6219242,CNL
chr18,Bn76232,30238797,96398810,66160013,CN
chr18,Bn76233,60059628,66866700,6807072,NBS
chr18,Bn76234,64114408,83947702,19833294,CNL
chr18,Bn76235,9124443,34855807,25731364,RLK
chr18,Bn76236,95425352,98381227,2955875,NBS
chr18,Bn76237,34473325,60493192,26019867,CNL
chr18,Bn76238,14701703,26510542,11808839,CNL
chr18,Bn76239,89912843,98104504,8191661,RLP
chr18,Bn76240,91754623,98437397,6682774,CN
chr18,Bn76241,46752148,47777981,1025833,TNL
chr18,Bn76242,80366814,98551414,18184600,TN
chr18,Bn76243,37332929,68206289,30873360,CN
chr18,Bn76244,4716189,7016964,2300775,TN
chr18,Bn76245,25296645,58420147,33123502,CNL
chr18,Bn76246,75045001,89585088,14540087,TN
chr18,Bn76247,41462597,94198546,52735949,TN
chr18,Bn76248,83748040,96348206,12600166,TNL
chr18,Bn76249,74579682,87299481,12719799,TN
chr18,Bn76250,38590119,91707901,53117782,TN
chr18,Bn76251,11742714,97914768,86172054,RLK
chr18,Bn76252,57358285,77363367,20005082,TN
chr18,Bn76253,82878544,90482432,7603888,TN
chr18,Bn76254,60106507,66259537,6153030,TN
chr18,Bn76255,95926336,99366736,3440400,CN
chr18,Bn76256,79772768,99913372,20140604,TN
chr18,Bn76257,81510500,92988063,11477563,CNL
chr18,Bn76258,73069911,96880976,23811065,RLP
chr18,Bn76259,4586533,15152648,10566115,CN
chr18,Bn76260,76968247,80770796,3802549,TN
chr18,Bn76261,67899808,76478490,8578682,TNL
chr18,Bn76262,54261112,57472349,3211237,RLK
chr18,Bn76263,94845222,97524625,2679403,RLP
chr18,Bn76264,77698748,96721464,19022716,RLK
chr18,Bn76265,61853979,89160182,27306203,TNL
chr18,Bn76266,96844726,97802858,958132,TNL
chr18,Bn76267,78967536,87607250,8639714,CNL
chr18,Bn76268,40921440,90983496,50062056,RLK
chr18,Bn76269,77717113,83895577,6178464,RLP
chr18,Bn76270,19545602,40736444,21190842,RLK
chr18,Bn76271,40397699,60585378,20187679,TN
chr18,Bn76272,48854695,61158841,12304146,TNL
chr18,Bn76273,76351541,86284586,9933045,RLP
chr18,Bn76274,92682798,94013374,1330576,TNL
chr18,Bn76275,16421249,22002536,5581287,TN
chr18,Bn76276,68452544,74197559,5745015,CN
chr18,Bn76277,73533560,75685049,2151489,TN
chr18,Bn76278,72976461,99215997,26239536,RLP
chr18,Bn76279,10103705,78620458,68516753,CN
chr18,Bn76280,99588729,99632676,43947,CN
chr18,Bn76281,40488148,72501372,32013224,RLP
chr18,Bn76282,11143182,80951119,69807937,TN
chr18,Bn76283,61224076,69864616,8640540,TN
chr18,Bn76284,37925362,72766812,34841450,CNL
chr18,Bn76285,92250372,97411458,5161086,RLP
chr18,Bn76286,72892367,83391041,10498674,NBS
chr18,Bn76287,91716493,93525830,1809337,NBS
chr18,Bn76288,79571292,84106939,4535647,TNL
chr18,Bn76289,75037842,86145734,11107892,RLP
chr18,Bn76290,25657846,48777410,23119564,RLK
chr18,Bn76291,80489020,95187458,14698438,CNL
chr18,Bn76292,7633579,78074394,70440815,CNL
chr18,Bn76293,49869447,58760991,8891544,CN
chr18,Bn76294,16463155,75721700,59258545,CNL
chr18,Bn76295,13098077,28234311,15136234,RLK
chr18,Bn76296,70983944,90534173,19550229,CNL
chr18,Bn76297,85593754,91754497,6160743,RLP
chr18,Bn76298,57332253,95507880,38175627,NBS
chr18,Bn76299,79510682,87610699,8100017,CNL
chr18,Bn76300,26817866,40780714,13962848,TNL
chr18,Bn76301,47137406,48736221,1598815,RLK
chr18,Bn76302,46373681,59973966,13600285,TNL
chr18,Bn76303,19454619,80896239,61441620,RLP
chr18,Bn76304,74607228,79055819,4448591,RLK
chr18,Bn76305,59132532,61141018,2008486,TNL
chr18,Bn76306,60667974,64138559,3470585,TNL
chr18,Bn76307,40694677,55844944,15150267,CNL
chr18,Bn76308,56909874,91629294,34719420,TNL
chr18,Bn76309,58811019,82454134,23643115,TN
chr18,Bn76310,57419148,64045863,6626715,RLP
chr18,Bn76311,49120442,92774766,43654324,CN
chr18,Bn76312,47242007,84019661,36777654,TNL
chr18,Bn76313,31693381,98851264,67157883,CNL
chr18,Bn76314,68299486,80732430,12432944,NBS
chr18,Bn76315,87222632,95512178,8289546,NBS
chr18,Bn76316,25760312,36580555,10820243,RLK
chr18,Bn76317,95300659,96795401,1494742,NBS
chr18,Bn76318,46447784,56220144,9772360,TN
chr18,Bn76319,55450581,89740633,34290052,RLK
chr18,Bn76320,48184492,93101425,44916933,RLK
chr18,Bn76321,53440973,55597986,2157013,TNL
chr18,Bn76322,9873717,10791039,917322,TNL
chr18,Bn76323,42471367,85571156,43099789,NBS
chr18,Bn76324,38726000,90853284,52127284,RLP
chr18,Bn76325,18280754,99339370,81058616,RLP
chr18,Bn76326,12461280,61033697,48572417,TN
chr18,Bn76327,30615318,31448719,833401,CN
chr18,Bn76328,27154218,58964090,31809872,CNL
chr18,Bn76329,28465438,77325761,48860323,NBS
chr18,Bn76330,50928180,65699679,14771499,RLP
chr18,Bn76331,12694933,15809765,3114832,CN
chr18,Bn76332,31173084,81011913,49838829,RLK
chr18,Bn76333,47411438,81255826,33844388,NBS
chr18,Bn76334,69171380,72984410,3813030,RLK
chr18,Bn76335,87638466,98366643,10728177,NBS
chr18,Bn76336,28764864,45270758,16505894,CNL
chr18,Bn76337,7715499,40136769,32421270,RLK
chr18,Bn76338,26918347,63602578,36684231,CN
chr18,Bn76339,24277587,44810316,20532729,RLP
chr18,Bn76340,82365802,90402875,8037073,TNL
chr18,Bn76341,42074173,56890066,14815893,CNL
chr18,Bn76342,27750718,56501292,28750574,TN
chr18,Bn76343,64384340,74682314,10297974,TN
chr18,Bn76344,36391577,96021762,59630185,RLP
chr18,Bn76345,64760467,83738742,18978275,RLP
chr18,Bn76346,99095946,99327173,231227,RLK
chr18,Bn76347,36372537,72121068,35748531,TN
chr18,Bn76348,95656020,99061050,3405030,RLK
chr18,Bn76349,36643944,99443951,62800007,RLK
chr18,Bn76350,41169579,44111053,2941474,CNL
chr18,Bn76351,95465390,96025447,560057,TN
chr18,Bn76352,79812009,84467737,4655728,CNL
chr18,Bn76353,86887980,98275889,11387909,RLK
chr18,Bn76354,48671305,69661835,20990530,CNL
chr18,Bn76355,17290806,63270898,45980092,NBS
chr18,Bn76356,25118329,41800484,16682155,CN
chr18,Bn76357,49412604,77989996,28577392,NBS
chr18,Bn76358,69642755,98785354,29142599,NBS
chr18,Bn76359,43403454,60091259,16687805,TNL
chr18,Bn76360,26681402,85638051,58956649,NBS
chr18,Bn76361,93646755,98975499,5328744,CN
chr18,Bn76362,82395761,87271123,4875362,TNL
chr18,Bn76363,31623949,42153058,10529109,RLP
chr18,Bn76364,19571588,47980349,28408761,TN
chr18,Bn76365,93141258,94999523,1858265,CNL
chr18,Bn76366,39009826,79556815,40546989,CN
chr18,Bn76367,61596341,74716284,13119943,CN
chr18,Bn76368,68990364,73222996,4232632,TNL
chr18,Bn76369,99635600,99859767,224167,NBS
chr18,Bn76370,61188743,93274899,32086156,CN
chr18,Bn76371,1691446,20591145,18899699,NBS
chr18,Bn76372,28546486,58192652,29646166,TNL
chr18,Bn76373,95920644,98255054,2334410,RLK
chr18,Bn76374,27997376,48752700,20755324,CN
chr18,Bn76375,53305552,86859807,33554255,TNL
chr18,Bn76376,66242516,78772124,12529608,TN
chr18,Bn76377,59386893,59459252,72359,RLP
chr18,Bn76378,68509969,96860750,28350781,CN
chr18,Bn76379,96313098,97662081,1348983,NBS
chr18,Bn76380,16299393,61655246,45355853,CNL
chr18,Bn76381,48261636,79149132,30887496,NBS
chr18,Bn76382,58393778,96739592,38345814,CNL
chr18,Bn76383,63236468,90853458,27616990,RLK
chr18,Bn76384,22078286,57484746,35406460,RLP
chr18,Bn76385,5076083,26879094,21803011,NBS
chr18,Bn76386,53986483,92871618,38885135,CNL
chr18,Bn76387,71547334,71759711,212377,TNL
chr18,Bn76388,9411197,49104052,39692855,TN
chr18,Bn76389,54858521,75903940,21045419,RLP
chr18,Bn76390,86047918,97546774,11498856,CN
chr18,Bn76391,37282368,74345742,37063374,CN
chr18,Bn76392,94220282,94968698,748416,TNL
chr18,Bn76393,8603497,17271539,8668042,TNL
chr18,Bn76394,55742252,95352139,39609887,NBS
chr18,Bn76395,60055311,69901253,9845942,NBS
chr18,Bn76396,96075299,98627758,2552459,TNL
chr18,Bn76397,56620990,98766624,42145634,RLP
chr18,Bn76398,72570116,95134814,22564698,TN
chr18,Bn76399,47949451,77604738,29655287,CN
chr18,Bn76400,46532925,64773985,18241060,CNL
chr18,Bn76401,53737468,81283393,27545925,NBS
chr18,Bn76402,32507267,59363613,26856346,CNL
chr18,Bn76403,47878661,97309006,49430345,TN
chr18,Bn76404,23900129,77912610,54012481,CNL
chr18,Bn76405,51349369,76575206,25225837,TNL
chr18,Bn76406,82665724,92276453,9610729,TN
chr18,Bn76407,82872403,86078207,3205804,RLK
chr18,Bn76408,92694602,96475286,3780684,NBS
chr18,Bn76409,50603517,55916194,5312677,TN
chr18,Bn76410,42308854,89077218,46768364,RLK
chr18,Bn76411,82990627,90244235,7253608,NBS
chr18,Bn76412,88998086,90279917,1281831,NBS
chr18,Bn76413,51226015,68503958,17277943,NBS
chr18,Bn76414,90258179,90493631,235452,RLP
chr18,Bn76415,73127599,88712144,15584545,TNL
chr18,Bn76416,81388178,89276123,7887945,CNL
chr18,Bn76417,18072501,45809320,27736819,RLK
chr18,Bn76418,12919697,85167325,72247628,RLP
chr18,Bn76419,50378307,67247297,16868990,TN
chr18,Bn76420,42932863,81463514,38530651,TNL
chr18,Bn76421,66031178,70137496,4106318,TNL
chr18,Bn76422,95509224,96122539,613315,CNL
chr18,Bn76423,36153199,44205861,8052662,CNL
chr18,Bn76424,94941666,98825374,3883708,CN
chr18,Bn76425,21514649,48707158,27192509,RLP
chr18,Bn76426,45192803,97096572,51903769,TN
chr18,Bn76427,70592856,85594135,15001279,RLP
chr18,Bn76428,97541710,98350900,809190,RLK
chr18,Bn76429,62562451,65407338,2844887,CN
chr18,Bn76430,66615109,93062629,26447520,TN
chr18,Bn76431,40649444,56044776,15395332,RLP
chr18,Bn76432,34625275,68342203,33716928,TN
chr18,Bn76433,50841239,62618458,11777219,NBS
chr18,Bn76434,5581024,51467451,45886427,CN
chr18,Bn76435,35953744,82165276,46211532,CNL
chr18,Bn76436,9056237,52069888,43013651,TNL
chr18,Bn76437,42933376,85252582,42319206,CN
chr18,Bn76438,82078369,93571374,11493005,NBS
chr18,Bn76439,60825987,91985658,31159671,TNL
chr18,Bn76440,39889047,84088398,44199351,NBS
chr18,Bn76441,88855450,95234812,6379362,RLK
chr18,Bn76442,29801558,69956481,40154923,TN
chr18,Bn76443,65661380,74487953,8826573,TNL
chr18,Bn76444,87720898,90323461,2602563,CNL
chr18,Bn76445,17152910,89874359,72721449,TNL
chr18,Bn76446,40485733,46358407,5872674,RLK
chr18,Bn76447,66905234,88785001,21879767,CN
chr18,Bn76448,13902078,62066181,48164103,CNL
chr18,Bn76449,57229328,92588934,35359606,TN
chr18,Bn76450,24119699,56231242,32111543,CNL
chr18,Bn76451,49154945,55163844,6008899,CNL
chr18,Bn76452,95020266,97100158,2079892,TNL
chr18,Bn76453,45684553,72563936,26879383,CNL
chr18,Bn76454,36176504,75996239,39819735,TN
chr18,Bn76455,61848242,80095152,18246910,CNL
chr18,Bn76456,71218553,73872032,2653479,CNL
chr18,Bn76457,29363361,53152831,23789470,CN
chr18,Bn76458,55577115,81119819,25542704,CNL
chr18,Bn76459,86751223,88534036,1782813,RLK
chr18,Bn76460,5310915,93716681,88405766,CNL
chr18,Bn76461,39223883,51952615,12728732,TN
chr18,Bn76462,13858809,22934060,9075251,RLP
chr18,Bn76463,75892382,82806061,6913679,CNL
chr18,Bn76464,1554848,98380527,96825679,RLK
chr18,Bn76465,33957523,34622864,665341,CN
chr18,Bn76466,84149693,84287197,137504,TNL
chr18,Bn76467,24525986,86003638,61477652,CN
chr18,Bn76468,63458121,78239047,14780926,RLK
chr18,Bn76469,69779292,87876493,18097201,RLP
chr18,Bn76470,92427458,92765423,337965,TN
chr18,Bn76471,9968873,81619791,71650918,NBS
chr18,Bn76472,68046568,99334675,31288107,CNL
chr18,Bn76473,68394851,81552916,13158065,CN
chr18,Bn76474,29146425,56401134,27254709,CNL
chr18,Bn76475,15253048,97087204,81834156,TNL
chr18,Bn76476,88562547,97353386,8790839,RLP
chr18,Bn76477,54827322,93579368,38752046,NBS
chr18,Bn76478,37496365,39696912,2200547,CNL
chr18,Bn76479,1323329,52679282,51355953,TNL
chr18,Bn76480,13629068,96451531,82822463,NBS
chr18,Bn76481,73839371,76112787,2273416,RLK
chr18,Bn76482,13797097,70819611,57022514,CN
chr18,Bn76483,15069220,28419609,13350389,TNL
chr18,Bn76484,89326280,95234648,5908368,CNL
chr18,Bn76485,26793953,52345276,25551323,CNL
chr18,Bn76486,74883846,77191821,2307975,CN
chr18,Bn76487,30271019,88339734,58068715,RLK
chr18,Bn76488,34759540,89309815,54550275,CNL
chr18,Bn76489,49951567,50399218,447651,RLP
chr18,Bn76490,24333602,53947555,29613953,TNL
chr18,Bn76491,62108462,94721762,32613300,NBS
chr18,Bn76492,91527688,96529788,5002100,RLP
chr18,Bn76493,87323457,99508250,12184793,TN
chr18,Bn76494,63485467,79701679,16216212,RLP
chr18,Bn76495,65082194,73689985,8607791,NBS
chr18,Bn76496,11437221,83217574,71780353,NBS
chr18,Bn76497,24810396,42623807,17813411,TNL
chr18,Bn76498,39208208,52726189,13517981,CN
chr18,Bn76499,34025303,62904114,28878811,TNL
chr18,Bn76500,22256602,24979928,2723326,TN
chr18,Bn76501,13301013,73073240,59772227,RLK
chr18,Bn76502,38749445,43345354,4595909,TN
chr18,Bn76503,38097992,84972520,46874528,TNL
chr18,Bn76504,17781505,74488998,56707493,CNL
chr18,Bn76505,16064255,85836343,69772088,TNL
chr18,Bn76506,53565495,82051242,28485747,TNL
chr18,Bn76507,43170766,75242176,32071410,RLK
chr18,Bn76508,73603776,79130600,5526824,RLP
chr18,Bn76509,73521221,95076864,21555643,RLP
chr18,Bn76510,7293255,41526648,34233393,RLK
chr18,Bn76511,1282088,56238452,54956364,TNL
chr18,Bn76512,4933115,23996587,19063472,RLP
chr18,Bn76513,41365582,52132725,10767143,CN
chr18,Bn76514,22054116,32940418,10886302,CNL
chr18,Bn76515,54698848,65318168,10619320,NBS
chr18,Bn76516,22285487,53978127,31692640,TNL
chr18,Bn76517,16706146,52771052,36064906,TNL
chr18,Bn76518,12023601,74548557,62524956,RLP
chr18,Bn76519,63995394,91895947,27900553,TN
chr18,Bn76520,16571624,72909310,56337686,TNL
chr18,Bn76521,7770677,90074407,82303730,NBS
chr18,Bn76522,25005049,58058030,33052981,RLP
chr18,Bn76523,77121739,89515676,12393937,CNL
chr18,Bn76524,90463640,95420459,4956819,NBS
chr18,Bn76525,94857957,97673216,2815259,CN
chr18,Bn76526,82421063,96393577,13972514,CN
chr18,Bn76527,9536051,47988969,38452918,CN
chr18,Bn76528,19638291,22586149,2947858,CNL
chr18,Bn76529,8274874,51646541,43371667,TNL
chr18,Bn76530,48823963,67459649,18635686,RLK
chr18,Bn76531,48316912,64928258,16611346,RLP
chr18,Bn76532,62826606,68921762,6095156,CNL
chr18,Bn76533,11117093,75219501,64102408,TN
chr18,Bn76534,37060136,96182470,59122334,TNL
chr18,Bn76535,91375434,97758674,6383240,TN
chr18,Bn76536,39540192,67201008,27660816,TNL
chr18,Bn76537,21889911,50380784,28490873,CNL
chr18,Bn76538,81434425,91880940,10446515,TNL
chr18,Bn76539,83586358,85069319,1482961,TN
chr18,Bn76540,92041099,98050599,6009500,NBS
chr18,Bn76541,13441744,18923776,5482032,NBS
chr18,Bn76542,67278228,82393492,15115264,TNL
chr18,Bn76543,39721146,88371366,48650220,TNL
chr18,Bn76544,94106678,99420920,5314242,CNL
chr18,Bn76545,33887428,50123909,16236481,CNL
chr18,Bn76546,76744514,96082319,19337805,CNL
chr18,Bn76547,87695506,97065615,9370109,TN
chr18,Bn76548,55980803,93333695,37352892,RLK
chr18,Bn76549,52168858,55772324,3603466,CNL
chr18,Bn76550,94059217,97410433,3351216,NBS
chr18,Bn76551,99137609,99294415,156806,TN
chr18,Bn76552,13915686,27814247,13898561,TN
chr18,Bn76553,66352875,85559271,19206396,TN
chr18,Bn76554,15304067,40807941,25503874,CNL
chr18,Bn76555,52019903,73923359,21903456,TN
chr18,Bn76556,42838235,89599119,46760884,CNL
chr18,Bn76557,1825440,60341141,58515701,NBS
chr18,Bn76558,9494051,92114814,82620763,CN
chr18,Bn76559,41544696,45079343,3534647,TNL
chr18,Bn76560,8363143,9406322,1043179,TNL
chr18,Bn76561,10656747,18217290,7560543,TNL
chr18,Bn76562,40658451,96041149,55382698,TN
chr18,Bn76563,80715034,83954763,3239729,RLP
chr18,Bn76564,87017844,91094601,4076757,TNL
chr18,Bn76565,21254558,67118609,45864051,NBS
chr18,Bn76566,77829971,91819870,13989899,TNL
chr18,Bn76567,36702466,56175760,19473294,TNL
chr18,Bn76568,70032806,74579325,4546519,NBS
chr18,Bn76569,3808937,95819730,92010793,NBS
chr18,Bn76570,42725493,64123134,21397641,RLP
chr18,Bn76571,87592230,98939166,11346936,RLK
chr18,Bn76572,81734611,99029820,17295209,TN
chr18,Bn76573,20949950,23491280,2541330,RLK
chr18,Bn76574,53374121,63143710,9769589,CNL
chr18,Bn76575,50999226,52508441,1509215,RLP
chr18,Bn76576,77207563,77397241,189678,TN
chr18,Bn76577,36313762,46516639,10202877,TN
chr18,Bn76578,41321431,86227896,44906465,CNL
chr18,Bn76579,39305481,86435608,47130127,NBS
chr18,Bn76580,77560598,91342084,13781486,RLK
chr18,Bn76581,59952310,88964361,29012051,RLK
chr18,Bn76582,93268954,96192545,2923591,TN
chr18,Bn76583,34702358,60363667,25661309,RLP
chr18,Bn76584,43662676,44586880,924204,RLK
chr18,Bn76585,86723497,92039733,5316236,RLP
chr18,Bn76586,31901461,97006693,65105232,RLK
chr18,Bn76587,26093209,93999780,67906571,CN
chr18,Bn76588,9469887,71690939,62221052,RLK
chr18,Bn76589,11336001,33405824,22069823,CNL
chr18,Bn76590,7351809,83550420,76198611,CN
chr18,Bn76591,35142623,64924234,29781611,CNL
chr18,Bn76592,71545662,79107765,7562103,TNL
chr18,Bn76593,1479613,4385329,2905716,CNL
chr18,Bn76594,23547426,80941505,57394079,TNL
chr18,Bn76595,82237838,83824214,1586376,CN
chr18,Bn76596,9496646,95088759,85592113,TN
chr18,Bn76597,16167746,17089802,922056,CN
chr18,Bn76598,21092448,49749538,28657090,TNL
chr18,Bn76599,80592447,98466314,17873867,TN
chr18,Bn76600,56037976,75372242,19334266,CN
chr18,Bn76601,43910924,70601549,26690625,RLK
chr18,Bn76602,79201076,99602290,20401214,RLK
chr18,Bn76603,82196043,89536245,7340202,TNL
chr18,Bn76604,11734027,27447175,15713148,CN
chr18,Bn76605,81166885,98677590,17510705,CNL
chr18,Bn76606,75233359,76950042,1716683,CNL
chr18,Bn76607,58234206,69258311,11024105,CNL
chr18,Bn76608,10067916,40344751,30276835,RLP
chr18,Bn76609,39282530,82781765,43499235,CN
chr18,Bn76610,53928040,83036403,29108363,CN
chr18,Bn76611,22952188,41531755,18579567,CNL
chr18,Bn76612,12148610,33966241,21817631,TN
chr18,Bn76613,83882774,88885801,5003027,RLP
chr18,Bn76614,89592531,89861151,268620,TN
chr18,Bn76615,7377171,10530669,3153498,RLP
chr18,Bn76616,90658825,94375920,3717095,NBS
chr18,Bn76617,29484661,63474300,33989639,CNL
chr18,Bn76618,80938133,82215795,1277662,TNL
chr18,Bn76619,28758951,76875356,48116405,TNL
chr18,Bn76620,32957198,37100150,4142952,RLK
chr18,Bn76621,38133710,50654765,12521055,NBS
chr18,Bn76622,34177036,95697921,61520885,CNL
chr18,Bn76623,89447414,93424642,3977228,CN
chr18,Bn76624,30904170,90370458,59466288,RLK
chr18,Bn76625,37948882,54797469,16848587,NBS
chr18,Bn76626,43579035,61082828,17503793,TN
chr18,Bn76627,54767107,76033460,21266353,NBS
chr18,Bn76628,36776393,39173241,2396848,NBS
chr18,Bn76629,85258182,93412163,8153981,CN
chr18,Bn76630,88287798,99327201,11039403,NBS
chr18,Bn76631,81956976,82491457,534481,NBS
chr18,Bn76632,90947142,99135063,8187921,RLK
chr18,Bn76633,74392480,75474742,1082262,CN
chr18,Bn76634,82257891,89120413,6862522,TN
chr18,Bn76635,84758052,91843931,7085879,RLP
chr18,Bn76636,93437795,95202533,1764738,NBS
chr18,Bn76637,29923150,32420064,2496914,TNL
chr18,Bn76638,94018244,94430231,411987,TN
chr18,Bn76639,21119179,23720013,2600834,CNL
chr18,Bn76640,22571282,31086647,8515365,TNL
chr18,Bn76641,12123845,35973103,23849258,CN
chr18,Bn76642,36392308,88318794,51926486,NBS
chr18,Bn76643,92729408,97548158,4818750,TNL
chr18,Bn76644,25258064,46536872,21278808,RLP
chr18,Bn76645,66235019,67050009,814990,TNL
chr18,Bn76646,89602603,93908869,4306266,RLK
chr18,Bn76647,2704702,79485357,76780655,TN
chr18,Bn76648,36909779,82818277,45908498,NBS
chr18,Bn76649,62525693,96096972,33571279,CNL
chr18,Bn76650,87289615,91430032,4140417,TNL
chr18,Bn76651,5963153,36324731,30361578,RLK
chr18,Bn76652,54806873,73267532,18460659,NBS
chr18,Bn76653,67268812,82451251,15182439,TN
chr18,Bn76654,46836643,80328143,33491500,TNL
chr18,Bn76655,73601961,97106749,23504788,CNL
chr18,Bn76656,15925377,41674480,25749103,TN
chr18,Bn76657,69010745,99567882,30557137,RLP
chr18,Bn76658,88271267,95330510,7059243,CNL
chr18,Bn76659,94520442,98941761,4421319,CNL
chr18,Bn76660,53707303,90930734,37223431,CNL
chr18,Bn76661,56858460,84543985,27685525,NBS
chr18,Bn76662,32673353,62696910,30023557,RLK
chr18,Bn76663,66198125,83062589,16864464,RLP
chr18,Bn76664,91749964,93894917,2144953,TN
chr18,Bn76665,49841833,80898213,31056380,RLK
chr18,Bn76666,82055554,98944422,16888868,CNL
chr18,Bn76667,68449467,69968629,1519162,CN
chr18,Bn76668,10947665,68637215,57689550,RLK
chr18,Bn76669,3304943,40229636,36924693,TNL
chr18,Bn76670,63113920,99072975,35959055,CN
chr18,Bn76671,14924113,41041651,26117538,RLK
chr18,Bn76672,40033808,96492305,56458497,CN
chr18,Bn76673,38398398,65731901,27333503,TN
chr18,Bn76674,59994971,78866691,18871720,NBS
chr18,Bn76675,84344493,90023763,5679270,NBS
chr18,Bn76676,50694050,65783903,15089853,RLP
chr18,Bn76677,42801695,72484526,29682831,NBS
chr18,Bn76678,1154876,54064614,52909738,TNL
chr18,Bn76679,6797732,24939157,18141425,NBS
chr18,Bn76680,79985885,99167330,19181445,CNL
chr18,Bn76681,78436255,94064481,15628226,NBS
chr18,Bn76682,6032876,11606555,5573679,RLK
chr18,Bn76683,5656801,66762821,61106020,TNL
chr18,Bn76684,56184661,65622939,9438278,CN
chr18,Bn76685,72990794,74943972,1953178,NBS
chr18,Bn76686,1090195,54723331,53633136,NBS
chr18,Bn76687,72009301,90284912,18275611,TNL
chr18,Bn76688,26188419,48886781,22698362,RLK
chr18,Bn76689,38182075,59819671,21637596,CN
chr18,Bn76690,6286601,66996245,60709644,RLP
chr18,Bn76691,8694322,47037317,38342995,CNL
chr18,Bn76692,3210509,47742120,44531611,CNL
chr18,Bn76693,20370792,31456733,11085941,CNL
chr18,Bn76694,44618102,94749470,50131368,RLP
chr18,Bn76695,67524020,84951178,17427158,CN
chr18,Bn76696,90527179,98989875,8462696,RLK
chr18,Bn76697,24392411,41610826,17218415,RLP
chr18,Bn76698,11744540,54238267,42493727,RLK
chr18,Bn76699,60903641,66483578,5579937,TNL
chr18,Bn76700,86921020,98112191,11191171,CN
chr18,Bn76701,41490894,60729335,19238441,RLK
chr18,Bn76702,70058702,85711794,15653092,TNL
chr18,Bn76703,98568703,98571523,2820,CNL
chr18,Bn76704,36779613,66338723,29559110,RLK
chr18,Bn76705,39719025,58448215,18729190,RLK
chr18,Bn76706,31839039,78991276,47152237,CNL
chr18,Bn76707,2444503,96150688,93706185,RLK
chr18,Bn76708,62302622,90202986,27900364,RLK
chr18,Bn76709,51145824,83959009,32813185,RLP
chr18,Bn76710,16797249,56406882,39609633,CN
chr18,Bn76711,67008863,81222240,14213377,CNL
chr18,Bn76712,50962924,62847848,11884924,CNL
chr18,Bn76713,63190278,72858519,9668241,CNL
chr18,Bn76714,76232995,94016401,17783406,RLP
chr18,Bn76715,49538983,86413439,36874456,NBS
chr18,Bn76716,95449467,97358799,1909332,RLP
chr18,Bn76717,21245795,58801013,37555218,RLP
chr18,Bn76718,81861434,93990540,12129106,TN
chr18,Bn76719,9973042,80961908,70988866,RLK
chr18,Bn76720,59657422,76094463,16437041,TN
chr18,Bn76721,72511972,99019204,26507232,NBS
chr18,Bn76722,55405270,67931017,12525747,RLK
chr18,Bn76723,81775103,86101537,4326434,CN
chr18,Bn76724,55699320,83788622,28089302,RLK
chr18,Bn76725,64471420,72289094,7817674,CNL
chr18,Bn76726,61692022,81149115,19457093,TNL
chr18,Bn76727,4399570,85616656,81217086,TNL
chr18,Bn76728,28655472,77850150,49194678,CNL
chr18,Bn76729,11515123,42008940,30493817,TNL
chr18,Bn76730,87858456,96890847,9032391,CNL
chr18,Bn76731,66741491,90040062,23298571,TN
chr18,Bn76732,88880437,99622048,10741611,TN
chr18,Bn76733,96737264,99568034,2830770,CN
chr18,Bn76734,13574267,21841589,8267322,CNL
chr18,Bn76735,42363864,92536286,50172422,CNL
chr18,Bn76736,57695450,62986269,5290819,RLK
chr18,Bn76737,28419744,97132824,68713080,TN
chr18,Bn76738,22834037,53046562,30212525,NBS
chr18,Bn76739,39532859,53748211,14215352,TN
chr18,Bn76740,81712593,98247221,16534628,RLP
chr18,Bn76741,11590466,70499841,58909375,CN
chr18,Bn76742,63491357,69046222,5554865,CN
chr18,Bn76743,75781975,89634711,13852736,RLK
chr18,Bn76744,60339769,63304665,2964896,NBS
chr18,Bn76745,1577393,41117102,39539709,CN
chr18,Bn76746,32769332,53800831,21031499,CN
chr18,Bn76747,6836276,47267395,40431119,TN
chr18,Bn76748,3119288,21234142,18114854,CNL
chr18,Bn76749,89306119,89942261,636142,TNL
chr18,Bn76750,56927264,78460137,21532873,TNL
chr18,Bn76751,14195927,92822238,78626311,TN
chr18,Bn76752,64138579,86970166,22831587,CNL
chr18,Bn76753,57759385,73580957,15821572,NBS
chr18,Bn76754,52694653,65077209,12382556,CNL
chr18,Bn76755,79900855,95570319,15669464,RLK
chr18,Bn76756,17120732,52814103,35693371,NBS
chr18,Bn76757,59070992,78543639,19472647,CNL
chr18,Bn76758,40968335,86247919,45279584,RLK
chr18,Bn76759,78463615,92704766,14241151,NBS
chr18,Bn76760,77054878,80149883,3095005,NBS
chr18,Bn76761,31443450,69083333,37639883,NBS
chr18,Bn76762,16946002,27866641,10920639,NBS
chr18,Bn76763,47318785,63592411,16273626,TN
chr18,Bn76764,30166537,39071156,8904619,RLK
chr18,Bn76765,26413934,37629378,11215444,CN
chr18,Bn76766,68911745,95830121,26918376,TNL
chr18,Bn76767,34728648,45121174,10392526,TN
chr18,Bn76768,15070945,93808406,78737461,RLK
chr18,Bn76769,79103064,89387533,10284469,RLP
chr18,Bn76770,47064393,75959312,28894919,CN
chr18,Bn76771,93046169,94191451,1145282,RLP
chr18,Bn76772,86831005,87380297,549292,CN
chr18,Bn76773,38147058,78081335,39934277,CN
chr18,Bn76774,23166007,81206561,58040554,NBS
chr18,Bn76775,45198444,68456734,23258290,NBS
chr18,Bn76776,9467322,58656733,49189411,CN
chr18,Bn76777,52736357,59732532,6996175,CNL
chr18,Bn76778,46887109,75063499,28176390,TNL
chr18,Bn76779,97487841,98194634,706793,TN
chr18,Bn76780,14157270,14226940,69670,CN
chr18,Bn76781,65998150,69899137,3900987,CNL
chr18,Bn76782,68231383,78854788,10623405,CN
chr18,Bn76783,68278365,78784074,10505709,RLK
chr18,Bn76784,67822395,74858706,7036311,TNL
chr18,Bn76785,31823979,91447599,59623620,CNL
chr18,Bn76786,37630206,60046585,22416379,NBS
chr18,Bn76787,15117435,58145067,43027632,TN
chr18,Bn76788,86300141,94485995,8185854,CNL
chr18,Bn76789,56883719,95536579,38652860,TNL
chr18,Bn76790,30998660,61694524,30695864,CN
chr18,Bn76791,48004545,97631024,49626479,CNL
chr18,Bn76792,38948431,47772503,8824072,NBS
chr18,Bn76793,56713821,89038193,32324372,CN
chr18,Bn76794,51483157,98060217,46577060,CN
chr18,Bn76795,16169830,75635401,59465571,TNL
chr18,Bn76796,32633376,47021149,14387773,TNL
chr18,Bn76797,36654026,59731055,23077029,RLP
chr18,Bn76798,69098175,93957341,24859166,TN
chr18,Bn76799,52469409,58733743,6264334,TNL
chr18,Bn76800,69754047,73058716,3304669,RLP
chr18,Bn76801,82070297,90792607,8722310,RLP
chr18,Bn76802,21327542,65534185,44206643,TNL
chr18,Bn76803,28439405,77699095,49259690,CN
chr18,Bn76804,16609759,18014636,1404877,CN
chr18,Bn76805,8348723,50640453,42291730,CNL
chr18,Bn76806,52357163,73846431,21489268,RLK
chr18,Bn76807,90316963,92131526,1814563,CNL
chr18,Bn76808,58406664,85652686,27246022,NBS
chr18,Bn76809,94477746,99282420,4804674,RLK
chr18,Bn76810,45174011,99505266,54331255,CNL
chr18,Bn76811,1294991,2997238,1702247,TNL
chr18,Bn76812,9891794,92928516,83036722,RLK
chr18,Bn76813,43474176,47637828,4163652,RLK
chr18,Bn76814,70977753,72273898,1296145,RLP
chr18,Bn76815,54271008,94689779,40418771,NBS
chr18,Bn76816,77156459,82613802,5457343,NBS
chr18,Bn76817,69963509,89785500,19821991,NBS
chr18,Bn76818,76379853,83877020,7497167,CNL
chr18,Bn76819,51298711,72836405,21537694,TN
chr18,Bn76820,56998093,79300597,22302504,CN
chr18,Bn76821,88459579,98368437,9908858,NBS
chr18,Bn76822,14642860,53722424,39079564,TN
chr18,Bn76823,56911805,62508796,5596991,NBS
chr18,Bn76824,89979525,90097843,118318,CN
chr18,Bn76825,66161751,91534068,25372317,RLP
chr18,Bn76826,39944616,51889744,11945128,TNL
chr18,Bn76827,51613379,97086363,45472984,CN
chr18,Bn76828,94147292,98415283,4267991,CNL
chr18,Bn76829,19218549,72976417,53757868,RLK
chr18,Bn76830,49523975,72060924,22536949,NBS
chr18,Bn76831,83241685,95287681,12045996,RLK
chr18,Bn76832,39600878,41792918,2192040,NBS
chr18,Bn76833,2572886,42865863,40292977,CN
chr18,Bn76834,34844209,56204678,21360469,TN
chr18,Bn76835,49859351,77676907,27817556,TN
chr18,Bn76836,61923833,76199884,14276051,TNL
chr18,Bn76837,67386780,93886283,26499503,RLP
chr18,Bn76838,21127061,34557697,13430636,TNL
chr18,Bn76839,91976261,97369959,5393698,CNL
chr18,Bn76840,50529181,77408760,26879579,CNL
chr18,Bn76841,97359098,98101071,741973,NBS
chr18,Bn76842,88868071,95533343,6665272,CN
chr18,Bn76843,1190525,4455710,3265185,NBS
chr18,Bn76844,15511480,65029452,49517972,RLK
chr18,Bn76845,43349867,86151149,42801282,TNL
chr18,Bn76846,5535070,54953311,49418241,CNL
chr18,Bn76847,15425029,66316535,50891506,CNL
chr18,Bn76848,77337410,87574754,10237344,TN
chr18,Bn76849,78375369,87519242,9143873,RLK
chr18,Bn76850,44754981,81080294,36325313,NBS
chr18,Bn76851,81179290,97080564,15901274,TNL
chr18,Bn76852,33117652,94926251,61808599,RLK
chr18,Bn76853,15743295,88482465,72739170,RLK
chr18,Bn76854,96465315,98099085,1633770,RLP
chr18,Bn76855,72902964,83565153,10662189,CN
chr18,Bn76856,72467873,87020891,14553018,CN
chr18,Bn76857,58013581,80557412,22543831,RLK
chr18,Bn76858,85411052,85792075,381023,TNL
chr18,Bn76859,82842665,97104327,14261662,CN
chr18,Bn76860,19872359,79195369,59323010,TN
chr18,Bn76861,88780856,96273181,7492325,CNL
chr18,Bn76862,80796754,82859847,2063093,CN
chr18,Bn76863,93851523,98833033,4981510,TNL
chr18,Bn76864,69674433,95904737,26230304,CNL
chr18,Bn76865,20346162,30346104,9999942,NBS
chr18,Bn76866,93284721,94769438,1484717,TN
chr18,Bn76867,9736481,13153207,3416726,RLK
chr18,Bn76868,87794133,91861533,4067400,RLP
chr18,Bn76869,66774176,68599544,1825368,TNL
chr18,Bn76870,71709543,97699543,25990000,CN
chr18,Bn76871,55357916,91143793,35785877,TN
chr18,Bn76872,40682061,48076598,7394537,TN
chr18,Bn76873,48939593,93151999,44212406,TNL
chr18,Bn76874,86654494,99827501,13173007,RLK
chr18,Bn76875,58601974,61262143,2660169,RLP
chr18,Bn76876,22940756,40893485,17952729,RLP
chr18,Bn76877,9782651,25378336,15595685,CNL
chr18,Bn76878,25174252,28234900,3060648,TNL
chr18,Bn76879,5816614,23201992,17385378,CN
chr18,Bn76880,56781028,82592529,25811501,RLP
chr18,Bn76881,7382959,51259320,43876361,RLP
chr18,Bn76882,33202056,67345456,34143400,NBS
chr18,Bn76883,37404243,64065901,26661658,TNL
chr18,Bn76884,26877003,36952188,10075185,RLP
chr18,Bn76885,40695125,82887429,42192304,TN
chr18,Bn76886,4371811,69031789,64659978,TN
chr18,Bn76887,64247241,82638226,18390985,NBS
chr18,Bn76888,69400875,82555297,13154422,RLK
chr18,Bn76889,15684310,84529242,68844932,CNL
chr18,Bn76890,28053315,84746175,56692860,CNL
chr18,Bn76891,16538066,28692159,12154093,RLP
chr18,Bn76892,10248340,32162540,21914200,CN
chr18,Bn76893,43710606,74863181,31152575,NBS
chr18,Bn76894,2396324,25917350,23521026,TNL
chr18,Bn76895,1222957,41824701,40601744,NBS
chr18,Bn76896,64765283,94042899,29277616,RLK
chr18,Bn76897,71773548,94160001,22386453,NBS
chr18,Bn76898,7112566,73890656,66778090,TNL
chr18,Bn76899,29467501,30550586,1083085,CNL
chr18,Bn76900,79255496,80851583,1596087,NBS
chr18,Bn76901,84509186,94676333,10167147,RLP
chr18,Bn76902,15411858,24142303,8730445,RLP
chr18,Bn76903,87491457,94281047,6789590,CN
chr18,Bn76904,87767905,97264044,9496139,TN
chr18,Bn76905,89778973,91671548,1892575,TN
chr18,Bn76906,86994280,93029276,6034996,RLK
chr18,Bn76907,48462806,58750949,10288143,RLK
chr18,Bn76908,82220054,98386748,16166694,TN
chr18,Bn76909,70958706,94014092,23055386,TNL
chr18,Bn76910,68598916,78740586,10141670,CN
chr18,Bn76911,11519622,21079871,9560249,RLP
chr18,Bn76912,39555878,59162408,19606530,NBS
chr18,Bn76913,55681983,73285324,17603341,TNL
chr18,Bn76914,10171957,88644899,78472942,CN
chr18,Bn76915,59108931,79428653,20319722,RLK
chr18,Bn76916,34266572,38368664,4102092,CNL
chr18,Bn76917,53563168,76866905,23303737,RLP
chr18,Bn76918,94654983,96676418,2021435,TNL
chr18,Bn76919,2276466,90584024,88307558,RLP
chr18,Bn76920,37745244,65809124,28063880,RLK
chr18,Bn76921,40683585,90272900,49589315,CN
chr18,Bn76922,58305274,75858436,17553162,TNL
chr18,Bn76923,19087530,37527295,18439765,CN
chr18,Bn76924,90539626,92811807,2272181,TNL
chr18,Bn76925,97184879,99821576,2636697,TN
chr18,Bn76926,70507984,83255424,12747440,CNL
chr18,Bn76927,36095910,59911485,23815575,TNL
chr18,Bn76928,64294880,74561769,10266889,CN
chr18,Bn76929,98077839,99649585,1571746,CNL
chr18,Bn76930,61349138,91518656,30169518,CN
chr18,Bn76931,55688043,78444334,22756291,RLP
chr18,Bn76932,17383039,29952624,12569585,CNL
chr18,Bn76933,95337338,99335003,3997665,RLP
chr18,Bn76934,59378786,90774625,31395839,NBS
chr18,Bn76935,48459840,85221906,36762066,NBS
chr18,Bn76936,51262490,83508562,32246072,CN
chr18,Bn76937,1617714,5454142,3836428,RLK
chr18,Bn76938,69644128,89612914,19968786,NBS
chr18,Bn76939,67562575,73287104,5724529,TN
chr18,Bn76940,65752232,74950478,9198246,RLP
chr18,Bn76941,85019600,87695699,2676099,TN
chr18,Bn76942,21486794,62331054,40844260,RLK
chr18,Bn76943,9143234,28641479,19498245,RLK
chr18,Bn76944,30983286,53659283,22675997,TNL
chr18,Bn76945,29449964,99004145,69554181,NBS
chr18,Bn76946,76330742,89715812,13385070,CN
chr18,Bn76947,6274377,7012229,737852,RLP
chr18,Bn76948,52547955,55256337,2708382,CNL
chr18,Bn76949,66523320,93389891,26866571,TNL
chr18,Bn76950,49148876,80486560,31337684,CNL
chr18,Bn76951,88109611,98684536,10574925,TN
chr18,Bn76952,62257773,73737596,11479823,NBS
chr18,Bn76953,85214486,96803065,11588579,RLP
chr18,Bn76954,25316727,47396801,22080074,TNL
chr18,Bn76955,39397405,44593740,5196335,NBS
chr18,Bn76956,27970588,76123553,48152965,TN
chr18,Bn76957,8372092,43546338,35174246,RLP
chr18,Bn76958,30511156,56884233,26373077,TN
chr18,Bn76959,46925540,88408795,41483255,TN
chr18,Bn76960,67917150,73993695,6076545,CN
chr18,Bn76961,99315689,99561893,246204,CNL
chr18,Bn76962,40856100,66485574,25629474,RLP
chr18,Bn76963,70846890,71445248,598358,TN
chr18,Bn76964,78224187,94844355,16620168,RLP
chr18,Bn76965,17019565,92116567,75097002,TNL
chr18,Bn76966,89325907,94773840,5447933,RLP
chr18,Bn76967,80986693,87085045,6098352,CN
chr18,Bn76968,63045237,63635680,590443,NBS
chr18,Bn76969,4958322,75506144,70547822,CNL
chr18,Bn76970,2181973,98695990,96514017,CNL
chr18,Bn76971,12379636,77761273,65381637,TN
chr18,Bn76972,13966167,79389215,65423048,TNL
chr18,Bn76973,90097753,94009049,3911296,TNL
chr18,Bn76974,47744414,48503808,759394,CNL
chr18,Bn76975,9315227,91982136,82666909,TNL
chr18,Bn76976,97476211,99909932,2433721,CN
chr18,Bn76977,40714772,65654708,24939936,RLP
chr18,Bn76978,47929117,88486198,40557081,NBS
chr18,Bn76979,89722570,90535678,813108,TN
chr18,Bn76980,53634205,58702354,5068149,RLK
chr18,Bn76981,59881718,73135654,13253936,NBS
chr18,Bn76982,38064809,46451148,8386339,CN
chr18,Bn76983,20221036,80592760,60371724,NBS
chr18,Bn76984,41105497,50912399,9806902,RLK
chr18,Bn76985,78799918,79507783,707865,TNL
chr18,Bn76986,58471494,60198616,1727122,RLK
chr18,Bn76987,30504157,32683914,2179757,NBS
chr18,Bn76988,29806821,89749952,59943131,CNL
chr18,Bn76989,64308277,87857608,23549331,CN
chr18,Bn76990,76264408,96942365,20677957,TN
chr18,Bn76991,22299757,35688391,13388634,CNL
chr18,Bn76992,22967542,43260659,20293117,RLP
chr18,Bn76993,59448164,60461201,1013037,CN
chr18,Bn76994,89998190,90150352,152162,NBS
chr18,Bn76995,17415038,37934213,20519175,RLP
chr18,Bn76996,27045650,46249007,19203357,CN
chr18,Bn76997,70160411,86073781,15913370,RLK
chr18,Bn76998,84519685,92482411,7962726,RLK
chr18,Bn76999,71091847,87810854,16719007,TN
chr18,Bn77000,34145755,88705320,54559565,RLK
chr18,Bn77001,20977652,57585402,36607750,CN
chr18,Bn77002,33145288,49836600,16691312,CN
chr18,Bn77003,30466781,46016576,15549795,TNL
chr18,Bn77004,83566120,97968583,14402463,RLP
chr18,Bn77005,25176992,66388388,41211396,RLK
chr18,Bn77006,23898845,83157703,59258858,TN
chr18,Bn77007,84346426,95513464,11167038,CNL
chr18,Bn77008,28183650,65767999,37584349,CNL
chr18,Bn77009,81027991,92692330,11664339,CNL
chr18,Bn77010,35860980,78606839,42745859,TN
chr18,Bn77011,86781111,97457446,10676335,TNL
chr18,Bn77012,98099900,98971651,871751,RLP
chr18,Bn77013,40783108,87845364,47062256,CN
chr18,Bn77014,34625769,84542767,49916998,TN
chr18,Bn77015,43213208,47023815,3810607,RLK
chr18,Bn77016,28817628,85749912,56932284,CNL
chr18,Bn77017,25018857,83669428,58650571,TNL
chr18,Bn77018,6996915,57854009,50857094,RLK
chr18,Bn77019,80193974,91595017,11401043,RLP
chr18,Bn77020,25072618,51555891,26483273,TN
chr18,Bn77021,29340574,84052753,54712179,RLK
chr18,Bn77022,33845024,49674880,15829856,NBS
chr18,Bn77023,39063667,49567711,10504044,TNL
chr18,Bn77024,72023902,86604699,14580797,CNL
chr18,Bn77025,38492778,97158655,58665877,RLK
chr18,Bn77026,92587426,99408980,6821554,CNL
chr18,Bn77027,33811605,70370948,36559343,TN
chr18,Bn77028,97393811,99187384,1793573,RLP
chr18,Bn77029,84308143,92346154,8038011,NBS
chr18,Bn77030,3470199,74014414,70544215,TNL
chr18,Bn77031,37839828,53650646,15810818,CNL
chr18,Bn77032,8261253,42256304,33995051,CN
chr18,Bn77033,19476173,97985993,78509820,CN
chr18,Bn77034,5561573,89255548,83693975,CN
chr18,Bn77035,39830224,73507723,33677499,CNL
chr18,Bn77036,43671344,84340388,40669044,CN
chr18,Bn77037,85410718,88188784,2778066,RLP
chr18,Bn77038,91035015,98084967,7049952,CN
chr18,Bn77039,74503152,92082096,17578944,RLK
chr18,Bn77040,49586727,99204737,49618010,RLP
chr18,Bn77041,83875474,91418032,7542558,CNL
chr18,Bn77042,10476681,52129258,41652577,CNL
chr18,Bn77043,46081303,95672364,49591061,TN
chr18,Bn77044,66007309,83662290,17654981,NBS
chr18,Bn77045,53205108,70805283,17600175,RLP
chr18,Bn77046,32165383,76442249,44276866,TN
chr18,Bn77047,20456285,54736544,34280259,TN
chr18,Bn77048,65676463,84664764,18988301,TN
chr18,Bn77049,91464059,94102287,2638228,CNL
chr18,Bn77050,95265947,95447540,181593,NBS
chr18,Bn77051,51731638,85947716,34216078,TN
chr18,Bn77052,32990449,96646770,63656321,TNL
chr18,Bn77053,2808585,39484981,36676396,TN
chr18,Bn77054,49599182,51089687,1490505,TNL
chr18,Bn77055,85382061,96602837,11220776,TNL
chr18,Bn77056,78868122,96780177,17912055,TN
chr18,Bn77057,60341489,75450658,15109169,TN
chr18,Bn77058,29121844,53903860,24782016,TNL
chr18,Bn77059,97798940,98707687,908747,RLP
chr18,Bn77060,62747430,66598786,3851356,RLK
chr18,Bn77061,86516427,94796669,8280242,CNL
chr18,Bn77062,86228251,90017733,3789482,TN
chr18,Bn77063,48906962,88002920,39095958,CN
chr18,Bn77064,53724211,83075809,29351598,NBS
chr18,Bn77065,11340590,47109285,35768695,RLP
chr18,Bn77066,68097685,81661986,13564301,CNL
chr18,Bn77067,93563671,99490592,5926921,CN
chr18,Bn77068,3209680,78658542,75448862,TNL
chr18,Bn77069,85861989,89229454,3367465,CNL
chr18,Bn77070,24019429,58770833,34751404,NBS
chr18,Bn77071,18901962,29732100,10830138,TNL
chr18,Bn77072,20513803,39032632,18518829,CNL
chr18,Bn77073,53633859,61719152,8085293,TNL
chr18,Bn77074,91453473,99112092,7658619,NBS
chr18,Bn77075,98620487,99060944,440457,CN
chr18,Bn77076,96981542,97734739,753197,TNL
chr18,Bn77077,2108076,30261045,28152969,RLP
chr18,Bn77078,48712914,51814331,3101417,CNL
chr18,Bn77079,15931405,46995468,31064063,CNL
chr18,Bn77080,76592137,81457026,4864889,TN
chr18,Bn77081,76615916,79254699,2638783,CNL
chr18,Bn77082,53671119,69353471,15682352,RLK
chr18,Bn77083,3006332,96099632,93093300,TN
chr18,Bn77084,29543200,58675462,29132262,RLP
chr18,Bn77085,23399624,49426481,26026857,CN
chr18,Bn77086,31585082,36639868,5054786,CNL
chr18,Bn77087,39913548,88561259,48647711,CNL
chr18,Bn77088,10759309,67790531,57031222,RLP
chr18,Bn77089,10251317,27480881,17229564,CN
chr18,Bn77090,38111269,39459137,1347868,RLK
chr18,Bn77091,13537048,86119984,72582936,CN
chr18,Bn77092,80087418,99445927,19358509,TN
chr18,Bn77093,11072777,16729958,5657181,CNL
chr18,Bn77094,60312058,75255286,14943228,NBS
chr18,Bn77095,3001901,3294875,292974,TNL
chr18,Bn77096,55041210,82433007,27391797,NBS
chr18,Bn77097,53042798,57732785,4689987,CNL
chr18,Bn77098,66419908,72807639,6387731,CN
chr18,Bn77099,68412507,78941219,10528712,CN
chr18,Bn77100,30972494,83135614,52163120,TNL
chr18,Bn77101,94580622,95162911,582289,NBS
chr18,Bn77102,7288517,95155357,87866840,RLP
chr18,Bn77103,60865824,86419498,25553674,CNL
chr18,Bn77104,84919709,93092324,8172615,CNL
chr18,Bn77105,72008388,98451078,26442690,TNL
chr18,Bn77106,18649662,89916515,71266853,CN
chr18,Bn77107,88626986,90876053,2249067,NBS
chr18,Bn77108,36451413,47473289,11021876,TN
chr18,Bn77109,17885296,88520468,70635172,CNL
chr18,Bn77110,44726734,71065057,26338323,RLK
chr18,Bn77111,92422402,94613353,2190951,RLK
chr18,Bn77112,35886756,76992838,41106082,TN
chr18,Bn77113,2551243,71167921,68616678,CNL
chr18,Bn77114,75375323,82541440,7166117,CN
chr18,Bn77115,42707664,83535893,40828229,CNL
chr18,Bn77116,97643530,97883635,240105,RLK
chr18,Bn77117,23323835,33445157,10121322,RLP
chr18,Bn77118,30968751,82763312,51794561,CN
chr18,Bn77119,84230320,96087245,11856925,TNL
chr18,Bn77120,14098188,80922597,66824409,CN
chr18,Bn77121,39185416,44451267,5265851,RLK
chr18,Bn77122,33524231,99832158,66307927,TNL
chr18,Bn77123,6153511,61690954,55537443,RLK
chr18,Bn77124,30560915,40639075,10078160,NBS
chr18,Bn77125,80114706,81362451,1247745,RLP
chr18,Bn77126,17990431,81240347,63249916,TNL
chr18,Bn77127,4739470,53730193,48990723,CN
chr18,Bn77128,17454580,80028626,62574046,TNL
chr18,Bn77129,15662842,16377336,714494,TNL
chr18,Bn77130,18639739,37926421,19286682,CNL
chr18,Bn77131,19160926,83919778,64758852,NBS
chr18,Bn77132,33572838,85672083,52099245,CN
chr18,Bn77133,97032584,98576131,1543547,TNL
chr18,Bn77134,43804422,76422015,32617593,TNL
chr18,Bn77135,63341804,64474869,1133065,TNL
chr18,Bn77136,85032941,88248823,3215882,NBS
chr18,Bn77137,2958808,70222348,67263540,CN
chr18,Bn77138,89149827,95046818,5896991,RLP
chr18,Bn77139,68366242,72411762,4045520,RLP
chr18,Bn77140,80831591,87967497,7135906,CNL
chr18,Bn77141,35563445,80576284,45012839,TNL
chr18,Bn77142,23353440,55377043,32023603,CNL
chr18,Bn77143,73636167,89104490,15468323,TN
chr18,Bn77144,62539642,83280628,20740986,CNL
chr18,Bn77145,95749268,97600081,1850813,RLK
chr18,Bn77146,5389448,41418714,36029266,TNL
chr18,Bn77147,14589880,62012696,47422816,TNL
chr18,Bn77148,77828213,97860078,20031865,TN
chr18,Bn77149,71469778,98529050,27059272,CNL
chr18,Bn77150,65579402,91509759,25930357,CNL
chr18,Bn77151,56012038,77831779,21819741,CN
chr18,Bn77152,96066219,96773000,706781,CNL
chr18,Bn77153,78318834,88887982,10569148,RLP
chr18,Bn77154,88739764,97316530,8576766,RLK
chr18,Bn77155,73362518,76038464,2675946,RLP
chr18,Bn77156,97823198,98344253,521055,TNL
chr18,Bn77157,16770051,19585616,2815565,NBS
chr18,Bn77158,49799224,65354207,15554983,CNL
chr18,Bn77159,8259417,17114196,8854779,CN
chr18,Bn77160,3845543,11148578,7303035,CN
chr18,Bn77161,24417368,84114365,59696997,CNL
chr18,Bn77162,21224238,86504519,65280281,CNL
chr18,Bn77163,96879752,99525272,2645520,RLP
chr18,Bn77164,81571423,83339261,1767838,RLK
chr18,Bn77165,34577789,54958150,20380361,TNL
chr18,Bn77166,5721125,96898908,91177783,NBS
chr18,Bn77167,14583486,36688795,22105309,CNL
chr18,Bn77168,68401798,69936196,1534398,CNL
chr18,Bn77169,29636079,67824552,38188473,CN
chr18,Bn77170,22296659,77586325,55289666,RLP
chr18,Bn77171,83487718,92600137,9112419,RLK
chr18,Bn77172,25555168,76049768,50494600,RLP
chr18,Bn77173,28560852,38307906,9747054,CNL
chr18,Bn77174,74364977,84793636,10428659,RLP
chr18,Bn77175,96713571,99319850,2606279,NBS
chr18,Bn77176,20026379,74267008,54240629,TN
chr18,Bn77177,73578018,89565965,15987947,RLP
chr18,Bn77178,47300189,81929789,34629600,TN
chr18,Bn77179,67785384,71126674,3341290,NBS
chr18,Bn77180,1666643,21383064,19716421,CNL
chr18,Bn77181,43113823,58603475,15489652,RLK
chr18,Bn77182,88426638,93718853,5292215,RLP
chr18,Bn77183,55295929,64874740,9578811,RLK
chr18,Bn77184,79132331,99584328,20451997,TNL
chr18,Bn77185,65066307,88225226,23158919,NBS
chr18,Bn77186,45979082,83734486,37755404,TN
chr18,Bn77187,85868931,94718450,8849519,TNL
chr18,Bn77188,18552884,58372892,39820008,RLK
chr18,Bn77189,41196550,57894045,16697495,RLK
chr18,Bn77190,63869663,75985117,12115454,TNL
chr18,Bn77191,11369592,70530050,59160458,RLK
chr18,Bn77192,62549850,93073976,30524126,NBS
chr18,Bn77193,30235150,51103924,20868774,RLK
chr18,Bn77194,15896917,79472793,63575876,NBS
chr18,Bn77195,10521875,49466261,38944386,NBS
chr18,Bn77196,67561562,78103156,10541594,TNL
chr18,Bn77197,75963583,89374338,13410755,CNL
chr18,Bn77198,68034813,82989900,14955087,RLP
chr18,Bn77199,8147606,74175676,66028070,CNL
chr18,Bn77200,79171627,94495045,15323418,CN
chr18,Bn77201,24629526,25846499,1216973,TNL
chr18,Bn77202,96907528,98317493,1409965,TN
chr18,Bn77203,27590817,78236539,50645722,CNL
chr18,Bn77204,68983601,94250668,25267067,TN
chr18,Bn77205,62192462,88203093,26010631,TN
chr18,Bn77206,35659562,81020955,45361393,TN
chr18,Bn77207,16690542,92372636,75682094,TN
chr18,Bn77208,61639833,69232169,7592336,RLK
chr18,Bn77209,41059988,56365344,15305356,TN
chr18,Bn77210,93905452,98608405,4702953,RLP
chr18,Bn77211,79696690,89764142,10067452,CN
chr18,Bn77212,30773042,58005203,27232161,RLK
chr18,Bn77213,25430087,29742959,4312872,RLK
chr18,Bn77214,76192773,82120268,5927495,RLK
chr18,Bn77215,36529098,42792361,6263263,TNL
chr18,Bn77216,64154960,80930465,16775505,NBS
chr18,Bn77217,43407859,66016435,22608576,TNL
chr18,Bn77218,9086384,20092691,11006307,RLP
chr18,Bn77219,43970450,87342761,43372311,TN
chr18,Bn77220,58092498,61129799,3037301,CNL
chr18,Bn77221,90497639,93899115,3401476,TN
chr18,Bn77222,31195669,51010008,19814339,TNL
chr18,Bn77223,16772943,34875868,18102925,NBS
chr18,Bn77224,68708940,92606021,23897081,TN
chr18,Bn77225,22384565,73271458,50886893,CNL
chr18,Bn77226,84796680,87450791,2654111,TN
chr18,Bn77227,51306331,67019126,15712795,TN
chr18,Bn77228,81863417,83579186,1715769,TN
chr18,Bn77229,22280230,72682614,50402384,CNL
chr18,Bn77230,85271609,92403312,7131703,CNL
chr18,Bn77231,76080075,89096086,13016011,RLK
chr18,Bn77232,20966574,62369246,41402672,TN
chr18,Bn77233,93956834,98670861,4714027,CN
chr18,Bn77234,61702855,64598071,2895216,RLK
chr18,Bn77235,8882648,78646130,69763482,CNL
chr18,Bn77236,58095440,74395411,16299971,CNL
chr18,Bn77237,36335605,48858347,12522742,TN
chr18,Bn77238,41802053,65004690,23202637,RLP
chr18,Bn77239,58741103,93784333,35043230,RLK
chr18,Bn77240,69898979,95865143,25966164,NBS
chr18,Bn77241,69956328,96542264,26585936,TNL
chr18,Bn77242,18759286,49761788,31002502,NBS
chr18,Bn77243,68296767,77353511,9056744,CNL
chr18,Bn77244,66987740,94324914,27337174,TN
chr18,Bn77245,51836782,72515861,20679079,NBS
chr18,Bn77246,84560113,88008908,3448795,TN
chr18,Bn77247,5179958,18839739,13659781,TN
chr18,Bn77248,22360885,24777785,2416900,CN
chr18,Bn77249,7379633,81000165,73620532,RLK
chr18,Bn77250,76572729,76582063,9334,TNL
chr18,Bn77251,45501631,57507441,12005810,NBS
chr18,Bn77252,51892111,93983233,42091122,RLP
chr18,Bn77253,91875578,93392732,1517154,TNL
chr18,Bn77254,31625450,43493664,11868214,RLK
chr18,Bn77255,84153584,96926633,12773049,RLK
chr18,Bn77256,61557153,71892793,10335640,CNL
chr18,Bn77257,27671054,86745761,59074707,CNL
chr18,Bn77258,7442688,20327236,12884548,TN
chr18,Bn77259,34961365,98469924,63508559,CNL
chr18,Bn77260,46434871,86150309,39715438,TN
chr18,Bn77261,77198616,98704555,21505939,RLP
chr18,Bn77262,63887914,78675392,14787478,CNL
chr18,Bn77263,75096505,85739066,10642561,RLP
chr18,Bn77264,62686542,95416267,32729725,RLP
chr18,Bn77265,10887059,24040836,13153777,CNL
chr18,Bn77266,78416431,91946157,13529726,RLK
chr18,Bn77267,97035048,99714750,2679702,RLK
chr18,Bn77268,79107875,85687664,6579789,NBS
chr18,Bn77269,64552692,89828790,25276098,TN
chr18,Bn77270,83880474,92684560,8804086,CNL
chr18,Bn77271,70542232,98361329,27819097,RLP
chr18,Bn77272,85549625,91850661,6301036,RLP
chr18,Bn77273,80477675,95005142,14527467,RLK
chr18,Bn77274,41173286,77176653,36003367,CN
chr18,Bn77275,67092768,99210313,32117545,NBS
chr18,Bn77276,85904862,94249765,8344903,RLP
chr18,Bn77277,84652535,88920005,4267470,TNL
chr18,Bn77278,70754707,75641117,4886410,TN
chr18,Bn77279,22478776,70682989,48204213,TN
chr18,Bn77280,25781541,94799215,69017674,TNL
chr18,Bn77281,4833233,37759900,32926667,TNL
chr18,Bn77282,36445453,63377532,26932079,CN
chr18,Bn77283,16281844,68649783,52367939,RLP
chr18,Bn77284,98233120,98251339,18219,TNL
chr18,Bn77285,28037188,88557029,60519841,TNL
chr18,Bn77286,59563802,74886044,15322242,RLK
chr18,Bn77287,73980897,87472513,13491616,CN
chr18,Bn77288,80771126,95604930,14833804,TN
chr18,Bn77289,80184670,87460717,7276047,NBS
chr18,Bn77290,56701689,78347060,21645371,CNL
chr18,Bn77291,88845743,97227905,8382162,TN
chr18,Bn77292,95588021,99737375,4149354,TN
chr18,Bn77293,88365695,89072081,706386,NBS
chr18,Bn77294,49263054,60413947,11150893,CNL
chr18,Bn77295,72730236,88188568,15458332,TNL
chr18,Bn77296,23029420,98268088,75238668,TNL
chr18,Bn77297,67078074,67988326,910252,RLK
chr18,Bn77298,27988763,52421181,24432418,RLK
chr18,Bn77299,98653424,99507467,854043,TNL
chr18,Bn77300,45983330,64219812,18236482,CNL
chr18,Bn77301,28850409,30004114,1153705,RLP
chr18,Bn77302,9152538,90095392,80942854,TN
chr18,Bn77303,70877895,93059558,22181663,NBS
chr18,Bn77304,92961919,95887320,2925401,TN
chr18,Bn77305,40368419,56379530,16011111,TN
chr18,Bn77306,92557838,99916379,7358541,TN
chr18,Bn77307,27428406,31348246,3919840,RLK
chr18,Bn77308,3780038,93360479,89580441,RLK
chr18,Bn77309,75500573,87815282,12314709,TNL
chr18,Bn77310,25332894,89925524,64592630,RLK
chr18,Bn77311,92266240,97597959,5331719,CNL
chr18,Bn77312,42838849,81370369,38531520,CNL
chr18,Bn77313,40092182,65316535,25224353,CN
chr18,Bn77314,28975358,93624984,64649626,RLK
chr18,Bn77315,53808012,74155266,20347254,NBS
chr18,Bn77316,84345320,93434574,9089254,TN
chr18,Bn77317,75016540,84170651,9154111,RLK
chr18,Bn77318,44440911,63825806,19384895,RLK
chr18,Bn77319,26913097,43277600,16364503,TN
chr18,Bn77320,61155419,92317780,31162361,RLK
chr18,Bn77321,50425476,57174271,6748795,CNL
chr18,Bn77322,53685360,97366456,43681096,NBS
chr18,Bn77323,44893640,59530349,14636709,NBS
chr18,Bn77324,31655890,89041073,57385183,TN
chr18,Bn77325,37625960,55205908,17579948,CN
chr18,Bn77326,58348338,60188725,1840387,TNL
chr18,Bn77327,92817802,94195247,1377445,CN
chr18,Bn77328,43587183,85802689,42215506,RLK
chr18,Bn77329,15408620,79408500,63999880,TNL
chr18,Bn77330,70198587,87947293,17748706,CN
chr18,Bn77331,76164089,94798295,18634206,NBS
chr18,Bn77332,49891889,98862687,48970798,CNL
chr18,Bn77333,68268189,91070869,22802680,TN
chr18,Bn77334,73188540,75490899,2302359,TNL
chr18,Bn77335,37154835,44622198,7467363,RLP
chr18,Bn77336,94065331,96865950,2800619,TN
chr18,Bn77337,36634332,61675642,25041310,NBS
chr18,Bn77338,43289145,54961223,11672078,TNL
chr18,Bn77339,57935573,96216548,38280975,RLK
chr18,Bn77340,12161654,73417988,61256334,TN
chr18,Bn77341,35621928,71153030,35531102,CN
chr18,Bn77342,77373047,81207071,3834024,NBS
chr18,Bn77343,88943756,95967925,7024169,TN
chr18,Bn77344,27051139,57513303,30462164,TN
chr18,Bn77345,70807315,81599167,10791852,TN
chr18,Bn77346,69403075,94773320,25370245,TNL
chr18,Bn77347,69400119,95155823,25755704,TN
chr18,Bn77348,36854035,50515705,13661670,RLP
chr18,Bn77349,50526752,59795330,9268578,NBS
chr18,Bn77350,95705126,99745745,4040619,RLP
chr18,Bn77351,80584047,93717917,13133870,RLK
chr18,Bn77352,6268938,46169401,39900463,NBS
chr18,Bn77353,55474289,93886633,38412344,RLK
chr18,Bn77354,5589792,44715096,39125304,TNL
chr18,Bn77355,39489556,73925796,34436240,TNL
chr18,Bn77356,57714397,93006013,35291616,CNL
chr18,Bn77357,70374599,98868957,28494358,CNL
chr18,Bn77358,71119308,75646153,4526845,RLP
chr18,Bn77359,49128493,84044710,34916217,NBS
chr18,Bn77360,69618042,88005858,18387816,NBS
chr18,Bn77361,71466085,90262505,18796420,RLK
chr18,Bn77362,11212371,35973679,24761308,NBS
chr18,Bn77363,96475611,98803172,2327561,RLP
chr18,Bn77364,69077617,70495504,1417887,TN
chr18,Bn77365,96624259,97417101,792842,RLK
chr18,Bn77366,19464649,59911814,40447165,TNL
chr18,Bn77367,58269506,62294409,4024903,TNL
chr18,Bn77368,85321146,88330191,3009045,CN
chr18,Bn77369,95035821,96992856,1957035,CNL
chr18,Bn77370,8569583,24302720,15733137,TN
chr18,Bn77371,8931250,21920083,12988833,TN
chr18,Bn77372,45856880,87744483,41887603,CNL
chr18,Bn77373,34742650,53079695,18337045,NBS
chr18,Bn77374,61780918,65909875,4128957,NBS
chr18,Bn77375,12102760,98967684,86864924,TN
chr18,Bn77376,50255787,54621230,4365443,CNL
chr18,Bn77377,49463646,74574325,25110679,TNL
chr18,Bn77378,40315357,73704677,33389320,RLP
chr18,Bn77379,44979070,73547905,28568835,RLP
chr18,Bn77380,96950859,98831315,1880456,TN
chr18,Bn77381,94134073,98079181,3945108,RLP
chr18,Bn77382,50793595,66679218,15885623,CNL
chr18,Bn77383,59996432,71743170,11746738,NBS
chr18,Bn77384,13738372,54960453,41222081,CNL
chr18,Bn77385,95075656,99472013,4396357,CN
chr18,Bn77386,36629098,76322562,39693464,RLK
chr18,Bn77387,71633083,76526492,4893409,CNL
chr18,Bn77388,50570539,51931868,1361329,RLK
chr18,Bn77389,22687480,49838254,27150774,NBS
chr18,Bn77390,13735124,58299583,44564459,RLK
chr18,Bn77391,4656167,92868531,88212364,RLP
chr18,Bn77392,87209188,89549959,2340771,RLP
chr18,Bn77393,42166164,49477554,7311390,NBS
chr18,Bn77394,96697263,99665250,2967987,NBS
chr18,Bn77395,15478131,42042946,26564815,NBS
chr18,Bn77396,47278026,74413875,27135849,NBS
chr18,Bn77397,33167654,49910539,16742885,RLP
chr18,Bn77398,74421825,93727642,19305817,TN
chr18,Bn77399,20100054,49947247,29847193,NBS
chr18,Bn77400,46957482,92765298,45807816,NBS
chr18,Bn77401,6157110,50171246,44014136,CNL
chr18,Bn77402,36125421,54785776,18660355,NBS
chr18,Bn77403,81360605,84318984,2958379,RLP
chr18,Bn77404,42985459,48267139,5281680,CN
chr18,Bn77405,96222545,96570526,347981,RLP
chr18,Bn77406,22358402,55458517,33100115,TNL
chr18,Bn77407,58904026,89586859,30682833,RLK
chr18,Bn77408,56709939,64098999,7389060,CN
chr18,Bn77409,89818166,93160220,3342054,RLP
chr18,Bn77410,51358823,70829114,19470291,TNL
chr18,Bn77411,12830591,26613713,13783122,NBS
chr18,Bn77412,64417520,85137312,20719792,RLK
chr18,Bn77413,93572323,93580398,8075,NBS
chr18,Bn77414,91939066,99304363,7365297,CN
chr18,Bn77415,93828633,96621265,2792632,TN
chr18,Bn77416,68930885,77285491,8354606,RLP
chr18,Bn77417,57993653,97190140,39196487,TN
chr18,Bn77418,98588220,99558489,970269,NBS
chr18,Bn77419,96486866,97307720,820854,RLK
chr18,Bn77420,80448974,92138837,11689863,NBS
chr18,Bn77421,52253559,56613573,4360014,NBS
chr18,Bn77422,12263395,95026883,82763488,CNL
chr18,Bn77423,17594257,86593868,68999611,CN
chr18,Bn77424,31441764,52216635,20774871,TNL
chr18,Bn77425,56726563,69796920,13070357,TN
chr18,Bn77426,16356164,48085629,31729465,RLK
chr18,Bn77427,94548171,96267944,1719773,TNL
chr18,Bn77428,78351866,79633649,1281783,NBS
chr18,Bn77429,48581570,54899087,6317517,CN
chr18,Bn77430,80960979,91356341,10395362,CNL
chr18,Bn77431,5179905,24484569,19304664,CNL
chr18,Bn77432,45221554,51797413,6575859,TNL
chr18,Bn77433,64748974,76406220,11657246,NBS
chr18,Bn77434,16995110,22800054,5804944,NBS
chr18,Bn77435,65059031,82440442,17381411,CN
chr18,Bn77436,61911434,95883534,33972100,TN
chr18,Bn77437,55088119,56779078,1690959,CN
chr18,Bn77438,74177456,85054010,10876554,RLP
chr18,Bn77439,43293341,78236711,34943370,RLP
chr18,Bn77440,95535673,99663167,4127494,RLP
chr18,Bn77441,95053096,96132339,1079243,CNL
chr18,Bn77442,87452401,96300065,8847664,TN
chr18,Bn77443,9940651,37502346,27561695,CNL
chr18,Bn77444,6703594,73519139,66815545,CNL
chr18,Bn77445,33505321,51359257,17853936,CNL
chr18,Bn77446,16803833,39005003,22201170,TNL
chr18,Bn77447,65885923,88765621,22879698,TNL
chr18,Bn77448,51614601,88127052,36512451,CNL
chr18,Bn77449,27704220,49825569,22121349,TNL
chr18,Bn77450,31573672,84031423,52457751,CNL
chr18,Bn77451,31186819,62201247,31014428,TN
chr18,Bn77452,74341313,90750170,16408857,TN
chr18,Bn77453,44312105,48463092,4150987,TN
chr18,Bn77454,51717398,70283212,18565814,RLP
chr18,Bn77455,47193152,83332333,36139181,RLP
chr18,Bn77456,50160734,83943110,33782376,TN
chr18,Bn77457,11298044,29490646,18192602,TNL
chr18,Bn77458,46525004,72081683,25556679,NBS
chr18,Bn77459,11435713,40563499,29127786,NBS
chr18,Bn77460,22590199,69799801,47209602,NBS
chr18,Bn77461,70751014,84535992,13784978,TN
chr18,Bn77462,67631879,80003858,12371979,TN
chr18,Bn77463,89181842,90461221,1279379,TN
chr18,Bn77464,23771904,73264702,49492798,NBS
chr18,Bn77465,2387209,71876416,69489207,TN
chr18,Bn77466,48540058,80002487,31462429,TNL
chr18,Bn77467,68402173,78115139,9712966,RLP
chr18,Bn77468,57596021,74939584,17343563,CNL
chr18,Bn77469,17692226,23537552,5845326,RLP
chr18,Bn77470,16337192,23927185,7589993,CN
chr18,Bn77471,12963407,27505276,14541869,TN
chr18,Bn77472,11189834,60468891,49279057,NBS
chr18,Bn77473,90929251,99681212,8751961,RLK
chr18,Bn77474,64679042,76290684,11611642,CN
chr18,Bn77475,52396535,66503032,14106497,NBS
chr18,Bn77476,91065757,97081146,6015389,TN
chr18,Bn77477,25915355,43806420,17891065,RLP
chr18,Bn77478,7645821,24294606,16648785,RLK
chr18,Bn77479,50862234,98767104,47904870,TNL
chr18,Bn77480,44515738,75504742,30989004,TNL
chr18,Bn77481,52865358,78859188,25993830,RLP
chr18,Bn77482,97062092,97781135,719043,CNL
chr18,Bn77483,86428660,96480528,10051868,NBS
chr18,Bn77484,21566892,50863612,29296720,TN
chr18,Bn77485,11009227,47684896,36675669,RLP
chr18,Bn77486,4285260,62503889,58218629,NBS
chr18,Bn77487,97810078,99824790,2014712,NBS
chr18,Bn77488,81881069,87101483,5220414,CN
chr18,Bn77489,31929146,54328946,22399800,CN
chr18,Bn77490,73873090,87207865,13334775,TNL
chr18,Bn77491,70924291,93572676,22648385,CN
chr18,Bn77492,14352475,30636611,16284136,TN
chr18,Bn77493,69078459,94641206,25562747,CN
chr18,Bn77494,31942087,52388786,20446699,TNL
chr18,Bn77495,37819750,53556583,15736833,RLK
chr18,Bn77496,32839931,62921931,30082000,RLP
chr18,Bn77497,81011210,92288508,11277298,NBS
chr18,Bn77498,90087485,95422206,5334721,RLP
chr18,Bn77499,23618255,32646472,9028217,RLP
chr18,Bn77500,53177617,71301457,18123840,CN
chr18,Bn77501,48409453,92699246,44289793,RLP
chr18,Bn77502,68808260,76718793,7910533,NBS
chr18,Bn77503,77709254,88414373,10705119,TNL
chr18,Bn77504,57423206,67745572,10322366,TN
chr18,Bn77505,22295749,59532194,37236445,TN
chr18,Bn77506,64070823,70572136,6501313,CNL
chr18,Bn77507,60498912,79338315,18839403,TN
chr18,Bn77508,2871632,95045020,92173388,CN
chr18,Bn77509,75060918,86787969,11727051,TNL
chr18,Bn77510,13375055,51149440,37774385,CNL
chr18,Bn77511,18081616,33779004,15697388,TNL
chr18,Bn77512,98842307,98973509,131202,TN
chr18,Bn77513,90547565,95878823,5331258,TN
chr18,Bn77514,34150583,84257857,50107274,TNL
chr18,Bn77515,6184658,86355048,80170390,RLP
chr18,Bn77516,89613250,90158847,545597,NBS
chr18,Bn77517,62074270,74917960,12843690,RLP
chr18,Bn77518,61260879,88375284,27114405,NBS
chr18,Bn77519,56365953,90880677,34514724,RLK
chr18,Bn77520,54980642,60905731,5925089,TNL
chr18,Bn77521,7577385,15438189,7860804,RLK
chr18,Bn77522,35401480,88495003,53093523,TNL
chr18,Bn77523,14786761,82105016,67318255,RLK
chr18,Bn77524,21758969,71481025,49722056,RLK
chr18,Bn77525,49655581,77278982,27623401,TN
chr18,Bn77526,66675804,83250026,16574222,TNL
chr18,Bn77527,42185074,52448264,10263190,TNL
chr18,Bn77528,2901132,14393438,11492306,RLK
chr18,Bn77529,61615944,64634297,3018353,RLP
chr18,Bn77530,6260742,28399737,22138995,CN
chr18,Bn77531,86393285,87724099,1330814,RLK
chr18,Bn77532,16501255,93721700,77220445,NBS
chr18,Bn77533,54130647,79448294,25317647,NBS
chr18,Bn77534,99561583,99844340,282757,TNL
chr18,Bn77535,95464255,96776522,1312267,NBS
chr18,Bn77536,13348660,95683117,82334457,TN
chr18,Bn77537,23309184,66735169,43425985,RLP
chr18,Bn77538,96276391,97676704,1400313,CN
chr18,Bn77539,79400656,85945716,6545060,RLP
chr18,Bn77540,24018993,25971407,1952414,TNL
chr18,Bn77541,14859465,78929679,64070214,NBS
chr18,Bn77542,92751158,92808594,57436,TNL
chr18,Bn77543,41466160,73580072,32113912,NBS
chr18,Bn77544,53353255,62433082,9079827,CN
chr18,Bn77545,44293112,86333609,42040497,NBS
chr18,Bn77546,83209555,94862806,11653251,RLP
chr18,Bn77547,4557526,74768833,70211307,CNL
chr18,Bn77548,98365657,99869345,1503688,RLK
chr18,Bn77549,81711813,83341190,1629377,TNL
chr18,Bn77550,19913220,88034840,68121620,RLP
chr18,Bn77551,21200362,48465616,27265254,NBS
chr18,Bn77552,52460408,76341544,23881136,RLP
chr18,Bn77553,58430704,90727813,32297109,NBS
chr18,Bn77554,39049835,71835753,32785918,CNL
chr18,Bn77555,4118183,55908647,51790464,CN
chr18,Bn77556,56902102,57922411,1020309,RLP
chr18,Bn77557,59199149,59522128,322979,RLP
chr18,Bn77558,77021514,77856114,834600,TNL
chr18,Bn77559,93996409,97861199,3864790,RLP
chr18,Bn77560,76008856,76499717,490861,RLK
chr18,Bn77561,99233190,99831043,597853,NBS
chr18,Bn77562,14514016,40232875,25718859,NBS
chr18,Bn77563,3027190,85019940,81992750,TNL
chr18,Bn77564,42952072,85626906,42674834,RLK
chr18,Bn77565,99410971,99583700,172729,RLP
chr18,Bn77566,56297885,75656381,19358496,RLP
chr18,Bn77567,32547355,46260031,13712676,TNL
chr18,Bn77568,20649767,86195607,65545840,CNL
chr18,Bn77569,82436255,98806683,16370428,CN
chr18,Bn77570,68126321,84723109,16596788,TNL
chr18,Bn77571,94870484,95496038,625554,RLP
chr18,Bn77572,24510198,35854170,11343972,RLP
chr18,Bn77573,5429485,15703025,10273540,TN
chr18,Bn77574,58648284,80928189,22279905,TNL
chr18,Bn77575,34044602,37501005,3456403,RLK
chr18,Bn77576,74859691,94475039,19615348,TNL
chr18,Bn77577,77771859,91634299,13862440,CN
chr18,Bn77578,62355276,68554635,6199359,TN
chr18,Bn77579,56774723,85625986,28851263,TNL
chr18,Bn77580,28910668,54965252,26054584,TN
chr18,Bn77581,63361894,95494563,32132669,CN
chr18,Bn77582,12884334,85714073,72829739,NBS
chr18,Bn77583,24168582,99636170,75467588,CN
chr18,Bn77584,52355898,74167535,21811637,TN
chr18,Bn77585,63046858,99375633,36328775,RLK
chr18,Bn77586,7039618,90933614,83893996,RLK
chr18,Bn77587,68691501,95858053,27166552,TN
chr18,Bn77588,77398040,97156491,19758451,CNL
chr18,Bn77589,18101029,94957588,76856559,NBS
chr18,Bn77590,32464866,33322729,857863,CNL
chr18,Bn77591,15224777,31580789,16356012,CN
chr18,Bn77592,20691220,51074991,30383771,CNL
chr18,Bn77593,84530966,85462188,931222,CN
chr18,Bn77594,47981420,56367960,8386540,CN
chr18,Bn77595,54915311,64843562,9928251,CN
chr18,Bn77596,20984426,24282434,3298008,TN
chr18,Bn77597,1454525,52911905,51457380,CNL
chr18,Bn77598,84284009,90388027,6104018,RLP
chr18,Bn77599,69687373,95557656,25870283,RLP
chr18,Bn77600,60041527,69898203,9856676,RLK
chr18,Bn77601,77006122,79302474,2296352,TNL
chr18,Bn77602,41901974,96978274,55076300,CNL
chr18,Bn77603,8167207,10792204,2624997,RLP
chr18,Bn77604,81001943,89038070,8036127,NBS
chr18,Bn77605,11896971,40720022,28823051,RLK
chr18,Bn77606,37671915,50972011,13300096,NBS
chr18,Bn77607,76030848,79537936,3507088,TN
chr18,Bn77608,85958075,88513927,2555852,TN
chr18,Bn77609,1553138,44205620,42652482,RLK
chr18,Bn77610,37252187,42780366,5528179,NBS
chr18,Bn77611,81523047,99224031,17700984,CNL
chr18,Bn77612,91739564,99065854,7326290,CN
chr18,Bn77613,40460046,48579548,8119502,CNL
chr18,Bn77614,8244545,38325706,30081161,CN
chr18,Bn77615,6102215,12229509,6127294,TNL
chr18,Bn77616,8747428,41083146,32335718,NBS
chr18,Bn77617,62977455,94883998,31906543,TNL
chr18,Bn77618,76823912,83233626,6409714,TNL
chr18,Bn77619,53361096,99606194,46245098,CN
chr18,Bn77620,95108443,99005927,3897484,RLK
chr18,Bn77621,94513490,95326276,812786,NBS
chr18,Bn77622,67946516,97920190,29973674,NBS
chr18,Bn77623,90546613,90552163,5550,RLP
chr18,Bn77624,76893947,95410788,18516841,TN
chr18,Bn77625,95821399,99905497,4084098,CNL
chr18,Bn77626,75485218,88545275,13060057,NBS
chr18,Bn77627,42739278,92918390,50179112,TNL
chr18,Bn77628,7177809,16634149,9456340,CNL
chr18,Bn77629,9727797,20770290,11042493,RLK
chr18,Bn77630,84019325,97933953,13914628,CN
chr18,Bn77631,69738835,76900130,7161295,RLK
chr18,Bn77632,86302159,93532987,7230828,RLK
chr18,Bn77633,28872082,86410411,57538329,CN
chr18,Bn77634,1193517,6016310,4822793,TN
chr18,Bn77635,19606506,55912520,36306014,TNL
chr18,Bn77636,30493589,80851661,50358072,CNL
chr18,Bn77637,10184175,23637732,13453557,TNL
chr18,Bn77638,95961327,99193076,3231749,TN
chr18,Bn77639,23547029,46490220,22943191,CN
chr18,Bn77640,25068790,57956925,32888135,TNL
chr18,Bn77641,96893812,99428952,2535140,RLK
chr18,Bn77642,59311722,81037281,21725559,TN
chr18,Bn77643,79494594,94699994,15205400,RLK
chr18,Bn77644,58531805,71827714,13295909,TN
chr18,Bn77645,78431825,88189533,9757708,TN
chr18,Bn77646,66477223,74751687,8274464,TNL
chr18,Bn77647,72919888,85777939,12858051,NBS
chr18,Bn77648,98438664,99571391,1132727,RLP
chr18,Bn77649,18926001,64135646,45209645,CN
chr18,Bn77650,26301687,82842133,56540446,TN
chr18,Bn77651,86864850,97706881,10842031,CN
chr18,Bn77652,10468934,54869856,44400922,CNL
chr18,Bn77653,39348657,49134660,9786003,NBS
chr18,Bn77654,59909228,91870826,31961598,RLK
chr18,Bn77655,7803785,86758689,78954904,RLP
chr18,Bn77656,12330517,69148522,56818005,CN
chr18,Bn77657,5638696,12646285,7007589,CNL
chr18,Bn77658,38280500,57438012,19157512,TN
chr18,Bn77659,17508570,58792419,41283849,CN
chr18,Bn77660,21585675,83612059,62026384,RLP
chr18,Bn77661,77594200,92041529,14447329,CN
chr18,Bn77662,70522197,73101706,2579509,TN
chr18,Bn77663,55415277,79547762,24132485,NBS
chr18,Bn77664,43982920,46365864,2382944,TN
chr18,Bn77665,43496530,77149359,33652829,RLK
chr18,Bn77666,91132541,99935282,8802741,TNL
chr18,Bn77667,89642884,94632567,4989683,TNL
chr18,Bn77668,3497172,54347101,50849929,NBS
chr18,Bn77669,31219289,94960571,63741282,CNL
chr18,Bn77670,88385138,91024808,2639670,TN
chr18,Bn77671,55605961,58379934,2773973,TNL
chr18,Bn77672,25299090,76935890,51636800,RLK
chr18,Bn77673,96331588,97320861,989273,TNL
chr18,Bn77674,60196810,98107673,37910863,RLP
chr18,Bn77675,47260247,97515827,50255580,NBS
chr18,Bn77676,24787977,26697848,1909871,RLP
chr18,Bn77677,99124408,99435246,310838,CN
chr18,Bn77678,35506098,87951191,52445093,CNL
chr18,Bn77679,89474488,99173412,9698924,NBS
chr18,Bn77680,47474985,91387355,43912370,CN
chr18,Bn77681,92151663,93827510,1675847,TNL
chr18,Bn77682,87229934,92228970,4999036,RLP
chr18,Bn77683,25378144,92245323,66867179,RLK
chr18,Bn77684,65869612,71483321,5613709,CNL
chr18,Bn77685,42388476,50517924,8129448,RLK
chr18,Bn77686,2705007,54881011,52176004,TNL
chr18,Bn77687,94733941,95907699,1173758,CNL
chr18,Bn77688,44792862,53835645,9042783,NBS
chr18,Bn77689,4246652,15721218,11474566,CNL
chr18,Bn77690,19926573,98364011,78437438,RLK
chr18,Bn77691,4310745,68756339,64445594,RLP
chr18,Bn77692,82498861,92030576,9531715,CN
chr18,Bn77693,33614975,91618264,58003289,TN
chr18,Bn77694,78981799,93881540,14899741,TNL
chr18,Bn77695,52520685,72016363,19495678,TNL
chr18,Bn77696,90517432,91707742,1190310,CNL
chr18,Bn77697,81778524,90787745,9009221,CN
chr18,Bn77698,79363184,80827426,1464242,RLK
chr18,Bn77699,36587135,67503361,30916226,RLK
chr18,Bn77700,56493303,69060133,12566830,RLK
chr18,Bn77701,89274470,93302658,4028188,CNL
chr18,Bn77702,76143741,83321312,7177571,TNL
chr18,Bn77703,77678913,90150003,12471090,TN
chr18,Bn77704,39877703,52116734,12239031,RLK
chr18,Bn77705,4130421,19522868,15392447,TN
chr18,Bn77706,96726238,96895731,169493,RLK
chr18,Bn77707,56042083,85213380,29171297,TNL
chr18,Bn77708,91126856,95278570,4151714,RLP
chr18,Bn77709,9998251,89133242,79134991,RLP
chr18,Bn77710,7151938,60901427,53749489,NBS
chr18,Bn77711,35185970,48316603,13130633,TNL
chr18,Bn77712,22330208,77597429,55267221,RLP
chr18,Bn77713,50397570,62784989,12387419,NBS
chr18,Bn77714,54722039,98750147,44028108,CNL
chr18,Bn77715,30402549,33369322,2966773,RLK
chr18,Bn77716,38850894,73351343,34500449,RLK
chr18,Bn77717,80736233,84643913,3907680,NBS
chr18,Bn77718,2888135,15972191,13084056,RLK
chr18,Bn77719,17420896,46005163,28584267,CNL
chr18,Bn77720,86113629,94551659,8438030,CNL
chr18,Bn77721,8707521,98848682,90141161,TNL
chr18,Bn77722,78150435,97490979,19340544,CNL
chr18,Bn77723,33923640,59579546,25655906,CN
chr18,Bn77724,42963990,65850865,22886875,NBS
chr18,Bn77725,53847088,83866080,30018992,TN
chr18,Bn77726,6760310,90243041,83482731,CNL
chr18,Bn77727,61542447,82899681,21357234,RLK
chr18,Bn77728,65645438,97062389,31416951,CN
chr18,Bn77729,23386933,65104813,41717880,RLK
chr18,Bn77730,24731310,90777716,66046406,NBS
chr18,Bn77731,39101512,93236011,54134499,TNL
chr18,Bn77732,63367696,76348562,12980866,RLK
chr18,Bn77733,7648677,27740908,20092231,TN
chr18,Bn77734,66853184,84031057,17177873,RLP
chr18,Bn77735,45383517,98647411,53263894,TN
chr18,Bn77736,61138975,91805137,30666162,RLP
chr18,Bn77737,7686097,80125931,72439834,TNL
chr18,Bn77738,33071300,99988809,66917509,CNL
chr18,Bn77739,54812814,70469914,15657100,NBS
chr18,Bn77740,65522208,88946896,23424688,TN
chr18,Bn77741,64394488,96815936,32421448,TNL
chr18,Bn77742,11329404,84705137,73375733,CNL
chr18,Bn77743,56224817,88917909,32693092,RLP
chr18,Bn77744,58823335,78440745,19617410,NBS
chr18,Bn77745,53769187,78873972,25104785,CNL
chr18,Bn77746,16251579,70415246,54163667,NBS
chr18,Bn77747,2887782,50697522,47809740,CN
chr18,Bn77748,88016374,89436498,1420124,CN
chr18,Bn77749,12218601,30713687,18495086,CNL
chr18,Bn77750,98499384,99499297,999913,TN
chr18,Bn77751,22819447,46168287,23348840,CN
chr18,Bn77752,15647248,81680304,66033056,NBS
chr18,Bn77753,47437244,97818258,50381014,TNL
chr18,Bn77754,95169639,98624708,3455069,RLK
chr18,Bn77755,75882586,77719032,1836446,RLP
chr18,Bn77756,65617470,90411393,24793923,CNL
chr18,Bn77757,65853956,87309653,21455697,CN
chr18,Bn77758,29178849,73416297,44237448,RLK
chr18,Bn77759,92368887,97546827,5177940,RLP
chr18,Bn77760,1418560,46139041,44720481,RLP
chr18,Bn77761,16993488,60723666,43730178,RLK
chr18,Bn77762,67704777,87372730,19667953,TNL
chr18,Bn77763,19862213,72064116,52201903,CN
chr18,Bn77764,64917713,71678174,6760461,TNL
chr18,Bn77765,90176629,95241335,5064706,RLK
chr18,Bn77766,3118652,46547866,43429214,TNL
chr18,Bn77767,62363932,87079174,24715242,TNL
chr18,Bn77768,86581303,89229876,2648573,RLP
chr18,Bn77769,47830445,81851344,34020899,CNL
chr18,Bn77770,76755710,84272039,7516329,CNL
chr18,Bn77771,32198709,38841068,6642359,RLK
chr18,Bn77772,93434968,93745013,310045,CNL
chr18,Bn77773,61841308,77766631,15925323,TN
chr18,Bn77774,61652254,81603126,19950872,RLK
chr18,Bn77775,63246003,89495925,26249922,CNL
chr18,Bn77776,5016001,36897532,31881531,RLP
chr18,Bn77777,43678340,95698939,52020599,TNL
chr18,Bn77778,15160235,67062275,51902040,TN
chr18,Bn77779,15350841,79887478,64536637,RLP
chr18,Bn77780,90380171,93290893,2910722,TNL
chr18,Bn77781,64788267,99849727,35061460,RLP
chr18,Bn77782,84854626,87876666,3022040,RLK
chr18,Bn77783,49129618,74512975,25383357,CN
chr18,Bn77784,76780845,87503819,10722974,NBS
chr18,Bn77785,34849520,77764429,42914909,CNL
chr18,Bn77786,53112472,61324568,8212096,CNL
chr18,Bn77787,92609887,99714345,7104458,CN
chr18,Bn77788,90983238,96972621,5989383,TNL
chr18,Bn77789,76781452,94892863,18111411,CN
chr18,Bn77790,57079090,69820269,12741179,RLP
chr18,Bn77791,91458050,94672102,3214052,NBS
chr18,Bn77792,75223815,92566114,17342299,RLK
chr18,Bn77793,96315139,99885222,3570083,CNL
chr18,Bn77794,93723872,95420123,1696251,RLK
chr18,Bn77795,90946776,91050154,103378,NBS
chr18,Bn77796,20138296,89656095,69517799,TNL
chr18,Bn77797,52954442,55522510,2568068,RLP
chr18,Bn77798,89785003,98995802,9210799,TN
chr18,Bn77799,29166548,33378267,4211719,RLP
chr18,Bn77800,8789299,9282783,493484,CNL
chr18,Bn77801,94177222,96791342,2614120,RLK
chr18,Bn77802,66267924,84108302,17840378,CNL
chr18,Bn77803,99165952,99303899,137947,CNL
chr18,Bn77804,28151715,88898837,60747122,CNL
chr18,Bn77805,21732520,41348390,19615870,CNL
chr18,Bn77806,95550757,96756066,1205309,RLP
chr18,Bn77807,70231182,87575042,17343860,TNL
chr18,Bn77808,47229169,69830022,22600853,RLP
chr18,Bn77809,36141940,41902260,5760320,RLP
chr18,Bn77810,90010797,92167255,2156458,RLK
chr18,Bn77811,88648657,93482818,4834161,TNL
chr18,Bn77812,88331314,92034344,3703030,CNL
chr18,Bn77813,1398410,86593774,85195364,NBS
chr18,Bn77814,22868116,43168311,20300195,CN
chr18,Bn77815,53111345,66340090,13228745,RLK
chr18,Bn77816,28994459,94766817,65772358,RLK
chr18,Bn77817,87757773,94695852,6938079,TN
chr18,Bn77818,78260558,94832350,16571792,CNL
chr18,Bn77819,71312837,89118712,17805875,NBS
chr18,Bn77820,5563410,96266976,90703566,RLP
chr18,Bn77821,42533312,44798759,2265447,CN
chr18,Bn77822,64389006,90474644,26085638,NBS
chr18,Bn77823,67141785,82912501,15770716,NBS
chr18,Bn77824,77696076,94580146,16884070,CNL
chr18,Bn77825,32690031,85187948,52497917,CN
chr18,Bn77826,60384165,69847744,9463579,RLP
chr18,Bn77827,75272836,76691535,1418699,CN
chr18,Bn77828,5688330,49600635,43912305,RLP
chr18,Bn77829,76580764,98275168,21694404,CNL
chr18,Bn77830,48560199,77468323,28908124,RLK
chr18,Bn77831,91928817,92735275,806458,CN
chr18,Bn77832,71767790,75034685,3266895,RLP
chr18,Bn77833,19144999,41451963,22306964,TN
chr18,Bn77834,82929623,99232310,16302687,RLK
chr18,Bn77835,20717306,75988741,55271435,RLK
chr18,Bn77836,1049120,52345588,51296468,NBS
chr18,Bn77837,95306660,95424597,117937,TN
chr18,Bn77838,88323418,90113100,1789682,TN
chr18,Bn77839,96176725,96190057,13332,TNL
chr18,Bn77840,90602160,93614630,3012470,TNL
chr18,Bn77841,13814248,86918806,73104558,CNL
chr18,Bn77842,54752893,67262807,12509914,TNL
chr18,Bn77843,79820555,93559234,13738679,RLK
chr18,Bn77844,80938971,86523249,5584278,CNL
chr18,Bn77845,2455239,79502727,77047488,RLK
chr18,Bn77846,10328465,53770015,43441550,TN
chr18,Bn77847,9282145,61048918,51766773,NBS
chr18,Bn77848,82043112,87774356,5731244,NBS
chr18,Bn77849,41799370,70464712,28665342,TN
chr18,Bn77850,94027455,99918861,5891406,TNL
chr18,Bn77851,73708964,83144672,9435708,RLK
chr18,Bn77852,12649693,26394072,13744379,CN
chr18,Bn77853,19265928,58457540,39191612,CN
chr18,Bn77854,33941637,97183390,63241753,TNL
chr18,Bn77855,38237734,54623150,16385416,RLK
chr18,Bn77856,25026453,92341794,67315341,RLK
chr18,Bn77857,83464836,91252931,7788095,CNL
chr18,Bn77858,57829620,60939613,3109993,TNL
chr18,Bn77859,28801357,66601974,37800617,CN
chr18,Bn77860,22071156,75763929,53692773,TNL
chr18,Bn77861,52323055,84722900,32399845,CNL
chr18,Bn77862,12744003,24623333,11879330,RLK
chr18,Bn77863,15567985,55905161,40337176,CN
chr18,Bn77864,18293636,71372307,53078671,TN
chr18,Bn77865,2408749,49146431,46737682,CN
chr18,Bn77866,60809650,71103339,10293689,CN
chr18,Bn77867,8589994,52697237,44107243,NBS
chr18,Bn77868,7720984,93147602,85426618,RLK
chr18,Bn77869,25149490,95530903,70381413,CN
chr18,Bn77870,67906771,99923814,32017043,RLK
chr18,Bn77871,30614455,48214811,17600356,RLK
chr18,Bn77872,70575973,92099743,21523770,TNL
chr18,Bn77873,48807630,72293928,23486298,RLP
chr18,Bn77874,74302405,75923651,1621246,NBS
chr18,Bn77875,35593660,57862025,22268365,CN
chr18,Bn77876,3654081,80774638,77120557,CN
chr18,Bn77877,3746772,72928821,69182049,RLP
chr18,Bn77878,54636189,98459233,43823044,TN
chr18,Bn77879,98444973,99588243,1143270,CNL
chr18,Bn77880,32978976,63880786,30901810,TNL
chr18,Bn77881,79064570,79864092,799522,RLK
chr18,Bn77882,28081274,53143046,25061772,RLP
chr18,Bn77883,87439622,90652010,3212388,NBS
chr18,Bn77884,14147741,43514880,29367139,CN
chr18,Bn77885,49590744,66413231,16822487,RLP
chr18,Bn77886,81162227,83573088,2410861,TNL
chr18,Bn77887,99399424,99974375,574951,RLP
chr18,Bn77888,84613035,92161693,7548658,TNL
chr18,Bn77889,1838245,73273125,71434880,CN
chr18,Bn77890,44120427,81730747,37610320,TN
chr18,Bn77891,17960741,18463749,503008,RLK
chr18,Bn77892,48212100,82866936,34654836,CNL
chr18,Bn77893,72731625,76313147,3581522,TN
chr18,Bn77894,23972478,97569970,73597492,CNL
chr18,Bn77895,84690492,95905446,11214954,TN
chr18,Bn77896,74232873,87966149,13733276,CN
chr18,Bn77897,43368382,73045928,29677546,TNL
chr18,Bn77898,33878293,58087004,24208711,TNL
chr18,Bn77899,60482744,70746021,10263277,NBS
chr18,Bn77900,60114378,76820360,16705982,CN
chr18,Bn77901,43701622,46145574,2443952,RLP
chr18,Bn77902,85627517,90083453,4455936,TN
chr18,Bn77903,93095781,94075762,979981,NBS
chr18,Bn77904,75412587,87149791,11737204,CN
chr18,Bn77905,9259929,85627500,76367571,RLK
chr18,Bn77906,42026905,57281292,15254387,CN
chr18,Bn77907,78144291,86685766,8541475,RLP
chr18,Bn77908,93647701,99783236,6135535,CN
chr18,Bn77909,94115146,97407477,3292331,NBS
chr18,Bn77910,11325250,21514950,10189700,TNL
chr18,Bn77911,27213650,34264527,7050877,TNL
chr18,Bn77912,92786810,97788287,5001477,CNL
chr18,Bn77913,9341115,83451767,74110652,RLP
chr18,Bn77914,69194993,99697587,30502594,CNL
chr18,Bn77915,42290462,66130400,23839938,CN
chr18,Bn77916,68398493,75193533,6795040,NBS
chr18,Bn77917,23731874,56536989,32805115,TN
chr18,Bn77918,41570148,99210412,57640264,CN
chr18,Bn77919,13965585,23077467,9111882,NBS
chr18,Bn77920,22873058,32963835,10090777,CNL
chr18,Bn77921,49203985,83839978,34635993,TNL
chr18,Bn77922,85742869,88879365,3136496,TN
chr18,Bn77923,4591940,59160005,54568065,TNL
chr18,Bn77924,12757004,73978035,61221031,RLK
chr18,Bn77925,16682811,57475935,40793124,RLP
chr18,Bn77926,91822705,96730638,4907933,TNL
chr18,Bn77927,16142382,28108621,11966239,NBS
chr18,Bn77928,63532729,88335750,24803021,CNL
chr18,Bn77929,22685011,96624646,73939635,TN
chr18,Bn77930,36450982,60312377,23861395,NBS
chr18,Bn77931,14742615,91666951,76924336,CN
chr18,Bn77932,83244731,94307108,11062377,CNL
chr18,Bn77933,68887433,97672923,28785490,CNL
chr18,Bn77934,89204007,97053348,7849341,RLP
chr18,Bn77935,87977304,97247180,9269876,CN
chr18,Bn77936,87446190,95251348,7805158,RLK
chr18,Bn77937,68082168,73329189,5247021,CN
chr18,Bn77938,66694499,91300205,24605706,TNL
chr18,Bn77939,75001808,95787981,20786173,TNL
chr18,Bn77940,57706763,60851601,3144838,RLP
chr18,Bn77941,80740127,88702323,7962196,TN
chr18,Bn77942,14848933,36214902,21365969,CNL
chr18,Bn77943,87951597,94543322,6591725,TNL
chr18,Bn77944,73351580,75311410,1959830,RLK
chr18,Bn77945,48875132,94080424,45205292,NBS
chr18,Bn77946,99032831,99586375,553544,TN
chr18,Bn77947,75441870,92270820,16828950,CN
chr18,Bn77948,92767765,98881366,6113601,TNL
chr18,Bn77949,40634241,67635061,27000820,TNL
chr18,Bn77950,44728902,82142922,37414020,RLK
chr18,Bn77951,97851703,98276405,424702,RLK
chr18,Bn77952,68498565,75371347,6872782,TN
chr18,Bn77953,9783678,40152330,30368652,TNL
chr18,Bn77954,73467071,79117597,5650526,TN
chr18,Bn77955,43359775,43528027,168252,RLP
chr18,Bn77956,39425859,48615620,9189761,CN
chr18,Bn77957,2541991,75519332,72977341,TNL
chr18,Bn77958,28861677,83231416,54369739,NBS
chr18,Bn77959,65108705,81293550,16184845,TN
chr18,Bn77960,21290148,40603087,19312939,CN
chr18,Bn77961,16141382,99934778,83793396,CNL
chr18,Bn77962,57208815,84722419,27513604,TNL
chr18,Bn77963,79143356,84120249,4976893,CNL
chr18,Bn77964,72896280,96046693,23150413,CN
chr18,Bn77965,90789399,94706186,3916787,CNL
chr18,Bn77966,24711843,81068102,56356259,RLK
chr18,Bn77967,82652565,92412588,9760023,CN
chr18,Bn77968,23411672,88075071,64663399,TNL
chr18,Bn77969,95632968,99010823,3377855,NBS
chr18,Bn77970,67507624,84099843,16592219,CNL
chr18,Bn77971,89603615,91101969,1498354,CNL
chr18,Bn77972,90392234,92500200,2107966,TN
chr18,Bn77973,99813817,99988254,174437,CN
chr18,Bn77974,95938377,97999430,2061053,CNL
chr18,Bn77975,76371323,91419519,15048196,RLP
chr18,Bn77976,64390358,93865467,29475109,CNL
chr18,Bn77977,71812961,86557818,14744857,RLP
chr18,Bn77978,23658240,41889372,18231132,TNL
chr18,Bn77979,11653629,34658532,23004903,NBS
chr18,Bn77980,72052827,85069280,13016453,RLP
chr18,Bn77981,44634154,49480142,4845988,TNL
chr18,Bn77982,86170633,88004567,1833934,CN
chr18,Bn77983,91729586,99531205,7801619,TNL
chr18,Bn77984,22588555,79580088,56991533,TN
chr18,Bn77985,90282398,97087919,6805521,NBS
chr18,Bn77986,30782643,46659192,15876549,CNL
chr18,Bn77987,32466106,44173245,11707139,NBS
chr18,Bn77988,5787109,80396361,74609252,CNL
chr18,Bn77989,24831684,30886763,6055079,TNL
chr18,Bn77990,95078898,97507434,2428536,RLK
chr18,Bn77991,24831206,92986386,68155180,RLK
chr18,Bn77992,12972514,63148720,50176206,CNL
chr18,Bn77993,45674524,62080389,16405865,CN
chr18,Bn77994,89749865,92185421,2435556,CN
chr18,Bn77995,67183035,81964858,14781823,RLK
chr18,Bn77996,63983049,90054451,26071402,TN
chr18,Bn77997,41343676,45244706,3901030,RLK
chr18,Bn77998,2425414,7846259,5420845,RLK
chr18,Bn77999,42355799,88280286,45924487,TN
chr18,Bn78000,28132084,66832136,38700052,CNL
chr18,Bn78001,98913774,99218209,304435,TN
chr18,Bn78002,9473988,55812352,46338364,NBS
chr18,Bn78003,21544624,58351756,36807132,RLP
chr18,Bn78004,55630447,99928190,44297743,TN
chr18,Bn78005,39766579,47178334,7411755,NBS
chr18,Bn78006,1171768,72604738,71432970,RLK
chr18,Bn78007,26710622,71701656,44991034,RLP
chr18,Bn78008,24702953,78633284,53930331,TNL
chr18,Bn78009,29305428,36663914,7358486,TNL
chr18,Bn78010,96111837,98038035,1926198,NBS
chr18,Bn78011,84697252,86588221,1890969,RLK
chr18,Bn78012,84127845,88860917,4733072,RLK
chr18,Bn78013,61224438,61979178,754740,TNL
chr18,Bn78014,92055387,94480022,2424635,CNL
chr18,Bn78015,44421514,88066475,43644961,NBS
chr18,Bn78016,89972707,94559471,4586764,RLK
chr18,Bn78017,28343405,55663641,27320236,RLK
chr18,Bn78018,31644179,74982768,43338589,CN
chr18,Bn78019,63660252,84171662,20511410,TN
chr18,Bn78020,91611653,96189323,4577670,TNL
chr18,Bn78021,55392354,92830312,37437958,RLK
chr18,Bn78022,17466530,48184639,30718109,TNL
chr18,Bn78023,10008166,79302625,69294459,CNL
chr18,Bn78024,19475313,74196875,54721562,RLK
chr18,Bn78025,59414403,88928344,29513941,RLK
chr18,Bn78026,93140543,95029716,1889173,RLP
chr18,Bn78027,84789731,92914243,8124512,RLK
chr18,Bn78028,30919362,47672539,16753177,RLK
chr18,Bn78029,27161009,73940372,46779363,TNL
chr18,Bn78030,21454768,52097579,30642811,TNL
chr18,Bn78031,96362996,98498953,2135957,TNL
chr18,Bn78032,54598654,75345187,20746533,NBS
chr18,Bn78033,26792289,41042518,14250229,CNL
chr18,Bn78034,34042375,95028948,60986573,TN
chr18,Bn78035,14150733,74002669,59851936,CNL
chr18,Bn78036,77499778,90614940,13115162,NBS
chr18,Bn78037,8776408,69904851,61128443,CNL
chr18,Bn78038,99378493,99863787,485294,CNL
chr18,Bn78039,26997740,68682945,41685205,TNL
chr18,Bn78040,95368471,96335010,966539,RLP
chr18,Bn78041,39350443,93552198,54201755,TNL
chr18,Bn78042,58427258,87241773,28814515,TNL
chr18,Bn78043,40765764,51843530,11077766,RLK
chr18,Bn78044,86184874,93529747,7344873,CNL
chr18,Bn78045,38617270,87506662,48889392,RLK
chr18,Bn78046,24757365,85082404,60325039,NBS
chr18,Bn78047,36267967,72822493,36554526,TN
chr18,Bn78048,96837666,97413844,576178,CNL
chr18,Bn78049,95365051,98517198,3152147,CNL
chr18,Bn78050,44024547,84043958,40019411,CN
chr18,Bn78051,18733345,34414928,15681583,CN
chr18,Bn78052,36947756,46950641,10002885,CN
chr18,Bn78053,87243375,94104789,6861414,RLP
chr18,Bn78054,2422136,91019314,88597178,TN
chr18,Bn78055,67505331,77535163,10029832,NBS
chr18,Bn78056,2981619,91032182,88050563,CNL
chr18,Bn78057,81578585,81999963,421378,CNL
chr18,Bn78058,72438711,97832837,25394126,NBS
chr18,Bn78059,91757257,99098356,7341099,CN
chr18,Bn78060,68579800,89212949,20633149,NBS
chr18,Bn78061,22052805,92538465,70485660,RLP
chr18,Bn78062,83934962,89324054,5389092,NBS
chr18,Bn78063,89216257,95773172,6556915,TNL
chr18,Bn78064,13033653,97695758,84662105,CNL
chr18,Bn78065,71310653,75317470,4006817,RLP
chr18,Bn78066,8195359,10274755,2079396,RLP
chr18,Bn78067,63483771,95878157,32394386,RLK
chr18,Bn78068,63011145,96851309,33840164,TN
chr18,Bn78069,88515189,94491435,5976246,TN
chr18,Bn78070,85455127,93990866,8535739,CN
chr18,Bn78071,21984647,33662431,11677784,RLP
chr18,Bn78072,88152801,96351542,8198741,TN
chr18,Bn78073,30270086,44911824,14641738,RLP
chr18,Bn78074,4948297,11270453,6322156,CN
chr18,Bn78075,82396106,86732175,4336069,NBS
chr18,Bn78076,91676339,94397446,2721107,NBS
chr18,Bn78077,13698240,42085941,28387701,RLK
chr18,Bn78078,28681140,85456297,56775157,RLK
chr18,Bn78079,36931093,80540842,43609749,TN
chr18,Bn78080,51126542,82716412,31589870,CN
chr18,Bn78081,6042083,29714787,23672704,RLK
chr18,Bn78082,8363975,69750220,61386245,CNL
chr18,Bn78083,84443642,96937805,12494163,RLP
chr18,Bn78084,28634266,73426567,44792301,RLK
chr18,Bn78085,95890205,99436051,3545846,RLP
chr18,Bn78086,30157679,59155891,28998212,RLP
chr18,Bn78087,21804239,32549287,10745048,RLP
chr18,Bn78088,40986471,87557675,46571204,CN
chr18,Bn78089,50809508,90271578,39462070,RLP
chr18,Bn78090,14513401,74350020,59836619,NBS
chr18,Bn78091,11827480,23318458,11490978,CNL
chr18,Bn78092,25178838,38689192,13510354,RLK
chr18,Bn78093,20764111,31424051,10659940,RLP
chr18,Bn78094,26120184,52879338,26759154,RLK
chr18,Bn78095,68056260,82926012,14869752,RLP
chr18,Bn78096,18315119,80974141,62659022,CNL
chr18,Bn78097,76679538,88683799,12004261,CN
chr18,Bn78098,75387853,80666548,5278695,RLK
chr18,Bn78099,13810930,65645067,51834137,TN
chr18,Bn78100,40954752,68080225,27125473,CNL
chr18,Bn78101,84848348,88436930,3588582,TNL
chr18,Bn78102,59878659,75986960,16108301,NBS
chr18,Bn78103,28438581,67839694,39401113,NBS
chr18,Bn78104,9872689,62509829,52637140,CNL
chr18,Bn78105,41001507,57658251,16656744,CNL
chr18,Bn78106,34188849,52561054,18372205,CN
chr18,Bn78107,68564023,79947810,11383787,CN
chr18,Bn78108,83628322,86032782,2404460,TNL
chr18,Bn78109,95465240,96850766,1385526,TNL
chr18,Bn78110,10438102,98139003,87700901,TNL
chr18,Bn78111,43815737,78509886,34694149,TN
chr18,Bn78112,57829789,78686149,20856360,CNL
chr18,Bn78113,8615967,34654117,26038150,RLK
chr18,Bn78114,27540784,75817713,48276929,RLK
chr18,Bn78115,47683928,82622237,34938309,TN
chr18,Bn78116,90044953,97220115,7175162,RLK
chr18,Bn78117,87042551,96421036,9378485,RLP
chr18,Bn78118,46762785,69077908,22315123,RLK
chr18,Bn78119,76920275,97754891,20834616,RLK
chr18,Bn78120,40631884,72485694,31853810,NBS
chr18,Bn78121,23924332,25480629,1556297,TN
chr18,Bn78122,20567705,82969388,62401683,TN
chr18,Bn78123,48513214,53046934,4533720,RLP
chr18,Bn78124,15675368,94572383,78897015,NBS
chr18,Bn78125,42773253,57724685,14951432,TN
chr18,Bn78126,18798543,37766098,18967555,RLK
chr18,Bn78127,98478268,98850587,372319,RLK
chr18,Bn78128,74154646,86507563,12352917,CN
chr18,Bn78129,17076416,39486328,22409912,TNL
chr18,Bn78130,34800524,39564809,4764285,RLK
chr18,Bn78131,19385260,34453815,15068555,CNL
chr18,Bn78132,99758721,99793097,34376,CN
chr18,Bn78133,80779229,99436129,18656900,RLK
chr18,Bn78134,31695222,85396233,53701011,TNL
chr18,Bn78135,95734679,96110486,375807,RLK
chr18,Bn78136,85639051,90165419,4526368,CNL
chr18,Bn78137,56128740,95903985,39775245,RLK
chr18,Bn78138,96542754,98152156,1609402,TNL
chr18,Bn78139,83361100,94260531,10899431,RLK
chr18,Bn78140,68660855,93821421,25160566,NBS
chr18,Bn78141,59843866,81775671,21931805,TN
chr18,Bn78142,53859984,61654799,7794815,CN
chr18,Bn78143,63490054,77603116,14113062,RLP
chr18,Bn78144,7134199,23400898,16266699,CN
chr18,Bn78145,73222995,82728719,9505724,TN
chr18,Bn78146,20500013,51564219,31064206,RLP
chr18,Bn78147,43211763,95263592,52051829,RLP
chr18,Bn78148,63272896,64336324,1063428,TN
chr18,Bn78149,3269138,52395832,49126694,RLK
chr18,Bn78150,9757931,89843925,80085994,TN
chr18,Bn78151,18468181,80576552,62108371,TNL
chr18,Bn78152,80537898,81077556,539658,RLK
chr18,Bn78153,51043999,59707378,8663379,CNL
chr18,Bn78154,40220228,80447999,40227771,TNL
chr18,Bn78155,87945145,94987735,7042590,RLK
chr18,Bn78156,60965011,90237895,29272884,NBS
chr18,Bn78157,40227960,46324675,6096715,CNL
chr18,Bn78158,71666456,85181719,13515263,TNL
chr18,Bn78159,40701472,68330621,27629149,CNL
chr18,Bn78160,44998834,98040849,53042015,TNL
chr18,Bn78161,8390494,77934408,69543914,TN
chr18,Bn78162,14326684,87437858,73111174,CN
chr18,Bn78163,20253949,52163560,31909611,RLK
chr18,Bn78164,25196886,65910708,40713822,CN
chr18,Bn78165,95137392,97197104,2059712,RLP
chr18,Bn78166,21581654,42944849,21363195,RLK
chr18,Bn78167,62835158,85540589,22705431,NBS
chr18,Bn78168,35580509,78063736,42483227,RLK
chr18,Bn78169,46043128,53483304,7440176,CN
chr18,Bn78170,14981357,45471677,30490320,RLK
chr18,Bn78171,14792469,35490434,20697965,CN
chr18,Bn78172,30421226,99687576,69266350,CN
chr18,Bn78173,31170857,41155880,9985023,CNL
chr18,Bn78174,7324520,99914538,92590018,TNL
chr18,Bn78175,34867952,64899057,30031105,TNL
chr18,Bn78176,98094184,99738290,1644106,RLP
chr18,Bn78177,85790942,97797984,12007042,CN
chr18,Bn78178,87653899,98865323,11211424,TN
chr18,Bn78179,4771405,30987069,26215664,TNL
chr18,Bn78180,10895585,47176913,36281328,TNL
chr18,Bn78181,90328810,98430459,8101649,TNL
chr18,Bn78182,94940919,98287999,3347080,CN
chr18,Bn78183,82655256,89080380,6425124,NBS
chr18,Bn78184,68300907,90136441,21835534,NBS
chr18,Bn78185,38059032,91388709,53329677,RLK
chr18,Bn78186,95211640,97701694,2490054,CNL
chr18,Bn78187,9877605,78599641,68722036,CNL
chr18,Bn78188,63553610,84751162,21197552,RLP
chr18,Bn78189,73236218,77701137,4464919,NBS
chr18,Bn78190,2527694,10551772,8024078,CNL
chr18,Bn78191,36001290,90488336,54487046,TN
chr18,Bn78192,22167410,73391465,51224055,CNL
chr18,Bn78193,76312261,86319109,10006848,CNL
chr18,Bn78194,19780586,78235783,58455197,NBS
chr18,Bn78195,30914659,82842604,51927945,TN
chr18,Bn78196,27077158,52829304,25752146,RLK
chr18,Bn78197,38145313,68164633,30019320,CNL
chr18,Bn78198,22581290,81387213,58805923,RLP
chr18,Bn78199,89758642,91786034,2027392,NBS
chr18,Bn78200,29430691,61070649,31639958,NBS
chr18,Bn78201,12232940,32463358,20230418,CNL
chr18,Bn78202,32604182,81031611,48427429,RLK
chr18,Bn78203,32729713,63163049,30433336,TN
chr18,Bn78204,74749598,95325166,20575568,RLP
chr18,Bn78205,6478638,33204786,26726148,NBS
chr18,Bn78206,74513910,77429223,2915313,CN
chr18,Bn78207,12059375,44514887,32455512,TNL
chr18,Bn78208,50536695,76878599,26341904,NBS
chr18,Bn78209,16045522,70716862,54671340,RLK
chr18,Bn78210,66092852,95767368,29674516,RLK
chr18,Bn78211,20870980,80142250,59271270,CNL
chr18,Bn78212,60095299,66479243,6383944,TNL
chr18,Bn78213,84340166,86276869,1936703,TN
chr18,Bn78214,21700402,69250345,47549943,RLK
chr18,Bn78215,43037074,45221633,2184559,TNL
chr18,Bn78216,1544773,25810054,24265281,CN
chr18,Bn78217,51799371,88294015,36494644,RLP
chr18,Bn78218,48966923,92682095,43715172,TN
chr18,Bn78219,98683341,98716135,32794,TN
chr18,Bn78220,85692718,88455477,2762759,TNL
chr18,Bn78221,34435070,66835709,32400639,TN
chr18,Bn78222,51980567,75223959,23243392,TN
chr18,Bn78223,49345781,98921010,49575229,NBS
chr18,Bn78224,31340789,44558206,13217417,CN
chr18,Bn78225,90749791,96992079,6242288,CN
chr18,Bn78226,74212880,90135058,15922178,TNL
chr18,Bn78227,79438476,96353580,16915104,RLK
chr18,Bn78228,36962237,72199381,35237144,RLK
chr18,Bn78229,34343468,86486738,52143270,RLK
chr18,Bn78230,52003743,77478041,25474298,RLK
chr18,Bn78231,53846227,85780804,31934577,RLK
chr18,Bn78232,54207192,62640216,8433024,TNL
chr18,Bn78233,45507981,64388955,18880974,CN
chr18,Bn78234,22478568,58780905,36302337,TNL
chr18,Bn78235,62001668,91973120,29971452,RLP
chr18,Bn78236,96041829,99593416,3551587,CNL
chr18,Bn78237,76073769,85904931,9831162,NBS
chr18,Bn78238,96634415,99017340,2382925,TNL
chr18,Bn78239,82360957,98219528,15858571,RLP
chr18,Bn78240,9235327,58758183,49522856,TNL
chr18,Bn78241,90196645,91926097,1729452,RLP
chr18,Bn78242,66308087,73137229,6829142,RLK
chr18,Bn78243,76875249,99331124,22455875,NBS
chr18,Bn78244,8596685,52209768,43613083,RLK
chr18,Bn78245,99398233,99697289,299056,RLP
chr18,Bn78246,77277648,92540107,15262459,TN
chr18,Bn78247,98211049,98479024,267975,TNL
chr18,Bn78248,29813335,87189529,57376194,TN
chr18,Bn78249,25354369,52394100,27039731,CN
chr18,Bn78250,1663981,62594595,60930614,CN
chr18,Bn78251,32210394,33637584,1427190,CN
chr18,Bn78252,41530007,67088909,25558902,NBS
chr18,Bn78253,50766519,99464933,48698414,TNL
chr18,Bn78254,68450873,80081456,11630583,CN
chr18,Bn78255,49157330,65426807,16269477,CN
chr18,Bn78256,54142384,92400808,38258424,RLP
chr18,Bn78257,88278811,88697627,418816,TNL
chr18,Bn78258,46031912,85440011,39408099,CN
chr18,Bn78259,33964329,80072226,46107897,TN
chr18,Bn78260,87415824,96932332,9516508,CNL
chr18,Bn78261,77906176,83098776,5192600,TNL
chr18,Bn78262,8633437,69623439,60990002,NBS
chr18,Bn78263,40780569,82717367,41936798,CNL
chr18,Bn78264,85291643,89094565,3802922,CNL
chr18,Bn78265,2108313,38016721,35908408,CN
chr18,Bn78266,65742813,83322757,17579944,CN
chr18,Bn78267,84269612,87337534,3067922,NBS
chr18,Bn78268,56736581,87441219,30704638,TNL
chr18,Bn78269,49196459,52367478,3171019,RLK
chr18,Bn78270,64156320,99573414,35417094,TNL
chr18,Bn78271,96729893,97933902,1204009,TN
chr18,Bn78272,58360060,59904431,1544371,TN
chr18,Bn78273,56738295,87932464,31194169,CN
chr18,Bn78274,32578418,91722071,59143653,RLK
chr18,Bn78275,45481919,78698211,33216292,CN
chr18,Bn78276,17522458,47636862,30114404,TN
chr18,Bn78277,59210459,90981671,31771212,NBS
chr18,Bn78278,92612605,95477224,2864619,TN
chr18,Bn78279,7654713,44691443,37036730,RLK
chr18,Bn78280,2794436,47966312,45171876,TN
chr18,Bn78281,11608231,22919645,11311414,RLK
chr18,Bn78282,75497886,79050003,3552117,CN
chr18,Bn78283,28617007,84563704,55946697,TNL
chr18,Bn78284,86146656,99253556,13106900,RLP
chr18,Bn78285,85930823,89092092,3161269,NBS
chr18,Bn78286,1833052,26162301,24329249,RLK
chr18,Bn78287,89223629,90144131,920502,CN
chr18,Bn78288,86451050,90873130,4422080,NBS
chr18,Bn78289,4321868,76787912,72466044,RLP
chr18,Bn78290,65880247,70147915,4267668,NBS
chr18,Bn78291,98874563,98882844,8281,CN
chr18,Bn78292,28009256,85049117,57039861,TN
chr18,Bn78293,67606839,82093562,14486723,NBS
chr18,Bn78294,93758035,99295077,5537042,NBS
chr18,Bn78295,81435018,89466502,8031484,CN
chr18,Bn78296,83751163,93026824,9275661,RLK
chr18,Bn78297,50293197,63982489,13689292,TNL
chr18,Bn78298,62725117,74383532,11658415,TN
chr18,Bn78299,79661702,99907633,20245931,TNL
chr18,Bn78300,46664273,94208750,47544477,CN
chr18,Bn78301,87867502,88861701,994199,RLP
chr18,Bn78302,67770472,81843689,14073217,RLP
chr18,Bn78303,44337459,94287050,49949591,NBS
chr18,Bn78304,39195068,74886991,35691923,TN
chr18,Bn78305,34020757,93125032,59104275,CNL
chr18,Bn78306,33702845,66042963,32340118,RLK
chr18,Bn78307,89214572,97888663,8674091,CN
chr18,Bn78308,74700450,78253579,3553129,TNL
chr18,Bn78309,92603177,93961859,1358682,RLK
chr18,Bn78310,32462447,68195592,35733145,CN
chr18,Bn78311,11522313,84746826,73224513,RLP
chr18,Bn78312,37176186,50171877,12995691,RLK
chr18,Bn78313,88332914,93345306,5012392,CN
chr18,Bn78314,21903881,88473979,66570098,TNL
chr18,Bn78315,87539104,90974632,3435528,TNL
chr18,Bn78316,43480195,98448144,54967949,CN
chr18,Bn78317,6791432,42686885,35895453,CN
chr18,Bn78318,83168176,87958004,4789828,NBS
chr18,Bn78319,90586017,98081286,7495269,RLP
chr18,Bn78320,87924579,98187940,10263361,CN
chr18,Bn78321,51317624,71922463,20604839,CN
chr18,Bn78322,87310753,92786490,5475737,CN
chr18,Bn78323,80866035,95394035,14528000,CNL
chr18,Bn78324,48326618,58158415,9831797,RLK
chr18,Bn78325,39529876,85678309,46148433,TN
chr18,Bn78326,27258005,54624368,27366363,TNL
chr18,Bn78327,50618732,97632831,47014099,CNL
chr18,Bn78328,4080958,26485296,22404338,TN
chr18,Bn78329,35462173,44514781,9052608,CNL
chr18,Bn78330,35260008,62918622,27658614,CNL
chr18,Bn78331,84185168,90661940,6476772,TNL
chr18,Bn78332,16719669,38002250,21282581,CN
chr18,Bn78333,12696046,48143853,35447807,TN
chr18,Bn78334,82428688,86715763,4287075,RLK
chr18,Bn78335,41430050,97474389,56044339,TNL
chr18,Bn78336,24429686,79586081,55156395,RLP
chr18,Bn78337,19962623,53716852,33754229,NBS
chr18,Bn78338,23077675,64045184,40967509,CN
chr18,Bn78339,59965285,79203850,19238565,TN
chr18,Bn78340,17525130,19982513,2457383,NBS
chr18,Bn78341,60803121,69192144,8389023,CNL
chr18,Bn78342,12349141,48637257,36288116,NBS
chr18,Bn78343,30300228,47223351,16923123,RLK
chr18,Bn78344,86416179,92011933,5595754,CN
chr18,Bn78345,15616608,31410892,15794284,CNL
chr18,Bn78346,63221046,85478866,22257820,CNL
chr18,Bn78347,21068536,23759844,2691308,TNL
chr18,Bn78348,4126428,87798612,83672184,RLK
chr18,Bn78349,60253486,90202571,29949085,CNL
chr18,Bn78350,43504071,58175986,14671915,NBS
chr18,Bn78351,65290404,76491312,11200908,CN
chr18,Bn78352,72989505,78392325,5402820,TNL
chr18,Bn78353,49965495,72218423,22252928,TNL
chr18,Bn78354,5798369,67879992,62081623,TNL
chr18,Bn78355,14015847,22458742,8442895,CNL
chr18,Bn78356,3708952,20695100,16986148,CN
chr18,Bn78357,80802185,92622605,11820420,NBS
chr18,Bn78358,43427495,67978401,24550906,CNL
chr18,Bn78359,61887858,74735860,12848002,TN
chr18,Bn78360,74050014,86666984,12616970,CN
chr18,Bn78361,36041065,42723776,6682711,TN
chr18,Bn78362,56688840,75452696,18763856,CNL
chr18,Bn78363,68146837,88794975,20648138,NBS
chr18,Bn78364,50233682,90717436,40483754,RLP
chr18,Bn78365,44757647,59755071,14997424,RLP
chr18,Bn78366,58615105,75368654,16753549,RLK
chr18,Bn78367,77478631,80028314,2549683,RLK
chr18,Bn78368,90775965,95202317,4426352,NBS
chr18,Bn78369,39599905,86348492,46748587,CNL
chr18,Bn78370,89063834,94582940,5519106,CNL
chr18,Bn78371,52727434,81098531,28371097,RLK
chr18,Bn78372,84255696,97951014,13695318,NBS
chr18,Bn78373,38069492,87731995,49662503,CN
chr18,Bn78374,98433981,98721750,287769,RLP
chr18,Bn78375,99573898,99787176,213278,CNL
chr18,Bn78376,15858288,86918519,71060231,CN
chr18,Bn78377,76498140,89539500,13041360,CNL
chr18,Bn78378,3805542,47421603,43616061,NBS
chr18,Bn78379,67650221,90647249,22997028,TNL
chr18,Bn78380,25052497,72016799,46964302,NBS
chr18,Bn78381,67932599,86080205,18147606,RLP
chr18,Bn78382,85207495,86510624,1303129,CN
chr18,Bn78383,96278800,99378090,3099290,RLP
chr18,Bn78384,81534776,97244145,15709369,CN
chr18,Bn78385,14595597,40820076,26224479,RLP
chr18,Bn78386,65850042,73708356,7858314,CNL
chr18,Bn78387,46358753,71268745,24909992,RLP
chr18,Bn78388,43042677,61215908,18173231,CN
chr18,Bn78389,61654186,75540954,13886768,TNL
chr18,Bn78390,77832464,87522930,9690466,RLP
chr18,Bn78391,49276867,84663829,35386962,RLK
chr18,Bn78392,98073131,99801950,1728819,RLK
chr18,Bn78393,28367568,90038134,61670566,TNL
chr18,Bn78394,59952212,97102193,37149981,RLP
chr18,Bn78395,27549228,79903434,52354206,NBS
chr18,Bn78396,70006345,75450265,5443920,TNL
chr18,Bn78397,24552261,94921135,70368874,RLP
chr18,Bn78398,25118395,65504561,40386166,RLK
chr18,Bn78399,86393872,96340067,9946195,CNL
chr18,Bn78400,31418238,94512652,63094414,RLP
chr18,Bn78401,33118165,58831296,25713131,CNL
chr18,Bn78402,81014821,81462497,447676,TNL
chr18,Bn78403,85198826,99275494,14076668,TNL
chr18,Bn78404,70160733,77764712,7603979,CNL
chr18,Bn78405,33972778,40345029,6372251,TN
chr18,Bn78406,49890568,68260550,18369982,RLK
chr18,Bn78407,77827659,89725876,11898217,NBS
chr18,Bn78408,64098503,93344870,29246367,CN
chr18,Bn78409,25001841,71184779,46182938,RLK
chr18,Bn78410,31496622,91703649,60207027,RLP
chr18,Bn78411,89483668,91639907,2156239,CN
chr18,Bn78412,21192317,36428922,15236605,CN
chr18,Bn78413,35661412,40956145,5294733,RLK
chr18,Bn78414,70573072,85131291,14558219,TN
chr18,Bn78415,39630476,61536900,21906424,NBS
chr18,Bn78416,42869140,63845039,20975899,TNL
chr18,Bn78417,20918025,76867059,55949034,TN
chr18,Bn78418,77503488,78823729,1320241,TNL
chr18,Bn78419,32017273,89810285,57793012,CN
chr18,Bn78420,21766025,71630192,49864167,RLK
chr18,Bn78421,40547372,61923738,21376366,RLK
chr18,Bn78422,3743404,74286925,70543521,NBS
chr18,Bn78423,27435432,61402361,33966929,RLK
chr18,Bn78424,28405568,39600617,11195049,NBS
chr18,Bn78425,87708124,99736700,12028576,TNL
chr18,Bn78426,91051067,98112720,7061653,NBS
chr18,Bn78427,49188780,58314051,9125271,RLP
chr18,Bn78428,24583767,45007091,20423324,CN
chr18,Bn78429,8489083,45285358,36796275,RLP
chr18,Bn78430,77883688,88604899,10721211,NBS
chr18,Bn78431,22453676,60864581,38410905,NBS
chr18,Bn78432,87341831,93709818,6367987,TN
chr18,Bn78433,39285427,72074253,32788826,CNL
chr18,Bn78434,63324658,72062607,8737949,RLP
chr18,Bn78435,51461316,85121306,33659990,NBS
chr18,Bn78436,41947777,90325977,48378200,TN
chr18,Bn78437,30725212,59574464,28849252,RLK
chr18,Bn78438,19483843,92366804,72882961,CNL
chr18,Bn78439,10211091,31815165,21604074,CNL
chr18,Bn78440,41805357,55267105,13461748,RLP
chr18,Bn78441,48422498,60728835,12306337,TN
chr18,Bn78442,2462849,54752097,52289248,CN
chr18,Bn78443,52918735,72274078,19355343,TN
chr18,Bn78444,1592248,56486609,54894361,RLP
chr18,Bn78445,18860678,61180891,42320213,TN
chr18,Bn78446,12039104,78514007,66474903,CNL
chr18,Bn78447,43026704,71010118,27983414,TNL
chr18,Bn78448,78713210,97065378,18352168,CNL
chr18,Bn78449,27331977,64416369,37084392,TN
chr18,Bn78450,41706873,95471193,53764320,CN
chr18,Bn78451,49098313,80745700,31647387,RLP
chr18,Bn78452,48049693,60204387,12154694,TNL
chr18,Bn78453,52103567,85355408,33251841,TNL
chr18,Bn78454,32609619,49522748,16913129,RLK
chr18,Bn78455,65578472,86353836,20775364,NBS
chr18,Bn78456,88090515,95147475,7056960,CNL
chr18,Bn78457,33836080,89903848,56067768,TN
chr18,Bn78458,95032022,96684495,1652473,RLP
chr18,Bn78459,83752532,88591875,4839343,RLK
chr18,Bn78460,61148224,94870983,33722759,TN
chr18,Bn78461,24842264,30863616,6021352,CNL
chr18,Bn78462,23157195,87629980,64472785,RLK
chr18,Bn78463,60839549,93621524,32781975,NBS
chr18,Bn78464,48619340,74155632,25536292,TNL
chr18,Bn78465,41280711,86281219,45000508,CNL
chr18,Bn78466,51099562,97170135,46070573,TNL
chr18,Bn78467,11372664,32117598,20744934,TN
chr18,Bn78468,35217954,71023320,35805366,NBS
chr18,Bn78469,78524297,98596141,20071844,TN
chr18,Bn78470,12080275,77767478,65687203,RLK
chr18,Bn78471,54635322,66854156,12218834,RLK
chr18,Bn78472,69902834,70424064,521230,NBS
chr18,Bn78473,67816219,99812387,31996168,TN
chr18,Bn78474,26139652,70923544,44783892,CN
chr18,Bn78475,41653414,51169489,9516075,TNL
chr18,Bn78476,29899179,68879158,38979979,CNL
chr18,Bn78477,68457294,97628918,29171624,NBS
chr18,Bn78478,52464717,72030428,19565711,CN
chr18,Bn78479,12220942,55217236,42996294,RLP
chr18,Bn78480,79521552,84337720,4816168,RLK
chr18,Bn78481,36679342,99605191,62925849,CN
chr18,Bn78482,43980228,50875302,6895074,CN
chr18,Bn78483,31924950,97476687,65551737,RLP
chr18,Bn78484,40291265,82038386,41747121,TNL
chr18,Bn78485,2472225,62811437,60339212,CNL
chr18,Bn78486,19847664,60066288,40218624,NBS
chr18,Bn78487,32490858,34016511,1525653,NBS
chr18,Bn78488,21446292,44726425,23280133,RLP
chr18,Bn78489,29303323,49049070,19745747,RLK
chr18,Bn78490,74201430,86623112,12421682,NBS
chr18,Bn78491,26991933,99607226,72615293,NBS
chr18,Bn78492,30329739,95166990,64837251,CNL
chr18,Bn78493,74703439,94533699,19830260,RLK
chr18,Bn78494,55339416,75516027,20176611,TNL
chr18,Bn78495,18263122,44230010,25966888,RLP
chr18,Bn78496,42633439,96733427,54099988,CNL
chr18,Bn78497,81496882,94894079,13397197,NBS
chr18,Bn78498,41309538,93673920,52364382,RLK
chr18,Bn78499,68371812,77011704,8639892,RLP
chr18,Bn78500,14843907,52772840,37928933,TN
chr18,Bn78501,1244772,90566162,89321390,TNL
chr18,Bn78502,92749165,97596612,4847447,CN
chr18,Bn78503,62406355,82732770,20326415,CNL
chr18,Bn78504,64292827,98556926,34264099,TN
chr18,Bn78505,5906867,14435676,8528809,RLK
chr18,Bn78506,45364857,73573661,28208804,RLP
chr18,Bn78507,67803357,99162347,31358990,RLP
chr18,Bn78508,42866835,95924491,53057656,RLK
chr18,Bn78509,92597614,95351689,2754075,NBS
chr18,Bn78510,74791191,78951600,4160409,CN
chr18,Bn78511,35031626,42318196,7286570,NBS
chr18,Bn78512,27474957,58638958,31164001,CNL
chr18,Bn78513,28730983,52905049,24174066,CN
chr18,Bn78514,84480598,91370131,6889533,RLK
chr18,Bn78515,54654232,90963135,36308903,RLK
chr18,Bn78516,48462577,94239367,45776790,TNL
chr18,Bn78517,91882808,99071082,7188274,RLK
chr18,Bn78518,16581336,71626397,55045061,TNL
chr18,Bn78519,88147128,92998185,4851057,CNL
chr18,Bn78520,28458746,64137636,35678890,NBS
chr18,Bn78521,57249216,70260878,13011662,CN
chr18,Bn78522,37840680,98371096,60530416,RLP
chr18,Bn78523,2948808,60253236,57304428,TN
chr18,Bn78524,41595246,48647035,7051789,TNL
chr18,Bn78525,5110718,99239527,94128809,CNL
chr18,Bn78526,72725718,96217075,23491357,CN
chr18,Bn78527,96396780,98802989,2406209,RLK
chr18,Bn78528,21125851,33316723,12190872,TN
chr18,Bn78529,50474073,52602604,2128531,TN
chr18,Bn78530,76216438,82702548,6486110,RLK
chr18,Bn78531,96355434,97420689,1065255,CN
chr18,Bn78532,13862270,82921537,69059267,TNL
chr18,Bn78533,20284126,74507617,54223491,RLK
chr18,Bn78534,92092755,95971981,3879226,CNL
chr18,Bn78535,61380701,93971004,32590303,TN
chr18,Bn78536,64985095,90555421,25570326,TNL
chr18,Bn78537,88854475,96149319,7294844,CN
chr18,Bn78538,79987065,88334776,8347711,TNL
chr18,Bn78539,15907644,38344954,22437310,CNL
chr18,Bn78540,54739037,99712421,44973384,RLP
chr18,Bn78541,96524541,98594854,2070313,RLP
chr18,Bn78542,70703053,85885682,15182629,TN
chr18,Bn78543,1749925,21726249,19976324,TN
chr18,Bn78544,69501465,85972841,16471376,TNL
chr18,Bn78545,84588262,96550602,11962340,CNL
chr18,Bn78546,77960587,78579133,618546,CNL
chr18,Bn78547,98431095,99063304,632209,RLK
chr18,Bn78548,20918240,94829483,73911243,RLP
chr18,Bn78549,43622673,73046380,29423707,TNL
chr18,Bn78550,93076876,94228764,1151888,NBS
chr18,Bn78551,1243348,69349960,68106612,CN
chr18,Bn78552,85345995,97062203,11716208,NBS
chr18,Bn78553,21609781,64270484,42660703,TNL
chr18,Bn78554,48218762,51113563,2894801,RLK
chr18,Bn78555,63645319,77964722,14319403,CNL
chr18,Bn78556,73363187,89623636,16260449,CN
chr18,Bn78557,13213654,63761876,50548222,NBS
chr18,Bn78558,26924299,35247743,8323444,TN
chr18,Bn78559,9157370,48649718,39492348,CNL
chr18,Bn78560,19836653,91900869,72064216,RLK
chr18,Bn78561,13348360,54545569,41197209,NBS
chr18,Bn78562,71872829,77028526,5155697,TNL
chr18,Bn78563,55612708,69243476,13630768,RLK
chr18,Bn78564,6820640,20347546,13526906,CNL
chr18,Bn78565,20848825,46763279,25914454,RLK
chr18,Bn78566,91969628,98822585,6852957,TN
chr18,Bn78567,18475913,67557685,49081772,RLP
chr18,Bn78568,47333193,48801386,1468193,CN
chr18,Bn78569,72201746,76098133,3896387,CNL
chr18,Bn78570,80472897,88768176,8295279,CN
chr18,Bn78571,29369031,98129709,68760678,TNL
chr18,Bn78572,70873250,84120422,13247172,RLK
chr18,Bn78573,4835247,4925771,90524,NBS
chr18,Bn78574,66938684,80144453,13205769,NBS
chr18,Bn78575,84304945,96824368,12519423,TNL
chr18,Bn78576,66120671,93651781,27531110,TN
chr18,Bn78577,41659176,76551158,34891982,RLP
chr18,Bn78578,4548714,13933412,9384698,NBS
chr18,Bn78579,57522061,61920063,4398002,CN
chr18,Bn78580,67760147,97964684,30204537,NBS
chr18,Bn78581,24450340,78171420,53721080,NBS
chr18,Bn78582,37589188,82484136,44894948,TN
chr18,Bn78583,35375143,77494134,42118991,CN
chr18,Bn78584,2754638,22639231,19884593,RLK
chr18,Bn78585,65580712,99083573,33502861,NBS
chr18,Bn78586,23005382,31108862,8103480,NBS
chr18,Bn78587,89287853,97964437,8676584,RLP
chr18,Bn78588,62298984,81536419,19237435,NBS
chr18,Bn78589,52614299,88869027,36254728,TNL
chr18,Bn78590,72831327,89719136,16887809,CN
chr18,Bn78591,77707420,85692675,7985255,CN
chr18,Bn78592,64949520,84808853,19859333,CN
chr18,Bn78593,12657983,57012003,44354020,NBS
chr18,Bn78594,19253198,82292722,63039524,TN
chr18,Bn78595,80333557,95427050,15093493,CNL
chr18,Bn78596,72399174,91432046,19032872,TN
chr18,Bn78597,17331282,42861405,25530123,RLK
chr18,Bn78598,77174888,86682683,9507795,NBS
chr18,Bn78599,35942825,61516660,25573835,TNL
chr18,Bn78600,19512565,83093538,63580973,TN
chr18,Bn78601,66746622,71084120,4337498,NBS
chr18,Bn78602,37133159,38829173,1696014,TN
chr18,Bn78603,92760590,98973918,6213328,RLK
chr18,Bn78604,56849675,60186942,3337267,TNL
chr18,Bn78605,26385647,88359530,61973883,CNL
chr18,Bn78606,83673026,83998183,325157,NBS
chr18,Bn78607,44096356,81608777,37512421,CNL
chr18,Bn78608,70778303,87710236,16931933,RLP
chr18,Bn78609,29316860,48412563,19095703,RLK
chr18,Bn78610,64798485,97095013,32296528,TNL
chr18,Bn78611,16802772,92686889,75884117,TN
chr18,Bn78612,95082900,99410003,4327103,TNL
chr18,Bn78613,28615587,93541447,64925860,CN
chr18,Bn78614,15454289,57027438,41573149,RLK
chr18,Bn78615,24860459,25904148,1043689,RLP
chr18,Bn78616,65356539,98101705,32745166,TN
chr18,Bn78617,25659449,96131470,70472021,RLP
chr18,Bn78618,79266585,83589652,4323067,CNL
chr18,Bn78619,37013383,91489916,54476533,TNL
chr18,Bn78620,39379222,51502127,12122905,CN
chr18,Bn78621,70627208,77826968,7199760,RLP
chr18,Bn78622,27595081,48428391,20833310,CNL
chr18,Bn78623,41765321,79844470,38079149,RLP
chr18,Bn78624,13623388,73812787,60189399,CN
chr18,Bn78625,79216604,90486834,11270230,RLP
chr18,Bn78626,18629864,85890966,67261102,TN
chr18,Bn78627,34487653,37401027,2913374,CNL
chr18,Bn78628,92147872,96090680,3942808,NBS
chr18,Bn78629,49869891,84940184,35070293,TN
chr18,Bn78630,66837793,84021529,17183736,TN
chr18,Bn78631,91156434,93392517,2236083,TN
chr18,Bn78632,36526961,47256122,10729161,RLP
chr18,Bn78633,23017934,77464776,54446842,CN
chr18,Bn78634,28374537,62300285,33925748,CNL
chr18,Bn78635,28133389,59383709,31250320,RLP
chr18,Bn78636,67925858,85135297,17209439,CNL
chr18,Bn78637,11625111,32820097,21194986,TNL
chr18,Bn78638,58323036,97257597,38934561,RLK
chr18,Bn78639,88705120,90788547,2083427,CNL
chr18,Bn78640,78097184,83794935,5697751,NBS
chr18,Bn78641,1487176,58037760,56550584,NBS
chr18,Bn78642,34067868,35608930,1541062,CNL
chr18,Bn78643,51475972,74945949,23469977,RLP
chr18,Bn78644,26633434,37139550,10506116,TNL
chr18,Bn78645,59601777,80777731,21175954,RLP
chr18,Bn78646,69936208,79940668,10004460,RLP
chr18,Bn78647,11816717,79916067,68099350,TN
chr18,Bn78648,4278000,71855896,67577896,CNL
chr18,Bn78649,94111854,98477629,4365775,TN
chr18,Bn78650,55524747,86038722,30513975,CNL
chr18,Bn78651,28554957,48547031,19992074,RLK
chr18,Bn78652,69384684,80534064,11149380,CNL
chr18,Bn78653,91106013,99823129,8717116,CN
chr18,Bn78654,22562705,66796741,44234036,RLK
chr18,Bn78655,77824804,78289916,465112,RLP
chr18,Bn78656,45820382,56306466,10486084,TNL
chr18,Bn78657,85885034,92459437,6574403,CN
chr18,Bn78658,37287789,80324726,43036937,NBS
chr18,Bn78659,85852832,92641176,6788344,NBS
chr18,Bn78660,15156205,91834924,76678719,NBS
chr18,Bn78661,15625311,75822498,60197187,RLP
chr18,Bn78662,42441712,66942319,24500607,CN
chr18,Bn78663,84827816,86111921,1284105,CN
chr18,Bn78664,94018592,94778874,760282,CNL
chr18,Bn78665,87125212,98536963,11411751,TNL
chr18,Bn78666,72058066,94418032,22359966,RLK
chr18,Bn78667,97887183,98161132,273949,CN
chr18,Bn78668,82077566,93143630,11066064,NBS
chr18,Bn78669,79147105,79666257,519152,RLK
chr18,Bn78670,68678951,94115883,25436932,RLK
chr18,Bn78671,53600452,82201097,28600645,TN
chr18,Bn78672,65030773,85462207,20431434,RLP
chr18,Bn78673,84641953,90267544,5625591,TNL
chr18,Bn78674,96033626,99107380,3073754,RLP
chr18,Bn78675,89120716,97663114,8542398,RLP
chr18,Bn78676,74965277,75170415,205138,RLK
chr18,Bn78677,60017414,73487328,13469914,RLP
chr18,Bn78678,60181387,82894320,22712933,RLP
chr18,Bn78679,38153317,54706505,16553188,RLP
chr18,Bn78680,7825118,47171371,39346253,TN
chr18,Bn78681,87207651,90360732,3153081,NBS
chr18,Bn78682,6701998,45280716,38578718,RLK
chr18,Bn78683,5009232,67770860,62761628,CNL
chr18,Bn78684,28144277,37917113,9772836,TN
chr18,Bn78685,34889815,36035707,1145892,RLK
chr18,Bn78686,93800426,99566440,5766014,CNL
chr18,Bn78687,31472601,97290817,65818216,RLP
chr18,Bn78688,14968765,67829785,52861020,TNL
chr18,Bn78689,64859044,65018605,159561,RLK
chr18,Bn78690,50363489,82199137,31835648,CNL
chr18,Bn78691,31279567,66541427,35261860,TN
chr18,Bn78692,52798415,55917931,3119516,CNL
chr18,Bn78693,75270400,85234989,9964589,TN
chr18,Bn78694,6433264,61078283,54645019,RLK
chr18,Bn78695,93526413,99205618,5679205,NBS
chr18,Bn78696,84198414,91872543,7674129,RLK
chr18,Bn78697,9819238,77709329,67890091,CNL
chr18,Bn78698,73645608,98082541,24436933,TN
chr18,Bn78699,46665558,77781338,31115780,NBS
chr18,Bn78700,18179403,20206953,2027550,CNL
chr18,Bn78701,66071171,66716218,645047,CN
chr18,Bn78702,72904278,73298446,394168,TN
chr18,Bn78703,28647744,82271388,53623644,NBS
chr18,Bn78704,58805614,67560292,8754678,RLP
chr18,Bn78705,86302354,88765346,2462992,CN
chr18,Bn78706,86261908,87639040,1377132,NBS
chr18,Bn78707,41672672,44299966,2627294,TNL
chr18,Bn78708,22875514,49592826,26717312,NBS
chr18,Bn78709,68382312,72644294,4261982,TN
chr18,Bn78710,64080234,80483517,16403283,NBS
chr18,Bn78711,12211138,38652268,26441130,RLP
chr18,Bn78712,75989306,89595378,13606072,NBS
chr18,Bn78713,62081430,91879591,29798161,NBS
chr18,Bn78714,68172664,99963182,31790518,RLP
chr18,Bn78715,42971700,54411069,11439369,TNL
chr18,Bn78716,98388050,98422552,34502,NBS
chr18,Bn78717,12261013,21397606,9136593,CN
chr18,Bn78718,52084998,72022083,19937085,TNL
chr18,Bn78719,7896215,71152744,63256529,NBS
chr18,Bn78720,38477398,52545945,14068547,CN
chr18,Bn78721,18938070,46420644,27482574,RLK
chr18,Bn78722,6163967,84775889,78611922,TNL
chr18,Bn78723,47908231,71401121,23492890,CNL
chr18,Bn78724,16244442,23048822,6804380,CNL
chr18,Bn78725,57512510,81912568,24400058,TNL
chr18,Bn78726,41965246,57551285,15586039,CN
chr18,Bn78727,5039123,59687555,54648432,NBS
chr18,Bn78728,11589018,91723452,80134434,TN
chr18,Bn78729,78152590,81110342,2957752,RLP
chr18,Bn78730,66880524,72425808,5545284,NBS
chr18,Bn78731,98327346,99603221,1275875,CN
chr18,Bn78732,34947072,73456894,38509822,TNL
chr18,Bn78733,15901651,86581655,70680004,CN
chr18,Bn78734,28070256,98016445,69946189,RLK
chr18,Bn78735,99560713,99891056,330343,CN
chr18,Bn78736,83544473,99811067,16266594,RLP
chr18,Bn78737,29098385,31322470,2224085,TNL
chr18,Bn78738,78467575,81718392,3250817,TN
chr18,Bn78739,22630107,49349802,26719695,CN
chr18,Bn78740,16258325,94286823,78028498,CN
chr18,Bn78741,49174129,49569885,395756,TNL
chr18,Bn78742,30590123,78280668,47690545,TN
chr18,Bn78743,74459565,83086626,8627061,TN
chr18,Bn78744,92929736,95252784,2323048,CNL
chr18,Bn78745,87099111,92960131,5861020,RLP
chr18,Bn78746,88187027,90573742,2386715,TNL
chr18,Bn78747,30218188,94153163,63934975,TN
chr18,Bn78748,68762654,88730863,19968209,RLP
chr18,Bn78749,18728804,57602248,38873444,TN
chr18,Bn78750,94188921,99815354,5626433,CNL
chr18,Bn78751,88319034,95316405,6997371,NBS
chr18,Bn78752,32212679,55425500,23212821,TN
chr18,Bn78753,66119370,98476687,32357317,RLK
chr18,Bn78754,81525814,93983152,12457338,NBS
chr18,Bn78755,66630423,95704176,29073753,RLP
chr18,Bn78756,55221005,76487783,21266778,RLP
chr18,Bn78757,79680097,93709973,14029876,TN
chr18,Bn78758,10352477,83155399,72802922,TNL
chr18,Bn78759,61561940,74878298,13316358,RLK
chr18,Bn78760,46364090,83196707,36832617,CNL
chr18,Bn78761,63574775,89119259,25544484,RLP
chr18,Bn78762,21559477,70617406,49057929,TNL
chr18,Bn78763,46240946,87507043,41266097,NBS
chr18,Bn78764,2575417,47213768,44638351,CNL
chr18,Bn78765,5655326,73763279,68107953,TNL
chr18,Bn78766,21910787,58267592,36356805,TN
chr18,Bn78767,28580618,83127654,54547036,RLP
chr18,Bn78768,62959921,66152922,3193001,RLK
chr18,Bn78769,73640347,88744896,15104549,TN
chr18,Bn78770,52408338,73602290,21193952,CNL
chr18,Bn78771,10078219,82168672,72090453,CNL
chr18,Bn78772,14391861,32526045,18134184,RLP
chr18,Bn78773,28432445,30664101,2231656,RLP
chr18,Bn78774,38711475,96383559,57672084,TNL
chr18,Bn78775,42376338,70186462,27810124,NBS
chr18,Bn78776,29532909,37101939,7569030,TN
chr18,Bn78777,45003780,91507866,46504086,NBS
chr18,Bn78778,40682820,86539621,45856801,TNL
chr18,Bn78779,89097891,92252138,3154247,TNL
chr18,Bn78780,96753206,97676651,923445,RLP
chr18,Bn78781,64371703,92015254,27643551,CN
chr18,Bn78782,87578109,99481807,11903698,CN
chr18,Bn78783,36743239,61179113,24435874,RLK
chr18,Bn78784,8790497,61415817,52625320,RLP
chr18,Bn78785,17647072,44336479,26689407,RLP
chr18,Bn78786,18268743,23456098,5187355,CNL
chr18,Bn78787,57473750,71284259,13810509,RLK
chr18,Bn78788,51134434,97953133,46818699,RLP
chr18,Bn78789,27580776,94797964,67217188,CNL
chr18,Bn78790,43472445,84429795,40957350,TN
chr18,Bn78791,47507585,62771174,15263589,NBS
chr18,Bn78792,58066264,68454322,10388058,RLP
chr18,Bn78793,72074064,91305361,19231297,RLK
chr18,Bn78794,81179244,84387478,3208234,RLP
chr18,Bn78795,19624920,19970852,345932,CNL
chr18,Bn78796,36518418,61259181,24740763,RLP
chr18,Bn78797,63328278,66898457,3570179,TNL
chr18,Bn78798,76079774,76146133,66359,TN
chr18,Bn78799,16814293,38647673,21833380,TN
chr18,Bn78800,49390214,65174109,15783895,TN
chr18,Bn78801,86369381,94819700,8450319,TN
chr18,Bn78802,55725118,83640767,27915649,NBS
chr18,Bn78803,98240211,99884545,1644334,RLP
chr18,Bn78804,75227486,86339655,11112169,RLK
chr18,Bn78805,12671669,81257268,68585599,CNL
chr18,Bn78806,91704010,98069743,6365733,RLK
chr18,Bn78807,59743564,73400985,13657421,CNL
chr18,Bn78808,28347252,75819500,47472248,CNL
chr18,Bn78809,47076499,95848250,48771751,NBS
chr18,Bn78810,60456131,93381494,32925363,NBS
chr18,Bn78811,44008047,68796801,24788754,NBS
chr18,Bn78812,78436991,92083868,13646877,RLP
chr18,Bn78813,80822969,93812376,12989407,NBS
chr18,Bn78814,97252884,99419052,2166168,RLP
chr18,Bn78815,71228382,74012380,2783998,TNL
chr18,Bn78816,93014238,98125445,5111207,CNL
chr18,Bn78817,96994519,97364923,370404,CN
chr18,Bn78818,77128615,80991408,3862793,RLK
chr18,Bn78819,23177362,48155250,24977888,TNL
chr18,Bn78820,59790783,61512686,1721903,TN
chr18,Bn78821,15398011,65311259,49913248,RLK
chr18,Bn78822,22214319,53461478,31247159,CNL
chr18,Bn78823,9494721,52429321,42934600,RLP
chr18,Bn78824,62643211,81961601,19318390,TN
chr18,Bn78825,98058047,98947295,889248,RLK
chr18,Bn78826,44097879,65300229,21202350,NBS
chr18,Bn78827,40470756,44804234,4333478,TNL
chr18,Bn78828,20574947,94688638,74113691,CN
chr18,Bn78829,47940386,97312429,49372043,CN
chr18,Bn78830,98687759,99587924,900165,RLK
chr18,Bn78831,44558859,86173244,41614385,RLP
chr18,Bn78832,29900349,78245909,48345560,RLP
chr18,Bn78833,22250920,91206598,68955678,TNL
chr18,Bn78834,49713227,71856905,22143678,CN
chr18,Bn78835,9140336,9888313,747977,RLP
chr18,Bn78836,42787411,49138524,6351113,TNL
chr18,Bn78837,7436455,65425022,57988567,NBS
chr18,Bn78838,3681868,17430828,13748960,RLP
chr18,Bn78839,41832781,83219572,41386791,CNL
chr18,Bn78840,91420350,97327560,5907210,NBS
chr18,Bn78841,1935411,54120087,52184676,CNL
chr18,Bn78842,92349147,94513771,2164624,RLK
chr18,Bn78843,24343588,33174279,8830691,CN
chr18,Bn78844,21685428,92632876,70947448,RLK
chr18,Bn78845,58163349,68991763,10828414,TN
chr18,Bn78846,19445179,20207064,761885,RLK
chr18,Bn78847,15448474,36841070,21392596,NBS
chr18,Bn78848,14721639,32729717,18008078,TNL
chr18,Bn78849,25135821,85492437,60356616,TN
chr18,Bn78850,30306372,43688816,13382444,TN
chr18,Bn78851,27251759,87027918,59776159,CNL
chr18,Bn78852,64502311,85270043,20767732,TN
chr18,Bn78853,31653545,70225594,38572049,TN
chr18,Bn78854,53643244,72211955,18568711,CN
chr18,Bn78855,60343740,68648755,8305015,TN
chr18,Bn78856,53461008,94193627,40732619,CN
chr18,Bn78857,35886702,40410797,4524095,TNL
chr18,Bn78858,26074798,69191564,43116766,CN
chr18,Bn78859,93204711,97702210,4497499,RLP
chr18,Bn78860,15855977,71624808,55768831,TNL
chr18,Bn78861,24883646,49059004,24175358,CN
chr18,Bn78862,6239856,37623446,31383590,TNL
chr18,Bn78863,51451642,84179911,32728269,CNL
chr18,Bn78864,77266756,95263475,17996719,TN
chr18,Bn78865,64721171,66990750,2269579,NBS
chr18,Bn78866,91232847,97663759,6430912,TN
chr18,Bn78867,72178220,99158173,26979953,TN
chr18,Bn78868,32933635,86976258,54042623,NBS
chr18,Bn78869,3511137,34036811,30525674,RLK
chr18,Bn78870,14020163,77822026,63801863,CN
chr18,Bn78871,87679800,95526858,7847058,RLK
chr18,Bn78872,48007772,77601918,29594146,CNL
chr18,Bn78873,45026610,62205901,17179291,NBS
chr18,Bn78874,11868105,40969573,29101468,CNL
chr18,Bn78875,16157580,62039034,45881454,TNL
chr18,Bn78876,91105936,96610781,5504845,CNL
chr18,Bn78877,1311651,50836429,49524778,TNL
chr18,Bn78878,57306375,88128915,30822540,RLP
chr18,Bn78879,83905757,86446288,2540531,RLP
chr18,Bn78880,18246211,48107813,29861602,RLP
chr18,Bn78881,35371970,99679106,64307136,NBS
chr18,Bn78882,67439113,77807873,10368760,RLK
chr18,Bn78883,84226618,85583390,1356772,TN
chr18,Bn78884,9785664,22350759,12565095,NBS
chr18,Bn78885,64180056,68716575,4536519,RLK
chr18,Bn78886,32039505,34822256,2782751,NBS
chr18,Bn78887,26319171,57341818,31022647,RLP
chr18,Bn78888,12392578,74395347,62002769,TNL
chr18,Bn78889,67478223,90527654,23049431,RLP
chr18,Bn78890,27744366,96297905,68553539,TNL
chr18,Bn78891,24631021,73607754,48976733,TN
chr18,Bn78892,95538684,99687772,4149088,CN
chr18,Bn78893,80135770,99996263,19860493,CNL
chr18,Bn78894,73685143,84610023,10924880,RLK
chr18,Bn78895,28681118,61852672,33171554,NBS
chr18,Bn78896,80234120,95547312,15313192,NBS
chr18,Bn78897,72182031,99554636,27372605,CN
chr18,Bn78898,90806530,94976177,4169647,NBS
chr18,Bn78899,47489391,58459988,10970597,TN
chr18,Bn78900,89018805,89444332,425527,CN
chr18,Bn78901,26421459,48142554,21721095,TN
chr18,Bn78902,6446101,10039162,3593061,NBS
chr18,Bn78903,66984844,81236150,14251306,CNL
chr18,Bn78904,50774237,73553489,22779252,RLK
chr18,Bn78905,95822116,96328821,506705,TNL
chr18,Bn78906,75963649,82779790,6816141,RLP
chr18,Bn78907,40344848,58591372,18246524,CNL
chr18,Bn78908,90785224,96777767,5992543,NBS
chr18,Bn78909,28881286,73870867,44989581,NBS
chr18,Bn78910,78206984,82383240,4176256,TNL
chr18,Bn78911,1838970,6430350,4591380,CN
chr18,Bn78912,72195003,90930575,18735572,TN
chr18,Bn78913,68406418,74449275,6042857,CN
chr18,Bn78914,72202902,73260870,1057968,TN
chr18,Bn78915,74965548,98661079,23695531,RLK
chr18,Bn78916,97122306,99526641,2404335,NBS
chr18,Bn78917,97807283,99154657,1347374,CN
chr18,Bn78918,37229490,91140472,53910982,RLK
chr18,Bn78919,81013879,85950740,4936861,TN
chr18,Bn78920,82876195,96690950,13814755,RLP
chr18,Bn78921,51254764,59326216,8071452,TNL
chr18,Bn78922,53292215,70228251,16936036,TNL
chr18,Bn78923,29540669,45693464,16152795,RLK
chr18,Bn78924,26790675,37358973,10568298,CN
chr18,Bn78925,24640245,97275337,72635092,CNL
chr18,Bn78926,58447743,61222577,2774834,RLP
chr18,Bn78927,35946657,55216333,19269676,RLK
chr18,Bn78928,44861870,84596361,39734491,CNL
chr18,Bn78929,62861497,97599022,34737525,TN
chr18,Bn78930,20349215,77036593,56687378,RLK
chr18,Bn78931,68806690,69984730,1178040,CNL
chr18,Bn78932,10136150,56186112,46049962,CN
chr18,Bn78933,2304988,46430920,44125932,NBS
chr18,Bn78934,38540039,85175714,46635675,CNL
chr18,Bn78935,70683248,78374299,7691051,TN
chr18,Bn78936,89631339,98932607,9301268,CN
chr18,Bn78937,84070177,91054208,6984031,RLK
chr18,Bn78938,97103404,99691136,2587732,TN
chr18,Bn78939,5138611,35355303,30216692,RLP
chr18,Bn78940,16329823,41788401,25458578,NBS
chr18,Bn78941,47777111,93428271,45651160,RLK
chr18,Bn78942,73358552,75361491,2002939,TN
chr18,Bn78943,55615261,72375561,16760300,TN
chr18,Bn78944,35262727,71415862,36153135,CNL
chr18,Bn78945,26617278,54383400,27766122,RLK
chr18,Bn78946,16399595,73253609,56854014,CNL
chr18,Bn78947,92962183,94243994,1281811,CN
chr18,Bn78948,98068482,99913609,1845127,RLP
chr18,Bn78949,95993442,98123600,2130158,TNL
chr18,Bn78950,64650017,70576811,5926794,CN
chr18,Bn78951,1944058,69376602,67432544,CNL
chr18,Bn78952,10958356,14404684,3446328,NBS
chr18,Bn78953,96179078,97049968,870890,RLP
chr18,Bn78954,64627573,79128499,14500926,TN
chr18,Bn78955,32750671,54998439,22247768,RLP
chr18,Bn78956,80383399,94163981,13780582,RLP
chr18,Bn78957,99761152,99847931,86779,CNL
chr18,Bn78958,13340787,64302087,50961300,CNL
chr18,Bn78959,11106398,13401741,2295343,CN
chr18,Bn78960,5781009,46520117,40739108,RLK
chr18,Bn78961,63807184,67266959,3459775,TNL
chr18,Bn78962,45045608,90610023,45564415,CNL
chr18,Bn78963,43570412,66689679,23119267,TN
chr18,Bn78964,98816172,99130830,314658,RLP
chr18,Bn78965,79739330,80110599,371269,NBS
chr18,Bn78966,2005306,25652158,23646852,RLP
chr18,Bn78967,14489227,77202921,62713694,CN
chr18,Bn78968,57607378,76794770,19187392,RLP
chr18,Bn78969,75242720,82696554,7453834,NBS
chr18,Bn78970,27461873,27863732,401859,TNL
chr18,Bn78971,38464239,48081690,9617451,RLK
chr18,Bn78972,5141263,66603511,61462248,RLP
chr18,Bn78973,59314408,70938038,11623630,TN
chr18,Bn78974,18725795,42123452,23397657,CN
chr18,Bn78975,97047977,98546847,1498870,NBS
chr18,Bn78976,59496359,74397559,14901200,TNL
chr18,Bn78977,55422297,64609150,9186853,RLK
chr18,Bn78978,8190981,88915922,80724941,CNL
chr18,Bn78979,10512375,48818825,38306450,TN
chr18,Bn78980,67223833,74936506,7712673,RLP
chr18,Bn78981,22197348,86628871,64431523,NBS
chr18,Bn78982,85386513,97361330,11974817,NBS
chr18,Bn78983,66092402,75253134,9160732,CN
chr18,Bn78984,78746089,90813555,12067466,TN
chr18,Bn78985,90688683,94884350,4195667,TNL
chr18,Bn78986,51138456,74205260,23066804,TNL
chr18,Bn78987,78764911,99041528,20276617,RLP
chr18,Bn78988,52330807,75391835,23061028,RLK
chr18,Bn78989,92084168,94688996,2604828,NBS
chr18,Bn78990,69958121,78165624,8207503,TNL
chr18,Bn78991,33437554,81092836,47655282,RLP
chr18,Bn78992,37494663,40608678,3114015,CN
chr18,Bn78993,16386924,24061861,7674937,TN
chr18,Bn78994,51501620,95548689,44047069,TNL
chr18,Bn78995,21161196,96414803,75253607,TNL
chr18,Bn78996,39637088,53497350,13860262,TNL
chr18,Bn78997,82563374,98373896,15810522,RLP
chr18,Bn78998,11457935,54420994,42963059,CN
chr18,Bn78999,9842207,74335311,64493104,RLP
chr18,Bn79000,28755060,57474942,28719882,RLK
chr18,Bn79001,56849840,70102210,13252370,CNL
chr18,Bn79002,71413878,81364690,9950812,TNL
chr18,Bn79003,22394781,89046578,66651797,RLK
chr18,Bn79004,71743006,84607841,12864835,RLK
chr18,Bn79005,20779930,59086935,38307005,TNL
chr18,Bn79006,9671704,36101710,26430006,RLK
chr18,Bn79007,84618700,85843691,1224991,CN
chr18,Bn79008,8048237,62666579,54618342,CNL
chr18,Bn79009,84779086,98750072,13970986,CN
chr18,Bn79010,14722614,71824797,57102183,RLK
chr18,Bn79011,58461453,86586576,28125123,CN
chr18,Bn79012,37055495,49544826,12489331,RLP
chr18,Bn79013,45666213,68372934,22706721,CN
chr18,Bn79014,56373684,83455317,27081633,NBS
chr18,Bn79015,89657687,89943106,285419,CNL
chr18,Bn79016,48165992,94030752,45864760,RLK
chr18,Bn79017,77287590,84264417,6976827,CN
chr18,Bn79018,65133058,82448985,17315927,NBS
chr18,Bn79019,40016401,61604959,21588558,NBS
chr18,Bn79020,92563371,93543163,979792,RLK
chr18,Bn79021,84624317,99419465,14795148,RLK
chr18,Bn79022,7496911,52042184,44545273,RLK
chr18,Bn79023,26764330,32388224,5623894,TNL
chr18,Bn79024,61702475,85685635,23983160,CN
chr18,Bn79025,58833309,84758639,25925330,NBS
chr18,Bn79026,21543372,43822650,22279278,TN
chr18,Bn79027,26310860,62249833,35938973,TNL
chr18,Bn79028,90099141,98291783,8192642,CNL
chr18,Bn79029,22520523,35397204,12876681,RLK
chr18,Bn79030,26213958,53751803,27537845,RLK
chr18,Bn79031,40038679,55976292,15937613,TNL
chr18,Bn79032,18248962,46238014,27989052,TN
chr18,Bn79033,49867156,70944837,21077681,CNL
chr18,Bn79034,44537768,76515208,31977440,NBS
chr18,Bn79035,36741152,65637848,28896696,TNL
chr18,Bn79036,4625561,7491926,2866365,TN
chr18,Bn79037,56927708,94455338,37527630,TNL
chr18,Bn79038,11118177,31045666,19927489,CN
chr18,Bn79039,5330203,16881454,11551251,NBS
chr18,Bn79040,57237089,75798978,18561889,TN
chr18,Bn79041,82579072,89503361,6924289,TN
chr18,Bn79042,69225200,85129743,15904543,CNL
chr18,Bn79043,28963040,81781206,52818166,CNL
chr18,Bn79044,56085915,73341773,17255858,TN
chr18,Bn79045,68633081,81229646,12596565,NBS
chr18,Bn79046,67492716,76224182,8731466,RLP
chr18,Bn79047,54831929,62574792,7742863,CN
chr18,Bn79048,97676288,98081712,405424,TNL
chr18,Bn79049,9499758,75134843,65635085,RLP
chr18,Bn79050,57044653,72114709,15070056,RLK
chr18,Bn79051,77723997,96690445,18966448,CNL
chr18,Bn79052,23569623,80061574,56491951,RLK
chr18,Bn79053,98565186,99504481,939295,RLP
chr18,Bn79054,38115837,69163372,31047535,CNL
chr18,Bn79055,54396750,94198849,39802099,TN
chr18,Bn79056,29102107,62355217,33253110,RLP
chr18,Bn79057,40840049,74769449,33929400,CN
chr18,Bn79058,51262371,96929121,45666750,TNL
chr18,Bn79059,35302516,53543701,18241185,CNL
chr18,Bn79060,29422366,38608761,9186395,RLP
chr18,Bn79061,4537851,18482857,13945006,TN
chr18,Bn79062,40465810,63272860,22807050,NBS
chr18,Bn79063,72030462,81111829,9081367,RLP
chr18,Bn79064,72400672,94286725,21886053,TN
chr18,Bn79065,81717497,85591362,3873865,TNL
chr18,Bn79066,26030275,26105334,75059,TNL
chr18,Bn79067,19106985,39267822,20160837,CNL
chr18,Bn79068,87128841,92061609,4932768,TN
chr18,Bn79069,32606058,99320945,66714887,NBS
chr18,Bn79070,32869804,57723200,24853396,CN
chr18,Bn79071,25177673,38055016,12877343,TN
chr18,Bn79072,48937271,86420451,37483180,TN
chr18,Bn79073,45871773,81370997,35499224,RLP
chr18,Bn79074,77832050,82542101,4710051,NBS
chr18,Bn79075,70997418,81132353,10134935,RLP
chr18,Bn79076,85488953,88823176,3334223,NBS
chr18,Bn79077,15482067,63847042,48364975,TNL
chr18,Bn79078,71204433,81428471,10224038,TN
chr18,Bn79079,75920813,80943858,5023045,TN
chr18,Bn79080,49457170,76811923,27354753,TN
chr18,Bn79081,72453549,87254091,14800542,TNL
chr18,Bn79082,49529907,76886271,27356364,RLK
chr18,Bn79083,85331441,95178706,9847265,CN
chr18,Bn79084,86195890,95587428,9391538,RLK
chr18,Bn79085,32181008,94279239,62098231,CN
chr18,Bn79086,22246298,31910353,9664055,RLK
chr18,Bn79087,21406797,49387037,27980240,RLK
chr18,Bn79088,10366046,75762075,65396029,CN
chr18,Bn79089,49161344,52639531,3478187,TN
chr18,Bn79090,80107160,93762892,13655732,TNL
chr18,Bn79091,67046474,83685596,16639122,RLP
chr18,Bn79092,36156348,72203670,36047322,RLP
chr18,Bn79093,83313585,86885265,3571680,CN
chr18,Bn79094,6071826,8866947,2795121,CNL
chr18,Bn79095,70250511,85231453,14980942,RLK
chr18,Bn79096,48946629,68720138,19773509,RLK
chr18,Bn79097,35233449,58238813,23005364,TNL
chr18,Bn79098,14358158,96128785,81770627,TNL
chr18,Bn79099,39342132,55706360,16364228,CNL
chr18,Bn79100,41286700,67030076,25743376,RLP
chr18,Bn79101,29964281,99409595,69445314,RLP
chr18,Bn79102,52175034,88955890,36780856,RLK
chr18,Bn79103,42686520,98050848,55364328,CNL
chr18,Bn79104,56720243,67447957,10727714,TNL
chr18,Bn79105,60139759,99498870,39359111,RLK
chr18,Bn79106,7078441,82462878,75384437,CNL
chr18,Bn79107,75934958,98484197,22549239,NBS
chr18,Bn79108,91121102,94241065,3119963,CN
chr18,Bn79109,73515662,95544489,22028827,RLP
chr18,Bn79110,58931629,77993376,19061747,CN
chr18,Bn79111,40711437,62769491,22058054,RLP
chr18,Bn79112,65198196,88106268,22908072,RLP
chr18,Bn79113,31635700,87753245,56117545,CNL
chr18,Bn79114,80754917,92834964,12080047,CNL
chr18,Bn79115,20735906,91399763,70663857,CN
chr18,Bn79116,1917735,5697189,3779454,TNL
chr18,Bn79117,81388702,93938396,12549694,CNL
chr18,Bn79118,10977770,87594783,76617013,CN
chr18,Bn79119,4291984,8344267,4052283,CN
chr18,Bn79120,66626382,77056561,10430179,CNL
chr18,Bn79121,67966795,90046264,22079469,TNL
chr18,Bn79122,82822213,96003136,13180923,RLK
chr18,Bn79123,21718192,79392026,57673834,TNL
chr18,Bn79124,73015790,94197895,21182105,CNL
chr18,Bn79125,28328124,82990374,54662250,CN
chr18,Bn79126,60090634,65412008,5321374,CN
chr18,Bn79127,55616772,82970482,27353710,RLP
chr18,Bn79128,94426962,96879252,2452290,CN
chr18,Bn79129,10416314,44254866,33838552,TNL
chr18,Bn79130,25238766,40214171,14975405,CN
chr18,Bn79131,74996477,92165233,17168756,NBS
chr18,Bn79132,26368342,84759844,58391502,NBS
chr18,Bn79133,33052297,42743116,9690819,NBS
chr18,Bn79134,56338149,84079405,27741256,TN
chr18,Bn79135,52528210,68382462,15854252,RLP
chr18,Bn79136,33841348,69240926,35399578,TNL
chr18,Bn79137,95390591,98876849,3486258,RLK
chr18,Bn79138,32610232,94053325,61443093,RLK
chr18,Bn79139,2670569,45637923,42967354,NBS
chr18,Bn79140,50555238,75843106,25287868,CN
chr18,Bn79141,54625413,56386141,1760728,RLK
chr18,Bn79142,23864786,45706239,21841453,TN
chr18,Bn79143,91546043,97184776,5638733,RLK
chr18,Bn79144,94689201,98808834,4119633,RLK
chr18,Bn79145,2637584,40009687,37372103,RLK
chr18,Bn79146,54348343,90881203,36532860,TNL
chr18,Bn79147,75148529,86380130,11231601,NBS
chr18,Bn79148,29589953,78677042,49087089,RLP
chr18,Bn79149,88039445,92302615,4263170,RLK
chr18,Bn79150,51606023,59135754,7529731,TNL
chr18,Bn79151,1511607,86223763,84712156,NBS
chr18,Bn79152,47756199,68946590,21190391,TNL
chr18,Bn79153,23704896,68000340,44295444,RLK
chr18,Bn79154,52661803,68772461,16110658,CNL
chr18,Bn79155,98738597,98903470,164873,RLK
chr18,Bn79156,82754151,99911016,17156865,TN
chr18,Bn79157,96242371,98363361,2120990,CN
chr18,Bn79158,4086808,51837224,47750416,RLK
chr18,Bn79159,58432768,77053124,18620356,RLK
chr18,Bn79160,83160912,83835746,674834,NBS
chr18,Bn79161,36357717,52317326,15959609,TNL
chr18,Bn79162,31467846,88300378,56832532,NBS
chr18,Bn79163,63123967,90353429,27229462,CNL
chr18,Bn79164,38888129,39914543,1026414,RLP
chr18,Bn79165,68198717,87161021,18962304,NBS
chr18,Bn79166,67408565,90946027,23537462,NBS
chr18,Bn79167,95744339,99070953,3326614,TNL
chr18,Bn79168,54970659,95242518,40271859,RLK
chr18,Bn79169,40337255,81803328,41466073,TN
chr18,Bn79170,80680605,82954451,2273846,RLK
chr18,Bn79171,73802660,99408484,25605824,NBS
chr18,Bn79172,27782404,62860051,35077647,RLP
chr18,Bn79173,16718107,17408785,690678,TN
chr18,Bn79174,77899988,90021696,12121708,CN
chr18,Bn79175,36478168,69785415,33307247,RLP
chr18,Bn79176,58421523,76806323,18384800,TNL
chr18,Bn79177,52144547,88450884,36306337,TNL
chr18,Bn79178,4344287,75766845,71422558,NBS
chr18,Bn79179,2080173,26657054,24576881,TN
chr18,Bn79180,2070469,98314700,96244231,RLP
chr18,Bn79181,49169320,69235755,20066435,RLP
chr18,Bn79182,65198978,74555431,9356453,NBS
chr18,Bn79183,24069379,80938333,56868954,RLP
chr18,Bn79184,23185008,30444328,7259320,RLP
chr18,Bn79185,80370103,84688538,4318435,CN
chr18,Bn79186,98834273,99568335,734062,NBS
chr18,Bn79187,27554620,89177048,61622428,CN
chr18,Bn79188,4446638,30670042,26223404,NBS
chr18,Bn79189,72721059,98961490,26240431,RLP
chr18,Bn79190,51277706,67271445,15993739,CNL
chr18,Bn79191,29411596,74549047,45137451,RLP
chr18,Bn79192,55624772,64408478,8783706,RLK
chr18,Bn79193,25659906,44283726,18623820,TN
chr18,Bn79194,63983100,88685091,24701991,RLP
chr18,Bn79195,84778204,95439595,10661391,TN
chr18,Bn79196,30843709,38985355,8141646,CN
chr18,Bn79197,72316323,94284936,21968613,NBS
chr18,Bn79198,96833954,99388223,2554269,NBS
chr18,Bn79199,44662737,54501987,9839250,RLP
chr18,Bn79200,53409402,53719776,310374,CNL
chr18,Bn79201,35578981,57781950,22202969,CN
chr18,Bn79202,74348763,85058165,10709402,TN
chr18,Bn79203,67669566,74184184,6514618,TNL
chr18,Bn79204,21696773,90171189,68474416,RLP
chr18,Bn79205,78799132,99480231,20681099,RLP
chr18,Bn79206,15607981,43432787,27824806,NBS
chr18,Bn79207,58225744,84734879,26509135,RLK
chr18,Bn79208,78404466,98020367,19615901,RLP
chr18,Bn79209,42800658,69910155,27109497,RLP
chr18,Bn79210,74439440,78144193,3704753,TN
chr18,Bn79211,17477896,66239273,48761377,RLK
chr18,Bn79212,22908936,96898851,73989915,TNL
chr18,Bn79213,70193181,83144863,12951682,CN
chr18,Bn79214,26613861,70964815,44350954,NBS
chr18,Bn79215,79802975,88123116,8320141,TNL
chr18,Bn79216,18172891,80203685,62030794,RLK
chr18,Bn79217,96459751,97251381,791630,TN
chr18,Bn79218,76217973,99029176,22811203,TNL
chr18,Bn79219,74294313,92515757,18221444,TN
chr18,Bn79220,82346319,82371331,25012,RLP
chr18,Bn79221,80325029,91898993,11573964,NBS
chr18,Bn79222,73215382,96011519,22796137,RLK
chr18,Bn79223,74741336,82325691,7584355,NBS
chr18,Bn79224,42725456,43589467,864011,TN
chr18,Bn79225,31116138,87878522,56762384,CNL
chr18,Bn79226,29852804,76930263,47077459,CN
chr18,Bn79227,21827523,99559971,77732448,RLK
chr18,Bn79228,73132477,95499485,22367008,CN
chr18,Bn79229,62443078,73294870,10851792,RLK
chr18,Bn79230,76689638,77693728,1004090,RLK
chr18,Bn79231,30289115,69695878,39406763,NBS
chr18,Bn79232,11258415,97521945,86263530,NBS
chr18,Bn79233,72375216,73611436,1236220,CNL
chr18,Bn79234,85806854,88098830,2291976,RLP
chr18,Bn79235,27200185,78491373,51291188,RLP
chr18,Bn79236,75372162,81207442,5835280,NBS
chr18,Bn79237,76696287,83403013,6706726,CNL
chr18,Bn79238,44278761,50148103,5869342,NBS
chr18,Bn79239,23661677,73834209,50172532,TNL
chr18,Bn79240,65728510,68665486,2936976,CN
chr18,Bn79241,70074494,83672389,13597895,NBS
chr18,Bn79242,68197376,97833860,29636484,RLK
chr18,Bn79243,42397693,96001720,53604027,RLK
chr18,Bn79244,79531195,83622468,4091273,TN
chr18,Bn79245,62297172,76676204,14379032,CNL
chr18,Bn79246,24640771,89282066,64641295,NBS
chr18,Bn79247,46814771,54886367,8071596,CNL
chr18,Bn79248,22865679,67063484,44197805,RLK
chr18,Bn79249,78587324,82925084,4337760,CN
chr18,Bn79250,1314664,7547317,6232653,TNL
chr18,Bn79251,30016437,67074020,37057583,CNL
chr18,Bn79252,73469136,89306080,15836944,NBS
chr18,Bn79253,72584343,90505827,17921484,TN
chr18,Bn79254,79208373,98870949,19662576,NBS
chr18,Bn79255,93965390,96147886,2182496,RLP
chr18,Bn79256,26083093,36382774,10299681,RLK
chr18,Bn79257,86691688,98141109,11449421,RLP
chr18,Bn79258,17549040,19844213,2295173,RLK
chr18,Bn79259,20254739,23214045,2959306,RLP
chr18,Bn79260,81771214,99479120,17707906,RLP
chr18,Bn79261,91662337,96930950,5268613,TNL
chr18,Bn79262,8040008,60439088,52399080,CNL
chr18,Bn79263,71915302,74695129,2779827,CN
chr18,Bn79264,85165093,99492809,14327716,TNL
chr18,Bn79265,30902920,86396907,55493987,CN
chr18,Bn79266,34694857,45895934,11201077,CN
chr18,Bn79267,1213206,45086161,43872955,TNL
chr18,Bn79268,60241605,68328820,8087215,CN
chr18,Bn79269,21858551,66092930,44234379,TNL
chr18,Bn79270,13554236,21538348,7984112,CN
chr18,Bn79271,42202828,58225458,16022630,NBS
chr18,Bn79272,89441163,98627935,9186772,TN
chr18,Bn79273,41263124,76528235,35265111,CN
chr18,Bn79274,84714259,90739367,6025108,CNL
chr18,Bn79275,83665234,88020661,4355427,RLK
chr18,Bn79276,38202086,38423960,221874,RLK
chr18,Bn79277,62863491,98543183,35679692,TN
chr18,Bn79278,97805344,97995671,190327,CNL
chr18,Bn79279,26926163,96325249,69399086,RLP
chr18,Bn79280,17784631,66344822,48560191,CNL
chr18,Bn79281,24273977,31311195,7037218,RLP
chr18,Bn79282,71173503,99466864,28293361,RLP
chr18,Bn79283,98387651,99782644,1394993,TN
chr18,Bn79284,87438292,95412384,7974092,RLP
chr18,Bn79285,27684048,62285373,34601325,RLP
chr18,Bn79286,69282296,97656796,28374500,TN
chr18,Bn79287,86622973,89929921,3306948,CN
chr18,Bn79288,31108515,65809340,34700825,TN
chr18,Bn79289,10249796,68043725,57793929,RLK
chr18,Bn79290,74093674,89187105,15093431,RLP
chr18,Bn79291,44669245,94950741,50281496,RLP
chr18,Bn79292,4405101,9760956,5355855,NBS
chr18,Bn79293,93915289,99651536,5736247,RLP
chr18,Bn79294,25336213,73514507,48178294,TN
chr18,Bn79295,87536428,92428720,4892292,NBS
chr18,Bn79296,50314909,65706552,15391643,TN
chr18,Bn79297,27773989,79504779,51730790,CN
chr18,Bn79298,90651856,91795248,1143392,TN
chr18,Bn79299,5317797,80229342,74911545,CN
chr18,Bn79300,36200459,54563426,18362967,NBS
chr18,Bn79301,52029247,91532519,39503272,NBS
chr18,Bn79302,10944014,22682836,11738822,RLK
chr18,Bn79303,44034392,60353572,16319180,RLP
chr18,Bn79304,75452904,95763929,20311025,TNL
chr18,Bn79305,13039172,15765254,2726082,TNL
chr18,Bn79306,39073283,65765998,26692715,RLP
chr18,Bn79307,71192216,74188193,2995977,TNL
chr18,Bn79308,68259319,72910742,4651423,NBS
chr18,Bn79309,94977158,98802756,3825598,CNL
chr18,Bn79310,12505832,75040067,62534235,TN
chr18,Bn79311,1071146,71395164,70324018,NBS
chr18,Bn79312,82029599,84353994,2324395,TNL
chr18,Bn79313,8536335,42482419,33946084,TN
chr18,Bn79314,62723509,77070581,14347072,CNL
chr18,Bn79315,57934516,80745985,22811469,RLP
chr18,Bn79316,47194233,77892249,30698016,CNL
chr18,Bn79317,92419109,98691679,6272570,CN
chr18,Bn79318,66093598,71686764,5593166,TN
chr18,Bn79319,92358090,93536262,1178172,CNL
chr18,Bn79320,71044888,85087109,14042221,TNL
chr18,Bn79321,30005937,66841536,36835599,TNL
chr18,Bn79322,43070305,89363566,46293261,CN
chr18,Bn79323,13479988,92471813,78991825,RLP
chr18,Bn79324,81268955,89193771,7924816,TNL
chr18,Bn79325,93203585,96658342,3454757,CN
chr18,Bn79326,27104243,46329471,19225228,NBS
chr18,Bn79327,85809404,98414744,12605340,CNL
chr18,Bn79328,20856514,44373757,23517243,CNL
chr18,Bn79329,46534550,53232797,6698247,NBS
chr18,Bn79330,11613742,37764479,26150737,RLP
chr18,Bn79331,14561006,18913306,4352300,TNL
chr18,Bn79332,19581970,55436495,35854525,RLK
chr18,Bn79333,14688048,57002459,42314411,CNL
chr18,Bn79334,66375361,66889518,514157,NBS
chr18,Bn79335,31542929,72444980,40902051,CN
chr18,Bn79336,10248811,53671626,43422815,TNL
chr18,Bn79337,9247366,96939899,87692533,CN
chr18,Bn79338,85862110,97264042,11401932,CNL
chr18,Bn79339,32154770,51157533,19002763,CNL
chr18,Bn79340,22582596,41443947,18861351,TN
chr18,Bn79341,84188420,86078863,1890443,CN
chr18,Bn79342,48690528,53861207,5170679,CN
chr18,Bn79343,73384325,97725098,24340773,RLK
chr18,Bn79344,76372042,86912175,10540133,RLK
chr18,Bn79345,73732915,91461256,17728341,TNL
chr18,Bn79346,30210380,78195693,47985313,TN
chr18,Bn79347,96388935,98597274,2208339,RLP
chr18,Bn79348,68882026,73831086,4949060,RLP
chr18,Bn79349,66074585,78130452,12055867,CNL
chr18,Bn79350,46537403,91252498,44715095,TN
chr18,Bn79351,26637778,90858357,64220579,TN
chr18,Bn79352,48166306,61130160,12963854,RLP
chr18,Bn79353,91587182,91645503,58321,NBS
chr18,Bn79354,17091008,20117847,3026839,RLP
chr18,Bn79355,73367861,74201484,833623,TNL
chr18,Bn79356,30781756,95779517,64997761,RLK
chr18,Bn79357,92485278,94205995,1720717,CNL
chr18,Bn79358,87017019,89162746,2145727,CN
chr18,Bn79359,39275041,54208313,14933272,RLP
chr18,Bn79360,38249558,63731657,25482099,RLP
chr18,Bn79361,86032210,90940709,4908499,NBS
chr18,Bn79362,99028042,99951358,923316,TN
chr18,Bn79363,9185525,46881869,37696344,NBS
chr18,Bn79364,33963797,93465963,59502166,CNL
chr18,Bn79365,19219892,86428100,67208208,NBS
chr18,Bn79366,87602833,89333445,1730612,RLK
chr18,Bn79367,39690851,84887049,45196198,TNL
chr18,Bn79368,31193268,71586652,40393384,RLK
chr18,Bn79369,29438908,64856731,35417823,RLP
chr18,Bn79370,89030206,96112202,7081996,TN
chr18,Bn79371,53995201,91325103,37329902,TNL
chr18,Bn79372,11393035,92649510,81256475,CN
chr18,Bn79373,24749618,35711609,10961991,RLK
chr18,Bn79374,44501818,70581367,26079549,NBS
chr18,Bn79375,58659996,86878021,28218025,RLP
chr18,Bn79376,36160855,98371068,62210213,RLK
chr18,Bn79377,48390564,98100884,49710320,CN
chr18,Bn79378,70985893,98076587,27090694,TN
chr18,Bn79379,60838268,79352390,18514122,TNL
chr18,Bn79380,65836148,86179539,20343391,NBS
chr18,Bn79381,23836554,24129305,292751,TNL
chr18,Bn79382,5657001,8270026,2613025,RLK
chr18,Bn79383,6127965,70782542,64654577,NBS
chr18,Bn79384,33760640,86081019,52320379,TNL
chr18,Bn79385,63576706,66076407,2499701,RLP
chr18,Bn79386,94130784,96369497,2238713,TNL
chr18,Bn79387,72666915,87409988,14743073,TN
chr18,Bn79388,44511119,68844554,24333435,RLK
chr18,Bn79389,58465426,62992046,4526620,CNL
chr18,Bn79390,51289763,74668229,23378466,RLP
chr18,Bn79391,17387689,54157125,36769436,NBS
chr18,Bn79392,60159665,78733875,18574210,TN
chr18,Bn79393,92745539,98346782,5601243,CN
chr18,Bn79394,88462629,88974371,511742,NBS
chr18,Bn79395,97439251,99135143,1695892,RLP
chr18,Bn79396,65929897,81828085,15898188,NBS
chr18,Bn79397,23872754,28161974,4289220,CN
chr18,Bn79398,36033717,89711916,53678199,CN
chr18,Bn79399,71214081,90351524,19137443,CNL
chr18,Bn79400,45518244,54497497,8979253,CN
chr18,Bn79401,19002904,71990072,52987168,CNL
chr18,Bn79402,59739346,82224823,22485477,CN
chr18,Bn79403,26495295,42931437,16436142,RLP
chr18,Bn79404,49919657,63553240,13633583,CNL
chr18,Bn79405,58432708,61500378,3067670,TN
chr18,Bn79406,58584082,60908300,2324218,RLK
chr18,Bn79407,67293326,95401210,28107884,CN
chr18,Bn79408,2363551,18805108,16441557,CN
chr18,Bn79409,82199512,88153150,5953638,CN
chr18,Bn79410,78497154,99940923,21443769,NBS
chr18,Bn79411,23434348,85609734,62175386,RLK
chr18,Bn79412,38860269,54705901,15845632,NBS
chr18,Bn79413,92879522,97469942,4590420,RLK
chr18,Bn79414,45222857,89621869,44399012,TN
chr18,Bn79415,99435930,99723242,287312,RLK
chr18,Bn79416,5903646,69137924,63234278,CNL
chr18,Bn79417,39184340,48955580,9771240,RLP
chr18,Bn79418,30536912,53330195,22793283,CNL
chr18,Bn79419,12286175,29632893,17346718,TN
chr18,Bn79420,43784743,82880803,39096060,TN
chr18,Bn79421,73713528,78156623,4443095,TNL
chr18,Bn79422,76908730,98211465,21302735,CN
chr18,Bn79423,88817372,95038731,6221359,CN
chr18,Bn79424,18125798,34204594,16078796,TN
chr18,Bn79425,21288188,56407964,35119776,RLP
chr18,Bn79426,57667056,92282511,34615455,RLP
chr18,Bn79427,40217136,58491795,18274659,RLK
chr18,Bn79428,65062313,70171902,5109589,NBS
chr18,Bn79429,37837884,40048216,2210332,NBS
chr18,Bn79430,32615484,82627782,50012298,RLK
chr18,Bn79431,51352558,77617028,26264470,RLK
chr18,Bn79432,85333705,90835299,5501594,RLK
chr18,Bn79433,86615742,91240806,4625064,NBS
chr18,Bn79434,2865835,23851815,20985980,TN
chr18,Bn79435,98553758,98996703,442945,TN
chr18,Bn79436,99548160,99872113,323953,RLK
chr18,Bn79437,57616251,82689184,25072933,TN
chr18,Bn79438,29829309,67068240,37238931,RLK
chr18,Bn79439,41774109,96845322,55071213,CNL
chr18,Bn79440,54357869,65447466,11089597,TNL
chr18,Bn79441,63670177,83021936,19351759,NBS
chr18,Bn79442,32661497,87341477,54679980,CN
chr18,Bn79443,37463464,58704636,21241172,RLK
chr18,Bn79444,70709763,93158643,22448880,TNL
chr18,Bn79445,41027562,75899922,34872360,NBS
chr18,Bn79446,77260455,80935315,3674860,NBS
chr18,Bn79447,43439791,97754529,54314738,CNL
chr18,Bn79448,78532724,97363060,18830336,NBS
chr18,Bn79449,37995801,98515207,60519406,RLP
chr18,Bn79450,90555367,98174519,7619152,NBS
chr18,Bn79451,11427156,85245915,73818759,CN
chr18,Bn79452,81307214,84793798,3486584,RLK
chr18,Bn79453,88476689,90036365,1559676,RLP
chr18,Bn79454,10962870,30198645,19235775,TNL
chr18,Bn79455,86948582,91481550,4532968,CN
chr18,Bn79456,70125514,96054679,25929165,RLK
chr18,Bn79457,86787360,93486243,6698883,RLP
chr18,Bn79458,13415054,86963047,73547993,CN
chr18,Bn79459,20733064,68831603,48098539,TN
chr18,Bn79460,86089216,91542385,5453169,TNL
chr18,Bn79461,26086936,95018547,68931611,RLK
chr18,Bn79462,97136509,98914644,1778135,RLK
chr18,Bn79463,11813800,25378410,13564610,NBS
chr18,Bn79464,41860261,85153786,43293525,CNL
chr18,Bn79465,26861544,29697125,2835581,RLK
chr18,Bn79466,75257101,87127009,11869908,TNL
chr18,Bn79467,62326117,79131542,16805425,RLP
chr18,Bn79468,27365590,67078123,39712533,RLP
chr18,Bn79469,78181499,83475354,5293855,TN
chr18,Bn79470,13321187,97683233,84362046,TN
chr18,Bn79471,66202817,89446445,23243628,NBS
chr18,Bn79472,13487863,89042879,75555016,TN
chr18,Bn79473,54682326,80525250,25842924,TNL
chr18,Bn79474,31950238,97338775,65388537,RLP
chr18,Bn79475,54108893,99689662,45580769,TNL
chr18,Bn79476,30099264,89546160,59446896,RLP
chr18,Bn79477,9286805,25356633,16069828,CN
chr18,Bn79478,76662031,91274753,14612722,CN
chr18,Bn79479,95721884,95764528,42644,TNL
chr18,Bn79480,94371128,94407729,36601,RLK
chr18,Bn79481,26358868,64977788,38618920,RLP
chr18,Bn79482,62056896,70558560,8501664,CN
chr18,Bn79483,2300970,19673894,17372924,CNL
chr18,Bn79484,14909113,33407081,18497968,CN
chr18,Bn79485,53496806,80558767,27061961,CNL
chr18,Bn79486,64219819,78675181,14455362,RLK
chr18,Bn79487,33510243,77213586,43703343,CN
chr18,Bn79488,27528352,28299003,770651,RLK
chr18,Bn79489,88396656,97566750,9170094,TNL
chr18,Bn79490,27206885,29357685,2150800,CNL
chr18,Bn79491,32272213,41067901,8795688,TN
chr18,Bn79492,20308713,54421228,34112515,TNL
chr18,Bn79493,98243457,99958749,1715292,CNL
chr18,Bn79494,60351002,87870787,27519785,TN
chr18,Bn79495,10185036,63104567,52919531,NBS
chr18,Bn79496,83205486,87143836,3938350,NBS
chr18,Bn79497,99118533,99168726,50193,CNL
chr18,Bn79498,70923878,95353652,24429774,RLK
chr18,Bn79499,77953408,90865440,12912032,TN
chr18,Bn79500,21669567,51729995,30060428,RLP
chr18,Bn79501,8931672,96067322,87135650,RLP
chr18,Bn79502,66553088,73453532,6900444,TN
chr18,Bn79503,76892491,87958226,11065735,NBS
chr18,Bn79504,17592496,95484710,77892214,NBS
chr18,Bn79505,10016570,21980832,11964262,RLK
chr18,Bn79506,56271984,64212213,7940229,TNL
chr18,Bn79507,19247273,73090211,53842938,RLP
chr18,Bn79508,13648549,28873482,15224933,TN
chr18,Bn79509,86575881,92423279,5847398,TN
chr18,Bn79510,9312229,70185719,60873490,CNL
chr18,Bn79511,48765999,52327290,3561291,RLK
chr18,Bn79512,5932989,59082114,53149125,RLK
chr18,Bn79513,35432593,74372605,38940012,NBS
chr18,Bn79514,75250334,95176230,19925896,CN
chr18,Bn79515,30327892,83107399,52779507,RLP
chr18,Bn79516,40380480,62913238,22532758,CNL
chr18,Bn79517,99223763,99333596,109833,NBS
chr18,Bn79518,53002628,73042681,20040053,CNL
chr18,Bn79519,84076439,85380476,1304037,RLP
chr18,Bn79520,42901848,52218002,9316154,CN
chr18,Bn79521,5895438,54474136,48578698,RLK
chr18,Bn79522,48591828,97361331,48769503,CN
chr18,Bn79523,67313110,75009722,7696612,RLK
chr18,Bn79524,34309446,96089195,61779749,TNL
chr18,Bn79525,67821595,70539143,2717548,TN
chr18,Bn79526,85899311,89532245,3632934,RLK
chr18,Bn79527,40800881,65261043,24460162,TN
chr18,Bn79528,22148508,46335634,24187126,TNL
chr18,Bn79529,21849811,65957953,44108142,TN
chr18,Bn79530,42359770,79154902,36795132,TN
chr18,Bn79531,11716581,44920483,33203902,RLK
chr18,Bn79532,61061122,68543879,7482757,TNL
chr18,Bn79533,36117746,95149519,59031773,CN
chr18,Bn79534,90731578,92332807,1601229,TN
chr18,Bn79535,50439570,71106386,20666816,NBS
chr18,Bn79536,2478816,12051063,9572247,NBS
chr18,Bn79537,4761683,92688217,87926534,TN
chr18,Bn79538,70479401,91956208,21476807,TNL
chr18,Bn79539,59951697,81489484,21537787,RLP
chr18,Bn79540,28423348,94502060,66078712,TN
chr18,Bn79541,10918355,25781027,14862672,RLP
chr18,Bn79542,33803448,77514729,43711281,CN
chr18,Bn79543,25408302,82533396,57125094,CN
chr18,Bn79544,64097053,69625749,5528696,TNL
chr18,Bn79545,56017395,58357750,2340355,RLP
chr18,Bn79546,37225688,49217296,11991608,NBS
chr18,Bn79547,81531876,85741678,4209802,RLP
chr18,Bn79548,56180519,68302135,12121616,TN
chr18,Bn79549,92473780,98912420,6438640,TNL
chr18,Bn79550,92385697,92988718,603021,NBS
chr18,Bn79551,3311437,83627271,80315834,RLP
chr18,Bn79552,98662312,99727978,1065666,CN
chr18,Bn79553,6176198,65435072,59258874,RLK
chr18,Bn79554,71225987,79087343,7861356,NBS
chr18,Bn79555,25732558,49562381,23829823,NBS
chr18,Bn79556,58765170,66193529,7428359,CNL
chr18,Bn79557,94810516,97816739,3006223,RLP
chr18,Bn79558,13100969,67667892,54566923,RLK
chr18,Bn79559,57152077,67107076,9954999,RLK
chr18,Bn79560,51262027,58340925,7078898,TNL
chr18,Bn79561,21810840,46086088,24275248,NBS
chr18,Bn79562,64271742,87664582,23392840,RLP
chr18,Bn79563,82482361,93366293,10883932,RLK
chr18,Bn79564,39793163,97411688,57618525,CNL
chr18,Bn79565,48220206,66801912,18581706,RLP
chr18,Bn79566,74378248,95713614,21335366,TNL
chr18,Bn79567,39336704,52615446,13278742,CNL
chr18,Bn79568,89385550,99339255,9953705,CNL
chr18,Bn79569,85424652,96085486,10660834,NBS
chr18,Bn79570,48532084,55986813,7454729,TNL
chr18,Bn79571,8671113,56272983,47601870,TN
chr18,Bn79572,44807930,65074144,20266214,TN
chr18,Bn79573,33449869,63537573,30087704,CNL
chr18,Bn79574,49492550,81748915,32256365,NBS
chr18,Bn79575,79000641,90982701,11982060,RLK
chr18,Bn79576,63199497,80006756,16807259,NBS
chr18,Bn79577,66731410,96114443,29383033,CN
chr18,Bn79578,57155599,80269618,23114019,CNL
chr18,Bn79579,92878898,99295989,6417091,TNL
chr18,Bn79580,8566342,39323167,30756825,CNL
chr18,Bn79581,22297392,25928952,3631560,RLP
chr18,Bn79582,12109440,23140821,11031381,RLK
chr18,Bn79583,86740307,91768593,5028286,RLP
chr18,Bn79584,72806767,80078909,7272142,RLK
chr18,Bn79585,18428686,22446539,4017853,RLK
chr18,Bn79586,34453466,50599163,16145697,CNL
chr18,Bn79587,75041056,85514898,10473842,NBS
chr18,Bn79588,44278390,71467819,27189429,CN
chr18,Bn79589,2342798,49408059,47065261,TN
chr18,Bn79590,99129586,99685057,555471,RLK
chr18,Bn79591,31753194,70925001,39171807,TN
chr18,Bn79592,28621362,84069351,55447989,TNL
chr18,Bn79593,26323447,74824029,48500582,CN
chr18,Bn79594,46473927,87390357,40916430,RLP
chr18,Bn79595,10535721,59989399,49453678,RLP
chr18,Bn79596,13517724,61318497,47800773,CN
chr18,Bn79597,26336359,90516830,64180471,RLK
chr18,Bn79598,83863175,94779134,10915959,CNL
chr18,Bn79599,40786500,88357979,47571479,CNL
chr18,Bn79600,70875624,90461241,19585617,CN
chr18,Bn79601,24146166,79526761,55380595,NBS
chr18,Bn79602,31080358,68996813,37916455,CNL
chr18,Bn79603,63143892,86067584,22923692,CNL
chr18,Bn79604,78918224,90690384,11772160,TNL
chr18,Bn79605,79331647,99541068,20209421,CNL
chr18,Bn79606,48157759,91221328,43063569,TN
chr18,Bn79607,8991028,23491631,14500603,CN
chr18,Bn79608,16364716,31863552,15498836,NBS
chr18,Bn79609,90664164,97990912,7326748,TN
chr18,Bn79610,77251149,79338647,2087498,CNL
chr18,Bn79611,71816095,71874311,58216,TN
chr18,Bn79612,41834385,49853936,8019551,RLK
chr18,Bn79613,96469963,98406902,1936939,CN
chr18,Bn79614,94228930,96656796,2427866,TNL
chr18,Bn79615,68069542,81959511,13889969,TN
chr18,Bn79616,99287190,99746251,459061,RLK
chr18,Bn79617,6100050,65192780,59092730,RLK
chr18,Bn79618,99299259,99905981,606722,TNL
chr18,Bn79619,64618004,84574366,19956362,TN
chr18,Bn79620,79831866,87210483,7378617,TNL
chr18,Bn79621,4988327,67695463,62707136,NBS
chr18,Bn79622,38109102,67953246,29844144,CN
chr18,Bn79623,52425080,95609115,43184035,RLK
chr18,Bn79624,44679657,59424028,14744371,CN
chr18,Bn79625,46106312,62717522,16611210,CNL
chr18,Bn79626,3367234,3658112,290878,CN
chr18,Bn79627,13877079,39630595,25753516,TNL
chr18,Bn79628,56655650,77066159,20410509,TNL
chr18,Bn79629,60778181,72108887,11330706,CNL
chr18,Bn79630,11497476,74962090,63464614,NBS
chr18,Bn79631,18077492,42478954,24401462,NBS
chr18,Bn79632,3669942,14531444,10861502,TNL
chr18,Bn79633,94946772,96204248,1257476,NBS
chr18,Bn79634,27257681,91404755,64147074,NBS
chr18,Bn79635,4652519,89372726,84720207,TNL
chr18,Bn79636,50216131,93288429,43072298,TN
chr18,Bn79637,11914476,80013418,68098942,NBS
chr18,Bn79638,46388896,94127684,47738788,CNL
chr18,Bn79639,17215403,33247747,16032344,TN
chr18,Bn79640,11416793,19312952,7896159,RLK
chr18,Bn79641,54758444,89324524,34566080,CN
chr18,Bn79642,67383806,80602231,13218425,RLK
chr18,Bn79643,70688603,81696116,11007513,TNL
chr18,Bn79644,12898959,57790700,44891741,CN
chr18,Bn79645,58904183,80930962,22026779,TN
chr18,Bn79646,2802564,28340743,25538179,NBS
chr18,Bn79647,18856502,20033986,1177484,TN
chr18,Bn79648,93481219,93576869,95650,CN
chr18,Bn79649,46415836,70626721,24210885,TN
chr18,Bn79650,45917085,71574736,25657651,RLK
chr18,Bn79651,23567851,58674427,35106576,TN
chr18,Bn79652,95415203,97486104,2070901,NBS
chr18,Bn79653,13667547,93913820,80246273,TN
chr18,Bn79654,68881155,86772958,17891803,RLP
chr18,Bn79655,13616539,87720590,74104051,RLK
chr18,Bn79656,28317456,94275374,65957918,RLK
chr18,Bn79657,50697051,53988256,3291205,TN
chr18,Bn79658,93943026,98484602,4541576,NBS
chr18,Bn79659,58917515,89903185,30985670,TN
chr18,Bn79660,64975287,74410449,9435162,TNL
chr18,Bn79661,78780645,92870728,14090083,TN
chr18,Bn79662,36317326,87414455,51097129,RLK
chr18,Bn79663,19863356,82984401,63121045,TNL
chr18,Bn79664,87622363,97561673,9939310,NBS
chr18,Bn79665,27024325,28339215,1314890,TN
chr18,Bn79666,17861200,57604267,39743067,CN
chr18,Bn79667,67053273,68735831,1682558,TNL
chr18,Bn79668,86965379,94358136,7392757,TN
chr18,Bn79669,52391345,67634447,15243102,CNL
chr18,Bn79670,37253656,52062330,14808674,CN
chr18,Bn79671,81547049,85544581,3997532,RLK
chr18,Bn79672,68225775,72890947,4665172,TNL
chr18,Bn79673,77168343,99656643,22488300,RLP
chr18,Bn79674,6978792,24067189,17088397,TNL
chr18,Bn79675,72905306,78813939,5908633,TNL
chr18,Bn79676,68389718,88951593,20561875,RLK
chr18,Bn79677,77524850,85379222,7854372,CNL
chr18,Bn79678,60040683,96962782,36922099,RLP
chr18,Bn79679,89057212,89547229,490017,TN
chr18,Bn79680,21532246,84232774,62700528,CNL
chr18,Bn79681,43874114,87933031,44058917,NBS
chr18,Bn79682,11861263,41157102,29295839,TN
chr18,Bn79683,86370707,95290999,8920292,RLK
chr18,Bn79684,54057527,91269239,37211712,RLK
chr18,Bn79685,48910199,60843461,11933262,CNL
chr18,Bn79686,99338887,99560937,222050,RLP
chr18,Bn79687,9910392,48911922,39001530,RLP
chr18,Bn79688,82266453,83497457,1231004,RLK
chr18,Bn79689,80398414,96536548,16138134,RLP
chr18,Bn79690,14211354,52141454,37930100,RLP
chr18,Bn79691,49925560,60095869,10170309,TNL
chr18,Bn79692,83322888,92620456,9297568,RLK
chr18,Bn79693,87237160,93034265,5797105,TN
chr18,Bn79694,29376218,33281287,3905069,NBS
chr18,Bn79695,53534501,88648164,35113663,TN
chr18,Bn79696,29263354,30065491,802137,RLP
chr18,Bn79697,47868309,77927011,30058702,RLP
chr18,Bn79698,40734125,50196314,9462189,CN
chr18,Bn79699,71543631,93000665,21457034,TNL
chr18,Bn79700,37745483,86096486,48351003,RLK
chr18,Bn79701,80140662,89916014,9775352,RLK
chr18,Bn79702,15594238,80532511,64938273,RLP
chr18,Bn79703,57437068,59307163,1870095,NBS
chr18,Bn79704,86355320,93050744,6695424,RLK
chr18,Bn79705,59133723,66411386,7277663,CN
chr18,Bn79706,19808189,35927476,16119287,RLP
chr18,Bn79707,17251130,69786353,52535223,CNL
chr18,Bn79708,85100587,98852965,13752378,RLP
chr18,Bn79709,18611118,70945482,52334364,RLP
chr18,Bn79710,96730276,97776307,1046031,RLK
chr18,Bn79711,82633918,95268022,12634104,NBS
chr18,Bn79712,87212663,95675167,8462504,CNL
chr18,Bn79713,4529269,26080551,21551282,NBS
chr18,Bn79714,63929597,77907300,13977703,NBS
chr18,Bn79715,12559206,62182440,49623234,TN
chr18,Bn79716,82534712,86254001,3719289,TN
chr18,Bn79717,15201130,20309457,5108327,CNL
chr18,Bn79718,21490646,77216138,55725492,NBS
chr18,Bn79719,3136100,7177949,4041849,TNL
chr18,Bn79720,35375796,79883282,44507486,CN
chr18,Bn79721,14258755,49888520,35629765,NBS
chr18,Bn79722,52822739,97394145,44571406,TN
chr18,Bn79723,85960045,93691237,7731192,CN
chr18,Bn79724,88513351,97445619,8932268,TN
chr18,Bn79725,40877668,49331198,8453530,NBS
chr18,Bn79726,91017587,98269632,7252045,TN
chr18,Bn79727,22748580,32180709,9432129,TN
chr18,Bn79728,75025553,89798945,14773392,RLP
chr18,Bn79729,24126063,87119519,62993456,TN
chr18,Bn79730,66450133,98806810,32356677,TN
chr18,Bn79731,4290090,40063726,35773636,TN
chr18,Bn79732,40073810,45521133,5447323,NBS
chr18,Bn79733,93378316,98656395,5278079,NBS
chr18,Bn79734,81650858,90054738,8403880,CNL
chr18,Bn79735,48575292,65763891,17188599,NBS
chr18,Bn79736,29345658,68407689,39062031,CNL
chr18,Bn79737,32035454,52573336,20537882,RLK
chr18,Bn79738,66830912,79512467,12681555,RLP
chr18,Bn79739,83837009,98096297,14259288,TN
chr18,Bn79740,47293915,88473458,41179543,RLK
chr18,Bn79741,69935311,73520369,3585058,TNL
chr18,Bn79742,1784810,29511252,27726442,CNL
chr18,Bn79743,78873907,90183119,11309212,RLK
chr18,Bn79744,58336777,65496541,7159764,CN
chr18,Bn79745,70264556,75308289,5043733,RLK
chr18,Bn79746,84346987,88717848,4370861,TNL
chr18,Bn79747,57958173,58057083,98910,CN
chr18,Bn79748,50249981,57208602,6958621,CNL
chr18,Bn79749,20540108,95036480,74496372,TN
chr18,Bn79750,6108305,94709544,88601239,CN
chr18,Bn79751,70566864,94978061,24411197,NBS
chr18,Bn79752,10756903,47836621,37079718,TN
chr18,Bn79753,88470774,89091369,620595,CNL
chr18,Bn79754,75771262,76456145,684883,CNL
chr18,Bn79755,75291534,98302407,23010873,RLK
chr18,Bn79756,26661059,54262070,27601011,TN
chr18,Bn79757,62643723,94473599,31829876,RLK
chr18,Bn79758,34283734,59525915,25242181,NBS
chr18,Bn79759,71601515,93447747,21846232,CNL
chr18,Bn79760,63117956,85165851,22047895,CN
chr18,Bn79761,84001863,84291738,289875,CN
chr18,Bn79762,36413686,99804462,63390776,CNL
chr18,Bn79763,94340267,95582467,1242200,RLP
chr18,Bn79764,69358950,89920564,20561614,CNL
chr18,Bn79765,34856498,73066885,38210387,NBS
chr18,Bn79766,39787489,69558196,29770707,RLK
chr18,Bn79767,82892508,91909629,9017121,TNL
chr18,Bn79768,13979706,22441918,8462212,CNL
chr18,Bn79769,5879485,72244444,66364959,RLP
chr18,Bn79770,52296737,72398788,20102051,CNL
chr18,Bn79771,86230302,89891845,3661543,TNL
chr18,Bn79772,52733423,86001816,33268393,TN
chr18,Bn79773,98212818,98328737,115919,CNL
chr18,Bn79774,63574850,69945955,6371105,TNL
chr18,Bn79775,89951368,95494571,5543203,TN
chr18,Bn79776,70541174,70919825,378651,TN
chr18,Bn79777,28674760,65465516,36790756,NBS
chr18,Bn79778,45947116,90142061,44194945,RLK
chr18,Bn79779,97368183,99945015,2576832,TN
chr18,Bn79780,71268194,83924421,12656227,TN
chr18,Bn79781,35257806,85236454,49978648,CNL
chr18,Bn79782,54818349,80176876,25358527,TN
chr18,Bn79783,50258064,59934601,9676537,RLK
chr18,Bn79784,83982082,89313850,5331768,RLK
chr18,Bn79785,72081011,83315826,11234815,CNL
chr18,Bn79786,70812378,77874982,7062604,TN
chr18,Bn79787,88602595,94972597,6370002,RLP
chr18,Bn79788,66088213,82971776,16883563,TN
chr18,Bn79789,77256667,91080895,13824228,CNL
chr18,Bn79790,56709098,57455099,746001,NBS
chr18,Bn79791,83354824,97830901,14476077,TNL
chr18,Bn79792,15473481,97162445,81688964,RLK
chr18,Bn79793,79832095,89145038,9312943,CNL
chr18,Bn79794,21100208,28724669,7624461,CNL
chr18,Bn79795,57190761,86990434,29799673,CN
chr18,Bn79796,43664441,87796722,44132281,CNL
chr18,Bn79797,72953690,88798859,15845169,CNL
chr18,Bn79798,32492532,55550153,23057621,CNL
chr18,Bn79799,50411412,52812929,2401517,TNL
chr18,Bn79800,40845582,86216432,45370850,RLK
chr18,Bn79801,74479660,85706136,11226476,CNL
chr18,Bn79802,66739160,88134380,21395220,NBS
chr18,Bn79803,74995098,90458894,15463796,RLK
chr18,Bn79804,89934028,97714465,7780437,RLP
chr18,Bn79805,72028338,75393955,3365617,NBS
chr18,Bn79806,57880059,72964202,15084143,RLK
chr18,Bn79807,6018284,52946549,46928265,CNL
chr18,Bn79808,76561076,78602975,2041899,TN
chr18,Bn79809,42613861,96981521,54367660,RLK
chr18,Bn79810,19710695,33981612,14270917,RLK
chr18,Bn79811,46599643,80183992,33584349,NBS
chr18,Bn79812,90062303,91990027,1927724,CNL
chr18,Bn79813,71392140,88489656,17097516,RLK
chr18,Bn79814,20167886,81975943,61808057,TN
chr18,Bn79815,68956268,97911998,28955730,RLK
chr18,Bn79816,27870748,88383730,60512982,RLK
chr18,Bn79817,73062837,85003337,11940500,CN
chr18,Bn79818,92811979,98807020,5995041,CN
chr18,Bn79819,89887253,99142480,9255227,RLP
chr18,Bn79820,11880216,19264810,7384594,RLK
chr18,Bn79821,1718697,98138182,96419485,RLP
chr18,Bn79822,2004380,99526916,97522536,TN
chr18,Bn79823,14482420,83411247,68928827,RLK
chr18,Bn79824,82365800,85035192,2669392,NBS
chr18,Bn79825,93825442,96476104,2650662,NBS
chr18,Bn79826,52141321,54951752,2810431,RLP
chr18,Bn79827,15310732,33192992,17882260,RLP
chr18,Bn79828,74536062,79564659,5028597,TN
chr18,Bn79829,74128494,82817745,8689251,CNL
chr18,Bn79830,32152613,57998702,25846089,CNL
chr18,Bn79831,64066873,86658993,22592120,NBS
chr18,Bn79832,47577303,48381865,804562,RLK
chr18,Bn79833,1773463,80748115,78974652,CN
chr18,Bn79834,93835166,95564091,1728925,TN
chr18,Bn79835,1070625,90226417,89155792,NBS
chr18,Bn79836,46166349,86398348,40231999,TN
chr18,Bn79837,64300799,72953014,8652215,RLP
chr18,Bn79838,77784839,79329821,1544982,TNL
chr18,Bn79839,15058784,82504506,67445722,NBS
chr18,Bn79840,84561066,92101422,7540356,RLP
chr18,Bn79841,20677168,81384077,60706909,RLP
chr18,Bn79842,87359007,96003205,8644198,TNL
chr18,Bn79843,17265864,64783921,47518057,CN
chr18,Bn79844,91313357,92365941,1052584,CN
chr18,Bn79845,96792687,99662131,2869444,NBS
chr18,Bn79846,27680963,77512421,49831458,RLK
chr18,Bn79847,74480618,79504029,5023411,TN
chr18,Bn79848,34520454,52691742,18171288,NBS
chr18,Bn79849,99535388,99877543,342155,CN
chr18,Bn79850,57121555,72238359,15116804,TNL
chr18,Bn79851,87771818,88453728,681910,CNL
chr18,Bn79852,31190753,35229681,4038928,CNL
chr18,Bn79853,36316509,54261445,17944936,CNL
chr18,Bn79854,5255031,77354779,72099748,TNL
chr18,Bn79855,38562055,92937314,54375259,NBS
chr18,Bn79856,44316365,95461264,51144899,CNL
chr18,Bn79857,8232143,68785954,60553811,TNL
chr18,Bn79858,31669037,76747331,45078294,CNL
chr18,Bn79859,12447390,21666497,9219107,CNL
chr18,Bn79860,23114521,84045545,60931024,RLK
chr18,Bn79861,90417281,91214704,797423,TN
chr18,Bn79862,56954424,89951240,32996816,TNL
chr18,Bn79863,65877000,73019934,7142934,TN
chr18,Bn79864,97732773,98811032,1078259,CN
chr18,Bn79865,56472792,59118316,2645524,TN
chr18,Bn79866,55703189,73114934,17411745,RLP
chr18,Bn79867,6040211,27973854,21933643,RLP
chr18,Bn79868,28272498,67462553,39190055,NBS
chr18,Bn79869,93397761,94576387,1178626,TNL
chr18,Bn79870,27860128,52754202,24894074,NBS
chr18,Bn79871,80768263,83688285,2920022,NBS
chr18,Bn79872,38033086,68064831,30031745,TNL
chr19,Bn79873,32038558,35195079,3156521,CNL
chr19,Bn79874,71105848,91676571,20570723,NBS
chr19,Bn79875,74322758,89837983,15515225,NBS
chr19,Bn79876,51200651,99947055,48746404,RLK
chr19,Bn79877,60428334,62211853,1783519,CNL
chr19,Bn79878,94276772,94878491,601719,CN
chr19,Bn79879,13766236,85468196,71701960,CNL
chr19,Bn79880,49625764,57523326,7897562,RLK
chr19,Bn79881,67953916,96199961,28246045,TN
chr19,Bn79882,9744952,96367879,86622927,TNL
chr19,Bn79883,85570047,90948859,5378812,RLP
chr19,Bn79884,4598195,85036702,80438507,NBS
chr19,Bn79885,68948772,79772047,10823275,TNL
chr19,Bn79886,65241278,90798816,25557538,CN
chr19,Bn79887,48543066,63107738,14564672,RLK
chr19,Bn79888,78005681,87682288,9676607,CNL
chr19,Bn79889,54370845,56788138,2417293,CNL
chr19,Bn79890,35261422,73082463,37821041,TN
chr19,Bn79891,39971512,82048930,42077418,CNL
chr19,Bn79892,40195261,70512500,30317239,RLP
chr19,Bn79893,16167509,47560225,31392716,TNL
chr19,Bn79894,16469115,22956036,6486921,TN
chr19,Bn79895,53965670,94001536,40035866,RLK
chr19,Bn79896,97966391,99077913,1111522,TN
chr19,Bn79897,8576997,69014748,60437751,CNL
chr19,Bn79898,58397936,84963415,26565479,CNL
chr19,Bn79899,27395122,74621526,47226404,RLP
chr19,Bn79900,23362389,87302943,63940554,TN
chr19,Bn79901,40503798,48862826,8359028,CNL
chr19,Bn79902,23926008,95951957,72025949,NBS
chr19,Bn79903,86099928,94828791,8728863,NBS
chr19,Bn79904,7972226,91788025,83815799,TNL
chr19,Bn79905,41668096,66050131,24382035,NBS
chr19,Bn79906,7935617,30145576,22209959,RLP
chr19,Bn79907,30508989,37763573,7254584,TNL
chr19,Bn79908,24013768,27434409,3420641,RLK
chr19,Bn79909,86628445,90768803,4140358,TN
chr19,Bn79910,65228040,83671567,18443527,RLP
chr19,Bn79911,83847112,94183692,10336580,TN
chr19,Bn79912,66122186,90318570,24196384,TNL
chr19,Bn79913,40703400,78401827,37698427,RLP
chr19,Bn79914,93256937,95014349,1757412,CN
chr19,Bn79915,82498939,88411840,5912901,TN
chr19,Bn79916,4923155,16825376,11902221,NBS
chr19,Bn79917,62902706,69072621,6169915,RLK
chr19,Bn79918,30906345,85844719,54938374,TN
chr19,Bn79919,63704993,64163182,458189,CNL
chr19,Bn79920,13253690,44983774,31730084,TN
chr19,Bn79921,42664977,51719446,9054469,NBS
chr19,Bn79922,30988842,98702273,67713431,RLK
chr19,Bn79923,56731936,81863091,25131155,RLP
chr19,Bn79924,43396653,49636011,6239358,TNL
chr19,Bn79925,19090177,91633430,72543253,NBS
chr19,Bn79926,28217836,76497848,48280012,CN
chr19,Bn79927,83596978,86726393,3129415,RLP
chr19,Bn79928,26076150,42382691,16306541,TNL
chr19,Bn79929,69310924,85896855,16585931,RLK
chr19,Bn79930,10723595,64434669,53711074,RLK
chr19,Bn79931,30934525,31151173,216648,RLP
chr19,Bn79932,38655659,63060910,24405251,CNL
chr19,Bn79933,41501883,41893325,391442,CN
chr19,Bn79934,94572523,98261889,3689366,TN
chr19,Bn79935,75843963,98742150,22898187,NBS
chr19,Bn79936,69792812,89326474,19533662,CN
chr19,Bn79937,31403443,73039845,41636402,CNL
chr19,Bn79938,24642695,66263152,41620457,CN
chr19,Bn79939,14322203,55697433,41375230,RLP
chr19,Bn79940,93165607,97062233,3896626,RLK
chr19,Bn79941,78874695,81400307,2525612,RLK
chr19,Bn79942,27210390,43309563,16099173,TNL
chr19,Bn79943,29894327,87290349,57396022,CNL
chr19,Bn79944,1146351,47695099,46548748,CN
chr19,Bn79945,81257408,94348647,13091239,TNL
chr19,Bn79946,58535122,66782510,8247388,RLK
chr19,Bn79947,26834752,45742547,18907795,TN
chr19,Bn79948,62856961,80627030,17770069,NBS
chr19,Bn79949,70948058,71893603,945545,CN
chr19,Bn79950,76719850,97637031,20917181,CNL
chr19,Bn79951,31824835,46747409,14922574,RLK
chr19,Bn79952,72996186,88634100,15637914,CNL
chr19,Bn79953,62644109,93692784,31048675,CN
chr19,Bn79954,27388227,93774800,66386573,TN
chr19,Bn79955,90023852,91773933,1750081,RLP
chr19,Bn79956,96106430,97452472,1346042,CN
chr19,Bn79957,62987721,76436112,13448391,CN
chr19,Bn79958,98561857,99322721,760864,TN
chr19,Bn79959,78477955,79229545,751590,CNL
chr19,Bn79960,67944560,76798227,8853667,CNL
chr19,Bn79961,83134963,89149131,6014168,RLP
chr19,Bn79962,72178249,74665068,2486819,TNL
chr19,Bn79963,48823505,50545021,1721516,TNL
chr19,Bn79964,62614831,95542538,32927707,RLP
chr19,Bn79965,65855340,86347526,20492186,NBS
chr19,Bn79966,13764899,17427135,3662236,CNL
chr19,Bn79967,40720029,99613801,58893772,CN
chr19,Bn79968,97849056,98747072,898016,NBS
chr19,Bn79969,79671899,98560492,18888593,RLK
chr19,Bn79970,67795128,68088920,293792,CN
chr19,Bn79971,44994332,96345969,51351637,RLK
chr19,Bn79972,51443664,62980448,11536784,CNL
chr19,Bn79973,47560072,88940938,41380866,CN
chr19,Bn79974,10269099,12404883,2135784,CN
chr19,Bn79975,18375384,92809821,74434437,NBS
chr19,Bn79976,80266093,99354522,19088429,CNL
chr19,Bn79977,65340863,88361674,23020811,NBS
chr19,Bn79978,36143052,39580993,3437941,RLP
chr19,Bn79979,50775495,69395225,18619730,RLP
chr19,Bn79980,11483480,87330491,75847011,CN
chr19,Bn79981,36950094,53259971,16309877,RLK
chr19,Bn79982,24955882,29456725,4500843,CNL
chr19,Bn79983,88107722,95200142,7092420,RLP
chr19,Bn79984,4935249,40596430,35661181,NBS
chr19,Bn79985,21311679,89816405,68504726,RLK
chr19,Bn79986,68165241,71804039,3638798,NBS
chr19,Bn79987,68929994,85348949,16418955,TNL
chr19,Bn79988,42514632,97192286,54677654,CN
chr19,Bn79989,16378957,20253904,3874947,CNL
chr19,Bn79990,79105340,98294010,19188670,CN
chr19,Bn79991,1864254,22214211,20349957,CNL
chr19,Bn79992,36420040,46440674,10020634,TN
chr19,Bn79993,83455659,87254096,3798437,CNL
chr19,Bn79994,77108317,93045588,15937271,NBS
chr19,Bn79995,57528240,92942238,35413998,TN
chr19,Bn79996,51216315,97887676,46671361,CN
chr19,Bn79997,48427268,76560209,28132941,TN
chr19,Bn79998,61639611,66626896,4987285,NBS
chr19,Bn79999,5147809,23321106,18173297,CNL
chr19,Bn80000,92152837,97170142,5017305,CN
chr19,Bn80001,20930160,88850093,67919933,RLK
chr19,Bn80002,65402413,95722297,30319884,NBS
chr19,Bn80003,67235598,86777810,19542212,TN
chr19,Bn80004,36973886,75854013,38880127,CNL
chr19,Bn80005,76635230,92854073,16218843,RLK
chr19,Bn80006,40778210,80375303,39597093,RLP
chr19,Bn80007,14701076,18125984,3424908,RLK
chr19,Bn80008,17829875,66930830,49100955,CNL
chr19,Bn80009,33512974,95305700,61792726,RLP
chr19,Bn80010,61819479,62360440,540961,RLK
chr19,Bn80011,30439330,91459224,61019894,NBS
chr19,Bn80012,29609432,84556036,54946604,CNL
chr19,Bn80013,52218861,68326027,16107166,TNL
chr19,Bn80014,33790110,57159436,23369326,CNL
chr19,Bn80015,13409247,18503751,5094504,RLK
chr19,Bn80016,30562351,79086362,48524011,TN
chr19,Bn80017,66914198,83774243,16860045,NBS
chr19,Bn80018,55277189,93550609,38273420,CN
chr19,Bn80019,62906306,76993095,14086789,RLP
chr19,Bn80020,69423882,99226459,29802577,TN
chr19,Bn80021,12105227,46613178,34507951,CNL
chr19,Bn80022,91101106,96729676,5628570,RLP
chr19,Bn80023,82455777,99499915,17044138,TNL
chr19,Bn80024,19151961,21212998,2061037,NBS
chr19,Bn80025,67373332,77658764,10285432,NBS
chr19,Bn80026,86903062,95562257,8659195,RLP
chr19,Bn80027,3629850,20725590,17095740,TN
chr19,Bn80028,87352149,89174485,1822336,CNL
chr19,Bn80029,24083348,66173890,42090542,RLP
chr19,Bn80030,82284001,97423200,15139199,TN
chr19,Bn80031,94388566,99696842,5308276,TNL
chr19,Bn80032,27555523,36756749,9201226,RLP
chr19,Bn80033,57297292,87395669,30098377,RLP
chr19,Bn80034,1640982,74554892,72913910,TN
chr19,Bn80035,96426307,97772895,1346588,TN
chr19,Bn80036,74103550,79552614,5449064,CN
chr19,Bn80037,63595271,94385832,30790561,TN
chr19,Bn80038,96758851,98767823,2008972,TN
chr19,Bn80039,71057682,82833893,11776211,CNL
chr19,Bn80040,33685252,84994417,51309165,CNL
chr19,Bn80041,27466005,76826306,49360301,TN
chr19,Bn80042,36715211,77184386,40469175,RLK
chr19,Bn80043,2750521,10670602,7920081,RLK
chr19,Bn80044,2467125,55414357,52947232,TN
chr19,Bn80045,89937133,97675167,7738034,RLK
chr19,Bn80046,11358696,29475211,18116515,CN
chr19,Bn80047,61181259,74592424,13411165,NBS
chr19,Bn80048,80193040,89869834,9676794,TNL
chr19,Bn80049,11036407,82157746,71121339,RLP
chr19,Bn80050,53368827,71961389,18592562,NBS
chr19,Bn80051,97189926,99053613,1863687,RLK
chr19,Bn80052,98083791,98727356,643565,CNL
chr19,Bn80053,41334453,85107692,43773239,CNL
chr19,Bn80054,90454018,95228501,4774483,RLK
chr19,Bn80055,80571052,89574460,9003408,CNL
chr19,Bn80056,5807767,60521230,54713463,RLK
chr19,Bn80057,73980489,86846807,12866318,NBS
chr19,Bn80058,72301189,94102934,21801745,RLK
chr19,Bn80059,8907268,93948993,85041725,CNL
chr19,Bn80060,89038695,94996457,5957762,CNL
chr19,Bn80061,87663264,99103510,11440246,NBS
chr19,Bn80062,84142063,85155975,1013912,CNL
chr19,Bn80063,32906486,89114366,56207880,TN
chr19,Bn80064,52551998,93388037,40836039,RLK
chr19,Bn80065,35182315,67044435,31862120,TNL
chr19,Bn80066,6891330,94417689,87526359,TN
chr19,Bn80067,73054244,97496549,24442305,RLP
chr19,Bn80068,53490769,83008244,29517475,RLK
chr19,Bn80069,25393726,99539464,74145738,TN
chr19,Bn80070,49044612,50018924,974312,CNL
chr19,Bn80071,82201123,92225456,10024333,RLP
chr19,Bn80072,95379938,97995167,2615229,CN
chr19,Bn80073,82270270,95479006,13208736,RLP
chr19,Bn80074,4389566,48243189,43853623,RLK
chr19,Bn80075,89881302,96206025,6324723,CNL
chr19,Bn80076,98162589,98830603,668014,NBS
chr19,Bn80077,95995163,99088055,3092892,CNL
chr19,Bn80078,3866118,60332745,56466627,RLP
chr19,Bn80079,49257093,55139401,5882308,CN
chr19,Bn80080,24794770,60059196,35264426,CN
chr19,Bn80081,98159134,98261790,102656,CN
chr19,Bn80082,18675563,29380131,10704568,RLK
chr19,Bn80083,71668458,73798183,2129725,NBS
chr19,Bn80084,25844931,77686089,51841158,RLP
chr19,Bn80085,50359828,56355247,5995419,NBS
chr19,Bn80086,70839053,86515487,15676434,RLK
chr19,Bn80087,34930738,93175980,58245242,RLP
chr19,Bn80088,52876576,81393367,28516791,TN
chr19,Bn80089,19173381,32201307,13027926,TN
chr19,Bn80090,65726643,77410714,11684071,TN
chr19,Bn80091,2904007,38245479,35341472,TNL
chr19,Bn80092,20930112,97585902,76655790,NBS
chr19,Bn80093,25520716,45789920,20269204,TNL
chr19,Bn80094,74797568,94682525,19884957,TNL
chr19,Bn80095,98150210,99192142,1041932,TN
chr19,Bn80096,67934572,79743713,11809141,CN
chr19,Bn80097,86770642,90071277,3300635,TN
chr19,Bn80098,48901037,66194925,17293888,CNL
chr19,Bn80099,8379901,69956501,61576600,CNL
chr19,Bn80100,95044117,98736349,3692232,RLK
chr19,Bn80101,45974111,77062648,31088537,TN
chr19,Bn80102,52690055,53215736,525681,NBS
chr19,Bn80103,26859603,97691119,70831516,RLK
chr19,Bn80104,94292998,95477400,1184402,CN
chr19,Bn80105,37067795,90296992,53229197,TNL
chr19,Bn80106,35760284,89962986,54202702,TNL
chr19,Bn80107,65627260,66121474,494214,TNL
chr19,Bn80108,86152487,99082022,12929535,RLK
chr19,Bn80109,59431558,87677942,28246384,NBS
chr19,Bn80110,6570972,81733917,75162945,NBS
chr19,Bn80111,40754481,77986175,37231694,CN
chr19,Bn80112,43565764,51584453,8018689,NBS
chr19,Bn80113,87632260,90535241,2902981,TN
chr19,Bn80114,4087452,71250362,67162910,NBS
chr19,Bn80115,90039681,92612754,2573073,TN
chr19,Bn80116,38827770,53373678,14545908,CNL
chr19,Bn80117,73324665,75155288,1830623,RLK
chr19,Bn80118,18466663,33694150,15227487,TN
chr19,Bn80119,87962724,94714081,6751357,RLK
chr19,Bn80120,6323948,42521406,36197458,TNL
chr19,Bn80121,81400899,99590148,18189249,TNL
chr19,Bn80122,27425508,81366671,53941163,TN
chr19,Bn80123,32117845,47538756,15420911,CNL
chr19,Bn80124,24104580,32405446,8300866,CNL
chr19,Bn80125,97039218,98236259,1197041,RLK
chr19,Bn80126,57908722,68334111,10425389,TN
chr19,Bn80127,2550424,23423453,20873029,RLP
chr19,Bn80128,35623481,47081166,11457685,CN
chr19,Bn80129,16213228,70129198,53915970,RLP
chr19,Bn80130,3083226,24306253,21223027,TNL
chr19,Bn80131,66927779,94119591,27191812,CN
chr19,Bn80132,95428892,99787132,4358240,TNL
chr19,Bn80133,33927816,66014582,32086766,CN
chr19,Bn80134,59257488,62058307,2800819,TNL
chr19,Bn80135,32389557,64380323,31990766,NBS
chr19,Bn80136,84822242,90200145,5377903,CN
chr19,Bn80137,40984700,57925294,16940594,CNL
chr19,Bn80138,51694624,94630848,42936224,RLP
chr19,Bn80139,10758030,93090750,82332720,CNL
chr19,Bn80140,17100093,41230899,24130806,CN
chr19,Bn80141,28422691,31949315,3526624,TNL
chr19,Bn80142,25452738,59640464,34187726,CNL
chr19,Bn80143,64202286,80760540,16558254,TN
chr19,Bn80144,67813649,90115284,22301635,RLK
chr19,Bn80145,75566411,94787091,19220680,NBS
chr19,Bn80146,28884554,93894679,65010125,TN
chr19,Bn80147,71363798,72568867,1205069,TN
chr19,Bn80148,71715913,99534525,27818612,RLK
chr19,Bn80149,55917061,82905517,26988456,CNL
chr19,Bn80150,8578100,57209958,48631858,CN
chr19,Bn80151,55540664,57568134,2027470,TN
chr19,Bn80152,47826978,79714665,31887687,RLP
chr19,Bn80153,49271579,77770489,28498910,CNL
chr19,Bn80154,78070611,85716669,7646058,TNL
chr19,Bn80155,40575211,70771031,30195820,TNL
chr19,Bn80156,32151095,84964565,52813470,TN
chr19,Bn80157,95251745,99553733,4301988,RLP
chr19,Bn80158,63567278,85756625,22189347,CN
chr19,Bn80159,42403621,56085367,13681746,RLP
chr19,Bn80160,53300431,98335850,45035419,TNL
chr19,Bn80161,47708104,71293975,23585871,TNL
chr19,Bn80162,11231290,74215866,62984576,RLP
chr19,Bn80163,3586963,52089447,48502484,RLP
chr19,Bn80164,36987173,70072150,33084977,RLP
chr19,Bn80165,4631551,5598898,967347,CNL
chr19,Bn80166,85125706,93011698,7885992,CN
chr19,Bn80167,81796020,97406932,15610912,NBS
chr19,Bn80168,79046915,92102160,13055245,TN
chr19,Bn80169,39593995,45775849,6181854,TN
chr19,Bn80170,64470371,95307027,30836656,RLK
chr19,Bn80171,83550408,91897717,8347309,RLP
chr19,Bn80172,58152641,70102907,11950266,CNL
chr19,Bn80173,26403740,46523429,20119689,CNL
chr19,Bn80174,73313189,78088794,4775605,RLK
chr19,Bn80175,82558032,95454726,12896694,TN
chr19,Bn80176,11179649,79429078,68249429,RLP
chr19,Bn80177,20370914,65138070,44767156,RLK
chr19,Bn80178,95198329,97441602,2243273,CN
chr19,Bn80179,41388905,79887946,38499041,RLP
chr19,Bn80180,6706642,38640734,31934092,CN
chr19,Bn80181,42861194,45729060,2867866,RLP
chr19,Bn80182,6194209,46330947,40136738,RLP
chr19,Bn80183,21467299,53118798,31651499,TN
chr19,Bn80184,59381826,86247773,26865947,CNL
chr19,Bn80185,27461380,48940724,21479344,CNL
chr19,Bn80186,33153387,78722143,45568756,TNL
chr19,Bn80187,64061092,96389375,32328283,RLP
chr19,Bn80188,55247005,98306424,43059419,CNL
chr19,Bn80189,44281010,86694892,42413882,NBS
chr19,Bn80190,41720991,47786156,6065165,TNL
chr19,Bn80191,97631145,97732564,101419,CN
chr19,Bn80192,90967801,93307552,2339751,TNL
chr19,Bn80193,97041779,98214886,1173107,TN
chr19,Bn80194,34879435,56167349,21287914,TNL
chr19,Bn80195,43841923,46950097,3108174,CN
chr19,Bn80196,21224933,62691663,41466730,CN
chr19,Bn80197,27700726,89861609,62160883,TNL
chr19,Bn80198,95124470,98936483,3812013,RLP
chr19,Bn80199,44166765,79568787,35402022,TN
chr19,Bn80200,34095604,50966341,16870737,TNL
chr19,Bn80201,95855898,96971443,1115545,RLP
chr19,Bn80202,44744781,50362139,5617358,TN
chr19,Bn80203,76512736,96467983,19955247,TNL
chr19,Bn80204,87097970,92950137,5852167,CN
chr19,Bn80205,73775285,96309303,22534018,TNL
chr19,Bn80206,84571806,90758906,6187100,RLP
chr19,Bn80207,96347341,97005332,657991,NBS
chr19,Bn80208,6734144,96081971,89347827,NBS
chr19,Bn80209,69343082,89627902,20284820,NBS
chr19,Bn80210,5580349,20031052,14450703,NBS
chr19,Bn80211,45081553,60649076,15567523,CNL
chr19,Bn80212,54057817,79885456,25827639,CN
chr19,Bn80213,56057325,92469924,36412599,CN
chr19,Bn80214,55039645,92096028,37056383,CNL
chr19,Bn80215,31590042,41247880,9657838,NBS
chr19,Bn80216,71284221,78223325,6939104,RLK
chr19,Bn80217,37559688,87289369,49729681,CN
chr19,Bn80218,45184786,64061964,18877178,TNL
chr19,Bn80219,56397349,99611256,43213907,TNL
chr19,Bn80220,30856336,46994818,16138482,NBS
chr19,Bn80221,1016015,16319363,15303348,TNL
chr19,Bn80222,98063743,99029845,966102,TNL
chr19,Bn80223,83399309,94424679,11025370,NBS
chr19,Bn80224,30779199,84449542,53670343,RLP
chr19,Bn80225,90695422,96048849,5353427,RLP
chr19,Bn80226,45784191,64513732,18729541,RLP
chr19,Bn80227,60226694,91635023,31408329,RLK
chr19,Bn80228,82233457,89039067,6805610,TNL
chr19,Bn80229,65350406,82943957,17593551,RLP
chr19,Bn80230,35455791,66953751,31497960,RLK
chr19,Bn80231,71397061,97483826,26086765,NBS
chr19,Bn80232,68264749,81639660,13374911,RLP
chr19,Bn80233,52253049,87886456,35633407,TN
chr19,Bn80234,65729612,86841113,21111501,CNL
chr19,Bn80235,28581138,63370363,34789225,RLP
chr19,Bn80236,44701728,69086610,24384882,RLP
chr19,Bn80237,8640309,76291626,67651317,TNL
chr19,Bn80238,49698710,75588589,25889879,CNL
chr19,Bn80239,7640524,93851369,86210845,CN
chr19,Bn80240,34417415,66325000,31907585,CN
chr19,Bn80241,76782883,97060859,20277976,RLK
chr19,Bn80242,6455202,30717501,24262299,CNL
chr19,Bn80243,69588163,88402591,18814428,CN
chr19,Bn80244,88079107,88803585,724478,RLP
chr19,Bn80245,20464792,59910870,39446078,RLK
chr19,Bn80246,61377848,86388143,25010295,CN
chr19,Bn80247,8002423,25029285,17026862,TN
chr19,Bn80248,88731599,90120638,1389039,CNL
chr19,Bn80249,89577261,96252294,6675033,CNL
chr19,Bn80250,33948804,59363037,25414233,TNL
chr19,Bn80251,30039669,53690294,23650625,CNL
chr19,Bn80252,94538178,99011449,4473271,CNL
chr19,Bn80253,9482289,30942495,21460206,RLP
chr19,Bn80254,96965295,97415583,450288,CN
chr19,Bn80255,67210691,70045048,2834357,CNL
chr19,Bn80256,26749831,45440961,18691130,CN
chr19,Bn80257,59106789,66191896,7085107,RLP
chr19,Bn80258,98735981,99631202,895221,NBS
chr19,Bn80259,14855125,66769666,51914541,TN
chr19,Bn80260,37548797,67509939,29961142,NBS
chr19,Bn80261,46923926,54626874,7702948,RLK
chr19,Bn80262,75779606,88081440,12301834,RLK
chr19,Bn80263,35427622,80117372,44689750,TN
chr19,Bn80264,38091295,55297205,17205910,TNL
chr19,Bn80265,51841535,98740550,46899015,TN
chr19,Bn80266,87160265,98429625,11269360,TNL
chr19,Bn80267,59268404,83108982,23840578,RLK
chr19,Bn80268,12688495,34809527,22121032,RLP
chr19,Bn80269,41033158,95856391,54823233,RLP
chr19,Bn80270,23088504,74766065,51677561,TN
chr19,Bn80271,30992026,35172879,4180853,TN
chr19,Bn80272,47524210,98161453,50637243,RLK
chr19,Bn80273,16386116,32896396,16510280,CN
chr19,Bn80274,63122846,80003571,16880725,NBS
chr19,Bn80275,17640948,58261383,40620435,RLP
chr19,Bn80276,18902800,87803330,68900530,NBS
chr19,Bn80277,49790037,95810515,46020478,NBS
chr19,Bn80278,19758901,61637504,41878603,TN
chr19,Bn80279,54563975,79685348,25121373,CN
chr19,Bn80280,42017286,84321411,42304125,TN
chr19,Bn80281,20385635,51887885,31502250,NBS
chr19,Bn80282,50676938,54117695,3440757,RLK
chr19,Bn80283,25052193,27061930,2009737,TN
chr19,Bn80284,83992019,91853336,7861317,RLP
chr19,Bn80285,52932134,85085096,32152962,TNL
chr19,Bn80286,31228985,66029163,34800178,RLK
chr19,Bn80287,38933184,65005951,26072767,CN
chr19,Bn80288,14190929,70562536,56371607,RLP
chr19,Bn80289,66443012,99582293,33139281,CN
chr19,Bn80290,13644490,23188748,9544258,RLP
chr19,Bn80291,72869189,90447833,17578644,TNL
chr19,Bn80292,51509557,78833581,27324024,CNL
chr19,Bn80293,86888901,96837913,9949012,TN
chr19,Bn80294,67505333,81528872,14023539,TNL
chr19,Bn80295,30653569,49434574,18781005,RLK
chr19,Bn80296,6649405,27048965,20399560,CNL
chr19,Bn80297,31696009,73839016,42143007,CNL
chr19,Bn80298,82329566,98466326,16136760,TN
chr19,Bn80299,8451273,90450036,81998763,RLP
chr19,Bn80300,65861943,82802773,16940830,RLP
chr19,Bn80301,83295217,84383988,1088771,NBS
chr19,Bn80302,71166158,75052914,3886756,NBS
chr19,Bn80303,16622269,90035571,73413302,TNL
chr19,Bn80304,5299216,77783224,72484008,RLK
chr19,Bn80305,65605763,76457465,10851702,CN
chr19,Bn80306,60665336,88554957,27889621,CN
chr19,Bn80307,59173616,77058868,17885252,RLP
chr19,Bn80308,90920599,96351048,5430449,RLP
chr19,Bn80309,77814145,79689122,1874977,NBS
chr19,Bn80310,90815607,96869460,6053853,NBS
chr19,Bn80311,50667768,84164508,33496740,NBS
chr19,Bn80312,59450179,88698865,29248686,CNL
chr19,Bn80313,41915880,85261761,43345881,CN
chr19,Bn80314,62595663,97370234,34774571,RLK
chr19,Bn80315,51999704,98202529,46202825,NBS
chr19,Bn80316,91822462,99924630,8102168,TNL
chr19,Bn80317,82475653,83644135,1168482,TN
chr19,Bn80318,35249316,55552977,20303661,RLP
chr19,Bn80319,69682895,80680040,10997145,RLK
chr19,Bn80320,59447143,69338423,9891280,CNL
chr19,Bn80321,58581022,76531522,17950500,RLK
chr19,Bn80322,1661599,8699678,7038079,RLP
chr19,Bn80323,44378061,98345901,53967840,CNL
chr19,Bn80324,77585220,90518686,12933466,RLK
chr19,Bn80325,29332428,62403295,33070867,NBS
chr19,Bn80326,38076484,65638203,27561719,RLP
chr19,Bn80327,89056191,89513825,457634,CN
chr19,Bn80328,68480773,75693450,7212677,RLK
chr19,Bn80329,20339364,78540043,58200679,RLP
chr19,Bn80330,76473757,83728955,7255198,RLK
chr19,Bn80331,47699768,72890088,25190320,RLK
chr19,Bn80332,44552971,46972532,2419561,CNL
chr19,Bn80333,38034951,92780660,54745709,TNL
chr19,Bn80334,41587779,55298039,13710260,RLP
chr19,Bn80335,10252587,96833517,86580930,RLP
chr19,Bn80336,10757864,24469817,13711953,RLK
chr19,Bn80337,92047344,99022258,6974914,CNL
chr19,Bn80338,41691460,84608971,42917511,CN
chr19,Bn80339,30519715,57568069,27048354,NBS
chr19,Bn80340,74253344,98174399,23921055,RLK
chr19,Bn80341,52900582,79993179,27092597,CN
chr19,Bn80342,32168815,34922463,2753648,TN
chr19,Bn80343,53163131,90810565,37647434,TN
chr19,Bn80344,70375279,71599458,1224179,RLP
chr19,Bn80345,50170690,81026441,30855751,TN
chr19,Bn80346,94845714,95581165,735451,RLP
chr19,Bn80347,6011010,92664910,86653900,NBS
chr19,Bn80348,18237577,22093824,3856247,CN
chr19,Bn80349,62253565,79068241,16814676,RLK
chr19,Bn80350,82218429,92213868,9995439,TN
chr19,Bn80351,36770634,48494229,11723595,TN
chr19,Bn80352,24553718,30391655,5837937,RLP
chr19,Bn80353,46068679,53920699,7852020,CNL
chr19,Bn80354,81023974,84194240,3170266,CN
chr19,Bn80355,24457022,69951071,45494049,RLP
chr19,Bn80356,6923738,58519717,51595979,CNL
chr19,Bn80357,87812761,97502193,9689432,TN
chr19,Bn80358,16066515,21723138,5656623,RLK
chr19,Bn80359,50106306,75515675,25409369,TN
chr19,Bn80360,91044126,94783591,3739465,CN
chr19,Bn80361,45741734,69083649,23341915,TNL
chr19,Bn80362,91949117,93069809,1120692,CN
chr19,Bn80363,90197411,91873136,1675725,CNL
chr19,Bn80364,1507966,57340065,55832099,NBS
chr19,Bn80365,66351630,93033705,26682075,CNL
chr19,Bn80366,2077852,10859562,8781710,NBS
chr19,Bn80367,2605055,39224784,36619729,CNL
chr19,Bn80368,8190676,46084427,37893751,TNL
chr19,Bn80369,49107457,50011107,903650,RLK
chr19,Bn80370,65276086,68949369,3673283,TNL
chr19,Bn80371,76027863,77783327,1755464,TN
chr19,Bn80372,57899077,58287184,388107,RLP
chr19,Bn80373,57500712,99524010,42023298,TNL
chr19,Bn80374,45779638,55797088,10017450,RLP
chr19,Bn80375,30120227,77197293,47077066,NBS
chr19,Bn80376,12521083,58399225,45878142,RLK
chr19,Bn80377,88568035,95915025,7346990,CNL
chr19,Bn80378,29173368,57795280,28621912,CNL
chr19,Bn80379,20879923,63020407,42140484,TN
chr19,Bn80380,20480162,59328277,38848115,TNL
chr19,Bn80381,13614251,18767186,5152935,CNL
chr19,Bn80382,18612791,98427589,79814798,TNL
chr19,Bn80383,99035565,99864897,829332,CN
chr19,Bn80384,66864880,76104229,9239349,NBS
chr19,Bn80385,79558670,97641068,18082398,CN
chr19,Bn80386,29862536,57566731,27704195,RLP
chr19,Bn80387,7111071,30102632,22991561,CN
chr19,Bn80388,78432714,98296821,19864107,RLK
chr19,Bn80389,40170010,91399503,51229493,RLP
chr19,Bn80390,56339344,65325433,8986089,TN
chr19,Bn80391,37723314,46213824,8490510,RLP
chr19,Bn80392,95582268,96601881,1019613,NBS
chr19,Bn80393,23744406,80685970,56941564,TN
chr19,Bn80394,39599002,78207972,38608970,TN
chr19,Bn80395,4661569,43117308,38455739,NBS
chr19,Bn80396,88727375,96583753,7856378,TNL
chr19,Bn80397,44031771,47672137,3640366,CNL
chr19,Bn80398,80363876,83635029,3271153,TN
chr19,Bn80399,17313414,59551645,42238231,RLP
chr19,Bn80400,18845663,62284300,43438637,TN
chr19,Bn80401,96663849,98823506,2159657,RLK
chr19,Bn80402,59938458,64557266,4618808,CN
chr19,Bn80403,40377094,89246311,48869217,TNL
chr19,Bn80404,88429857,89591093,1161236,RLK
chr19,Bn80405,56872891,57880780,1007889,TN
chr19,Bn80406,45671564,60246503,14574939,RLK
chr19,Bn80407,8860269,82026610,73166341,CNL
chr19,Bn80408,96072374,98060140,1987766,RLK
chr19,Bn80409,4297412,10247831,5950419,TN
chr19,Bn80410,43225221,81226633,38001412,TN
chr19,Bn80411,58404683,92778594,34373911,RLP
chr19,Bn80412,72443402,76112271,3668869,CNL
chr19,Bn80413,10128307,58581422,48453115,TNL
chr19,Bn80414,79776519,82987221,3210702,CN
chr19,Bn80415,81320969,97038278,15717309,TN
chr19,Bn80416,93942525,98392950,4450425,RLP
chr19,Bn80417,73089873,83144300,10054427,CN
chr19,Bn80418,91493759,91637163,143404,TN
chr19,Bn80419,94020079,98350493,4330414,TNL
chr19,Bn80420,68300199,73934977,5634778,NBS
chr19,Bn80421,87476967,88450167,973200,CN
chr19,Bn80422,82628441,92621199,9992758,CNL
chr19,Bn80423,98050664,99980004,1929340,NBS
chr19,Bn80424,27065974,78089830,51023856,RLP
chr19,Bn80425,44268578,59797653,15529075,TNL
chr19,Bn80426,34758774,90085810,55327036,RLP
chr19,Bn80427,10230087,44041905,33811818,RLK
chr19,Bn80428,68889406,77721405,8831999,CNL
chr19,Bn80429,80304278,88887386,8583108,RLK
chr19,Bn80430,83971194,92098879,8127685,CNL
chr19,Bn80431,14289954,42647643,28357689,NBS
chr19,Bn80432,52928465,65916661,12988196,RLP
chr19,Bn80433,62851654,92048590,29196936,NBS
chr19,Bn80434,93964112,96134542,2170430,CNL
chr19,Bn80435,55396490,99487342,44090852,CN
chr19,Bn80436,81744024,97775098,16031074,TNL
chr19,Bn80437,34578235,86392678,51814443,TN
chr19,Bn80438,33102690,77943854,44841164,RLP
chr19,Bn80439,16977636,48869760,31892124,TN
chr19,Bn80440,97980979,99578045,1597066,RLP
chr19,Bn80441,62790931,80163408,17372477,CN
chr19,Bn80442,61472251,68957677,7485426,CNL
chr19,Bn80443,41819087,47351038,5531951,RLP
chr19,Bn80444,11108791,51186208,40077417,TN
chr19,Bn80445,70121592,72201164,2079572,TNL
chr19,Bn80446,80378380,91421033,11042653,CN
chr19,Bn80447,86424636,94764652,8340016,CNL
chr19,Bn80448,54052068,92840208,38788140,CN
chr19,Bn80449,80502875,96138689,15635814,CN
chr19,Bn80450,78651119,82038638,3387519,TNL
chr19,Bn80451,36369720,65069595,28699875,TNL
chr19,Bn80452,25773990,72309732,46535742,TNL
chr19,Bn80453,32686209,89158075,56471866,NBS
chr19,Bn80454,42507244,67788801,25281557,RLP
chr19,Bn80455,57897597,77463743,19566146,CNL
chr19,Bn80456,93970615,95282246,1311631,CN
chr19,Bn80457,44075114,80500784,36425670,CN
chr19,Bn80458,30716374,90517775,59801401,RLP
chr19,Bn80459,99715193,99926281,211088,TN
chr19,Bn80460,13082227,42824080,29741853,RLK
chr19,Bn80461,55341501,65900797,10559296,TN
chr19,Bn80462,53988855,92221688,38232833,RLK
chr19,Bn80463,84026387,89835654,5809267,CNL
chr19,Bn80464,21184254,98104158,76919904,RLP
chr19,Bn80465,39295744,71750575,32454831,TNL
chr19,Bn80466,26836614,86106991,59270377,TN
chr19,Bn80467,6938998,39329399,32390401,RLK
chr19,Bn80468,4226970,38056587,33829617,TN
chr19,Bn80469,67289758,83505073,16215315,TN
chr19,Bn80470,48665751,94981834,46316083,TNL
chr19,Bn80471,52847180,56560465,3713285,CN
chr19,Bn80472,13322907,61152446,47829539,NBS
chr19,Bn80473,71680158,95078453,23398295,CNL
chr19,Bn80474,44406277,90777844,46371567,RLP
chr19,Bn80475,1116270,34656240,33539970,NBS
chr19,Bn80476,28009711,96554617,68544906,CNL
chr19,Bn80477,33298083,75738241,42440158,RLK
chr19,Bn80478,3582444,69230036,65647592,RLK
chr19,Bn80479,16847310,77686750,60839440,RLP
chr19,Bn80480,28078519,90533582,62455063,CNL
chr19,Bn80481,6372702,72725331,66352629,TNL
chr19,Bn80482,79369071,90646277,11277206,RLK
chr19,Bn80483,96089291,97335428,1246137,CN
chr19,Bn80484,13394723,46468657,33073934,NBS
chr19,Bn80485,39729678,81847610,42117932,CNL
chr19,Bn80486,42603684,53239945,10636261,TN
chr19,Bn80487,78855028,89590238,10735210,RLK
chr19,Bn80488,57311345,87903593,30592248,TN
chr19,Bn80489,10384559,65409366,55024807,TN
chr19,Bn80490,38048437,75306446,37258009,NBS
chr19,Bn80491,38953301,91926417,52973116,CN
chr19,Bn80492,89797291,95498356,5701065,RLK
chr19,Bn80493,55957603,85727625,29770022,RLK
chr19,Bn80494,28365289,70195447,41830158,TN
chr19,Bn80495,25414620,25952258,537638,RLP
chr19,Bn80496,50598202,90626669,40028467,CNL
chr19,Bn80497,3190233,49452164,46261931,CNL
chr19,Bn80498,49481382,83611011,34129629,CNL
chr19,Bn80499,11103860,98435562,87331702,RLK
chr19,Bn80500,35884970,83087901,47202931,RLP
chr19,Bn80501,80144005,84181236,4037231,TNL
chr19,Bn80502,55226237,77612949,22386712,TNL
chr19,Bn80503,89404428,98547614,9143186,CNL
chr19,Bn80504,59274621,82019020,22744399,RLP
chr19,Bn80505,93471701,98393627,4921926,NBS
chr19,Bn80506,72948065,89003213,16055148,CN
chr19,Bn80507,53071667,81455165,28383498,CN
chr19,Bn80508,53247432,67698404,14450972,TN
chr19,Bn80509,43423008,81107243,37684235,CNL
chr19,Bn80510,17808186,57977713,40169527,RLK
chr19,Bn80511,55810090,83989264,28179174,CN
chr19,Bn80512,14169173,23767289,9598116,TN
chr19,Bn80513,31739051,37766450,6027399,RLK
chr19,Bn80514,86717329,88312485,1595156,NBS
chr19,Bn80515,6811880,71272579,64460699,NBS
chr19,Bn80516,70445410,83533019,13087609,TNL
chr19,Bn80517,43841479,64899202,21057723,TN
chr19,Bn80518,71959702,79542100,7582398,TNL
chr19,Bn80519,76946876,79414247,2467371,NBS
chr19,Bn80520,69467169,98579276,29112107,TNL
chr19,Bn80521,21325233,42569431,21244198,NBS
chr19,Bn80522,97761555,98170328,408773,CN
chr19,Bn80523,31950220,80412684,48462464,RLP
chr19,Bn80524,64547055,69870087,5323032,TN
chr19,Bn80525,15768607,96918906,81150299,TNL
chr19,Bn80526,56233007,58552995,2319988,CNL
chr19,Bn80527,82315488,84980355,2664867,CN
chr19,Bn80528,92266309,94303544,2037235,CN
chr19,Bn80529,52940350,91109588,38169238,CNL
chr19,Bn80530,13077772,22724571,9646799,NBS
chr19,Bn80531,71237376,85581166,14343790,CN
chr19,Bn80532,93392767,96786689,3393922,CN
chr19,Bn80533,99005460,99755294,749834,TNL
chr19,Bn80534,96656720,98811494,2154774,TNL
chr19,Bn80535,51329551,71738752,20409201,RLP
chr19,Bn80536,72325591,80353744,8028153,RLP
chr19,Bn80537,41346952,59885418,18538466,RLP
chr19,Bn80538,99198849,99390756,191907,NBS
chr19,Bn80539,19218005,54472402,35254397,NBS
chr19,Bn80540,41280502,49629360,8348858,CNL
chr19,Bn80541,75738896,84228059,8489163,RLP
chr19,Bn80542,58754418,85806051,27051633,RLP
chr19,Bn80543,99502947,99721964,219017,TNL
chr19,Bn80544,76169846,93457647,17287801,CNL
chr19,Bn80545,54552673,62733961,8181288,RLK
chr19,Bn80546,48878301,69298063,20419762,NBS
chr19,Bn80547,68150166,69336310,1186144,TNL
chr19,Bn80548,23123260,59436787,36313527,RLK
chr19,Bn80549,93781486,94633511,852025,NBS
chr19,Bn80550,66020885,81682118,15661233,RLP
chr19,Bn80551,53842929,83465706,29622777,CNL
chr19,Bn80552,72172232,92223498,20051266,RLK
chr19,Bn80553,3116523,88347902,85231379,TNL
chr19,Bn80554,60142974,77572379,17429405,RLK
chr19,Bn80555,49825861,63852940,14027079,NBS
chr19,Bn80556,56534131,58002956,1468825,TNL
chr19,Bn80557,69981294,84211894,14230600,CNL
chr19,Bn80558,19889611,92837408,72947797,RLP
chr19,Bn80559,86149245,91871452,5722207,NBS
chr19,Bn80560,26498992,81472021,54973029,NBS
chr19,Bn80561,36129286,62579912,26450626,CNL
chr19,Bn80562,52459291,73397469,20938178,TN
chr19,Bn80563,54366046,64693638,10327592,NBS
chr19,Bn80564,32598048,86956995,54358947,CN
chr19,Bn80565,61096443,77221023,16124580,RLK
chr19,Bn80566,69139016,80816342,11677326,RLP
chr19,Bn80567,3325431,26258079,22932648,NBS
chr19,Bn80568,12783032,32501000,19717968,NBS
chr19,Bn80569,28740732,32772239,4031507,CNL
chr19,Bn80570,98614627,98669413,54786,TNL
chr19,Bn80571,97223146,98703456,1480310,RLK
chr19,Bn80572,57660473,92735185,35074712,NBS
chr19,Bn80573,35832508,66019013,30186505,RLK
chr19,Bn80574,40390727,86343480,45952753,TN
chr19,Bn80575,7096183,8565152,1468969,RLK
chr19,Bn80576,8270036,78199665,69929629,RLP
chr19,Bn80577,90319570,98719716,8400146,CNL
chr19,Bn80578,47642658,91471911,43829253,TN
chr19,Bn80579,24157864,56462265,32304401,CN
chr19,Bn80580,84062091,97396278,13334187,RLK
chr19,Bn80581,5966372,87217880,81251508,TN
chr19,Bn80582,99735498,99885829,150331,CN
chr19,Bn80583,42719556,87569238,44849682,RLP
chr19,Bn80584,29093127,38753228,9660101,TN
chr19,Bn80585,74311725,80209236,5897511,CN
chr19,Bn80586,19591246,34445138,14853892,CNL
chr19,Bn80587,53668204,69299699,15631495,CN
chr19,Bn80588,28142384,30016266,1873882,TNL
chr19,Bn80589,89809224,92283499,2474275,NBS
chr19,Bn80590,41662140,68943442,27281302,RLK
chr19,Bn80591,90226383,94979250,4752867,RLK
chr19,Bn80592,51982085,82113148,30131063,CNL
chr19,Bn80593,33577085,68781279,35204194,CN
chr19,Bn80594,27656222,50517333,22861111,NBS
chr19,Bn80595,7281266,30660092,23378826,RLK
chr19,Bn80596,39971766,59305222,19333456,NBS
chr19,Bn80597,30410130,60304027,29893897,CN
chr19,Bn80598,6668184,8736343,2068159,NBS
chr19,Bn80599,30844017,99109993,68265976,RLP
chr19,Bn80600,10987755,95965540,84977785,CNL
chr19,Bn80601,33100095,77460267,44360172,TN
chr19,Bn80602,88096595,98632301,10535706,NBS
chr19,Bn80603,12144375,86589666,74445291,RLP
chr19,Bn80604,1087738,66331116,65243378,TNL
chr19,Bn80605,11932396,70937485,59005089,RLK
chr19,Bn80606,75383186,80739338,5356152,CN
chr19,Bn80607,86394042,96479034,10084992,RLP
chr19,Bn80608,88234353,91977909,3743556,CNL
chr19,Bn80609,49089558,89497377,40407819,RLK
chr19,Bn80610,31570662,32570624,999962,CN
chr19,Bn80611,98480298,99360150,879852,CN
chr19,Bn80612,37175660,97333239,60157579,RLK
chr19,Bn80613,42259676,57136479,14876803,CN
chr19,Bn80614,51285139,60197139,8912000,CN
chr19,Bn80615,9535671,28775576,19239905,NBS
chr19,Bn80616,1542032,26401534,24859502,RLK
chr19,Bn80617,6992250,58263920,51271670,RLK
chr19,Bn80618,19161019,58694592,39533573,NBS
chr19,Bn80619,79043696,95977141,16933445,TNL
chr19,Bn80620,46516605,58896342,12379737,CN
chr19,Bn80621,5242205,98204513,92962308,NBS
chr19,Bn80622,7015237,93150966,86135729,RLP
chr19,Bn80623,5878457,82676102,76797645,CNL
chr19,Bn80624,73000324,79613850,6613526,TNL
chr19,Bn80625,25448927,56439610,30990683,RLK
chr19,Bn80626,14515957,90113495,75597538,TNL
chr19,Bn80627,86776123,89814649,3038526,NBS
chr19,Bn80628,88076742,90124170,2047428,TN
chr19,Bn80629,56241319,61736046,5494727,CNL
chr19,Bn80630,95925090,97825913,1900823,RLK
chr19,Bn80631,48390514,74101276,25710762,RLP
chr19,Bn80632,68532409,73168603,4636194,TN
chr19,Bn80633,35299751,36817895,1518144,RLP
chr19,Bn80634,34382201,55840624,21458423,RLP
chr19,Bn80635,84999140,94850647,9851507,CNL
chr19,Bn80636,47758216,76305243,28547027,TNL
chr19,Bn80637,24558369,68260797,43702428,TN
chr19,Bn80638,9508350,12984575,3476225,NBS
chr19,Bn80639,81603428,85670448,4067020,TNL
chr19,Bn80640,11098831,35197596,24098765,CN
chr19,Bn80641,67862132,90874243,23012111,NBS
chr19,Bn80642,76037573,91787234,15749661,TN
chr19,Bn80643,73606343,82025376,8419033,RLP
chr19,Bn80644,3378806,80026476,76647670,TNL
chr19,Bn80645,23846176,95936417,72090241,TNL
chr19,Bn80646,29505836,88692528,59186692,RLP
chr19,Bn80647,4470704,51898099,47427395,RLK
chr19,Bn80648,3036761,95900318,92863557,CN
chr19,Bn80649,26825245,70185510,43360265,CN
chr19,Bn80650,18912627,84125417,65212790,TN
chr19,Bn80651,89951695,95048504,5096809,CN
chr19,Bn80652,46556121,65935195,19379074,TN
chr19,Bn80653,90003746,90631623,627877,CNL
chr19,Bn80654,92578698,95287886,2709188,TNL
chr19,Bn80655,20663646,78753683,58090037,TNL
chr19,Bn80656,76846599,93763165,16916566,CNL
chr19,Bn80657,44567709,51822236,7254527,NBS
chr19,Bn80658,46500719,61236375,14735656,CNL
chr19,Bn80659,67261558,68259892,998334,RLP
chr19,Bn80660,63837191,94089088,30251897,RLK
chr19,Bn80661,14806683,71344263,56537580,TN
chr19,Bn80662,12315983,62666645,50350662,NBS
chr19,Bn80663,22702109,25190018,2487909,RLP
chr19,Bn80664,78396343,87987685,9591342,CN
chr19,Bn80665,93424742,93671067,246325,CNL
chr19,Bn80666,21332302,84066140,62733838,TN
chr19,Bn80667,77291619,95115631,17824012,NBS
chr19,Bn80668,76671279,77702252,1030973,CN
chr19,Bn80669,14190988,59833609,45642621,TNL
chr19,Bn80670,18480970,86425971,67945001,CNL
chr19,Bn80671,44238793,93061382,48822589,RLK
chr19,Bn80672,77244928,97342047,20097119,RLK
chr19,Bn80673,80344899,80529326,184427,NBS
chr19,Bn80674,67385379,99272140,31886761,CN
chr19,Bn80675,45394273,73860587,28466314,RLP
chr19,Bn80676,65106744,85933181,20826437,RLP
chr19,Bn80677,29650701,76040111,46389410,TN
chr19,Bn80678,58475565,92652451,34176886,CN
chr19,Bn80679,77024019,93346407,16322388,CN
chr19,Bn80680,44302709,50215854,5913145,RLK
chr19,Bn80681,68918960,88546080,19627120,CN
chr19,Bn80682,25090363,29833382,4743019,NBS
chr19,Bn80683,30033575,62603198,32569623,TN
chr19,Bn80684,9567192,47111776,37544584,CNL
chr19,Bn80685,79558815,95902567,16343752,CN
chr19,Bn80686,37826412,89748673,51922261,RLP
chr19,Bn80687,32988524,49879453,16890929,NBS
chr19,Bn80688,44533507,53472944,8939437,TN
chr19,Bn80689,54693279,91478774,36785495,TN
chr19,Bn80690,44647585,96292837,51645252,NBS
chr19,Bn80691,2335451,10840305,8504854,RLK
chr19,Bn80692,54049519,65836832,11787313,RLP
chr19,Bn80693,20490877,32152813,11661936,RLP
chr19,Bn80694,9342202,57761354,48419152,TN
chr19,Bn80695,51023869,83499365,32475496,RLK
chr19,Bn80696,36160469,82649741,46489272,CN
chr19,Bn80697,95685893,97113880,1427987,CN
chr19,Bn80698,34787540,45088479,10300939,RLP
chr19,Bn80699,39124810,80205188,41080378,NBS
chr19,Bn80700,51549204,99530268,47981064,CN
chr19,Bn80701,31388940,50438960,19050020,RLK
chr19,Bn80702,65038746,84928258,19889512,TNL
chr19,Bn80703,17080083,18804954,1724871,CN
chr19,Bn80704,4502256,92135581,87633325,RLK
chr19,Bn80705,13877789,55533880,41656091,NBS
chr19,Bn80706,63676843,64475985,799142,RLK
chr19,Bn80707,33945181,85234419,51289238,RLK
chr19,Bn80708,78084741,92878658,14793917,CN
chr19,Bn80709,46763320,90643939,43880619,CN
chr19,Bn80710,78398966,87522850,9123884,RLK
chr19,Bn80711,6821779,32054895,25233116,RLP
chr19,Bn80712,38179040,44299715,6120675,TNL
chr19,Bn80713,14115319,27683613,13568294,RLK
chr19,Bn80714,32404432,50406743,18002311,CN
chr19,Bn80715,38544175,64768748,26224573,TNL
chr19,Bn80716,76169070,77064612,895542,TNL
chr19,Bn80717,69737453,88543229,18805776,NBS
chr19,Bn80718,45945767,87120121,41174354,CNL
chr19,Bn80719,52485803,56344772,3858969,NBS
chr19,Bn80720,83804991,90305997,6501006,CN
chr19,Bn80721,63408040,97373287,33965247,RLK
chr19,Bn80722,46100078,86136293,40036215,CNL
chr19,Bn80723,99185615,99749863,564248,CN
chr19,Bn80724,30663364,88757387,58094023,CN
chr19,Bn80725,69628465,99434119,29805654,CN
chr19,Bn80726,20834186,82502597,61668411,RLP
chr19,Bn80727,96828410,97860614,1032204,RLP
chr19,Bn80728,23264980,92002862,68737882,NBS
chr19,Bn80729,24655362,80740829,56085467,CN
chr19,Bn80730,79122423,89467960,10345537,NBS
chr19,Bn80731,7611837,16254422,8642585,RLK
chr19,Bn80732,68118934,75864146,7745212,RLP
chr19,Bn80733,64119175,73314716,9195541,CN
chr19,Bn80734,3958308,67718873,63760565,CN
chr19,Bn80735,12919073,95177427,82258354,CNL
chr19,Bn80736,82012780,95909945,13897165,RLK
chr19,Bn80737,51006567,62797829,11791262,TN
chr19,Bn80738,62109188,70588810,8479622,TN
chr19,Bn80739,37826483,39023313,1196830,CNL
chr19,Bn80740,67668265,68612335,944070,CN
chr19,Bn80741,32819396,86979270,54159874,CN
chr19,Bn80742,33355792,44195662,10839870,CN
chr19,Bn80743,95958557,98258312,2299755,TNL
chr19,Bn80744,40632520,81182468,40549948,RLK
chr19,Bn80745,8541920,58252579,49710659,NBS
chr19,Bn80746,1234917,97450602,96215685,TN
chr19,Bn80747,77086141,95223266,18137125,CNL
chr19,Bn80748,77587132,97879271,20292139,TN
chr19,Bn80749,81975710,95673733,13698023,RLP
chr19,Bn80750,36108972,88541852,52432880,RLP
chr19,Bn80751,47031726,96254107,49222381,CN
chr19,Bn80752,61236588,61519952,283364,RLK
chr19,Bn80753,46857297,90467513,43610216,CN
chr19,Bn80754,55353544,78349413,22995869,TN
chr19,Bn80755,73445266,91521935,18076669,CN
chr19,Bn80756,38382411,68333975,29951564,TNL
chr19,Bn80757,82770299,88441264,5670965,NBS
chr19,Bn80758,82226682,91037568,8810886,CN
chr19,Bn80759,83813963,95162666,11348703,NBS
chr19,Bn80760,46295571,75004056,28708485,CNL
chr19,Bn80761,82436557,99570510,17133953,RLK
chr19,Bn80762,48977805,54012196,5034391,TN
chr19,Bn80763,84770209,87169792,2399583,TN
chr19,Bn80764,59632288,87172836,27540548,CNL
chr19,Bn80765,3611699,87032027,83420328,TN
chr19,Bn80766,97669462,99031133,1361671,TNL
chr19,Bn80767,29045226,35825450,6780224,CN
chr19,Bn80768,16223074,94497857,78274783,RLK
chr19,Bn80769,51873491,70430466,18556975,RLP
chr19,Bn80770,38185779,42923164,4737385,RLP
chr19,Bn80771,72356282,97609759,25253477,TN
chr19,Bn80772,53624417,93933023,40308606,NBS
chr19,Bn80773,19956131,99856941,79900810,NBS
chr19,Bn80774,29680143,47105810,17425667,RLP
chr19,Bn80775,44407562,69252778,24845216,RLP
chr19,Bn80776,2282722,86061945,83779223,CNL
chr19,Bn80777,81724581,92251851,10527270,RLP
chr19,Bn80778,30076837,39149285,9072448,RLK
chr19,Bn80779,98648679,99780780,1132101,CNL
chr19,Bn80780,52906826,86782843,33876017,TN
chr19,Bn80781,38423475,80326020,41902545,TN
chr19,Bn80782,97802362,98810730,1008368,CNL
chr19,Bn80783,98333740,98871852,538112,CN
chr19,Bn80784,77031263,97482497,20451234,RLP
chr19,Bn80785,72234701,83405126,11170425,CNL
chr19,Bn80786,94651988,95850007,1198019,RLP
chr19,Bn80787,22220716,83673460,61452744,RLK
chr19,Bn80788,57864418,71438197,13573779,TN
chr19,Bn80789,9401744,80915623,71513879,CN
chr19,Bn80790,30394488,30600529,206041,TNL
chr19,Bn80791,32197687,83912416,51714729,CN
chr19,Bn80792,5944032,96839413,90895381,CN
chr19,Bn80793,58129841,87766293,29636452,RLK
chr19,Bn80794,91005491,96304798,5299307,TN
chr19,Bn80795,92841925,98348487,5506562,RLK
chr19,Bn80796,31231678,68560132,37328454,TN
chr19,Bn80797,63240769,85903953,22663184,RLK
chr19,Bn80798,43140929,65488841,22347912,RLP
chr19,Bn80799,49932548,60310088,10377540,RLK
chr19,Bn80800,51415628,71508025,20092397,NBS
chr19,Bn80801,31223411,65528391,34304980,TN
chr19,Bn80802,95927970,98310236,2382266,TNL
chr19,Bn80803,43593044,51757804,8164760,RLP
chr19,Bn80804,86922905,93564290,6641385,TN
chr19,Bn80805,1111964,11288299,10176335,TNL
chr19,Bn80806,38035413,94189029,56153616,NBS
chr19,Bn80807,76394687,85986103,9591416,CN
chr19,Bn80808,2214153,92314489,90100336,TNL
chr19,Bn80809,55652022,73799549,18147527,NBS
chr19,Bn80810,43710822,55238882,11528060,TN
chr19,Bn80811,75694248,98817175,23122927,CNL
chr19,Bn80812,53485467,89410686,35925219,NBS
chr19,Bn80813,56574607,60219122,3644515,NBS
chr19,Bn80814,68915273,99458507,30543234,RLK
chr19,Bn80815,97118143,97925855,807712,NBS
chr19,Bn80816,55081930,60246537,5164607,CN
chr19,Bn80817,28831148,40429946,11598798,TN
chr19,Bn80818,6019191,41501569,35482378,CN
chr19,Bn80819,49368901,65291860,15922959,RLK
chr19,Bn80820,42398736,68010286,25611550,RLP
chr19,Bn80821,11068371,50913800,39845429,CNL
chr19,Bn80822,1385448,47511748,46126300,TNL
chr19,Bn80823,82018844,96339033,14320189,TN
chr19,Bn80824,65002455,74345784,9343329,CN
chr19,Bn80825,62971621,69399226,6427605,CNL
chr19,Bn80826,41305324,67041844,25736520,NBS
chr19,Bn80827,87424647,94955776,7531129,CNL
chr19,Bn80828,72957946,85887080,12929134,RLK
chr19,Bn80829,36404937,86321133,49916196,RLP
chr19,Bn80830,18074356,42219589,24145233,CN
chr19,Bn80831,78958677,95269713,16311036,TN
chr19,Bn80832,73080766,77031136,3950370,TNL
chr19,Bn80833,26413074,62983008,36569934,CN
chr19,Bn80834,90628614,93964611,3335997,RLP
chr19,Bn80835,85754284,89116428,3362144,CNL
chr19,Bn80836,43916774,62404627,18487853,RLP
chr19,Bn80837,37799572,52157589,14358017,TNL
chr19,Bn80838,1414352,29504270,28089918,RLK
chr19,Bn80839,90464058,91966987,1502929,RLP
chr19,Bn80840,26823141,57361542,30538401,RLP
chr19,Bn80841,28326668,74206287,45879619,RLP
chr19,Bn80842,85050422,96465022,11414600,TNL
chr19,Bn80843,20161145,40677621,20516476,RLP
chr19,Bn80844,40173100,67275150,27102050,TNL
chr19,Bn80845,17843720,83454315,65610595,TNL
chr19,Bn80846,30336724,49464370,19127646,CN
chr19,Bn80847,96861561,97164470,302909,NBS
chr19,Bn80848,6475009,79564393,73089384,NBS
chr19,Bn80849,80698386,99204970,18506584,CN
chr19,Bn80850,4244528,76966033,72721505,TN
chr19,Bn80851,7920030,44454727,36534697,RLK
chr19,Bn80852,90076293,94369478,4293185,NBS
chr19,Bn80853,66507965,75993883,9485918,RLK
chr19,Bn80854,30103369,44901823,14798454,RLK
chr19,Bn80855,34154396,63042328,28887932,RLP
chr19,Bn80856,64686802,90594813,25908011,TN
chr19,Bn80857,84408976,98424941,14015965,NBS
chr19,Bn80858,86134650,90466592,4331942,TNL
chr19,Bn80859,75963167,94224516,18261349,CN
chr19,Bn80860,5457534,78397860,72940326,RLP
chr19,Bn80861,38649245,49188864,10539619,RLP
chr19,Bn80862,69704644,70786598,1081954,TNL
chr19,Bn80863,14135833,81633711,67497878,RLK
chr19,Bn80864,5299946,10658866,5358920,NBS
chr19,Bn80865,15523420,25167753,9644333,CN
chr19,Bn80866,11183852,23095334,11911482,CN
chr19,Bn80867,58766246,72437345,13671099,CNL
chr19,Bn80868,75352794,90885796,15533002,NBS
chr19,Bn80869,65997462,99775928,33778466,TN
chr19,Bn80870,15715576,43666300,27950724,CNL
chr19,Bn80871,80448661,81334472,885811,TN
chr19,Bn80872,88801773,89439672,637899,TNL
chr19,Bn80873,4428134,41408703,36980569,RLP
chr19,Bn80874,83641697,83878704,237007,CNL
chr19,Bn80875,56695116,66502637,9807521,RLP
chr19,Bn80876,40203655,99206430,59002775,TN
chr19,Bn80877,1661708,96561888,94900180,RLK
chr19,Bn80878,64539755,89126543,24586788,CN
chr19,Bn80879,90028681,98221161,8192480,TN
chr19,Bn80880,72240279,75038740,2798461,RLP
chr19,Bn80881,62053740,97055358,35001618,CNL
chr19,Bn80882,70379706,99150794,28771088,NBS
chr19,Bn80883,32749740,84971355,52221615,RLP
chr19,Bn80884,14280310,43954790,29674480,TNL
chr19,Bn80885,54505290,57058479,2553189,CN
chr19,Bn80886,18834246,97554945,78720699,CN
chr19,Bn80887,74994236,82094537,7100301,TN
chr19,Bn80888,68233023,94954104,26721081,RLP
chr19,Bn80889,47464331,90252857,42788526,RLK
chr19,Bn80890,63714401,88552936,24838535,TNL
chr19,Bn80891,73528637,99089160,25560523,RLK
chr19,Bn80892,60379785,60732083,352298,RLK
chr19,Bn80893,58735603,62449615,3714012,RLK
chr19,Bn80894,84835669,96597363,11761694,CN
chr19,Bn80895,79436398,95281645,15845247,CNL
chr19,Bn80896,58699231,97892525,39193294,TN
chr19,Bn80897,41579730,64072127,22492397,RLK
chr19,Bn80898,38053681,57509614,19455933,NBS
chr19,Bn80899,71717329,99327965,27610636,CNL
chr19,Bn80900,13593239,53759904,40166665,TN
chr19,Bn80901,33273867,65628234,32354367,RLP
chr19,Bn80902,99806362,99979913,173551,TNL
chr19,Bn80903,58700002,87795894,29095892,CN
chr19,Bn80904,62909831,65865914,2956083,RLK
chr19,Bn80905,37116694,53481660,16364966,CN
chr19,Bn80906,90728472,97219078,6490606,TNL
chr19,Bn80907,37301230,45751388,8450158,RLP
chr19,Bn80908,49785456,89000021,39214565,TNL
chr19,Bn80909,63573275,88471473,24898198,NBS
chr19,Bn80910,64508713,94795324,30286611,TN
chr19,Bn80911,79594034,98701411,19107377,CN
chr19,Bn80912,92278980,94856242,2577262,TNL
chr19,Bn80913,84989115,90991200,6002085,NBS
chr19,Bn80914,89906119,96333518,6427399,CN
chr19,Bn80915,36691955,75586812,38894857,TN
chr19,Bn80916,43689681,81736410,38046729,TN
chr19,Bn80917,66309722,75645131,9335409,TNL
chr19,Bn80918,18486039,58676523,40190484,TN
chr19,Bn80919,60855272,93991985,33136713,RLK
chr19,Bn80920,52644961,69721841,17076880,NBS
chr19,Bn80921,38364308,59419416,21055108,CNL
chr19,Bn80922,8036476,44549737,36513261,TN
chr19,Bn80923,10185682,35459798,25274116,TNL
chr19,Bn80924,93684079,99696471,6012392,TNL
chr19,Bn80925,89887741,90483323,595582,TN
chr19,Bn80926,12592095,57047749,44455654,TN
chr19,Bn80927,29563484,79774831,50211347,CN
chr19,Bn80928,19475817,97480929,78005112,CN
chr19,Bn80929,2149645,86241346,84091701,TN
chr19,Bn80930,53103783,53872283,768500,CN
chr19,Bn80931,88507937,89022041,514104,CN
chr19,Bn80932,43443405,82935476,39492071,TNL
chr19,Bn80933,90622305,90848996,226691,TN
chr19,Bn80934,86046044,97417607,11371563,CNL
chr19,Bn80935,75499624,95291136,19791512,RLK
chr19,Bn80936,53967980,72148363,18180383,TN
chr19,Bn80937,44511762,78979751,34467989,CN
chr19,Bn80938,75901039,82749740,6848701,NBS
chr19,Bn80939,91298321,94065703,2767382,CN
chr19,Bn80940,61999325,77505809,15506484,NBS
chr19,Bn80941,20244853,74570213,54325360,TN
chr19,Bn80942,32764047,53886883,21122836,TNL
chr19,Bn80943,31420746,50636759,19216013,RLP
chr19,Bn80944,18975452,73829547,54854095,NBS
chr19,Bn80945,30922975,47372803,16449828,TN
chr19,Bn80946,76138716,78606916,2468200,TNL
chr19,Bn80947,38583585,65200371,26616786,CNL
chr19,Bn80948,44476374,68489328,24012954,RLK
chr19,Bn80949,50990069,57787444,6797375,RLK
chr19,Bn80950,53068139,71322156,18254017,TN
chr19,Bn80951,29021141,76550482,47529341,RLP
chr19,Bn80952,23365888,95406444,72040556,CNL
chr19,Bn80953,84029830,86946972,2917142,TN
chr19,Bn80954,35649368,43149085,7499717,RLK
chr19,Bn80955,84384381,98374297,13989916,RLP
chr19,Bn80956,32823643,74585389,41761746,RLK
chr19,Bn80957,64807529,92384262,27576733,RLK
chr19,Bn80958,66776093,94299854,27523761,TN
chr19,Bn80959,52504456,98394208,45889752,TN
chr19,Bn80960,7847580,94619480,86771900,TNL
chr19,Bn80961,12661044,78584854,65923810,RLP
chr19,Bn80962,11672558,11838498,165940,TNL
chr19,Bn80963,42875113,68268960,25393847,CNL
chr19,Bn80964,30946634,85704098,54757464,RLK
chr19,Bn80965,79935790,85531260,5595470,TN
chr19,Bn80966,81338532,89095393,7756861,RLK
chr19,Bn80967,76974107,91239847,14265740,TN
chr19,Bn80968,22839156,63316022,40476866,RLK
chr19,Bn80969,96733876,99862991,3129115,TNL
chr19,Bn80970,23594839,63949580,40354741,CNL
chr19,Bn80971,5211822,79469124,74257302,CN
chr19,Bn80972,54200579,68888417,14687838,RLK
chr19,Bn80973,4503953,93022341,88518388,NBS
chr19,Bn80974,6284433,26773498,20489065,TN
chr19,Bn80975,57094832,91173463,34078631,TN
chr19,Bn80976,51343435,76310731,24967296,RLP
chr19,Bn80977,43733991,53045000,9311009,TN
chr19,Bn80978,10437114,52598148,42161034,TN
chr19,Bn80979,87084794,91702264,4617470,NBS
chr19,Bn80980,58545145,94908662,36363517,RLP
chr19,Bn80981,19121460,57638748,38517288,TN
chr19,Bn80982,21222985,63042273,41819288,RLK
chr19,Bn80983,74204947,84959118,10754171,TN
chr19,Bn80984,43386987,53549961,10162974,CNL
chr19,Bn80985,77077148,90327231,13250083,RLP
chr19,Bn80986,56103527,95271785,39168258,TNL
chr19,Bn80987,66113999,95178012,29064013,NBS
chr19,Bn80988,84497590,85332188,834598,CNL
chr19,Bn80989,14722346,64683550,49961204,TN
chr19,Bn80990,54114824,93999523,39884699,TNL
chr19,Bn80991,17624265,89015948,71391683,TNL
chr19,Bn80992,81064261,99269384,18205123,TN
chr19,Bn80993,42377919,71407303,29029384,TN
chr19,Bn80994,63951264,77063659,13112395,TN
chr19,Bn80995,18445126,39460486,21015360,CN
chr19,Bn80996,21995715,79126473,57130758,CNL
chr19,Bn80997,34013395,87853658,53840263,CN
chr19,Bn80998,34183240,83361042,49177802,CNL
chr19,Bn80999,16464458,39957938,23493480,CNL
chr19,Bn81000,3918510,28054178,24135668,NBS
chr19,Bn81001,90589357,97082090,6492733,RLP
chr19,Bn81002,97503366,99072688,1569322,TN
chr19,Bn81003,52713284,63406903,10693619,TN
chr19,Bn81004,63258340,77565336,14306996,CNL
chr19,Bn81005,77145199,87163121,10017922,NBS
chr19,Bn81006,93129164,96289109,3159945,TN
chr19,Bn81007,98792931,99510207,717276,RLK
chr19,Bn81008,78543837,97876207,19332370,RLK
chr19,Bn81009,63162905,88175567,25012662,TN
chr19,Bn81010,76518174,97482866,20964692,TNL
chr19,Bn81011,95506625,98963724,3457099,CN
chr19,Bn81012,76496580,97660304,21163724,CNL
chr19,Bn81013,53139873,87784965,34645092,NBS
chr19,Bn81014,43712212,46628695,2916483,NBS
chr19,Bn81015,48081440,90573460,42492020,CN
chr19,Bn81016,36803288,63777032,26973744,CNL
chr19,Bn81017,90970761,95621689,4650928,TN
chr19,Bn81018,24655354,31798551,7143197,RLP
chr19,Bn81019,53138151,77217815,24079664,NBS
chr19,Bn81020,89598476,93881543,4283067,RLK
chr19,Bn81021,20591560,55126426,34534866,RLK
chr19,Bn81022,44622173,87857983,43235810,CNL
chr19,Bn81023,58022896,97500593,39477697,CNL
chr19,Bn81024,85005075,92473501,7468426,RLP
chr19,Bn81025,22247030,53059323,30812293,RLK
chr19,Bn81026,76936372,83643269,6706897,RLP
chr19,Bn81027,12111255,52441440,40330185,RLP
chr19,Bn81028,35438056,65254897,29816841,RLK
chr19,Bn81029,65019890,94638436,29618546,TNL
chr19,Bn81030,30737479,97335050,66597571,RLK
chr19,Bn81031,45746653,77721472,31974819,CN
chr19,Bn81032,87825449,99713899,11888450,NBS
chr19,Bn81033,2978805,47474813,44496008,RLP
chr19,Bn81034,38258019,63564299,25306280,CNL
chr19,Bn81035,99554099,99922852,368753,RLK
chr19,Bn81036,75059160,93393994,18334834,CN
chr19,Bn81037,38656083,40740571,2084488,TNL
chr19,Bn81038,72330945,81844238,9513293,CN
chr19,Bn81039,87625454,98759653,11134199,TNL
chr19,Bn81040,94605576,97062577,2457001,TNL
chr19,Bn81041,28947270,51427514,22480244,RLK
chr19,Bn81042,44200279,65764751,21564472,TNL
chr19,Bn81043,25316872,40049286,14732414,TNL
chr19,Bn81044,12448852,98384510,85935658,TNL
chr19,Bn81045,33968872,67091420,33122548,TNL
chr19,Bn81046,18778894,46431148,27652254,CNL
chr19,Bn81047,36251351,51393527,15142176,TN
chr19,Bn81048,7211124,29798698,22587574,RLK
chr19,Bn81049,62177129,81784534,19607405,RLP
chr19,Bn81050,30368760,39545643,9176883,RLK
chr19,Bn81051,42960507,43210129,249622,TNL
chr19,Bn81052,57826269,85188295,27362026,CN
chr19,Bn81053,7093826,90309343,83215517,NBS
chr19,Bn81054,49221349,85878041,36656692,TNL
chr19,Bn81055,36241789,38271261,2029472,NBS
chr19,Bn81056,24376627,56963998,32587371,NBS
chr19,Bn81057,78090396,97539046,19448650,CNL
chr19,Bn81058,63634878,65900861,2265983,CNL
chr19,Bn81059,41361509,75949182,34587673,CNL
chr19,Bn81060,41872451,56059924,14187473,TNL
chr19,Bn81061,15068837,44115892,29047055,NBS
chr19,Bn81062,38304648,44905750,6601102,TNL
chr19,Bn81063,82317699,92351853,10034154,CN
chr19,Bn81064,26254635,60095725,33841090,CN
chr19,Bn81065,36720203,83773380,47053177,RLK
chr19,Bn81066,71727823,71988930,261107,CNL
chr19,Bn81067,78077004,79346635,1269631,RLK
chr19,Bn81068,42405152,43160031,754879,RLK
chr19,Bn81069,40439639,44035527,3595888,TN
chr19,Bn81070,57352960,61237903,3884943,RLK
chr19,Bn81071,49901121,91455806,41554685,TN
chr19,Bn81072,7417831,19993441,12575610,RLK
chr19,Bn81073,34100004,46093395,11993391,TN
chr19,Bn81074,63784298,96280948,32496650,TN
chr19,Bn81075,89413908,90429187,1015279,TN
chr19,Bn81076,59330966,67350266,8019300,TN
chr19,Bn81077,67927358,73658179,5730821,NBS
chr19,Bn81078,27828379,48311982,20483603,TNL
chr19,Bn81079,48167521,74224870,26057349,NBS
chr19,Bn81080,53660701,58064277,4403576,CN
chr19,Bn81081,92295496,93467499,1172003,CN
chr19,Bn81082,13980127,34653148,20673021,TNL
chr19,Bn81083,37778621,73456575,35677954,CNL
chr19,Bn81084,34792639,38948353,4155714,NBS
chr19,Bn81085,21333515,95119488,73785973,RLK
chr19,Bn81086,67575778,74327325,6751547,TNL
chr19,Bn81087,68780079,99622155,30842076,CNL
chr19,Bn81088,44791374,91626121,46834747,CNL
chr19,Bn81089,23896317,40342408,16446091,NBS
chr19,Bn81090,72155955,96407197,24251242,TNL
chr19,Bn81091,19914288,59748234,39833946,RLK
chr19,Bn81092,22564552,53662034,31097482,TN
chr19,Bn81093,39238540,78475662,39237122,CN
chr19,Bn81094,55954761,60117538,4162777,TN
chr19,Bn81095,68805669,86862178,18056509,CN
chr19,Bn81096,69069433,73089637,4020204,RLK
chr19,Bn81097,31103954,31896638,792684,RLK
chr19,Bn81098,49471483,65986575,16515092,CNL
chr19,Bn81099,65934061,95296943,29362882,TN
chr19,Bn81100,32586913,85659752,53072839,CN
chr19,Bn81101,40518830,71258287,30739457,RLK
chr19,Bn81102,63764579,94790910,31026331,CNL
chr19,Bn81103,86003365,92345457,6342092,TN
chr19,Bn81104,74730324,76032491,1302167,RLP
chr19,Bn81105,73190640,96929366,23738726,CNL
chr19,Bn81106,43496940,69431736,25934796,CN
chr19,Bn81107,95369442,99538088,4168646,TNL
chr19,Bn81108,27939379,43026340,15086961,TN
chr19,Bn81109,34195978,95548088,61352110,RLK
chr19,Bn81110,48881629,79325453,30443824,RLK
chr19,Bn81111,34272657,73006434,38733777,RLP
chr19,Bn81112,77251743,98564671,21312928,TN
chr19,Bn81113,89236937,91982463,2745526,RLP
chr19,Bn81114,7053693,83080643,76026950,CN
chr19,Bn81115,72281896,78021117,5739221,NBS
chr19,Bn81116,5630127,54547786,48917659,TNL
chr19,Bn81117,97691559,97951394,259835,TNL
chr19,Bn81118,27104473,64064277,36959804,RLK
chr19,Bn81119,2533127,64125902,61592775,CN
chr19,Bn81120,44283803,85297095,41013292,RLP
chr19,Bn81121,25035497,77551258,52515761,RLP
chr19,Bn81122,50283690,87234202,36950512,CNL
chr19,Bn81123,89909485,91756047,1846562,TNL
chr19,Bn81124,37262669,63771704,26509035,NBS
chr19,Bn81125,90831758,96377462,5545704,TN
chr19,Bn81126,18835188,33402366,14567178,TN
chr19,Bn81127,83672394,88008144,4335750,TNL
chr19,Bn81128,74951304,84957113,10005809,CN
chr19,Bn81129,22619070,23177144,558074,CN
chr19,Bn81130,21405327,33074049,11668722,NBS
chr19,Bn81131,98588614,98899671,311057,RLP
chr19,Bn81132,46136066,51754780,5618714,RLP
chr19,Bn81133,63592718,66313531,2720813,CNL
chr19,Bn81134,90378587,95716870,5338283,TNL
chr19,Bn81135,73911519,90792638,16881119,CN
chr19,Bn81136,25999807,29204485,3204678,TNL
chr19,Bn81137,90596917,93636140,3039223,RLK
chr19,Bn81138,96316058,98494281,2178223,TN
chr19,Bn81139,96156314,97271362,1115048,NBS
chr19,Bn81140,96336766,96979105,642339,CNL
chr19,Bn81141,38556287,75312730,36756443,NBS
chr19,Bn81142,71415373,91966252,20550879,TN
chr19,Bn81143,39246078,67359269,28113191,RLK
chr19,Bn81144,45420310,97926751,52506441,NBS
chr19,Bn81145,80088267,81965633,1877366,RLP
chr19,Bn81146,55162659,99881353,44718694,CN
chr19,Bn81147,99296840,99676975,380135,TNL
chr19,Bn81148,80792932,92441699,11648767,RLP
chr19,Bn81149,44183247,51622925,7439678,RLK
chr19,Bn81150,94440959,98929953,4488994,TN
chr19,Bn81151,90265239,95660115,5394876,NBS
chr19,Bn81152,65273202,68751843,3478641,RLK
chr19,Bn81153,26955446,61655831,34700385,TN
chr19,Bn81154,9482958,91731443,82248485,CNL
chr19,Bn81155,54288029,69638345,15350316,RLK
chr19,Bn81156,64044579,94035479,29990900,CNL
chr19,Bn81157,75783265,82905428,7122163,CNL
chr19,Bn81158,7854767,78806151,70951384,RLP
chr19,Bn81159,44227492,47725636,3498144,TN
chr19,Bn81160,76158178,85818993,9660815,CN
chr19,Bn81161,5640664,25321401,19680737,CNL
chr19,Bn81162,2090809,17267887,15177078,CN
chr19,Bn81163,70187148,94277899,24090751,NBS
chr19,Bn81164,5100234,46823707,41723473,CNL
chr19,Bn81165,26535817,65123432,38587615,TNL
chr19,Bn81166,70711330,75092961,4381631,CNL
chr19,Bn81167,66314124,97259259,30945135,RLP
chr19,Bn81168,99816831,99838051,21220,CNL
chr19,Bn81169,65112534,77006513,11893979,CNL
chr19,Bn81170,42999886,91884503,48884617,TNL
chr19,Bn81171,97858141,99691270,1833129,TNL
chr19,Bn81172,34830315,49676560,14846245,CNL
chr19,Bn81173,36958851,37522016,563165,CNL
chr19,Bn81174,1222280,28018421,26796141,NBS
chr19,Bn81175,43388438,78635091,35246653,TN
chr19,Bn81176,45379162,70769658,25390496,CN
chr19,Bn81177,32351837,49059947,16708110,TN
chr19,Bn81178,30280189,94527529,64247340,RLK
chr19,Bn81179,92022617,92906686,884069,TNL
chr19,Bn81180,59229761,73862851,14633090,RLK
chr19,Bn81181,71242689,97081659,25838970,RLP
chr19,Bn81182,95869794,99917971,4048177,TNL
chr19,Bn81183,14504923,79471847,64966924,RLK
chr19,Bn81184,68483649,95425860,26942211,RLP
chr19,Bn81185,47565092,89224593,41659501,RLK
chr19,Bn81186,24143848,76690434,52546586,CN
chr19,Bn81187,87940981,97407030,9466049,RLP
chr19,Bn81188,34965172,71835415,36870243,CNL
chr19,Bn81189,17371279,99802825,82431546,RLK
chr19,Bn81190,55276139,80135478,24859339,CN
chr19,Bn81191,43283235,88796130,45512895,CN
chr19,Bn81192,64029691,67866216,3836525,RLP
chr19,Bn81193,36590307,96825524,60235217,RLK
chr19,Bn81194,64834678,95746867,30912189,TNL
chr19,Bn81195,94385914,99777770,5391856,TNL
chr19,Bn81196,29344443,75290762,45946319,RLK
chr19,Bn81197,19225670,96621056,77395386,TN
chr19,Bn81198,52956807,96774679,43817872,TN
chr19,Bn81199,42761666,59338503,16576837,TN
chr19,Bn81200,56269654,64142824,7873170,CN
chr19,Bn81201,53519126,93044780,39525654,NBS
chr19,Bn81202,64808581,89714685,24906104,RLK
chr19,Bn81203,24526338,95066406,70540068,RLP
chr19,Bn81204,69211584,85318445,16106861,CN
chr19,Bn81205,2921352,84007618,81086266,NBS
chr19,Bn81206,9911920,27769655,17857735,NBS
chr19,Bn81207,45908927,52277838,6368911,NBS
chr19,Bn81208,77351267,93414132,16062865,CN
chr19,Bn81209,45130848,85533995,40403147,CNL
chr19,Bn81210,39996932,72046781,32049849,NBS
chr19,Bn81211,62669497,87240996,24571499,RLK
chr19,Bn81212,18053203,46080397,28027194,RLP
chr19,Bn81213,55200791,85537014,30336223,NBS
chr19,Bn81214,15417226,76755858,61338632,CN
chr19,Bn81215,80465702,94791975,14326273,TN
chr19,Bn81216,34140307,47002951,12862644,NBS
chr19,Bn81217,66946480,89344939,22398459,CN
chr19,Bn81218,3793794,63414421,59620627,CN
chr19,Bn81219,74584591,89305258,14720667,CN
chr19,Bn81220,22476688,91081809,68605121,TNL
chr19,Bn81221,36766528,44653332,7886804,CN
chr19,Bn81222,58860395,76730368,17869973,NBS
chr19,Bn81223,45785018,93700577,47915559,CN
chr19,Bn81224,12929495,44310483,31380988,CNL
chr19,Bn81225,38128620,76924899,38796279,TNL
chr19,Bn81226,5322968,62929913,57606945,CN
chr19,Bn81227,52336065,92364094,40028029,CN
chr19,Bn81228,58421817,75099794,16677977,CN
chr19,Bn81229,53516241,94894614,41378373,RLK
chr19,Bn81230,59689047,59716702,27655,CN
chr19,Bn81231,82734216,94182563,11448347,RLK
chr19,Bn81232,37432083,87309607,49877524,NBS
chr19,Bn81233,26500393,75588792,49088399,RLP
chr19,Bn81234,41535387,80327280,38791893,TNL
chr19,Bn81235,31569415,34240496,2671081,CNL
chr19,Bn81236,11891563,60574249,48682686,RLK
chr19,Bn81237,8951365,12257209,3305844,RLK
chr19,Bn81238,64495091,70860641,6365550,CN
chr19,Bn81239,12097208,59903035,47805827,RLK
chr19,Bn81240,11589986,63412001,51822015,TNL
chr19,Bn81241,94834575,97266249,2431674,TN
chr19,Bn81242,44653658,86596458,41942800,CN
chr19,Bn81243,63002359,64253058,1250699,RLP
chr19,Bn81244,31035344,57140377,26105033,CNL
chr19,Bn81245,38031136,78499495,40468359,NBS
chr19,Bn81246,83272463,88153331,4880868,CN
chr19,Bn81247,88259323,99932631,11673308,RLK
chr19,Bn81248,65337663,79964012,14626349,RLP
chr19,Bn81249,38045514,86736282,48690768,RLP
chr19,Bn81250,70835565,88131612,17296047,RLK
chr19,Bn81251,11648636,38420025,26771389,CNL
chr19,Bn81252,42432996,96218549,53785553,TNL
chr19,Bn81253,27131120,65725664,38594544,CN
chr19,Bn81254,8451520,63412125,54960605,CN
chr19,Bn81255,56226020,74018653,17792633,RLK
chr19,Bn81256,34378217,91656819,57278602,RLP
chr19,Bn81257,14609767,24098094,9488327,NBS
chr19,Bn81258,44394165,59402121,15007956,NBS
chr19,Bn81259,14563074,45869762,31306688,CNL
chr19,Bn81260,87974965,97106089,9131124,CNL
chr19,Bn81261,87520229,89012031,1491802,CN
chr19,Bn81262,26244135,44127360,17883225,TN
chr19,Bn81263,17017830,33614568,16596738,RLK
chr19,Bn81264,25863361,26130633,267272,TN
chr19,Bn81265,75807954,84998555,9190601,CNL
chr19,Bn81266,46729739,55921405,9191666,CN
chr19,Bn81267,85219950,90416739,5196789,CNL
chr19,Bn81268,80072858,99055444,18982586,RLP
chr19,Bn81269,15862677,82592698,66730021,RLK
chr19,Bn81270,27229936,66792230,39562294,CN
chr19,Bn81271,28842162,36456420,7614258,RLP
chr19,Bn81272,99865517,99899056,33539,RLK
chr19,Bn81273,43508341,74517090,31008749,RLK
chr19,Bn81274,34105681,41281532,7175851,RLP
chr19,Bn81275,23450351,37053288,13602937,CN
chr19,Bn81276,75657857,88177968,12520111,RLP
chr19,Bn81277,73360547,95653038,22292491,RLP
chr19,Bn81278,7853050,47050391,39197341,RLK
chr19,Bn81279,28766100,60033527,31267427,CNL
chr19,Bn81280,45551530,97660136,52108606,RLP
chr19,Bn81281,23322049,36750140,13428091,RLK
chr19,Bn81282,84774397,95044760,10270363,CNL
chr19,Bn81283,54515080,61173483,6658403,NBS
chr19,Bn81284,4581175,55498120,50916945,TN
chr19,Bn81285,43399666,61909734,18510068,RLK
chr19,Bn81286,7809780,19721466,11911686,CN
chr19,Bn81287,2336027,35515277,33179250,TNL
chr19,Bn81288,60052633,94994253,34941620,TNL
chr19,Bn81289,28541616,83987220,55445604,CN
chr19,Bn81290,3834855,50358606,46523751,TNL
chr19,Bn81291,74143334,88321368,14178034,TN
chr19,Bn81292,98848235,98945389,97154,NBS
chr19,Bn81293,6970644,62006103,55035459,CN
chr19,Bn81294,69102947,95786599,26683652,RLP
chr19,Bn81295,86977105,99413238,12436133,RLK
chr19,Bn81296,54129282,82553103,28423821,CNL
chr19,Bn81297,41297598,91150640,49853042,NBS
chr19,Bn81298,24870237,73271663,48401426,CNL
chr19,Bn81299,52853032,72518364,19665332,NBS
chr19,Bn81300,37356106,56878495,19522389,NBS
chr19,Bn81301,11291686,33227532,21935846,TNL
chr19,Bn81302,4200007,68888707,64688700,NBS
chr19,Bn81303,1279380,11902010,10622630,NBS
chr19,Bn81304,25580764,93699515,68118751,RLK
chr19,Bn81305,32785278,37310510,4525232,CN
chr19,Bn81306,64805980,83391926,18585946,CN
chr19,Bn81307,57413187,61870961,4457774,TNL
chr19,Bn81308,96098067,99619808,3521741,TN
chr19,Bn81309,40662576,68132676,27470100,CNL
chr19,Bn81310,94015096,96826587,2811491,NBS
chr19,Bn81311,24634878,67255334,42620456,NBS
chr19,Bn81312,77965454,96755413,18789959,RLK
chr19,Bn81313,91417692,99557712,8140020,NBS
chr19,Bn81314,79326328,97448844,18122516,TN
chr19,Bn81315,93648918,99530443,5881525,RLP
chr19,Bn81316,61617011,92575317,30958306,RLK
chr19,Bn81317,18860849,94671801,75810952,CNL
chr19,Bn81318,85450106,96333736,10883630,TNL
chr19,Bn81319,27412142,61370102,33957960,CN
chr19,Bn81320,20689975,39906499,19216524,TNL
chr19,Bn81321,52221959,98515076,46293117,CN
chr19,Bn81322,88232145,95405714,7173569,NBS
chr19,Bn81323,75169429,99961965,24792536,CN
chr19,Bn81324,30113819,74242135,44128316,TN
chr19,Bn81325,87637041,97954467,10317426,TNL
chr19,Bn81326,33039003,36701655,3662652,CN
chr19,Bn81327,13035067,82219592,69184525,TNL
chr19,Bn81328,54080682,74993292,20912610,CNL
chr19,Bn81329,76618255,80667010,4048755,CNL
chr19,Bn81330,37027824,99875950,62848126,NBS
chr19,Bn81331,73560689,80569059,7008370,TNL
chr19,Bn81332,13375263,22447385,9072122,RLK
chr19,Bn81333,96144479,98167795,2023316,TN
chr19,Bn81334,70781646,74357514,3575868,CN
chr19,Bn81335,5513023,99388959,93875936,RLP
chr19,Bn81336,55893481,56416901,523420,TNL
chr19,Bn81337,83675231,97730151,14054920,CNL
chr19,Bn81338,10698318,27411690,16713372,NBS
chr19,Bn81339,73283604,98152153,24868549,RLP
chr19,Bn81340,49997527,80820599,30823072,TNL
chr19,Bn81341,25877510,87259392,61381882,NBS
chr19,Bn81342,69984409,86934111,16949702,TNL
chr19,Bn81343,89882121,91317272,1435151,CN
chr19,Bn81344,36245743,49643015,13397272,TN
chr19,Bn81345,70913410,88417564,17504154,TN
chr19,Bn81346,3112959,75353462,72240503,CN
chr19,Bn81347,51099348,89060015,37960667,NBS
chr19,Bn81348,7213125,82123710,74910585,TNL
chr19,Bn81349,95460217,96822632,1362415,TNL
chr19,Bn81350,77652406,82578815,4926409,TNL
chr19,Bn81351,49826058,62821605,12995547,RLP
chr19,Bn81352,80921692,90291889,9370197,CN
chr19,Bn81353,44655550,47868173,3212623,RLP
chr19,Bn81354,81014844,87246625,6231781,TNL
chr19,Bn81355,71070772,77090620,6019848,NBS
chr19,Bn81356,33348828,42234374,8885546,CNL
chr19,Bn81357,84193927,87647730,3453803,CN
chr19,Bn81358,6455091,25199789,18744698,RLK
chr19,Bn81359,25592399,57577026,31984627,TNL
chr19,Bn81360,47291802,73282978,25991176,TNL
chr19,Bn81361,50614341,99076840,48462499,TNL
chr19,Bn81362,24837208,92681805,67844597,TNL
chr19,Bn81363,74588963,83900303,9311340,TNL
chr19,Bn81364,31685048,73641676,41956628,RLP
chr19,Bn81365,9959591,22522496,12562905,TN
chr19,Bn81366,96316288,97154995,838707,TNL
chr19,Bn81367,54204774,59167528,4962754,NBS
chr19,Bn81368,17256739,46462167,29205428,CNL
chr19,Bn81369,82022182,93585031,11562849,NBS
chr19,Bn81370,71697096,95693782,23996686,RLK
chr19,Bn81371,9498190,15560255,6062065,NBS
chr19,Bn81372,55513812,84360412,28846600,RLP
chr19,Bn81373,30965709,97104123,66138414,RLK
chr19,Bn81374,38181599,73964433,35782834,CN
chr19,Bn81375,31717601,70936071,39218470,TNL
chr19,Bn81376,45124139,94872747,49748608,NBS
chr19,Bn81377,96883406,97878071,994665,NBS
chr19,Bn81378,78744141,89859253,11115112,NBS
chr19,Bn81379,69870880,78162498,8291618,CN
chr19,Bn81380,24215034,55578935,31363901,NBS
chr19,Bn81381,97636078,99951990,2315912,CNL
chr19,Bn81382,10069851,19112593,9042742,RLP
chr19,Bn81383,71246736,89892260,18645524,RLK
chr19,Bn81384,65156302,77843493,12687191,TN
chr19,Bn81385,78917900,86104356,7186456,CN
chr19,Bn81386,61615318,68235805,6620487,RLK
chr19,Bn81387,78198970,87444543,9245573,CN
chr19,Bn81388,86109763,96816604,10706841,RLP
chr19,Bn81389,73049161,95354072,22304911,TN
chr19,Bn81390,32826298,78756278,45929980,NBS
chr19,Bn81391,97120970,98174939,1053969,TN
chr19,Bn81392,23178080,45708222,22530142,CN
chr19,Bn81393,80920491,90057845,9137354,RLP
chr19,Bn81394,11410651,81711758,70301107,NBS
chr19,Bn81395,99019010,99598745,579735,TNL
chr19,Bn81396,64983094,88684186,23701092,CNL
chr19,Bn81397,55046472,62300553,7254081,RLP
chr19,Bn81398,59588750,79305185,19716435,CNL
chr19,Bn81399,30176342,70821734,40645392,RLK
chr19,Bn81400,94536591,96833068,2296477,RLK
chr19,Bn81401,44130960,87954174,43823214,CNL
chr19,Bn81402,9202813,34456896,25254083,TNL
chr19,Bn81403,69299472,93976563,24677091,TNL
chr19,Bn81404,72580732,92284859,19704127,NBS
chr19,Bn81405,97663829,99633892,1970063,TN
chr19,Bn81406,57767564,75766370,17998806,RLK
chr19,Bn81407,17286600,17556358,269758,TNL
chr19,Bn81408,27137582,56554901,29417319,CNL
chr19,Bn81409,28910275,83240814,54330539,CNL
chr19,Bn81410,83622892,96285955,12663063,CNL
chr19,Bn81411,91322221,96498297,5176076,NBS
chr19,Bn81412,16035430,77170141,61134711,TN
chr19,Bn81413,76020530,93771762,17751232,TN
chr19,Bn81414,20581623,97893779,77312156,TNL
chr19,Bn81415,49422629,82336115,32913486,CNL
chr19,Bn81416,28003521,89207439,61203918,CNL
chr19,Bn81417,67539593,92769728,25230135,RLP
chr19,Bn81418,71485048,85148954,13663906,RLK
chr19,Bn81419,61893117,99243050,37349933,CN
chr19,Bn81420,69132776,75472186,6339410,RLP
chr19,Bn81421,92742149,94492038,1749889,RLP
chr19,Bn81422,8768532,60134833,51366301,TNL
chr19,Bn81423,66820192,67519680,699488,TNL
chr19,Bn81424,19158615,22454052,3295437,CNL
chr19,Bn81425,94945444,98025105,3079661,TNL
chr19,Bn81426,40463499,89345003,48881504,TN
chr19,Bn81427,50893564,73132500,22238936,NBS
chr19,Bn81428,81785080,88063479,6278399,CN
chr19,Bn81429,66302125,84656902,18354777,NBS
chr19,Bn81430,19217431,25145072,5927641,RLP
chr19,Bn81431,48986125,70213359,21227234,RLK
chr19,Bn81432,70823893,94354217,23530324,TNL
chr19,Bn81433,73250002,86716308,13466306,CNL
chr19,Bn81434,94703408,97500540,2797132,RLP
chr19,Bn81435,90498004,98912966,8414962,NBS
chr19,Bn81436,92400439,96061024,3660585,RLK
chr19,Bn81437,23714567,85003720,61289153,CNL
chr19,Bn81438,53687820,63290487,9602667,TNL
chr19,Bn81439,79713362,80159750,446388,RLK
chr19,Bn81440,72036259,88437830,16401571,TNL
chr19,Bn81441,20905589,79346423,58440834,CNL
chr19,Bn81442,86475746,99218787,12743041,NBS
chr19,Bn81443,86265429,91746440,5481011,NBS
chr19,Bn81444,60759555,82602233,21842678,CN
chr19,Bn81445,31583547,43573097,11989550,CNL
chr19,Bn81446,20235818,36567227,16331409,CNL
chr19,Bn81447,63482790,95781265,32298475,TNL
chr19,Bn81448,15608097,82534825,66926728,RLK
chr19,Bn81449,91404847,95442986,4038139,RLP
chr19,Bn81450,4371930,41746336,37374406,CN
chr19,Bn81451,80449164,97333524,16884360,CN
chr19,Bn81452,30886568,52734806,21848238,TNL
chr19,Bn81453,52531290,77821570,25290280,CNL
chr19,Bn81454,17949489,20008679,2059190,TNL
chr19,Bn81455,14097979,36138161,22040182,CNL
chr19,Bn81456,9728864,10912316,1183452,NBS
chr19,Bn81457,15994889,99077355,83082466,NBS
chr19,Bn81458,63086248,99667607,36581359,CN
chr19,Bn81459,67894644,86311793,18417149,CN
chr19,Bn81460,48818434,98433638,49615204,CNL
chr19,Bn81461,46884423,76402609,29518186,RLK
chr19,Bn81462,95678701,96608720,930019,CN
chr19,Bn81463,89403117,93418164,4015047,TNL
chr19,Bn81464,94968666,96388622,1419956,RLK
chr19,Bn81465,78675908,86446992,7771084,RLK
chr19,Bn81466,8552684,78620499,70067815,TN
chr19,Bn81467,60529631,66267336,5737705,RLK
chr19,Bn81468,5189155,35448447,30259292,TN
chr19,Bn81469,34526155,82393096,47866941,RLP
chr19,Bn81470,45407368,97088710,51681342,NBS
chr19,Bn81471,3587716,53133945,49546229,RLP
chr19,Bn81472,1215337,85140947,83925610,RLP
chr19,Bn81473,73598199,93060538,19462339,CNL
chr19,Bn81474,79344998,99847225,20502227,CNL
chr19,Bn81475,30108577,84569583,54461006,CN
chr19,Bn81476,46293326,50886909,4593583,CN
chr19,Bn81477,65010197,72418659,7408462,TN
chr19,Bn81478,14443122,84914906,70471784,NBS
chr19,Bn81479,67604863,98252499,30647636,NBS
chr19,Bn81480,71249022,93526266,22277244,NBS
chr19,Bn81481,45476900,90983654,45506754,NBS
chr19,Bn81482,8621907,28940703,20318796,TN
chr19,Bn81483,79442816,80931197,1488381,NBS
chr19,Bn81484,5646765,76428730,70781965,CN
chr19,Bn81485,69080004,73345765,4265761,TN
chr19,Bn81486,83895611,89206548,5310937,TN
chr19,Bn81487,70541296,88258520,17717224,CN
chr19,Bn81488,66559379,80250533,13691154,CN
chr19,Bn81489,25635276,46062067,20426791,CNL
chr19,Bn81490,96459165,98294965,1835800,RLK
chr19,Bn81491,51568027,82966780,31398753,TNL
chr19,Bn81492,47015177,52640163,5624986,CNL
chr19,Bn81493,43387358,80747819,37360461,NBS
chr19,Bn81494,83972815,87727535,3754720,CNL
chr19,Bn81495,10151925,31869647,21717722,CN
chr19,Bn81496,10655541,13469143,2813602,TNL
chr19,Bn81497,97761219,98646271,885052,TNL
chr19,Bn81498,28042970,43768189,15725219,CN
chr19,Bn81499,23619881,44411153,20791272,RLP
chr19,Bn81500,77628095,92967170,15339075,TNL
chr19,Bn81501,64662209,74583694,9921485,NBS
chr19,Bn81502,62154081,66199955,4045874,TN
chr19,Bn81503,13337860,17479539,4141679,TNL
chr19,Bn81504,92555392,98058848,5503456,CN
chr19,Bn81505,30733375,58509876,27776501,TNL
chr19,Bn81506,54333028,78347991,24014963,TN
chr19,Bn81507,77694565,81500107,3805542,RLK
chr19,Bn81508,6430718,35404704,28973986,TNL
chr19,Bn81509,98065293,99786803,1721510,CN
chr19,Bn81510,44716358,98538407,53822049,TNL
chr19,Bn81511,78341854,80322702,1980848,TNL
chr19,Bn81512,22113850,73899708,51785858,TN
chr19,Bn81513,34238429,71773916,37535487,CNL
chr19,Bn81514,86206637,94870080,8663443,TNL
chr19,Bn81515,67944053,92674962,24730909,TNL
chr19,Bn81516,56561547,64856852,8295305,RLK
chr19,Bn81517,63694597,65249638,1555041,TN
chr19,Bn81518,35133051,79817507,44684456,RLP
chr19,Bn81519,72451498,89482233,17030735,CN
chr19,Bn81520,78117391,93923882,15806491,CN
chr19,Bn81521,90229303,99868011,9638708,CNL
chr19,Bn81522,10774379,78510461,67736082,TNL
chr19,Bn81523,36987627,48605552,11617925,TN
chr19,Bn81524,68385397,96050827,27665430,RLP
chr19,Bn81525,81303639,83152747,1849108,TNL
chr19,Bn81526,50882957,51827326,944369,RLP
chr19,Bn81527,6954938,40852949,33898011,NBS
chr19,Bn81528,97772940,99239845,1466905,CNL
chr19,Bn81529,50581631,72209633,21628002,TNL
chr19,Bn81530,86063585,98565062,12501477,TNL
chr19,Bn81531,8820843,65428221,56607378,RLP
chr19,Bn81532,39129064,58593784,19464720,CN
chr19,Bn81533,58729469,65604495,6875026,TNL
chr19,Bn81534,31561455,77343423,45781968,RLP
chr19,Bn81535,11339625,17996949,6657324,RLP
chr19,Bn81536,66920944,82901331,15980387,NBS
chr19,Bn81537,43901080,73658407,29757327,RLK
chr19,Bn81538,77907249,83160026,5252777,CNL
chr19,Bn81539,24871360,52747565,27876205,CN
chr19,Bn81540,59268740,91760787,32492047,TNL
chr19,Bn81541,62929713,97878223,34948510,CNL
chr19,Bn81542,89653114,98767899,9114785,CN
chr19,Bn81543,61616038,73946060,12330022,CN
chr19,Bn81544,31614580,51734699,20120119,TN
chr19,Bn81545,65127840,75366509,10238669,RLK
chr19,Bn81546,17975528,70968510,52992982,TN
chr19,Bn81547,98169036,98393825,224789,NBS
chr19,Bn81548,11443721,79432262,67988541,NBS
chr19,Bn81549,91464064,96275166,4811102,CNL
chr19,Bn81550,81813598,83126977,1313379,CNL
chr19,Bn81551,6172346,46986722,40814376,RLK
chr19,Bn81552,73168325,98449518,25281193,NBS
chr19,Bn81553,15003113,35386189,20383076,RLK
chr19,Bn81554,23022818,65508695,42485877,TNL
chr19,Bn81555,11597672,28383060,16785388,NBS
chr19,Bn81556,99292859,99604288,311429,RLP
chr19,Bn81557,21649391,95424450,73775059,RLP
chr19,Bn81558,72409756,85729718,13319962,CN
chr19,Bn81559,79965410,82041297,2075887,RLP
chr19,Bn81560,3584310,32870833,29286523,CNL
chr19,Bn81561,62409515,68928644,6519129,CNL
chr19,Bn81562,36125531,64902781,28777250,NBS
chr19,Bn81563,26887403,49620908,22733505,TNL
chr19,Bn81564,71290974,90678362,19387388,CN
chr19,Bn81565,1186317,90732818,89546501,CNL
chr19,Bn81566,61141685,77142520,16000835,CNL
chr19,Bn81567,39992484,63648682,23656198,RLP
chr19,Bn81568,39761376,59863339,20101963,CNL
chr19,Bn81569,62500762,75484980,12984218,RLP
chr19,Bn81570,95579594,98757172,3177578,CN
chr19,Bn81571,88094640,99172795,11078155,NBS
chr19,Bn81572,6910369,57707305,50796936,RLP
chr19,Bn81573,85554710,89289540,3734830,TNL
chr19,Bn81574,35357269,64827298,29470029,TN
chr19,Bn81575,53165589,91151179,37985590,RLP
chr19,Bn81576,12662051,58256839,45594788,RLP
chr19,Bn81577,44759806,74502200,29742394,CN
chr19,Bn81578,56875472,69888549,13013077,CNL
chr19,Bn81579,74173213,86288653,12115440,CN
chr19,Bn81580,90474770,97753052,7278282,TNL
chr19,Bn81581,59661726,75619782,15958056,CNL
chr19,Bn81582,99165576,99667468,501892,TNL
chr19,Bn81583,75621613,81340554,5718941,NBS
chr19,Bn81584,8084875,25089935,17005060,TN
chr19,Bn81585,38458244,55897962,17439718,NBS
chr19,Bn81586,99313674,99626778,313104,TN
chr19,Bn81587,96267024,98067826,1800802,RLK
chr19,Bn81588,44666830,74562483,29895653,RLP
chr19,Bn81589,63606935,78620869,15013934,NBS
chr19,Bn81590,32858524,67604395,34745871,TNL
chr19,Bn81591,75858922,77235250,1376328,TN
chr19,Bn81592,11542587,33307031,21764444,RLK
chr19,Bn81593,18285867,69312929,51027062,CNL
chr19,Bn81594,16537458,93510343,76972885,CNL
chr19,Bn81595,3685931,44625826,40939895,NBS
chr19,Bn81596,26429633,75545871,49116238,CNL
chr19,Bn81597,14409172,25272757,10863585,TN
chr19,Bn81598,9299209,69456638,60157429,NBS
chr19,Bn81599,92202443,99947443,7745000,TNL
chr19,Bn81600,4322392,93413430,89091038,RLP
chr19,Bn81601,92516641,97603863,5087222,TN
chr19,Bn81602,13476245,13865226,388981,RLP
chr19,Bn81603,32665396,89998205,57332809,NBS
chr19,Bn81604,59124037,66402461,7278424,CN
chr19,Bn81605,10922029,57699050,46777021,RLP
chr19,Bn81606,78921260,80553331,1632071,RLP
chr19,Bn81607,94884905,95144213,259308,RLP
chr19,Bn81608,19462136,87358946,67896810,RLK
chr19,Bn81609,40901191,41445591,544400,TN
chr19,Bn81610,40810542,61047899,20237357,TN
chr19,Bn81611,77504056,87201918,9697862,TNL
chr19,Bn81612,85403590,85829977,426387,RLP
chr19,Bn81613,64729801,93851193,29121392,CNL
chr19,Bn81614,69498568,95733362,26234794,CNL
chr19,Bn81615,99859138,99909035,49897,RLP
chr19,Bn81616,10355980,82264905,71908925,TNL
chr19,Bn81617,52065833,99279295,47213462,CNL
chr19,Bn81618,39097852,53204595,14106743,RLK
chr19,Bn81619,16954907,94326645,77371738,NBS
chr19,Bn81620,80745767,82804720,2058953,TN
chr19,Bn81621,12027417,30635488,18608071,CNL
chr19,Bn81622,56456251,90733990,34277739,TNL
chr19,Bn81623,75662038,97798832,22136794,RLK
chr19,Bn81624,88128376,97220936,9092560,TNL
chr19,Bn81625,81249260,81278147,28887,TN
chr19,Bn81626,10605111,66070721,55465610,CN
chr19,Bn81627,48076175,48736799,660624,NBS
chr19,Bn81628,98884129,99837148,953019,RLK
chr19,Bn81629,59101367,60100582,999215,TNL
chr19,Bn81630,86394963,87331861,936898,RLK
chr19,Bn81631,84668420,85220021,551601,RLP
chr19,Bn81632,94857226,99116602,4259376,NBS
chr19,Bn81633,48436090,83390222,34954132,RLP
chr19,Bn81634,32581988,66001017,33419029,RLK
chr19,Bn81635,2542273,29351877,26809604,CNL
chr19,Bn81636,79390073,99604162,20214089,RLK
chr19,Bn81637,28272191,69101009,40828818,NBS
chr19,Bn81638,44333762,92991646,48657884,NBS
chr19,Bn81639,62083971,68906164,6822193,RLK
chr19,Bn81640,16079892,18109136,2029244,NBS
chr19,Bn81641,53226926,77666655,24439729,TN
chr19,Bn81642,6125289,53139890,47014601,RLK
chr19,Bn81643,1726612,56556115,54829503,NBS
chr19,Bn81644,22849391,29365399,6516008,CN
chr19,Bn81645,22321548,90850890,68529342,CN
chr19,Bn81646,38864078,81959169,43095091,TNL
chr19,Bn81647,97993147,99543131,1549984,RLP
chr19,Bn81648,76650810,99564974,22914164,RLK
chr19,Bn81649,1627012,17998601,16371589,TN
chr19,Bn81650,62957728,71511043,8553315,NBS
chr19,Bn81651,51987077,70163668,18176591,TNL
chr19,Bn81652,7980187,70246464,62266277,RLP
chr19,Bn81653,91538840,98297233,6758393,TN
chr19,Bn81654,34247999,49418978,15170979,TN
chr19,Bn81655,73450675,81068851,7618176,RLP
chr19,Bn81656,31940216,61346337,29406121,NBS
chr19,Bn81657,14515539,96753566,82238027,RLK
chr19,Bn81658,88341290,99271968,10930678,CNL
chr19,Bn81659,55270977,99269266,43998289,CN
chr19,Bn81660,82548559,85906391,3357832,RLP
chr19,Bn81661,65261861,97130215,31868354,RLK
chr19,Bn81662,2652762,82453792,79801030,NBS
chr19,Bn81663,51945398,72753114,20807716,NBS
chr19,Bn81664,42418881,58609807,16190926,RLK
chr19,Bn81665,30452592,33652265,3199673,RLK
chr19,Bn81666,33988875,50916219,16927344,RLP
chr19,Bn81667,43990601,60489657,16499056,NBS
chr19,Bn81668,55269229,58561783,3292554,CN
chr19,Bn81669,28712824,55765362,27052538,CN
chr19,Bn81670,37478550,63885245,26406695,NBS
chr19,Bn81671,91792582,93873478,2080896,TNL
chr19,Bn81672,96084846,97140740,1055894,NBS
chr19,Bn81673,26441834,38822316,12380482,NBS
chr19,Bn81674,18151444,52915846,34764402,TN
chr19,Bn81675,44451811,53412913,8961102,NBS
chr19,Bn81676,4265356,22136796,17871440,CN
chr19,Bn81677,99922809,99923430,621,CN
chr19,Bn81678,16033369,53730277,37696908,TN
chr19,Bn81679,78830390,91979326,13148936,TNL
chr19,Bn81680,67737776,69202676,1464900,RLK
chr19,Bn81681,22700906,74544181,51843275,CN
chr19,Bn81682,39363012,58962561,19599549,RLK
chr19,Bn81683,41937162,90001000,48063838,TNL
chr19,Bn81684,51085467,98453993,47368526,TN
chr19,Bn81685,70631762,94690367,24058605,NBS
chr19,Bn81686,17745839,61965550,44219711,CNL
chr19,Bn81687,15814627,23990812,8176185,TN
chr19,Bn81688,63362627,63521464,158837,RLK
chr19,Bn81689,64930587,92784983,27854396,TNL
chr19,Bn81690,81982576,91959650,9977074,NBS
chr19,Bn81691,32020107,57829108,25809001,TN
chr19,Bn81692,41814768,41969005,154237,RLP
chr19,Bn81693,17615017,22329760,4714743,CN
chr19,Bn81694,17076681,34432884,17356203,RLK
chr19,Bn81695,81566644,99267635,17700991,CNL
chr19,Bn81696,13116080,56262475,43146395,RLK
chr19,Bn81697,47841459,62940524,15099065,NBS
chr19,Bn81698,35367605,38630732,3263127,RLP
chr19,Bn81699,24697516,53653266,28955750,TNL
chr19,Bn81700,77462871,97468584,20005713,TN
chr19,Bn81701,61687813,92331377,30643564,RLK
chr19,Bn81702,21809486,67727173,45917687,TNL
chr19,Bn81703,62363602,64009806,1646204,TNL
chr19,Bn81704,26329433,82800173,56470740,RLK
chr19,Bn81705,8703417,54259282,45555865,RLP
chr19,Bn81706,51849381,74100557,22251176,CN
chr19,Bn81707,22661194,88323759,65662565,RLP
chr19,Bn81708,25057625,68503312,43445687,CN
chr19,Bn81709,69896966,72324612,2427646,TN
chr19,Bn81710,30770121,99173880,68403759,CNL
chr19,Bn81711,53033244,66251179,13217935,NBS
chr19,Bn81712,18603354,25003777,6400423,RLK
chr19,Bn81713,4694738,95527675,90832937,CNL
chr19,Bn81714,96880986,97321395,440409,RLP
chr19,Bn81715,3928390,74777066,70848676,CNL
chr19,Bn81716,18906954,41225257,22318303,RLK
chr19,Bn81717,26725982,95516312,68790330,TN
chr19,Bn81718,23564715,36154480,12589765,TN
chr19,Bn81719,5558028,20913697,15355669,CNL
chr19,Bn81720,30213795,77804165,47590370,RLK
chr19,Bn81721,94659050,98111088,3452038,TNL
chr19,Bn81722,98613704,99613468,999764,CNL
chr19,Bn81723,96847758,98148546,1300788,RLK
chr19,Bn81724,29864771,32363286,2498515,RLK
chr19,Bn81725,59391245,68349493,8958248,RLK
chr19,Bn81726,13957395,28305605,14348210,NBS
chr19,Bn81727,67766811,97350470,29583659,RLP
chr19,Bn81728,11133421,15592807,4459386,NBS
chr19,Bn81729,75273976,96944494,21670518,CN
chr19,Bn81730,70802845,82137127,11334282,RLK
chr19,Bn81731,36812527,81628437,44815910,CN
chr19,Bn81732,84338854,99348109,15009255,TNL
chr19,Bn81733,73977279,95227949,21250670,CNL
chr19,Bn81734,36477048,95742155,59265107,TNL
chr19,Bn81735,79217118,82075411,2858293,TN
chr19,Bn81736,6702608,96975390,90272782,RLK
chr19,Bn81737,66423544,98753751,32330207,CN
chr19,Bn81738,9299019,15186879,5887860,RLP
chr19,Bn81739,50284555,96280656,45996101,RLK
chr19,Bn81740,76818061,96991458,20173397,RLP
chr19,Bn81741,40808847,40928305,119458,TN
chr19,Bn81742,41830928,88023568,46192640,CNL
chr19,Bn81743,80071212,87647862,7576650,CN
chr19,Bn81744,75292948,78877136,3584188,TN
chr19,Bn81745,1973822,92998577,91024755,TN
chr19,Bn81746,35310811,70021395,34710584,TN
chr19,Bn81747,55949836,99942683,43992847,NBS
chr19,Bn81748,50298448,98205828,47907380,TNL
chr19,Bn81749,62021624,72111921,10090297,TN
chr19,Bn81750,63413758,77850554,14436796,TNL
chr19,Bn81751,80923704,97804156,16880452,CN
chr19,Bn81752,92002915,99631378,7628463,TN
chr19,Bn81753,20856298,21082236,225938,TN
chr19,Bn81754,31227217,97698745,66471528,TN
chr19,Bn81755,90182052,96655475,6473423,RLP
chr19,Bn81756,30114549,44580652,14466103,TN
chr19,Bn81757,86559544,93767231,7207687,RLP
chr19,Bn81758,1812688,96101359,94288671,TNL
chr19,Bn81759,26016887,70713248,44696361,RLP
chr19,Bn81760,14848554,18113955,3265401,CNL
chr19,Bn81761,99161280,99874385,713105,TNL
chr19,Bn81762,8789909,81527657,72737748,RLP
chr19,Bn81763,59748243,85279363,25531120,CN
chr19,Bn81764,36271236,37487477,1216241,NBS
chr19,Bn81765,70913936,72816993,1903057,CN
chr19,Bn81766,86325974,95377839,9051865,CN
chr19,Bn81767,65190615,82907744,17717129,NBS
chr19,Bn81768,98469796,98739132,269336,CN
chr19,Bn81769,70540976,78419658,7878682,CNL
chr19,Bn81770,26704730,67193859,40489129,NBS
chr19,Bn81771,87363319,92370974,5007655,RLP
chr19,Bn81772,92735766,95830822,3095056,TNL
chr19,Bn81773,22594726,78615730,56021004,CN
chr19,Bn81774,42175765,70303615,28127850,NBS
chr19,Bn81775,10962236,53778934,42816698,CN
chr19,Bn81776,44254803,92880105,48625302,TN
chr19,Bn81777,72739404,77804052,5064648,NBS
chr19,Bn81778,69981655,90233951,20252296,TN
chr19,Bn81779,71528154,97411362,25883208,RLK
chr19,Bn81780,78278438,90322800,12044362,TN
chr19,Bn81781,35956723,76046897,40090174,NBS
chr19,Bn81782,94233367,96490108,2256741,NBS
chr19,Bn81783,61997544,77674475,15676931,RLK
chr19,Bn81784,97114664,99247664,2133000,TNL
chr19,Bn81785,84863398,98003025,13139627,TN
chr19,Bn81786,65628249,78108499,12480250,CN
chr19,Bn81787,38929472,81900818,42971346,CN
chr19,Bn81788,35963062,51008944,15045882,TNL
chr19,Bn81789,69902937,75711061,5808124,CNL
chr19,Bn81790,7873530,96328569,88455039,CN
chr19,Bn81791,55668074,62422311,6754237,NBS
chr19,Bn81792,20650741,38055018,17404277,TN
chr19,Bn81793,23900263,97356577,73456314,TN
chr19,Bn81794,9142805,39487701,30344896,NBS
chr19,Bn81795,16963185,87816178,70852993,TNL
chr19,Bn81796,97255680,98899777,1644097,TNL
chr19,Bn81797,96500013,97957029,1457016,CNL
chr19,Bn81798,92811434,98262913,5451479,RLK
chr19,Bn81799,91284912,99479422,8194510,CN
chr19,Bn81800,98387062,99771370,1384308,CN
chr19,Bn81801,21172818,46956136,25783318,NBS
chr19,Bn81802,28500430,29551922,1051492,TN
chr19,Bn81803,72632771,88169786,15537015,NBS
chr19,Bn81804,76908192,84425698,7517506,CN
chr19,Bn81805,84261333,87348316,3086983,NBS
chr19,Bn81806,95895544,98293753,2398209,RLP
chr19,Bn81807,63716039,89087443,25371404,TN
chr19,Bn81808,79477293,94193508,14716215,TN
chr19,Bn81809,8808919,22807433,13998514,TNL
chr19,Bn81810,20594897,93833907,73239010,TN
chr19,Bn81811,10546096,14840947,4294851,TN
chr19,Bn81812,84083970,98407212,14323242,RLP
chr19,Bn81813,32574236,76950536,44376300,CNL
chr19,Bn81814,63174315,97049160,33874845,NBS
chr19,Bn81815,97180440,97293475,113035,TNL
chr19,Bn81816,99580775,99934574,353799,RLK
chr19,Bn81817,6375482,97340601,90965119,RLK
chr19,Bn81818,51123170,88914862,37791692,TN
chr19,Bn81819,40787186,87880135,47092949,CN
chr19,Bn81820,41120237,60491015,19370778,RLP
chr19,Bn81821,66185082,72297063,6111981,CNL
chr19,Bn81822,34715810,70907113,36191303,RLK
chr19,Bn81823,78502349,95761144,17258795,CN
chr19,Bn81824,73437819,81145106,7707287,NBS
chr19,Bn81825,84539894,91677085,7137191,TN
chr19,Bn81826,78652681,87871937,9219256,TNL
chr19,Bn81827,95248427,98506211,3257784,RLK
chr19,Bn81828,71396770,95134513,23737743,RLK
chr19,Bn81829,43352245,59712496,16360251,RLP
chr19,Bn81830,98031195,99073275,1042080,RLP
chr19,Bn81831,89037205,93519116,4481911,CN
chr19,Bn81832,89473876,98018629,8544753,TNL
chr19,Bn81833,9493165,45407357,35914192,TN
chr19,Bn81834,45021465,78891940,33870475,TN
chr19,Bn81835,63807927,91654698,27846771,TNL
chr19,Bn81836,12053523,38678613,26625090,CNL
chr19,Bn81837,85604870,91584444,5979574,NBS
chr19,Bn81838,82440371,89574625,7134254,NBS
chr19,Bn81839,1645412,38388878,36743466,CN
chr19,Bn81840,93989823,95333977,1344154,TNL
chr19,Bn81841,6498899,56477001,49978102,CN
chr19,Bn81842,6588740,85206015,78617275,RLK
chr19,Bn81843,39306068,50079304,10773236,NBS
chr19,Bn81844,87430590,94931772,7501182,CN
chr19,Bn81845,24066859,68840065,44773206,NBS
chr19,Bn81846,25248409,62424014,37175605,RLP
chr19,Bn81847,98363480,99104317,740837,RLK
chr19,Bn81848,1683016,84206379,82523363,CN
chr19,Bn81849,12646882,94920475,82273593,RLK
chr19,Bn81850,74606670,95322338,20715668,RLP
chr19,Bn81851,79149749,84911928,5762179,CN
chr19,Bn81852,71987630,75723008,3735378,NBS
chr19,Bn81853,27008016,48613715,21605699,RLK
chr19,Bn81854,31587017,43545791,11958774,CN
chr19,Bn81855,71922775,91941277,20018502,NBS
chr19,Bn81856,26917181,31241767,4324586,RLK
chr19,Bn81857,46382115,95424160,49042045,CNL
chr19,Bn81858,28076876,30409070,2332194,NBS
chr19,Bn81859,28332831,73060547,44727716,TNL
chr19,Bn81860,86146789,96809901,10663112,TN
chr19,Bn81861,52959633,62995046,10035413,CNL
chr19,Bn81862,53770865,64713695,10942830,CN
chr19,Bn81863,5389554,21093821,15704267,CNL
chr19,Bn81864,51764700,56659452,4894752,RLP
chr19,Bn81865,66883635,93455438,26571803,TNL
chr19,Bn81866,74723597,79300173,4576576,CNL
chr19,Bn81867,64041165,67576710,3535545,RLP
chr19,Bn81868,85992532,98669602,12677070,NBS
chr19,Bn81869,43528707,61959061,18430354,TN
chr19,Bn81870,13063651,38304782,25241131,CNL
chr19,Bn81871,15779823,81876268,66096445,RLK
chr19,Bn81872,39595129,81814684,42219555,TN
chr19,Bn81873,88062872,89841155,1778283,CNL
chr19,Bn81874,27441375,41421830,13980455,NBS
chr19,Bn81875,78201437,96246252,18044815,CN
chr19,Bn81876,42620615,43936132,1315517,RLP
chr19,Bn81877,90000273,98205924,8205651,CN
chr19,Bn81878,97486887,99162927,1676040,RLK
chr19,Bn81879,59569162,95728059,36158897,RLP
chr19,Bn81880,32426039,81498887,49072848,NBS
chr19,Bn81881,30754052,54527140,23773088,TNL
chr19,Bn81882,73574171,75631701,2057530,CNL
chr19,Bn81883,7638542,46501470,38862928,CNL
chr19,Bn81884,63211338,86632400,23421062,CNL
chr19,Bn81885,89511853,97757762,8245909,CN
chr19,Bn81886,3722134,68984491,65262357,CN
chr19,Bn81887,4328733,27915193,23586460,CN
chr19,Bn81888,40249972,43069571,2819599,TNL
chr19,Bn81889,94606096,99652445,5046349,TNL
chr19,Bn81890,51288407,61182095,9893688,CNL
chr19,Bn81891,87346177,89107164,1760987,CNL
chr19,Bn81892,78596180,89205740,10609560,TNL
chr19,Bn81893,38965662,78762099,39796437,TNL
chr19,Bn81894,84863121,88085502,3222381,NBS
chr19,Bn81895,80028717,92392973,12364256,TN
chr19,Bn81896,41371895,78234013,36862118,TNL
chr19,Bn81897,61903930,84842521,22938591,TN
chr19,Bn81898,77722646,94845523,17122877,TN
chr19,Bn81899,93966409,98991578,5025169,CN
chr19,Bn81900,81598288,86380313,4782025,RLK
chr19,Bn81901,72068922,72624542,555620,RLK
chr19,Bn81902,79253734,97459812,18206078,NBS
chr19,Bn81903,33031027,40595749,7564722,CN
chr19,Bn81904,80890366,84122255,3231889,RLK
chr19,Bn81905,27257402,77101791,49844389,RLK
chr19,Bn81906,11473812,50190920,38717108,RLP
chr19,Bn81907,33847646,57443684,23596038,CNL
chr19,Bn81908,59646534,73054002,13407468,CNL
chr19,Bn81909,75508426,90585045,15076619,TN
chr19,Bn81910,75991828,94533643,18541815,RLK
chr19,Bn81911,8802757,39529795,30727038,TNL
chr19,Bn81912,32169162,61892477,29723315,CNL
chr19,Bn81913,41824452,74408748,32584296,TNL
chr19,Bn81914,11259181,50469479,39210298,CN
chr19,Bn81915,73431481,88633277,15201796,RLP
chr19,Bn81916,59721190,68818737,9097547,CN
chr19,Bn81917,57335263,91220418,33885155,CNL
chr19,Bn81918,94308082,99394189,5086107,TNL
chr19,Bn81919,82259201,94359389,12100188,CN
chr19,Bn81920,51327944,63861795,12533851,TNL
chr19,Bn81921,92763800,95845338,3081538,TNL
chr19,Bn81922,40232894,40863133,630239,CNL
chr19,Bn81923,13722547,24261212,10538665,RLK
chr19,Bn81924,43377383,85947258,42569875,RLP
chr19,Bn81925,76855148,87562627,10707479,RLP
chr19,Bn81926,31979859,80791721,48811862,TN
chr19,Bn81927,99551707,99647668,95961,RLP
chr19,Bn81928,99500375,99774734,274359,TN
chr19,Bn81929,35756639,68637471,32880832,CN
chr19,Bn81930,37463646,71145892,33682246,CN
chr19,Bn81931,3533157,60241544,56708387,RLP
chr19,Bn81932,83083129,95631494,12548365,TNL
chr19,Bn81933,25402593,89189588,63786995,TNL
chr19,Bn81934,63175897,84510575,21334678,CNL
chr19,Bn81935,22037907,71953666,49915759,TN
chr19,Bn81936,77102262,83361927,6259665,CNL
chr19,Bn81937,82830371,85774898,2944527,RLP
chr19,Bn81938,14271997,90493382,76221385,CNL
chr19,Bn81939,38980817,68522462,29541645,RLP
chr19,Bn81940,59697068,99681308,39984240,TN
chr19,Bn81941,16296134,50485135,34189001,CNL
chr19,Bn81942,37040636,45056862,8016226,TNL
chr19,Bn81943,3020695,39498886,36478191,RLP
chr19,Bn81944,33760193,56681285,22921092,CN
chr19,Bn81945,65135287,81341557,16206270,NBS
chr19,Bn81946,89138618,97917014,8778396,CNL
chr19,Bn81947,73273471,93536939,20263468,TN
chr19,Bn81948,28356829,81508842,53152013,RLP
chr19,Bn81949,21582101,63537250,41955149,NBS
chr19,Bn81950,6727178,92827198,86100020,RLP
chr19,Bn81951,78712217,89244459,10532242,RLK
chr19,Bn81952,11971414,64923391,52951977,CN
chr19,Bn81953,59305338,98271288,38965950,RLP
chr19,Bn81954,81977853,89131968,7154115,TN
chr19,Bn81955,10425101,76908294,66483193,TNL
chr19,Bn81956,30388908,39915782,9526874,NBS
chr19,Bn81957,38674861,87118322,48443461,RLP
chr19,Bn81958,55178647,99818104,44639457,TN
chr19,Bn81959,99557144,99583535,26391,RLP
chr19,Bn81960,11981960,29550528,17568568,RLP
chr19,Bn81961,94362877,97982306,3619429,TN
chr19,Bn81962,75285905,91730463,16444558,CN
chr19,Bn81963,51918144,74719923,22801779,RLK
chr19,Bn81964,7507920,33978140,26470220,TN
chr19,Bn81965,64804277,85228356,20424079,CN
chr19,Bn81966,63117354,70564112,7446758,CNL
chr19,Bn81967,15642911,82179092,66536181,TN
chr19,Bn81968,60837979,85510383,24672404,TNL
chr19,Bn81969,18864227,67266739,48402512,CNL
chr19,Bn81970,20273555,73138164,52864609,RLK
chr19,Bn81971,39106903,45033947,5927044,TNL
chr19,Bn81972,33460373,43530458,10070085,TNL
chr19,Bn81973,82741633,99192171,16450538,RLP
chr19,Bn81974,37735856,45185119,7449263,RLP
chr19,Bn81975,30861275,95879456,65018181,TNL
chr19,Bn81976,87344962,87417678,72716,CN
chr19,Bn81977,38419518,41109256,2689738,RLP
chr19,Bn81978,26347325,57701551,31354226,RLP
chr19,Bn81979,37668623,74621713,36953090,NBS
chr19,Bn81980,86367540,88050104,1682564,RLK
chr19,Bn81981,17047001,98920548,81873547,NBS
chr19,Bn81982,69101345,97444304,28342959,RLP
chr19,Bn81983,74960386,96298141,21337755,CNL
chr19,Bn81984,85905202,98448817,12543615,NBS
chr19,Bn81985,58131001,82101938,23970937,CNL
chr19,Bn81986,38077028,85575274,47498246,CN
chr19,Bn81987,10474826,46965654,36490828,TN
chr19,Bn81988,99684588,99731415,46827,NBS
chr19,Bn81989,50853275,74964116,24110841,RLK
chr19,Bn81990,66807690,70279860,3472170,NBS
chr19,Bn81991,21419112,48874627,27455515,TNL
chr19,Bn81992,89420089,93960338,4540249,TNL
chr19,Bn81993,76223741,85858698,9634957,RLK
chr19,Bn81994,5980166,41908088,35927922,RLK
chr19,Bn81995,66312053,83990184,17678131,RLK
chr19,Bn81996,84656026,97366573,12710547,CNL
chr19,Bn81997,43203721,70716529,27512808,TN
chr19,Bn81998,96488273,99183320,2695047,TN
chr19,Bn81999,68009059,69741739,1732680,TNL
chr19,Bn82000,12597663,50647525,38049862,TNL
chr19,Bn82001,68524698,92060524,23535826,NBS
chr19,Bn82002,22350451,65003136,42652685,NBS
chr19,Bn82003,65613105,80923022,15309917,CNL
chr19,Bn82004,19145166,59060568,39915402,RLP
chr19,Bn82005,95563240,96282041,718801,TN
chr19,Bn82006,39965572,59039757,19074185,TNL
chr19,Bn82007,46710506,87364015,40653509,NBS
chr19,Bn82008,94692175,99743369,5051194,RLK
chr19,Bn82009,28913586,68711784,39798198,NBS
chr19,Bn82010,9019088,66222450,57203362,RLK
chr19,Bn82011,65036735,70871305,5834570,TN
chr19,Bn82012,45204245,71211148,26006903,RLK
chr19,Bn82013,80274303,86912710,6638407,TNL
chr19,Bn82014,40407804,83043174,42635370,NBS
chr19,Bn82015,36297296,93099530,56802234,TN
chr19,Bn82016,76000404,93332936,17332532,TNL
chr19,Bn82017,53464151,64725136,11260985,TNL
chr19,Bn82018,73003533,83149618,10146085,TN
chr19,Bn82019,65111952,91590297,26478345,TN
chr19,Bn82020,95799742,96990084,1190342,RLP
chr19,Bn82021,10420938,68144817,57723879,TNL
chr19,Bn82022,72052621,77203537,5150916,TNL
chr19,Bn82023,56468154,99221099,42752945,RLK
chr19,Bn82024,76219778,96484148,20264370,NBS
chr19,Bn82025,6783433,49246270,42462837,CNL
chr19,Bn82026,25306846,70756174,45449328,NBS
chr19,Bn82027,36673255,70393430,33720175,CNL
chr19,Bn82028,78885190,94901190,16016000,NBS
chr19,Bn82029,70142491,96986538,26844047,NBS
chr19,Bn82030,50257601,50545483,287882,NBS
chr19,Bn82031,39475740,57077237,17601497,TN
chr19,Bn82032,29462324,31997246,2534922,CN
chr19,Bn82033,76956039,95391429,18435390,TNL
chr19,Bn82034,71355979,98812115,27456136,CNL
chr19,Bn82035,61895921,98318738,36422817,CNL
chr19,Bn82036,68376550,97449504,29072954,RLP
chr19,Bn82037,90019859,98113628,8093769,TNL
chr19,Bn82038,96945855,98696575,1750720,TNL
chr19,Bn82039,61920330,86586088,24665758,TNL
chr19,Bn82040,31872201,84915762,53043561,RLK
chr19,Bn82041,63959224,82221524,18262300,RLP
chr19,Bn82042,70495315,89862472,19367157,TN
chr19,Bn82043,61975487,83844150,21868663,CNL
chr19,Bn82044,2796986,12698864,9901878,CN
chr19,Bn82045,22563041,93573464,71010423,TNL
chr19,Bn82046,66166837,82795002,16628165,NBS
chr19,Bn82047,10588664,59716436,49127772,TNL
chr19,Bn82048,78332793,82693648,4360855,CN
chr19,Bn82049,2295078,49542745,47247667,NBS
chr19,Bn82050,48742653,65230937,16488284,RLK
chr19,Bn82051,67115367,75394526,8279159,CNL
chr19,Bn82052,2291858,84665909,82374051,CNL
chr19,Bn82053,57204337,84295438,27091101,NBS
chr19,Bn82054,34458121,78855932,44397811,RLK
chr19,Bn82055,42702070,50108331,7406261,RLK
chr19,Bn82056,28120701,43043817,14923116,NBS
chr19,Bn82057,31932346,66936919,35004573,RLP
chr19,Bn82058,25752777,54616235,28863458,TN
chr19,Bn82059,50366368,81049167,30682799,TN
chr19,Bn82060,29230637,48187475,18956838,CNL
chr19,Bn82061,14827428,78574252,63746824,RLK
chr19,Bn82062,28937023,46215149,17278126,RLK
chr19,Bn82063,77874394,92494181,14619787,CNL
chr19,Bn82064,10675388,75260350,64584962,RLP
chr19,Bn82065,8651616,87247208,78595592,CNL
chr19,Bn82066,50517349,94151784,43634435,NBS
chr19,Bn82067,65527891,66343600,815709,RLK
chr19,Bn82068,34069240,42439515,8370275,TN
chr19,Bn82069,77013337,83822815,6809478,TNL
chr19,Bn82070,67032232,74085003,7052771,RLK
chr19,Bn82071,31554297,64042983,32488686,RLK
chr19,Bn82072,83973506,86355044,2381538,CNL
chr19,Bn82073,55682120,74103374,18421254,NBS
chr19,Bn82074,33414459,95744010,62329551,NBS
chr19,Bn82075,98550607,98880388,329781,RLK
chr19,Bn82076,87299927,92660395,5360468,CN
chr19,Bn82077,26868676,90680206,63811530,RLK
chr19,Bn82078,70595370,98089897,27494527,TNL
chr19,Bn82079,45871071,57416451,11545380,CNL
chr19,Bn82080,2726135,42755554,40029419,CN
chr19,Bn82081,28620834,97861043,69240209,NBS
chr19,Bn82082,98462585,99125293,662708,NBS
chr19,Bn82083,45405923,93329983,47924060,NBS
chr19,Bn82084,45756571,95272120,49515549,CNL
chr19,Bn82085,67772637,78966138,11193501,NBS
chr19,Bn82086,48220982,96579249,48358267,RLP
chr19,Bn82087,10621184,70209786,59588602,RLK
chr19,Bn82088,97988511,98522380,533869,RLP
chr19,Bn82089,26702290,74245200,47542910,CN
chr19,Bn82090,68398532,90557129,22158597,TN
chr19,Bn82091,27326751,29088929,1762178,CN
chr19,Bn82092,70216120,97522662,27306542,CNL
chr19,Bn82093,24223921,71520539,47296618,NBS
chr19,Bn82094,62939036,75664451,12725415,RLP
chr19,Bn82095,49409812,80102217,30692405,RLP
chr19,Bn82096,90802237,99993885,9191648,CN
chr19,Bn82097,86693419,95563069,8869650,CN
chr19,Bn82098,81361344,98532303,17170959,RLP
chr19,Bn82099,87413479,99845410,12431931,TNL
chr19,Bn82100,95802610,98592742,2790132,CN
chr19,Bn82101,20148910,91527260,71378350,RLP
chr19,Bn82102,35759354,72282094,36522740,CNL
chr19,Bn82103,95866882,95973006,106124,TN
chr19,Bn82104,2341375,24592024,22250649,CNL
chr19,Bn82105,65258230,95337483,30079253,CNL
chr19,Bn82106,69211522,74186138,4974616,RLK
chr19,Bn82107,36031907,89506984,53475077,NBS
chr19,Bn82108,73997646,81178003,7180357,RLK
chr19,Bn82109,18279439,63051918,44772479,NBS
chr19,Bn82110,89408567,97334063,7925496,NBS
chr19,Bn82111,41189007,95086323,53897316,CN
chr19,Bn82112,55911351,90414229,34502878,RLK
chr19,Bn82113,12148001,68707677,56559676,CNL
chr19,Bn82114,9282409,11053346,1770937,RLP
chr19,Bn82115,7858364,16775301,8916937,TN
chr19,Bn82116,96910135,97379871,469736,CNL
chr19,Bn82117,41749996,54588169,12838173,RLK
chr19,Bn82118,38913052,40238748,1325696,TNL
chr19,Bn82119,69810551,87361868,17551317,CN
chr19,Bn82120,59416642,77275948,17859306,CNL
chr19,Bn82121,28640685,68840099,40199414,RLP
chr19,Bn82122,70619909,76058232,5438323,TN
chr19,Bn82123,74575948,74887462,311514,TNL
chr19,Bn82124,90503175,93339680,2836505,TN
chr19,Bn82125,70737076,90326658,19589582,NBS
chr19,Bn82126,8989623,21162013,12172390,RLP
chr19,Bn82127,70624715,82605018,11980303,TN
chr19,Bn82128,39848350,94487441,54639091,RLK
chr19,Bn82129,34528114,71219520,36691406,CNL
chr19,Bn82130,66651098,89008115,22357017,TNL
chr19,Bn82131,29758755,89356154,59597399,RLK
chr19,Bn82132,82125126,86160438,4035312,CNL
chr19,Bn82133,82498317,92048303,9549986,TNL
chr19,Bn82134,5047707,91712523,86664816,CN
chr19,Bn82135,21016372,32157529,11141157,NBS
chr19,Bn82136,15658982,95196951,79537969,RLP
chr19,Bn82137,90156749,91774685,1617936,TN
chr19,Bn82138,83203994,95650667,12446673,TN
chr19,Bn82139,49042644,97485742,48443098,CNL
chr19,Bn82140,72610094,76065195,3455101,NBS
chr19,Bn82141,78444244,78527937,83693,NBS
chr19,Bn82142,30558208,62994023,32435815,NBS
chr19,Bn82143,40515995,93907470,53391475,TNL
chr19,Bn82144,16097329,20145621,4048292,RLK
chr19,Bn82145,52140119,81250062,29109943,RLP
chr19,Bn82146,33023744,72307236,39283492,RLP
chr19,Bn82147,41563450,70181878,28618428,CNL
chr19,Bn82148,38860488,51431044,12570556,RLP
chr19,Bn82149,54177749,57751463,3573714,RLK
chr19,Bn82150,82891491,84266745,1375254,CN
chr19,Bn82151,73550334,97953798,24403464,RLP
chr19,Bn82152,21185116,93840787,72655671,CNL
chr19,Bn82153,21115152,46171404,25056252,NBS
chr19,Bn82154,9191550,12046276,2854726,TN
chr19,Bn82155,30184738,79352099,49167361,RLK
chr19,Bn82156,50288325,64657253,14368928,RLK
chr19,Bn82157,89909487,98618805,8709318,CNL
chr19,Bn82158,99678518,99907306,228788,RLK
chr19,Bn82159,98706237,98986358,280121,TNL
chr19,Bn82160,88084855,91523244,3438389,CN
chr19,Bn82161,20173282,82007037,61833755,TN
chr19,Bn82162,38780064,56328151,17548087,CNL
chr19,Bn82163,56959747,70785335,13825588,CN
chr19,Bn82164,56055158,65141318,9086160,RLK
chr19,Bn82165,87485196,97426871,9941675,TNL
chr19,Bn82166,24162381,35285821,11123440,NBS
chr19,Bn82167,12634876,57405921,44771045,TNL
chr19,Bn82168,1812985,15409870,13596885,NBS
chr19,Bn82169,85887036,90380581,4493545,NBS
chr19,Bn82170,36949931,38461430,1511499,CNL
chr19,Bn82171,42728706,74637153,31908447,NBS
chr19,Bn82172,88035049,88424919,389870,TN
chr19,Bn82173,43415073,52263997,8848924,RLK
chr19,Bn82174,92962237,93747621,785384,TN
chr19,Bn82175,38771527,62074569,23303042,TN
chr19,Bn82176,81462617,99545831,18083214,TNL
chr19,Bn82177,94056595,96549510,2492915,TN
chr19,Bn82178,11327300,13537099,2209799,CN
chr19,Bn82179,80841138,97263227,16422089,CNL
chr19,Bn82180,40437665,79476571,39038906,TNL
chr19,Bn82181,91776293,95394549,3618256,RLK
chr19,Bn82182,91736351,97221054,5484703,RLK
chr19,Bn82183,6870546,46377177,39506631,RLK
chr19,Bn82184,6531167,71987330,65456163,RLP
chr19,Bn82185,75698000,90372670,14674670,TNL
chr19,Bn82186,64790751,72891114,8100363,CN
chr19,Bn82187,45809110,63971121,18162011,TNL
chr19,Bn82188,82921962,85772608,2850646,RLK
chr19,Bn82189,20145337,45205937,25060600,TN
chr19,Bn82190,99306602,99541530,234928,RLP
chr19,Bn82191,68250051,71215909,2965858,RLP
chr19,Bn82192,4799626,33353769,28554143,TNL
chr19,Bn82193,95156513,95777160,620647,RLP
chr19,Bn82194,15572912,87313985,71741073,NBS
chr19,Bn82195,79294635,98061534,18766899,RLK
chr19,Bn82196,96497260,97076585,579325,TNL
chr19,Bn82197,59118266,71116949,11998683,CNL
chr19,Bn82198,60162190,67682765,7520575,TN
chr19,Bn82199,98672531,99972804,1300273,RLK
chr19,Bn82200,35895394,98130582,62235188,TN
chr19,Bn82201,71026132,98099907,27073775,CNL
chr19,Bn82202,68807381,81217473,12410092,NBS
chr19,Bn82203,47963572,63439132,15475560,NBS
chr19,Bn82204,81542792,96446688,14903896,NBS
chr19,Bn82205,97459039,99273265,1814226,RLK
chr19,Bn82206,96960210,97427579,467369,TNL
chr19,Bn82207,37795604,98006414,60210810,NBS
chr19,Bn82208,83194804,97239447,14044643,CN
chr19,Bn82209,65987051,82011739,16024688,RLK
chr19,Bn82210,25474477,36808487,11334010,NBS
chr19,Bn82211,4408605,73679409,69270804,TN
chr19,Bn82212,20256332,28388735,8132403,RLK
chr19,Bn82213,64902556,77014635,12112079,NBS
chr19,Bn82214,5465458,41965705,36500247,TN
chr19,Bn82215,30400063,69960703,39560640,NBS
chr19,Bn82216,93024307,95379605,2355298,CN
chr19,Bn82217,46541687,70457801,23916114,RLK
chr19,Bn82218,59574240,94373511,34799271,RLK
chr19,Bn82219,17900457,64846311,46945854,CNL
chr19,Bn82220,76587930,97122174,20534244,TNL
chr19,Bn82221,27481538,39158296,11676758,NBS
chr19,Bn82222,78248159,82263669,4015510,RLP
chr19,Bn82223,70676130,99046199,28370069,TNL
chr19,Bn82224,14391994,63378435,48986441,CNL
chr19,Bn82225,18795694,85308447,66512753,NBS
chr19,Bn82226,27058366,80428334,53369968,CN
chr19,Bn82227,87826222,99371264,11545042,TNL
chr19,Bn82228,44545557,52757166,8211609,NBS
chr19,Bn82229,88132169,88524818,392649,RLK
chr19,Bn82230,57539924,82681599,25141675,RLP
chr19,Bn82231,46185525,50621328,4435803,CNL
chr19,Bn82232,82494455,82819027,324572,NBS
chr19,Bn82233,61395319,82174665,20779346,CN
chr19,Bn82234,27567224,73736942,46169718,RLK
chr19,Bn82235,64744012,92222630,27478618,CN
chr19,Bn82236,9711943,14004013,4292070,TN
chr19,Bn82237,67400015,68273081,873066,TN
chr19,Bn82238,33405479,76186332,42780853,RLK
chr19,Bn82239,51961048,75748442,23787394,RLK
chr19,Bn82240,3754868,70678356,66923488,TN
chr19,Bn82241,58060223,87303364,29243141,TNL
chr19,Bn82242,80000943,89066260,9065317,CN
chr19,Bn82243,82688466,90209550,7521084,NBS
chr19,Bn82244,70088189,75981965,5893776,CN
chr19,Bn82245,36923088,64130024,27206936,TNL
chr19,Bn82246,3592919,10123493,6530574,CNL
chr19,Bn82247,11311072,53283476,41972404,CN
chr19,Bn82248,62993775,84775944,21782169,TN
chr19,Bn82249,25171120,75401917,50230797,NBS
chr19,Bn82250,73313191,76515771,3202580,RLK
chr19,Bn82251,71882743,97507179,25624436,CN
chr19,Bn82252,81439634,83253239,1813605,TNL
chr19,Bn82253,45365053,53559225,8194172,RLK
chr19,Bn82254,34014297,55305169,21290872,TN
chr19,Bn82255,56342852,85945365,29602513,RLK
chr19,Bn82256,38123798,90379596,52255798,CN
chr19,Bn82257,49207207,86814108,37606901,CNL
chr19,Bn82258,7774352,51577614,43803262,TN
chr19,Bn82259,22376927,59741839,37364912,CNL
chr19,Bn82260,74560553,87937084,13376531,RLP
chr19,Bn82261,71122435,85789642,14667207,TNL
chr19,Bn82262,84705112,99450689,14745577,CN
chr19,Bn82263,29376856,60233824,30856968,CNL
chr19,Bn82264,95399271,96293204,893933,NBS
chr19,Bn82265,60730054,96180408,35450354,CNL
chr19,Bn82266,56836954,94298900,37461946,CNL
chr19,Bn82267,97901576,99767772,1866196,RLP
chr19,Bn82268,35962835,64777311,28814476,TNL
chr19,Bn82269,98514050,99614220,1100170,TN
chr19,Bn82270,94877408,95753653,876245,CNL
chr19,Bn82271,19991753,27265902,7274149,RLK
chr19,Bn82272,81015009,81407318,392309,RLK
chr19,Bn82273,79298329,84161207,4862878,RLP
chr19,Bn82274,40131672,53704954,13573282,TNL
chr19,Bn82275,82291715,99362370,17070655,RLK
chr19,Bn82276,9174224,79105911,69931687,TNL
chr19,Bn82277,52144771,69881950,17737179,NBS
chr19,Bn82278,92977308,99022008,6044700,RLP
chr19,Bn82279,38596221,63616107,25019886,RLP
chr19,Bn82280,42873617,72887378,30013761,NBS
chr19,Bn82281,33074842,45152267,12077425,TNL
chr19,Bn82282,44597432,55640793,11043361,RLK
chr19,Bn82283,95470175,99085547,3615372,NBS
chr19,Bn82284,28739319,68723605,39984286,CNL
chr19,Bn82285,27216095,28405942,1189847,CN
chr19,Bn82286,14146786,47959510,33812724,TNL
chr19,Bn82287,56697154,86879380,30182226,CNL
chr19,Bn82288,42105280,57447755,15342475,RLK
chr19,Bn82289,41485387,84623795,43138408,TNL
chr19,Bn82290,71484419,92190685,20706266,CN
chr19,Bn82291,17802731,22010018,4207287,TNL
chr19,Bn82292,68954790,88576136,19621346,RLP
chr19,Bn82293,40054568,65528613,25474045,RLP
chr19,Bn82294,13613245,89437193,75823948,TNL
chr19,Bn82295,38713071,88716892,50003821,NBS
chr19,Bn82296,14713871,23165025,8451154,RLK
chr19,Bn82297,35706720,90507678,54800958,NBS
chr19,Bn82298,53608073,95665106,42057033,TNL
chr19,Bn82299,78753038,98999173,20246135,RLK
chr19,Bn82300,8914896,92658074,83743178,RLK
chr19,Bn82301,82198814,96765941,14567127,TNL
chr19,Bn82302,32854573,32876716,22143,RLP
chr19,Bn82303,71802957,75106481,3303524,CNL
chr19,Bn82304,72799702,79316888,6517186,RLK
chr19,Bn82305,92267278,92551875,284597,CNL
chr19,Bn82306,52470053,57123466,4653413,RLP
chr19,Bn82307,69079559,91051073,21971514,RLP
chr19,Bn82308,72406571,78172855,5766284,RLK
chr19,Bn82309,56219209,64677517,8458308,RLK
chr19,Bn82310,22993771,53616996,30623225,RLK
chr19,Bn82311,49059274,50871599,1812325,TNL
chr19,Bn82312,49323421,61146144,11822723,TNL
chr19,Bn82313,42422910,95877638,53454728,NBS
chr19,Bn82314,50370999,77438370,27067371,TNL
chr19,Bn82315,61961887,83266197,21304310,CN
chr19,Bn82316,61209890,84009237,22799347,TNL
chr19,Bn82317,64772872,68402026,3629154,CN
chr19,Bn82318,71849111,76606765,4757654,RLP
chr19,Bn82319,9733518,70131999,60398481,NBS
chr19,Bn82320,49951405,76678286,26726881,TN
chr19,Bn82321,50525714,87637929,37112215,TNL
chr19,Bn82322,55139573,96584338,41444765,RLP
chr19,Bn82323,20063253,59468852,39405599,TN
chr19,Bn82324,7136055,98699372,91563317,TN
chr19,Bn82325,38168728,88801135,50632407,CN
chr19,Bn82326,30584124,57917431,27333307,TNL
chr19,Bn82327,58530601,94575612,36045011,TNL
chr19,Bn82328,60904958,87004779,26099821,CNL
chr19,Bn82329,68828018,99419312,30591294,NBS
chr19,Bn82330,90486210,96933739,6447529,CN
chr19,Bn82331,50442562,61242312,10799750,RLK
chr19,Bn82332,93614117,99277565,5663448,TN
chr19,Bn82333,49083781,81686410,32602629,NBS
chr19,Bn82334,78880533,97182561,18302028,RLP
chr19,Bn82335,54115705,76451843,22336138,CN
chr19,Bn82336,89830752,92086008,2255256,NBS
chr19,Bn82337,48308795,63372026,15063231,TN
chr19,Bn82338,92414451,95158092,2743641,NBS
chr19,Bn82339,29028857,66123263,37094406,CNL
chr19,Bn82340,91298965,99003066,7704101,TN
chr19,Bn82341,7480766,96400934,88920168,CN
chr19,Bn82342,40283497,66056731,25773234,NBS
chr19,Bn82343,46786637,74385289,27598652,RLK
chr19,Bn82344,16533522,60516891,43983369,NBS
chr19,Bn82345,19281808,21374138,2092330,CNL
chr19,Bn82346,77501495,97058846,19557351,NBS
chr19,Bn82347,72585731,77121582,4535851,RLP
chr19,Bn82348,49513037,68753759,19240722,CNL
chr19,Bn82349,20620629,78637992,58017363,RLP
chr19,Bn82350,89263158,99892355,10629197,RLP
chr19,Bn82351,14687728,17856448,3168720,CNL
chr19,Bn82352,41419933,52353927,10933994,TN
chr19,Bn82353,13869588,88283091,74413503,TNL
chr19,Bn82354,37119312,87296714,50177402,CN
chr19,Bn82355,98275750,98869385,593635,RLP
chr19,Bn82356,69036943,80544114,11507171,RLP
chr19,Bn82357,46163927,61170380,15006453,TNL
chr19,Bn82358,25713919,60577506,34863587,TN
chr19,Bn82359,24014739,97369446,73354707,TN
chr19,Bn82360,54453150,57113108,2659958,CNL
chr19,Bn82361,46310419,61796394,15485975,CN
chr19,Bn82362,86623529,88003941,1380412,RLK
chr19,Bn82363,42305911,90841416,48535505,CNL
chr19,Bn82364,78666452,94233378,15566926,TN
chr19,Bn82365,22204060,94955179,72751119,NBS
chr19,Bn82366,31151529,45854218,14702689,NBS
chr19,Bn82367,27427404,33370871,5943467,RLP
chr19,Bn82368,92083827,97532048,5448221,RLK
chr19,Bn82369,33106965,53874238,20767273,RLP
chr19,Bn82370,82593333,89980808,7387475,CNL
chr19,Bn82371,73070687,92518586,19447899,CN
chr19,Bn82372,34615183,86741224,52126041,TN
chr19,Bn82373,58834952,65948162,7113210,NBS
chr19,Bn82374,41755496,52860026,11104530,TN
chr19,Bn82375,59010167,97833772,38823605,RLK
chr19,Bn82376,70147068,80455736,10308668,RLK
chr19,Bn82377,17044097,24530729,7486632,CNL
chr19,Bn82378,32130397,37808752,5678355,NBS
chr19,Bn82379,51225873,99563514,48337641,CNL
chr19,Bn82380,31904823,87551234,55646411,RLK
chr19,Bn82381,7676159,44082338,36406179,TN
chr19,Bn82382,68015391,81187207,13171816,CNL
chr19,Bn82383,40312862,63330959,23018097,TN
chr19,Bn82384,84503052,99680522,15177470,NBS
chr19,Bn82385,27197536,91462244,64264708,NBS
chr19,Bn82386,91028928,98299403,7270475,TN
chr19,Bn82387,62610254,72153819,9543565,NBS
chr19,Bn82388,6438119,19425777,12987658,RLP
chr19,Bn82389,1779124,98715709,96936585,TN
chr19,Bn82390,33438744,80393566,46954822,TN
chr19,Bn82391,10742348,98169973,87427625,NBS
chr19,Bn82392,66318375,82304695,15986320,TN
chr19,Bn82393,30375515,50462302,20086787,RLK
chr19,Bn82394,68400032,81644663,13244631,RLP
chr19,Bn82395,97095596,99205661,2110065,NBS
chr19,Bn82396,86681400,86912235,230835,RLP
chr19,Bn82397,55695250,73336186,17640936,CN
chr19,Bn82398,9970181,32292780,22322599,RLP
chr19,Bn82399,73401608,84030354,10628746,TN
chr19,Bn82400,31870693,51975282,20104589,RLK
chr19,Bn82401,81054086,89286755,8232669,RLK
chr19,Bn82402,24081782,43686969,19605187,RLK
chr19,Bn82403,6885699,8968581,2082882,NBS
chr19,Bn82404,84291865,90651513,6359648,CNL
chr19,Bn82405,24042128,37313036,13270908,TN
chr19,Bn82406,63923751,87844194,23920443,RLK
chr19,Bn82407,80217343,80631319,413976,NBS
chr19,Bn82408,84259936,86371152,2111216,CN
chr19,Bn82409,10230695,82232900,72002205,CNL
chr19,Bn82410,91583068,94024200,2441132,CN
chr19,Bn82411,50522741,53080054,2557313,NBS
chr19,Bn82412,73165655,98231794,25066139,RLP
chr19,Bn82413,56551536,59229049,2677513,CN
chr19,Bn82414,66537716,85960319,19422603,TNL
chr19,Bn82415,26985193,68912654,41927461,RLP
chr19,Bn82416,88943050,98237269,9294219,TN
chr19,Bn82417,19278824,41591629,22312805,CNL
chr19,Bn82418,73609533,75697369,2087836,CN
chr19,Bn82419,29204801,44308825,15104024,CNL
chr19,Bn82420,5606773,80748725,75141952,RLK
chr19,Bn82421,59656078,64118036,4461958,RLP
chr19,Bn82422,30229574,32084962,1855388,RLP
chr19,Bn82423,27216450,82541464,55325014,CN
chr19,Bn82424,19392399,71146867,51754468,RLK
chr19,Bn82425,36827378,98518001,61690623,CN
chr19,Bn82426,56826559,73029822,16203263,CNL
chr19,Bn82427,73458532,99328449,25869917,RLP
chr19,Bn82428,77042387,96075451,19033064,TN
chr19,Bn82429,74957259,97356152,22398893,CN
chr19,Bn82430,28042068,42511785,14469717,TNL
chr19,Bn82431,5512152,54345931,48833779,CNL
chr19,Bn82432,52998955,81714787,28715832,TNL
chr19,Bn82433,76856456,81443177,4586721,CNL
chr19,Bn82434,44378394,56796821,12418427,TNL
chr19,Bn82435,27491627,50519484,23027857,TNL
chr19,Bn82436,32690205,54999284,22309079,RLK
chr19,Bn82437,78822620,91145420,12322800,NBS
chr19,Bn82438,15161553,90042192,74880639,CNL
chr19,Bn82439,97715494,99965977,2250483,RLP
chr19,Bn82440,95314864,95364743,49879,TNL
chr19,Bn82441,69917473,80143313,10225840,RLP
chr19,Bn82442,3432076,52850656,49418580,TN
chr19,Bn82443,6073970,38700001,32626031,RLK
chr19,Bn82444,71677684,76024827,4347143,TNL
chr19,Bn82445,65656646,67984050,2327404,RLK
chr19,Bn82446,1990881,13289968,11299087,CNL
chr19,Bn82447,24040797,67713671,43672874,CNL
chr19,Bn82448,49122316,64158195,15035879,CNL
chr19,Bn82449,65632675,96033267,30400592,TN
chr19,Bn82450,94540432,96919735,2379303,NBS
chr19,Bn82451,88001936,88608487,606551,CNL
chr19,Bn82452,95497106,99827973,4330867,TNL
chr19,Bn82453,74221315,83871496,9650181,TN
chr19,Bn82454,83794768,98671195,14876427,TNL
chr19,Bn82455,51661473,56844201,5182728,RLP
chr19,Bn82456,53519893,79542509,26022616,TN
chr19,Bn82457,30048272,55012613,24964341,TN
chr19,Bn82458,63419246,88605895,25186649,RLP
chr19,Bn82459,69512267,87568278,18056011,NBS
chr19,Bn82460,17504529,87725392,70220863,TN
chr19,Bn82461,76336354,85831645,9495291,TNL
chr19,Bn82462,39295325,98277521,58982196,RLP
chr19,Bn82463,27544146,51877681,24333535,CNL
chr19,Bn82464,36595084,82589753,45994669,CNL
chr19,Bn82465,32860038,86037236,53177198,CNL
chr19,Bn82466,33973367,73011469,39038102,TNL
chr19,Bn82467,77522443,91045835,13523392,CN
chr19,Bn82468,44164611,86534655,42370044,RLK
chr19,Bn82469,31703956,36913029,5209073,CN
chr19,Bn82470,65968974,99379395,33410421,TN
chr19,Bn82471,37026793,86991799,49965006,NBS
chr19,Bn82472,40820614,68142165,27321551,CNL
chr19,Bn82473,31346487,93653251,62306764,CN
chr19,Bn82474,93665768,96267099,2601331,TN
chr19,Bn82475,23362876,34108185,10745309,CNL
chr19,Bn82476,56821550,58130473,1308923,RLK
chr19,Bn82477,92389354,93380542,991188,RLP
chr19,Bn82478,86022651,98145090,12122439,CN
chr19,Bn82479,6229942,83715923,77485981,NBS
chr19,Bn82480,38931727,72724097,33792370,RLK
chr19,Bn82481,45043169,75953220,30910051,CNL
chr19,Bn82482,6970396,40675351,33704955,RLP
chr19,Bn82483,29923022,84953876,55030854,CNL
chr19,Bn82484,16459768,25803160,9343392,CN
chr19,Bn82485,54067420,90299254,36231834,NBS
chr19,Bn82486,90772535,91592801,820266,TN
chr19,Bn82487,78366593,88581002,10214409,TN
chr19,Bn82488,27352333,63667527,36315194,CN
chr19,Bn82489,74419757,79551247,5131490,CNL
chr19,Bn82490,79008841,79225122,216281,NBS
chr19,Bn82491,15387072,74472504,59085432,CN
chr19,Bn82492,36078233,54744726,18666493,RLK
chr19,Bn82493,61096238,96636262,35540024,CN
chr19,Bn82494,37254596,90415013,53160417,RLK
chr19,Bn82495,69260830,74021459,4760629,TN
chr19,Bn82496,52861548,82019586,29158038,TN
chr19,Bn82497,51655806,66641506,14985700,RLK
chr19,Bn82498,16128598,79962957,63834359,CNL
chr19,Bn82499,52963894,93304228,40340334,RLK
chr19,Bn82500,34817616,80160178,45342562,CN
chr19,Bn82501,73748270,84265235,10516965,RLK
chr19,Bn82502,8771016,72451546,63680530,TN
chr19,Bn82503,29716798,93063711,63346913,CN
chr19,Bn82504,8093747,36928226,28834479,TN
chr19,Bn82505,5962153,23348907,17386754,NBS
chr19,Bn82506,38121727,88508891,50387164,RLK
chr19,Bn82507,71891589,79545448,7653859,TN
chr19,Bn82508,41862764,80573021,38710257,NBS
chr19,Bn82509,10032282,34639249,24606967,CNL
chr19,Bn82510,90869303,92199169,1329866,NBS
chr19,Bn82511,97620164,99439888,1819724,NBS
chr19,Bn82512,54454129,92690351,38236222,RLP
chr19,Bn82513,76642099,85616989,8974890,RLP
chr19,Bn82514,78813949,92346524,13532575,TN
chr19,Bn82515,4495271,99816321,95321050,TNL
chr19,Bn82516,8568727,33800746,25232019,RLP
chr19,Bn82517,59277192,80147797,20870605,RLP
chr19,Bn82518,43738421,72678385,28939964,RLK
chr19,Bn82519,13525516,86444786,72919270,TN
chr19,Bn82520,45901988,96177859,50275871,NBS
chr19,Bn82521,2757628,37722099,34964471,NBS
chr19,Bn82522,27739472,93819425,66079953,TN
chr19,Bn82523,11643761,42691306,31047545,CN
chr19,Bn82524,47644821,70937526,23292705,CNL
chr19,Bn82525,41756506,99895086,58138580,TNL
chr19,Bn82526,42578508,70596628,28018120,RLP
chr19,Bn82527,22605480,31674726,9069246,CN
chr19,Bn82528,68727460,85455655,16728195,RLK
chr19,Bn82529,32009466,48003842,15994376,CN
chr19,Bn82530,37348545,84674014,47325469,RLK
chr19,Bn82531,9802075,25219198,15417123,TN
chr19,Bn82532,93343494,99767676,6424182,RLP
chr19,Bn82533,93679133,97767851,4088718,CN
chr19,Bn82534,91404954,93687426,2282472,RLK
chr19,Bn82535,95649448,98955686,3306238,TN
chr19,Bn82536,18027648,53512570,35484922,RLK
chr19,Bn82537,38024765,70513663,32488898,CN
chr19,Bn82538,70197226,74502536,4305310,CNL
chr19,Bn82539,76719030,89980932,13261902,CNL
chr19,Bn82540,92491184,99288290,6797106,NBS
chr19,Bn82541,46525512,89132904,42607392,CNL
chr19,Bn82542,57996569,92136627,34140058,NBS
chr19,Bn82543,87817134,88273654,456520,TNL
chr19,Bn82544,92413183,95838941,3425758,TNL
chr19,Bn82545,24077747,47438003,23360256,TNL
chr19,Bn82546,89027989,90609275,1581286,CNL
chr19,Bn82547,55715864,92763963,37048099,CN
chr19,Bn82548,73350739,75149155,1798416,TN
chr19,Bn82549,68101649,90717872,22616223,TNL
chr19,Bn82550,94930077,98675739,3745662,RLK
chr19,Bn82551,97188603,99996063,2807460,CN
chr19,Bn82552,26900602,39046951,12146349,CN
chr19,Bn82553,73138574,99824399,26685825,CNL
chr19,Bn82554,31546400,63348814,31802414,TNL
chr19,Bn82555,20856549,48003446,27146897,NBS
chr19,Bn82556,20024653,51652570,31627917,TN
chr19,Bn82557,51924566,84255927,32331361,TN
chr19,Bn82558,58664431,97347894,38683463,TN
chr19,Bn82559,17221870,66526725,49304855,CNL
chr19,Bn82560,52729758,79115295,26385537,CNL
chr19,Bn82561,55906821,93841887,37935066,RLP
chr19,Bn82562,27468610,89584644,62116034,RLP
chr19,Bn82563,44103981,90779867,46675886,RLK
chr19,Bn82564,86770193,92102392,5332199,NBS
chr19,Bn82565,96761735,96788632,26897,CN
chr19,Bn82566,20993935,85776662,64782727,RLP
chr19,Bn82567,5931093,97971416,92040323,RLP
chr19,Bn82568,96424713,98635876,2211163,CNL
chr19,Bn82569,89642458,95703994,6061536,NBS
chr19,Bn82570,24238470,39088917,14850447,CNL
chr19,Bn82571,94767495,95423957,656462,CNL
chr19,Bn82572,42055958,78291944,36235986,RLP
chr19,Bn82573,70520375,83099908,12579533,NBS
chr19,Bn82574,13292477,75525324,62232847,NBS
chr19,Bn82575,9212790,95937844,86725054,TN
chr19,Bn82576,13433186,66229992,52796806,NBS
chr19,Bn82577,63789341,93635306,29845965,RLP
chr19,Bn82578,12816270,30570953,17754683,CN
chr19,Bn82579,48566406,58918788,10352382,CNL
chr19,Bn82580,36921154,81691797,44770643,CN
chr19,Bn82581,21683549,52537276,30853727,TN
chr19,Bn82582,55024065,95656055,40631990,NBS
chr19,Bn82583,89411676,92354418,2942742,RLK
chr19,Bn82584,64996616,81294853,16298237,CN
chr19,Bn82585,9617246,91483020,81865774,CN
chr19,Bn82586,40630196,51870096,11239900,RLP
chr19,Bn82587,41145683,94758086,53612403,NBS
chr19,Bn82588,87927366,89112551,1185185,CNL
chr19,Bn82589,52157734,65950866,13793132,NBS
chr19,Bn82590,81048519,93160599,12112080,TNL
chr19,Bn82591,61150476,72089067,10938591,CN
chr19,Bn82592,96639593,98701108,2061515,NBS
chr19,Bn82593,54559255,91612660,37053405,NBS
chr19,Bn82594,53444314,88137108,34692794,RLK
chr19,Bn82595,53070673,83320694,30250021,TNL
chr19,Bn82596,43736999,73573627,29836628,TN
chr19,Bn82597,44523417,57294039,12770622,CN
chr19,Bn82598,68400944,80207841,11806897,NBS
chr19,Bn82599,63100194,91337160,28236966,TN
chr19,Bn82600,24891729,94881740,69990011,CNL
chr19,Bn82601,72494752,79254591,6759839,RLP
chr19,Bn82602,66309747,84563211,18253464,RLP
chr19,Bn82603,97055133,97727562,672429,RLK
chr19,Bn82604,97488693,99561600,2072907,CNL
chr19,Bn82605,97927025,97940540,13515,CN
chr19,Bn82606,42553602,50688477,8134875,RLK
chr19,Bn82607,42489332,82878338,40389006,RLK
chr19,Bn82608,18090860,67359519,49268659,CNL
chr19,Bn82609,72661752,94408258,21746506,CNL
chr19,Bn82610,50815994,95101194,44285200,RLP
chr19,Bn82611,97176558,97598587,422029,NBS
chr19,Bn82612,21062360,57252802,36190442,CN
chr19,Bn82613,43733643,93334965,49601322,RLK
chr19,Bn82614,95775580,99345686,3570106,RLP
chr19,Bn82615,1207516,1731042,523526,NBS
chr19,Bn82616,59402107,80249038,20846931,CNL
chr19,Bn82617,40758198,73512996,32754798,TN
chr19,Bn82618,49642296,90859861,41217565,RLK
chr19,Bn82619,40907496,82673010,41765514,NBS
chr19,Bn82620,52071874,64926400,12854526,CN
chr19,Bn82621,46645153,78556515,31911362,TNL
chr19,Bn82622,72465055,78101585,5636530,RLK
chr19,Bn82623,1355155,67140587,65785432,CN
chr19,Bn82624,9608948,37722688,28113740,RLK
chr19,Bn82625,13443732,27480841,14037109,NBS
chr19,Bn82626,1141985,8010033,6868048,RLP
chr19,Bn82627,77557962,96404677,18846715,RLP
chr19,Bn82628,23438185,63891921,40453736,NBS
chr19,Bn82629,58894939,95658517,36763578,NBS
chr19,Bn82630,93516854,99129552,5612698,RLK
chr19,Bn82631,92044450,96644385,4599935,RLK
chr19,Bn82632,17090418,74456894,57366476,CN
chr19,Bn82633,83834165,86955205,3121040,CNL
chr19,Bn82634,57529209,95781678,38252469,RLK
chr19,Bn82635,54939156,95269821,40330665,RLP
chr19,Bn82636,2363566,93567020,91203454,TN
chr19,Bn82637,73440906,93618126,20177220,CNL
chr19,Bn82638,66494202,73839049,7344847,CN
chr19,Bn82639,2489682,12747227,10257545,CNL
chr19,Bn82640,25043615,33544014,8500399,TN
chr19,Bn82641,53790518,81315872,27525354,TNL
chr19,Bn82642,39626762,74403882,34777120,NBS
chr19,Bn82643,50245358,96628449,46383091,TNL
chr19,Bn82644,4286643,12184038,7897395,RLP
chr19,Bn82645,74017878,92916823,18898945,RLP
chr19,Bn82646,76188038,92190118,16002080,CNL
chr19,Bn82647,22226270,26758553,4532283,CNL
chr19,Bn82648,33795436,83044774,49249338,TNL
chr19,Bn82649,99797840,99939153,141313,CN
chr19,Bn82650,63620856,88994485,25373629,TN
chr19,Bn82651,40993580,53397068,12403488,RLK
chr19,Bn82652,62389377,91947010,29557633,RLK
chr19,Bn82653,30398290,34330144,3931854,NBS
chr19,Bn82654,60965530,68118117,7152587,RLP
chr19,Bn82655,12899679,97976355,85076676,CNL
chr19,Bn82656,99004198,99577669,573471,NBS
chr19,Bn82657,24846920,70772762,45925842,TN
chr19,Bn82658,83739834,95655023,11915189,TN
chr19,Bn82659,50230073,72367318,22137245,NBS
chr19,Bn82660,8506051,55218100,46712049,TNL
chr19,Bn82661,82718979,96718475,13999496,RLK
chr19,Bn82662,57705181,77311020,19605839,RLP
chr19,Bn82663,86577634,96594231,10016597,RLK
chr19,Bn82664,66303814,89665896,23362082,NBS
chr19,Bn82665,41818796,44486432,2667636,RLK
chr19,Bn82666,29679451,72327407,42647956,NBS
chr19,Bn82667,68873545,98593310,29719765,RLP
chr19,Bn82668,86985461,95758669,8773208,RLP
chr19,Bn82669,79991148,88531510,8540362,CNL
chr19,Bn82670,23021110,90037724,67016614,NBS
chr19,Bn82671,28758462,59368680,30610218,RLK
chr19,Bn82672,81427365,92451131,11023766,CN
chr19,Bn82673,30147750,88483639,58335889,TNL
chr19,Bn82674,68333866,79073877,10740011,TNL
chr19,Bn82675,79851412,80691418,840006,CNL
chr19,Bn82676,81357739,86283362,4925623,CNL
chr19,Bn82677,73018012,81521939,8503927,RLP
chr19,Bn82678,14775941,20652650,5876709,NBS
chr19,Bn82679,58079447,78886530,20807083,TN
chr19,Bn82680,92917539,94092659,1175120,RLP
chr19,Bn82681,80900794,82586620,1685826,RLK
chr19,Bn82682,54617791,94384091,39766300,RLK
chr19,Bn82683,3130587,65455029,62324442,TN
chr19,Bn82684,99449134,99549526,100392,NBS
chr19,Bn82685,65056088,67963433,2907345,CN
chr19,Bn82686,87616452,89966620,2350168,CN
chr19,Bn82687,1444963,5695805,4250842,TN
chr19,Bn82688,27721714,34864366,7142652,TNL
chr19,Bn82689,48619221,72768230,24149009,NBS
chr19,Bn82690,36579440,50234994,13655554,CNL
chr19,Bn82691,23537453,75537326,51999873,NBS
chr19,Bn82692,55560714,73588269,18027555,CNL
chr19,Bn82693,52047753,90862457,38814704,TN
chr19,Bn82694,81038542,94185141,13146599,CN
chr19,Bn82695,25847162,31368806,5521644,TN
chr19,Bn82696,63876473,66521077,2644604,NBS
chr19,Bn82697,84883500,85476205,592705,TN
chr19,Bn82698,88343371,94814228,6470857,CN
chr19,Bn82699,38551837,44167209,5615372,CNL
chr19,Bn82700,19403666,20091429,687763,TNL
chr19,Bn82701,11946250,51920451,39974201,CNL
chr19,Bn82702,12867071,19128305,6261234,TNL
chr19,Bn82703,29413412,51280372,21866960,CNL
chr19,Bn82704,29322750,39569543,10246793,NBS
chr19,Bn82705,85826161,87169126,1342965,CN
chr19,Bn82706,4953528,57213127,52259599,RLK
chr19,Bn82707,67532261,88203839,20671578,TN
chr19,Bn82708,44636364,74709885,30073521,NBS
chr19,Bn82709,58953716,59093767,140051,CNL
chr19,Bn82710,76783429,84082025,7298596,CN
chr19,Bn82711,99823977,99840671,16694,NBS
chr19,Bn82712,8043569,61524616,53481047,RLP
chr19,Bn82713,12937632,83299335,70361703,TN
chr19,Bn82714,20306426,30694121,10387695,NBS
chr19,Bn82715,41726194,48075660,6349466,CN
chr19,Bn82716,29443183,62571897,33128714,RLP
chr19,Bn82717,65925479,82094211,16168732,TN
chr19,Bn82718,53707924,81519857,27811933,TNL
chr19,Bn82719,10531671,32572375,22040704,NBS
chr19,Bn82720,68306566,76847930,8541364,RLP
chr19,Bn82721,60287653,88413297,28125644,TNL
chr19,Bn82722,98372298,98668593,296295,RLP
chr19,Bn82723,94056032,94235869,179837,CNL
chr19,Bn82724,60438364,62654925,2216561,TNL
chr19,Bn82725,33330246,54487143,21156897,NBS
chr19,Bn82726,94477270,94507279,30009,CN
chr19,Bn82727,13147151,38811065,25663914,TN
chr19,Bn82728,13833671,40780045,26946374,CNL
chr19,Bn82729,64611789,85425993,20814204,RLK
chr19,Bn82730,6144257,49368530,43224273,TNL
chr19,Bn82731,89782085,89807256,25171,CN
chr19,Bn82732,28435796,75148561,46712765,CN
chr19,Bn82733,20625373,77292587,56667214,CNL
chr19,Bn82734,54024679,71784400,17759721,NBS
chr19,Bn82735,34529595,65165059,30635464,CNL
chr19,Bn82736,48506665,77059375,28552710,CN
chr19,Bn82737,4079097,80023069,75943972,TN
chr19,Bn82738,92567978,98255243,5687265,TN
chr19,Bn82739,16464720,71923574,55458854,RLK
chr19,Bn82740,24842416,93496933,68654517,CNL
chr19,Bn82741,6606134,23618920,17012786,RLP
chr19,Bn82742,19681858,84713876,65032018,NBS
chr19,Bn82743,38371365,93725238,55353873,CN
chr19,Bn82744,22101699,25650504,3548805,TN
chr19,Bn82745,56966242,91702173,34735931,NBS
chr19,Bn82746,58370557,64134934,5764377,CN
chr19,Bn82747,99790622,99957601,166979,TNL
chr19,Bn82748,59819821,70739081,10919260,TN
chr19,Bn82749,75273618,98846952,23573334,NBS
chr19,Bn82750,23871658,79082233,55210575,TN
chr19,Bn82751,44609453,65969635,21360182,CNL
chr19,Bn82752,86550060,92485300,5935240,RLP
chr19,Bn82753,38530711,56903805,18373094,CN
chr19,Bn82754,31543513,56105042,24561529,CNL
chr19,Bn82755,37666631,96607019,58940388,CNL
chr19,Bn82756,2703607,34026976,31323369,CNL
chr19,Bn82757,87937229,90877004,2939775,NBS
chr19,Bn82758,16116880,71211096,55094216,RLP
chr19,Bn82759,32443410,97171854,64728444,CNL
chr19,Bn82760,84981742,86402517,1420775,TN
chr19,Bn82761,62860210,97852200,34991990,NBS
chr19,Bn82762,87452543,93866041,6413498,CNL
chr19,Bn82763,93529306,99769175,6239869,CN
chr19,Bn82764,94649727,98631537,3981810,TN
chr19,Bn82765,96048413,98365514,2317101,TNL
chr19,Bn82766,28721309,70480393,41759084,RLK
chr19,Bn82767,82693108,88617277,5924169,CNL
chr19,Bn82768,7393989,95291648,87897659,NBS
chr19,Bn82769,83043970,86930290,3886320,CN
chr19,Bn82770,85405600,99216294,13810694,TN
chr19,Bn82771,3443525,36899578,33456053,CN
chr19,Bn82772,5812704,46965721,41153017,RLP
chr19,Bn82773,74777245,85316435,10539190,CN
chr19,Bn82774,6245917,55901558,49655641,CN
chr19,Bn82775,91310590,92618197,1307607,TNL
chr19,Bn82776,31686007,90772343,59086336,RLP
chr19,Bn82777,72072110,87804105,15731995,TN
chr19,Bn82778,87596361,93886294,6289933,CNL
chr19,Bn82779,68137955,76116984,7979029,RLP
chr19,Bn82780,46807643,70014390,23206747,RLK
chr19,Bn82781,76259087,79168753,2909666,RLK
chr19,Bn82782,13080049,92783386,79703337,TNL
chr19,Bn82783,54785222,85311514,30526292,RLP
chr19,Bn82784,59827599,74404900,14577301,TN
chr19,Bn82785,61156406,86224308,25067902,TNL
chr19,Bn82786,3693057,23033744,19340687,CN
chr19,Bn82787,37786779,87592694,49805915,RLP
chr19,Bn82788,65110143,82096908,16986765,CNL
chr19,Bn82789,88076307,91672684,3596377,NBS
chr19,Bn82790,55213818,56737359,1523541,NBS
chr19,Bn82791,72879091,78646847,5767756,RLK
chr19,Bn82792,76718984,78532565,1813581,CNL
chr19,Bn82793,43707507,83401045,39693538,CN
chr19,Bn82794,51897913,85295337,33397424,NBS
chr19,Bn82795,25412782,26039384,626602,TNL
chr19,Bn82796,21835732,82891216,61055484,CNL
chr19,Bn82797,81700960,98316760,16615800,TNL
chr19,Bn82798,92988772,95111858,2123086,RLK
chr19,Bn82799,20711387,28187093,7475706,TN
chr19,Bn82800,31643620,37277555,5633935,RLP
chr19,Bn82801,88701488,97679571,8978083,RLK
chr19,Bn82802,64247675,67698008,3450333,CN
chr19,Bn82803,33275924,36099928,2824004,CNL
chr19,Bn82804,87556134,91712118,4155984,CNL
chr19,Bn82805,85585859,97941052,12355193,TNL
chr19,Bn82806,63262266,71163350,7901084,TNL
chr19,Bn82807,69075170,81287330,12212160,TNL
chr19,Bn82808,18900695,77410442,58509747,RLK
chr19,Bn82809,67946972,81265832,13318860,RLP
chr19,Bn82810,26478654,80813740,54335086,TNL
chr19,Bn82811,84417307,99759047,15341740,CN
chr19,Bn82812,39053564,72067524,33013960,TNL
chr19,Bn82813,84068086,88549890,4481804,TN
chr19,Bn82814,25501644,89906134,64404490,TN
chr19,Bn82815,62139887,67267400,5127513,RLP
chr19,Bn82816,81538322,93857616,12319294,RLK
chr19,Bn82817,97516977,99007120,1490143,CN
chr19,Bn82818,56974885,74284071,17309186,CN
chr19,Bn82819,37309827,69478338,32168511,NBS
chr19,Bn82820,13254305,44749955,31495650,CN
chr19,Bn82821,25907233,58108181,32200948,TN
chr19,Bn82822,87565715,92480857,4915142,CN
chr19,Bn82823,9515620,80859537,71343917,RLP
chr19,Bn82824,97587533,99859679,2272146,RLK
chr19,Bn82825,51948064,62098857,10150793,CN
chr19,Bn82826,42320639,51148085,8827446,RLK
chr19,Bn82827,90443914,98792544,8348630,NBS
chr19,Bn82828,28993926,50108873,21114947,TN
chr19,Bn82829,94311183,99877161,5565978,TN
chr19,Bn82830,81908817,98835100,16926283,TNL
chr19,Bn82831,88280462,94358840,6078378,TN
chr19,Bn82832,12539688,76994768,64455080,NBS
chr19,Bn82833,77857871,90109727,12251856,RLP
chr19,Bn82834,82641487,85037525,2396038,CNL
chr19,Bn82835,95153557,97935553,2781996,TN
chr19,Bn82836,59718617,72393091,12674474,TNL
chr19,Bn82837,88629509,98910585,10281076,RLK
chr19,Bn82838,81935099,83798740,1863641,TN
chr19,Bn82839,43713383,74870297,31156914,TN
chr19,Bn82840,39387892,79698994,40311102,TNL
chr19,Bn82841,37569096,75955360,38386264,RLP
chr19,Bn82842,74147637,84499932,10352295,TNL
chr19,Bn82843,76916640,80614230,3697590,RLK
chr19,Bn82844,2543270,81746580,79203310,NBS
chr19,Bn82845,30765186,82981437,52216251,TN
chr19,Bn82846,77092698,99707392,22614694,NBS
chr19,Bn82847,62209997,88915285,26705288,TNL
chr19,Bn82848,51266967,77899828,26632861,CN
chr19,Bn82849,16419695,99742356,83322661,CNL
chr19,Bn82850,62895565,97918639,35023074,TNL
chr19,Bn82851,68213172,81881005,13667833,NBS
chr19,Bn82852,74507534,89461362,14953828,NBS
chr19,Bn82853,95077937,98090503,3012566,RLK
chr19,Bn82854,95819867,98642849,2822982,CNL
chr19,Bn82855,30575854,81123816,50547962,TN
chr19,Bn82856,98295416,98719193,423777,TN
chr19,Bn82857,86003287,91403585,5400298,RLP
chr19,Bn82858,65820365,77332386,11512021,TNL
chr19,Bn82859,77189015,86367944,9178929,TNL
chr19,Bn82860,74340644,78544131,4203487,CN
chr19,Bn82861,86274163,98131278,11857115,NBS
chr19,Bn82862,69612168,83912661,14300493,TN
chr19,Bn82863,57098033,70157316,13059283,NBS
chr19,Bn82864,97126220,99817344,2691124,TN
chr19,Bn82865,86645960,91059711,4413751,CNL
chr19,Bn82866,85885599,93235666,7350067,TNL
chr19,Bn82867,3141398,10227471,7086073,CN
chr19,Bn82868,85832154,99904134,14071980,CN
chr19,Bn82869,52274473,67139595,14865122,CN
chr19,Bn82870,24243428,51300545,27057117,NBS
chr19,Bn82871,2871185,47769687,44898502,TNL
chr19,Bn82872,27082788,88812773,61729985,TN
chr19,Bn82873,43256958,59057421,15800463,TNL
chr19,Bn82874,27757753,34529433,6771680,CN
chr19,Bn82875,12485680,22878450,10392770,RLK
chr19,Bn82876,90015327,91523895,1508568,TN
chr19,Bn82877,66021635,88289744,22268109,RLP
chr19,Bn82878,77568848,93359212,15790364,NBS
chr19,Bn82879,94384123,94552808,168685,CN
chr19,Bn82880,27083035,86267020,59183985,RLK
chr19,Bn82881,5267845,50883259,45615414,CN
chr19,Bn82882,48062550,89831596,41769046,NBS
chr19,Bn82883,89027321,94310461,5283140,TN
chr19,Bn82884,47133711,75318731,28185020,TNL
chr19,Bn82885,47464707,70615177,23150470,TN
chr19,Bn82886,79499173,99460750,19961577,TNL
chr19,Bn82887,12309515,19352467,7042952,CNL
chr19,Bn82888,62245614,89054381,26808767,TNL
chr19,Bn82889,29819469,68515380,38695911,TNL
chr19,Bn82890,99615751,99959189,343438,RLP
chr19,Bn82891,13684770,61399193,47714423,RLK
chr19,Bn82892,80044093,91803629,11759536,NBS
chr19,Bn82893,48328404,95699815,47371411,TNL
chr19,Bn82894,23226282,63052768,39826486,CNL
chr19,Bn82895,45956630,46570835,614205,NBS
chr19,Bn82896,80733502,86811833,6078331,NBS
chr19,Bn82897,8576664,60632334,52055670,NBS
chr19,Bn82898,98018524,99863441,1844917,CN
chr19,Bn82899,22323070,94762947,72439877,CN
chr19,Bn82900,3005947,63325566,60319619,NBS
chr19,Bn82901,31150737,36783881,5633144,RLP
chr19,Bn82902,39824177,98448102,58623925,CN
chr19,Bn82903,22554992,87538627,64983635,NBS
chr19,Bn82904,24480575,62172870,37692295,RLP
chr19,Bn82905,57100652,71163706,14063054,CN
chr19,Bn82906,9118379,12972882,3854503,CN
chr19,Bn82907,35206954,78845301,43638347,TNL
chr19,Bn82908,99414709,99738817,324108,TNL
chr19,Bn82909,22679504,49569592,26890088,CN
chr19,Bn82910,91615204,96989056,5373852,RLP
chr19,Bn82911,43657403,80197423,36540020,RLP
chr19,Bn82912,3117173,8283522,5166349,NBS
chr19,Bn82913,15005976,28857467,13851491,CNL
chr19,Bn82914,56397772,91801964,35404192,CN
chr19,Bn82915,87941403,89556696,1615293,RLP
chr19,Bn82916,45232881,81609454,36376573,CN
chr19,Bn82917,81218965,83223320,2004355,CN
chr19,Bn82918,47349941,88833959,41484018,TNL
chr19,Bn82919,55381189,98911444,43530255,NBS
chr19,Bn82920,50598422,97127104,46528682,RLK
chr19,Bn82921,22875016,46513237,23638221,RLP
chr19,Bn82922,82308923,92627353,10318430,RLK
chr19,Bn82923,71167833,81126825,9958992,RLP
chr19,Bn82924,49546673,81696556,32149883,TNL
chr19,Bn82925,28769830,51441850,22672020,RLP
chr19,Bn82926,94607199,99736041,5128842,CN
chr19,Bn82927,26623890,39852067,13228177,CNL
chr19,Bn82928,89299587,94811682,5512095,RLK
chr19,Bn82929,67780966,75223732,7442766,NBS
chr19,Bn82930,82395583,99216977,16821394,RLK
chr19,Bn82931,82692599,94598954,11906355,CNL
chr19,Bn82932,39771408,63389630,23618222,NBS
chr19,Bn82933,38196856,50428371,12231515,TNL
chr19,Bn82934,85130084,93543362,8413278,CN
chr19,Bn82935,47624654,90398182,42773528,TN
chr19,Bn82936,23986699,42775251,18788552,CN
chr19,Bn82937,9187676,9671161,483485,RLP
chr19,Bn82938,77526435,96978165,19451730,TNL
chr19,Bn82939,52215978,60471112,8255134,TNL
chr19,Bn82940,87172973,91271841,4098868,RLP
chr19,Bn82941,11314754,65476435,54161681,CNL
chr19,Bn82942,41018878,85996826,44977948,TN
chr19,Bn82943,53288688,65350229,12061541,CNL
chr19,Bn82944,71631425,87824473,16193048,TNL
chr19,Bn82945,3794947,49711210,45916263,NBS
chr19,Bn82946,87935157,90734583,2799426,RLK
chr19,Bn82947,61747507,67863762,6116255,RLP
chr19,Bn82948,98975644,99915689,940045,NBS
chr19,Bn82949,41417703,75433688,34015985,TN
chr19,Bn82950,70292610,94825089,24532479,NBS
chr19,Bn82951,30012312,42048895,12036583,RLK
chr19,Bn82952,50808143,83941691,33133548,TN
chr19,Bn82953,89519235,97731921,8212686,RLK
chr19,Bn82954,99570332,99742621,172289,TNL
chr19,Bn82955,98562937,99421295,858358,TNL
chr19,Bn82956,54861235,78437329,23576094,CN
chr19,Bn82957,73283794,88659560,15375766,RLP
chr19,Bn82958,89277996,99622908,10344912,RLK
chr19,Bn82959,79216596,98331856,19115260,NBS
chr19,Bn82960,9905916,94920239,85014323,RLP
chr19,Bn82961,91387248,91692420,305172,CNL
chr19,Bn82962,72261647,76914758,4653111,TNL
chr19,Bn82963,46422979,61400191,14977212,CN
chr19,Bn82964,40522645,81156099,40633454,TNL
chr19,Bn82965,84567083,88055777,3488694,CN
chr19,Bn82966,37872041,68035842,30163801,NBS
chr19,Bn82967,50989457,56881331,5891874,NBS
chr19,Bn82968,86624379,98435135,11810756,RLK
chr19,Bn82969,61361109,80988527,19627418,TNL
chr19,Bn82970,45376409,61550090,16173681,RLP
chr19,Bn82971,14708672,97599713,82891041,RLK
chr19,Bn82972,62503562,75406872,12903310,CN
chr19,Bn82973,15729310,53342113,37612803,NBS
chr19,Bn82974,58479484,91261495,32782011,NBS
chr19,Bn82975,98897587,99563997,666410,CNL
chr19,Bn82976,50091741,95050996,44959255,RLK
chr19,Bn82977,20659422,64561180,43901758,CNL
chr19,Bn82978,28400477,54141649,25741172,NBS
chr19,Bn82979,2526393,85072643,82546250,TNL
chr19,Bn82980,86171651,86516537,344886,CNL
chr19,Bn82981,17565845,34074514,16508669,CNL
chr19,Bn82982,34215252,99219037,65003785,RLK
chr19,Bn82983,76758573,97088684,20330111,RLP
chr19,Bn82984,11461559,90454047,78992488,RLP
chr19,Bn82985,2251131,6410554,4159423,TNL
chr19,Bn82986,50079293,51492161,1412868,RLP
chr19,Bn82987,95722969,99617870,3894901,TNL
chr19,Bn82988,39933757,63329630,23395873,RLK
chr19,Bn82989,26912546,79147881,52235335,TN
chr19,Bn82990,94078264,96013243,1934979,NBS
chr19,Bn82991,63000077,85023310,22023233,CN
chr19,Bn82992,40763514,76423375,35659861,TNL
chr19,Bn82993,69456325,75075641,5619316,CNL
chr19,Bn82994,10113986,81738957,71624971,CNL
chr19,Bn82995,12434900,15191449,2756549,RLK
chr19,Bn82996,70604671,92366076,21761405,TN
chr19,Bn82997,42483644,70704464,28220820,CN
chr19,Bn82998,14602995,82688996,68086001,RLK
chr19,Bn82999,46514880,90317125,43802245,NBS
chr19,Bn83000,57894335,79677261,21782926,RLP
chr19,Bn83001,13864607,47231061,33366454,RLP
chr19,Bn83002,58390753,72002389,13611636,RLK
chr19,Bn83003,41569522,91161130,49591608,TN
chr19,Bn83004,72212711,91157407,18944696,CN
chr19,Bn83005,47594982,80145727,32550745,CN
chr19,Bn83006,98110409,99154258,1043849,TNL
chr19,Bn83007,83001273,87399398,4398125,CNL
chr19,Bn83008,14920467,28180097,13259630,RLP
chr19,Bn83009,18413876,44865760,26451884,TNL
chr19,Bn83010,5633702,18807906,13174204,CNL
chr19,Bn83011,91068893,99335589,8266696,RLK
chr19,Bn83012,90624200,94518822,3894622,RLK
chr19,Bn83013,48134622,81533101,33398479,TNL
chr19,Bn83014,5126199,75653066,70526867,CN
chr19,Bn83015,16291093,27017602,10726509,RLP
chr19,Bn83016,50289682,78500908,28211226,CN
chr19,Bn83017,10865589,19770301,8904712,RLK
chr19,Bn83018,37790956,79542100,41751144,RLP
chr19,Bn83019,13114094,46334713,33220619,TN
chr19,Bn83020,25514808,37480449,11965641,TNL
chr19,Bn83021,58714026,60891960,2177934,NBS
chr19,Bn83022,59234390,88257346,29022956,RLK
chr19,Bn83023,19849853,40327082,20477229,CN
chr19,Bn83024,3191090,9687813,6496723,RLP
chr19,Bn83025,58176581,95242780,37066199,CNL
chr19,Bn83026,49487491,97650895,48163404,RLP
chr19,Bn83027,97489807,99262044,1772237,CNL
chr19,Bn83028,89360085,98785869,9425784,CN
chr19,Bn83029,7037040,78608955,71571915,NBS
chr19,Bn83030,85700962,86497587,796625,RLP
chr19,Bn83031,30662053,42672542,12010489,CNL
chr19,Bn83032,12957527,80976884,68019357,TNL
chr19,Bn83033,79420617,93995020,14574403,TN
chr19,Bn83034,3643876,64614453,60970577,RLP
chr19,Bn83035,43212724,64805656,21592932,CN
chr19,Bn83036,22714363,93511961,70797598,RLP
chr19,Bn83037,24210013,29218308,5008295,RLP
chr19,Bn83038,95282084,96127986,845902,RLK
chr19,Bn83039,7382952,89331454,81948502,NBS
chr19,Bn83040,78843938,94280180,15436242,CN
chr19,Bn83041,89934468,92627216,2692748,TNL
chr19,Bn83042,98748137,99909020,1160883,CN
chr19,Bn83043,88653637,99259556,10605919,CNL
chr19,Bn83044,62564149,77660471,15096322,TN
chr19,Bn83045,96464227,99275620,2811393,RLP
chr19,Bn83046,45428140,60528548,15100408,CN
chr19,Bn83047,91794642,92043341,248699,RLP
chr19,Bn83048,92164381,99866482,7702101,CN
chr19,Bn83049,6745060,90654462,83909402,RLP
chr19,Bn83050,77729625,93779577,16049952,RLP
chr19,Bn83051,85394750,89508895,4114145,RLP
chr19,Bn83052,8600658,75519873,66919215,TNL
chr19,Bn83053,28028800,71689930,43661130,RLP
chr19,Bn83054,43251779,61559345,18307566,RLP
chr19,Bn83055,79853505,84630618,4777113,CN
chr19,Bn83056,42798833,66218464,23419631,CN
chr19,Bn83057,65979784,68484660,2504876,RLK
chr19,Bn83058,97184438,99311878,2127440,CN
chr19,Bn83059,54002281,74689916,20687635,NBS
chr19,Bn83060,70749058,89811226,19062168,RLP
chr19,Bn83061,3948254,28053822,24105568,RLP
chr19,Bn83062,33427879,88184214,54756335,NBS
chr19,Bn83063,77802891,87058152,9255261,RLP
chr19,Bn83064,68423553,77954830,9531277,NBS
chr19,Bn83065,49360533,92491295,43130762,RLP
chr19,Bn83066,45838195,96354478,50516283,CNL
chr19,Bn83067,28162070,59785563,31623493,RLP
chr19,Bn83068,88491677,96065993,7574316,CN
chr19,Bn83069,15990559,31169225,15178666,TNL
chr19,Bn83070,7340391,98215460,90875069,TN
chr19,Bn83071,17990958,43065159,25074201,CN
chr19,Bn83072,5352054,75950029,70597975,TN
chr19,Bn83073,32277307,93851332,61574025,TN
chr19,Bn83074,92248265,94307822,2059557,CN
chr19,Bn83075,54984513,82749369,27764856,RLP
chr19,Bn83076,27829403,79922735,52093332,TNL
chr19,Bn83077,22166765,77395866,55229101,TN
chr19,Bn83078,13636002,84375923,70739921,TN
chr19,Bn83079,14418725,88751400,74332675,RLP
chr19,Bn83080,36022868,68539411,32516543,CN
chr19,Bn83081,14095558,76279766,62184208,TNL
chr19,Bn83082,58477959,72455054,13977095,TNL
chr19,Bn83083,86257764,95432710,9174946,CNL
chr19,Bn83084,74593837,76068230,1474393,NBS
chr19,Bn83085,6951790,97963756,91011966,CNL
chr19,Bn83086,80138783,95626271,15487488,CN
chr19,Bn83087,71551615,89068449,17516834,TNL
chr19,Bn83088,90469606,91196501,726895,CNL
chr19,Bn83089,53675034,56290503,2615469,TN
chr19,Bn83090,11329938,91493592,80163654,CNL
chr19,Bn83091,38742468,84495270,45752802,RLK
chr19,Bn83092,25939632,71251808,45312176,RLP
chr19,Bn83093,58260223,77106665,18846442,TNL
chr19,Bn83094,60290216,92238689,31948473,TN
chr19,Bn83095,16168705,71897032,55728327,NBS
chr19,Bn83096,48480339,70869868,22389529,RLK
chr19,Bn83097,18639116,89203809,70564693,TN
chr19,Bn83098,29705439,64135892,34430453,CN
chr19,Bn83099,4027402,60544458,56517056,CNL
chr19,Bn83100,44080764,54537652,10456888,CN
chr19,Bn83101,35199424,84399388,49199964,NBS
chr19,Bn83102,33527363,39276633,5749270,RLP
chr19,Bn83103,7946605,81253597,73306992,NBS
chr19,Bn83104,84932193,88820563,3888370,CNL
chr19,Bn83105,87349416,98977281,11627865,RLP
chr19,Bn83106,46634289,60419971,13785682,TN
chr19,Bn83107,25793874,81350737,55556863,TNL
chr19,Bn83108,44984169,90464397,45480228,TNL
chr19,Bn83109,75298711,93865693,18566982,TNL
chr19,Bn83110,55048032,73555953,18507921,CN
chr19,Bn83111,68883377,70059507,1176130,CN
chr19,Bn83112,64701588,92408051,27706463,RLP
chr19,Bn83113,51420116,69292016,17871900,NBS
chr19,Bn83114,62448616,80364349,17915733,CNL
chr19,Bn83115,58059713,70173675,12113962,CNL
chr19,Bn83116,26978005,46892381,19914376,CNL
chr19,Bn83117,7536796,88336176,80799380,TN
chr19,Bn83118,49476401,53632498,4156097,CNL
chr19,Bn83119,26972784,27240882,268098,NBS
chr19,Bn83120,28749598,47543056,18793458,RLP
chr19,Bn83121,50912077,80873633,29961556,RLP
chr19,Bn83122,7342367,94534653,87192286,CNL
chr19,Bn83123,40515854,73817327,33301473,NBS
chr19,Bn83124,79371999,95468880,16096881,TNL
chr19,Bn83125,61298724,92016243,30717519,CN
chr19,Bn83126,68253409,80968908,12715499,RLK
chr19,Bn83127,67831773,72042902,4211129,CN
chr19,Bn83128,55774061,62121129,6347068,TNL
chr19,Bn83129,28348664,44551529,16202865,TNL
chr19,Bn83130,62236749,66978056,4741307,RLK
chr19,Bn83131,66333820,69108533,2774713,TN
chr19,Bn83132,21899972,66667018,44767046,NBS
chr19,Bn83133,67925691,69613009,1687318,RLP
chr19,Bn83134,57667151,62087066,4419915,NBS
chr19,Bn83135,66766950,77357293,10590343,CNL
chr19,Bn83136,65728233,96267627,30539394,RLK
chr19,Bn83137,15084421,20973364,5888943,NBS
chr19,Bn83138,94270460,98636706,4366246,TNL
chr19,Bn83139,12754997,81157565,68402568,RLP
chr19,Bn83140,89250023,99796751,10546728,RLP
chr19,Bn83141,6220922,58308742,52087820,TN
chr19,Bn83142,3787639,91043945,87256306,RLP
chr19,Bn83143,45099758,60706533,15606775,CNL
chr19,Bn83144,49029563,98719259,49689696,RLP
chr19,Bn83145,98254027,99286449,1032422,CNL
chr19,Bn83146,58466509,99577468,41110959,TN
chr19,Bn83147,79410748,86184298,6773550,TN
chr19,Bn83148,51537617,63963643,12426026,CNL
chr19,Bn83149,30027134,82990184,52963050,RLK
chr19,Bn83150,48717391,57305602,8588211,NBS
chr19,Bn83151,5159836,85149108,79989272,CNL
chr19,Bn83152,42765645,50313039,7547394,RLK
chr19,Bn83153,22931247,86410756,63479509,NBS
chr19,Bn83154,29160072,42809200,13649128,TNL
chr19,Bn83155,98235312,99163330,928018,RLP
chr19,Bn83156,29367856,65610459,36242603,RLP
chr19,Bn83157,41113916,72210611,31096695,CNL
chr19,Bn83158,83686740,88434144,4747404,RLP
chr19,Bn83159,18562978,83340329,64777351,CNL
chr19,Bn83160,40366887,92242585,51875698,TN
chr19,Bn83161,31988706,81846994,49858288,NBS
chr19,Bn83162,29663092,72407440,42744348,TN
chr19,Bn83163,24184457,59722661,35538204,TNL
chr19,Bn83164,61424109,62593280,1169171,NBS
chr19,Bn83165,15679744,54044899,38365155,TN
chr19,Bn83166,39389803,51814122,12424319,NBS
chr19,Bn83167,58456732,67739577,9282845,CN
chr19,Bn83168,82137744,96998324,14860580,CNL
chr19,Bn83169,79421427,85609689,6188262,NBS
chr19,Bn83170,10683001,38402656,27719655,RLK
chr19,Bn83171,14773223,90639324,75866101,RLP
chr19,Bn83172,7689925,73803085,66113160,TN
chr19,Bn83173,72825764,95317445,22491681,TN
chr19,Bn83174,57543783,74654554,17110771,NBS
chr19,Bn83175,65758693,88540640,22781947,CN
chr19,Bn83176,17417263,33266155,15848892,RLK
chr19,Bn83177,80875190,82925750,2050560,CN
chr19,Bn83178,75455688,80048057,4592369,CNL
chr19,Bn83179,60308175,62270977,1962802,NBS
chr19,Bn83180,28380895,83502647,55121752,CN
chr19,Bn83181,75230938,94578914,19347976,NBS
chr19,Bn83182,68151716,73223293,5071577,TNL
chr19,Bn83183,50003279,71933357,21930078,RLP
chr19,Bn83184,26846698,38607774,11761076,RLK
chr19,Bn83185,63438934,82920507,19481573,TNL
chr19,Bn83186,87814380,99874982,12060602,RLP
chr19,Bn83187,67542735,85543973,18001238,TN
chr19,Bn83188,96807995,98681264,1873269,CN
chr19,Bn83189,50486371,60635143,10148772,RLP
chr19,Bn83190,60354819,87570267,27215448,CNL
chr19,Bn83191,46421067,87091623,40670556,CNL
chr19,Bn83192,48316936,99043227,50726291,CNL
chr19,Bn83193,2939597,10436933,7497336,NBS
chr19,Bn83194,82869195,94188847,11319652,TN
chr19,Bn83195,18072938,71135069,53062131,TNL
chr19,Bn83196,26617509,66115051,39497542,TNL
chr19,Bn83197,36661185,88087067,51425882,CNL
chr19,Bn83198,26260174,76480399,50220225,RLK
chr19,Bn83199,16392352,99596573,83204221,TNL
chr19,Bn83200,4925956,79210572,74284616,RLK
chr19,Bn83201,7291390,12667012,5375622,RLP
chr19,Bn83202,68906061,86555411,17649350,RLP
chr19,Bn83203,76954668,89920127,12965459,CNL
chr19,Bn83204,50814714,81210557,30395843,RLP
chr19,Bn83205,48867898,49447624,579726,RLP
chr19,Bn83206,60500003,70215445,9715442,TNL
chr19,Bn83207,36766427,39551653,2785226,NBS
chr19,Bn83208,40087697,89621968,49534271,TN
chr19,Bn83209,36031899,46639618,10607719,CNL
chr19,Bn83210,90557569,96806285,6248716,CN
chr19,Bn83211,40881686,44498431,3616745,TNL
chr19,Bn83212,32415765,50548073,18132308,RLK
chr19,Bn83213,35948930,68881689,32932759,CN
chr19,Bn83214,32338798,65463868,33125070,NBS
chr19,Bn83215,87594914,96969828,9374914,RLP
chr19,Bn83216,7655034,35711156,28056122,RLK
chr19,Bn83217,86026021,89691242,3665221,NBS
chr19,Bn83218,27877030,40526664,12649634,CNL
chr19,Bn83219,6859169,21233450,14374281,RLP
chr19,Bn83220,62458008,79397196,16939188,CNL
chr19,Bn83221,56729567,94042779,37313212,RLK
chr19,Bn83222,92420938,94249064,1828126,CNL
chr19,Bn83223,30530382,48659122,18128740,NBS
chr19,Bn83224,76267035,93701435,17434400,CN
chr19,Bn83225,77304543,82888066,5583523,NBS
chr19,Bn83226,96277527,98498890,2221363,RLP
chr19,Bn83227,5035903,24104374,19068471,TN
chr19,Bn83228,37519034,51803282,14284248,CN
chr19,Bn83229,18180062,98117953,79937891,RLK
chr19,Bn83230,26314403,28525398,2210995,NBS
chr19,Bn83231,35370462,43460538,8090076,NBS
chr19,Bn83232,91023559,97820991,6797432,TN
chr19,Bn83233,76018873,91660743,15641870,RLK
chr19,Bn83234,26900527,79110012,52209485,RLP
chr19,Bn83235,27915355,63942127,36026772,RLK
chr19,Bn83236,83184555,89475143,6290588,RLP
chr19,Bn83237,58068514,75137992,17069478,CN
chr19,Bn83238,63322827,81540427,18217600,TN
chr19,Bn83239,6096813,31960050,25863237,RLK
chr19,Bn83240,22304773,98852493,76547720,TN
chr19,Bn83241,26116599,95366641,69250042,RLP
chr19,Bn83242,71072660,75797930,4725270,CNL
chr19,Bn83243,84459160,85685345,1226185,TN
chr19,Bn83244,44469260,78381086,33911826,RLP
chr19,Bn83245,19354275,31831265,12476990,NBS
chr19,Bn83246,99819188,99993900,174712,TNL
chr19,Bn83247,10255611,17176595,6920984,CN
chr19,Bn83248,49588500,82874256,33285756,CN
chr19,Bn83249,81253756,89672572,8418816,RLK
chr19,Bn83250,64533056,97390173,32857117,CNL
chr19,Bn83251,93396680,99448746,6052066,NBS
chr19,Bn83252,11171233,88515863,77344630,TN
chr19,Bn83253,58881428,83492433,24611005,CN
chr19,Bn83254,77362947,77739483,376536,RLK
chr19,Bn83255,59693632,96808627,37114995,CNL
chr19,Bn83256,6630320,35681598,29051278,CNL
chr19,Bn83257,39702367,47745562,8043195,CN
chr19,Bn83258,25119658,95235748,70116090,CNL
chr19,Bn83259,60164503,92682671,32518168,RLP
chr19,Bn83260,42696358,69525607,26829249,RLK
chr19,Bn83261,54427214,89364200,34936986,RLK
chr19,Bn83262,1326496,68170332,66843836,RLK
chr19,Bn83263,92996839,95700939,2704100,RLP
chr19,Bn83264,76435491,99956101,23520610,TN
chr19,Bn83265,44363058,92863175,48500117,TN
chr19,Bn83266,2426689,91692669,89265980,CN
chr19,Bn83267,43712472,58864949,15152477,TN
chr19,Bn83268,15092452,52480061,37387609,CNL
chr19,Bn83269,64120042,71605604,7485562,RLP
chr19,Bn83270,57638813,85659907,28021094,CNL
chr19,Bn83271,10395644,26176550,15780906,CN
chr19,Bn83272,83142980,93690892,10547912,CNL
chr19,Bn83273,13124051,29125760,16001709,TNL
chr19,Bn83274,19046929,32229458,13182529,CN
chr19,Bn83275,65173867,88136544,22962677,CNL
chr19,Bn83276,43154414,68905686,25751272,NBS
chr19,Bn83277,37070157,47919350,10849193,TN
chr19,Bn83278,88710300,97861368,9151068,CN
chr19,Bn83279,28066606,35813874,7747268,RLK
chr19,Bn83280,62144376,63277004,1132628,CNL
chr19,Bn83281,30668688,62133062,31464374,TN
chr19,Bn83282,68672511,69416575,744064,RLK
chr19,Bn83283,4107381,27860198,23752817,NBS
chr19,Bn83284,20196709,72703693,52506984,NBS
chr19,Bn83285,14342387,92730733,78388346,CNL
chr19,Bn83286,5476814,25595516,20118702,TNL
chr19,Bn83287,13340991,27447623,14106632,NBS
chr19,Bn83288,56891800,86944477,30052677,TNL
chr19,Bn83289,10097450,16897554,6800104,CN
chr19,Bn83290,8429398,12188108,3758710,TNL
chr19,Bn83291,95689573,96003928,314355,CN
chr19,Bn83292,32153365,99114827,66961462,RLK
chr19,Bn83293,12618110,79870889,67252779,CN
chr19,Bn83294,59772952,96810878,37037926,TNL
chr19,Bn83295,53616299,79237466,25621167,NBS
chr19,Bn83296,26633450,58653634,32020184,NBS
chr19,Bn83297,80983368,88246868,7263500,TNL
chr19,Bn83298,24119769,33286230,9166461,RLK
chr19,Bn83299,16020798,53124251,37103453,TN
chr19,Bn83300,9838203,21656435,11818232,NBS
chr19,Bn83301,53235529,94435746,41200217,TNL
chr19,Bn83302,36271935,67434883,31162948,TN
chr19,Bn83303,32276754,82939518,50662764,TNL
chr19,Bn83304,10884106,18280353,7396247,CNL
chr19,Bn83305,99350678,99424427,73749,TNL
chr19,Bn83306,81305447,96105754,14800307,RLP
chr19,Bn83307,43943895,60684981,16741086,NBS
chr19,Bn83308,38308423,49461587,11153164,TN
chr19,Bn83309,2635037,41632677,38997640,RLK
chr19,Bn83310,58237052,83027358,24790306,NBS
chr19,Bn83311,69091628,97242039,28150411,TN
chr19,Bn83312,94521084,96129007,1607923,CN
chr19,Bn83313,63454824,67806459,4351635,CN
chr19,Bn83314,39660741,66442219,26781478,CN
chr19,Bn83315,10237535,71054996,60817461,TN
chr19,Bn83316,13130071,84181924,71051853,TN
chr19,Bn83317,93976668,96999944,3023276,CN
chr19,Bn83318,78296403,96829016,18532613,CNL
chr19,Bn83319,71178966,86923380,15744414,TN
chr19,Bn83320,85857551,87413067,1555516,RLK
chr19,Bn83321,87029177,95054372,8025195,CN
chr19,Bn83322,16582623,75668794,59086171,RLK
chr19,Bn83323,58109894,79721012,21611118,TNL
chr19,Bn83324,15666224,80728303,65062079,CN
chr19,Bn83325,49528568,63611776,14083208,NBS
chr19,Bn83326,79453722,85203615,5749893,RLP
chr19,Bn83327,58096730,67328892,9232162,NBS
chr19,Bn83328,13986147,52140410,38154263,RLK
chr19,Bn83329,1811672,36104218,34292546,TN
chr19,Bn83330,96433086,97790033,1356947,TNL
chr19,Bn83331,52038782,84729226,32690444,TN
chr19,Bn83332,83121157,86569063,3447906,CNL
chr19,Bn83333,21016565,71275401,50258836,NBS
chr19,Bn83334,25086072,54511623,29425551,CNL
chr19,Bn83335,43718378,71260858,27542480,RLK
chr19,Bn83336,25251119,90262716,65011597,TN
chr19,Bn83337,75186083,76076185,890102,NBS
chr19,Bn83338,72833161,79885382,7052221,CNL
chr19,Bn83339,80447187,81550845,1103658,CNL
chr19,Bn83340,78325343,84127163,5801820,RLP
chr19,Bn83341,87854023,98460896,10606873,RLP
chr19,Bn83342,8118005,64404399,56286394,RLK
chr19,Bn83343,27515877,80823616,53307739,TN
chr19,Bn83344,60681828,95569475,34887647,CN
chr19,Bn83345,58207156,79701577,21494421,CNL
chr19,Bn83346,44242818,91772129,47529311,TN
chr19,Bn83347,13122719,90579594,77456875,TN
chr19,Bn83348,3915121,43020063,39104942,TN
chr19,Bn83349,27445961,91519709,64073748,RLP
chr19,Bn83350,73100501,98821895,25721394,RLP
chr19,Bn83351,97392705,97967362,574657,TNL
chr19,Bn83352,29361703,58983354,29621651,CN
chr19,Bn83353,55831211,77573968,21742757,CNL
chr19,Bn83354,26763695,92455646,65691951,RLP
chr19,Bn83355,33296700,36360632,3063932,TN
chr19,Bn83356,66813885,83382569,16568684,NBS
chr19,Bn83357,36012493,71813033,35800540,RLK
chr19,Bn83358,45650698,78728481,33077783,CN
chr19,Bn83359,28116674,56923968,28807294,CNL
chr19,Bn83360,18244109,45189562,26945453,RLP
chr19,Bn83361,89378465,99584007,10205542,TN
chr19,Bn83362,98818690,99307473,488783,TNL
chr19,Bn83363,92757543,95491986,2734443,TN
chr19,Bn83364,48540304,80349218,31808914,RLK
chr19,Bn83365,79255241,90906679,11651438,RLP
chr19,Bn83366,9154188,73091917,63937729,RLP
chr19,Bn83367,28404482,56576377,28171895,TNL
chr19,Bn83368,40427880,59963527,19535647,TN
chr19,Bn83369,39713746,50732475,11018729,TNL
chr19,Bn83370,86170932,88177259,2006327,RLP
chr19,Bn83371,27367003,93613363,66246360,RLK
chr19,Bn83372,14619692,65885502,51265810,RLK
chr19,Bn83373,20753284,97148110,76394826,TNL
chr19,Bn83374,52006615,80419583,28412968,TNL
chr19,Bn83375,11250588,97028465,85777877,CN
chr19,Bn83376,55183695,93645088,38461393,TNL
chr19,Bn83377,36668655,80160948,43492293,NBS
chr19,Bn83378,11866662,84846086,72979424,RLP
chr19,Bn83379,37010699,51896422,14885723,NBS
chr19,Bn83380,85605803,98875988,13270185,CNL
chr19,Bn83381,61257467,98140562,36883095,RLP
chr19,Bn83382,63875015,68174740,4299725,NBS
chr19,Bn83383,40172510,98883037,58710527,TN
chr19,Bn83384,13533153,47911616,34378463,RLK
chr19,Bn83385,89378775,96724795,7346020,RLP
chr19,Bn83386,12882165,32180407,19298242,RLP
chr19,Bn83387,93406084,94781346,1375262,CNL
chr19,Bn83388,73232709,92093531,18860822,CN
chr19,Bn83389,45774093,93861600,48087507,CN
chr19,Bn83390,78615866,94598496,15982630,NBS
chr19,Bn83391,49035710,49148536,112826,CNL
chr19,Bn83392,37332695,71518877,34186182,RLP
chr19,Bn83393,9474730,24233681,14758951,TN
chr19,Bn83394,77493986,84513358,7019372,RLP
chr19,Bn83395,12527403,28958196,16430793,RLK
chr19,Bn83396,68722026,72475311,3753285,NBS
chr19,Bn83397,50858762,63671699,12812937,CNL
chr19,Bn83398,87563509,90980435,3416926,NBS
chr19,Bn83399,41471639,60466161,18994522,NBS
chr19,Bn83400,82585779,95254200,12668421,CN
chr19,Bn83401,32650903,99599737,66948834,CNL
chr19,Bn83402,82536412,84330708,1794296,CNL
chr19,Bn83403,78246036,86580548,8334512,NBS
chr19,Bn83404,49277227,91908838,42631611,TNL
chr19,Bn83405,97889955,99858471,1968516,CN
chr19,Bn83406,86908672,94363752,7455080,CNL
chr19,Bn83407,39750069,71969504,32219435,RLK
chr19,Bn83408,40226752,43551149,3324397,CN
chr19,Bn83409,85268751,89955702,4686951,RLK
chr19,Bn83410,66364573,75721322,9356749,NBS
chr19,Bn83411,92475345,93357857,882512,TNL
chr19,Bn83412,24982792,42696519,17713727,TNL
chr19,Bn83413,69191299,89689416,20498117,NBS
chr19,Bn83414,38339634,39619941,1280307,TN
chr19,Bn83415,16980937,73372703,56391766,TN
chr19,Bn83416,86768256,88849428,2081172,TNL
chr19,Bn83417,40261541,59852162,19590621,NBS
chr19,Bn83418,63118615,88439250,25320635,RLK
chr19,Bn83419,97163384,99256288,2092904,CNL
chr19,Bn83420,42140086,66081639,23941553,NBS
chr19,Bn83421,67763194,88375426,20612232,RLK
chr19,Bn83422,29746532,82165515,52418983,TNL
chr19,Bn83423,30203699,43825962,13622263,TN
chr19,Bn83424,55884736,72636310,16751574,NBS
chr19,Bn83425,24433252,78026855,53593603,NBS
chr19,Bn83426,37654040,61184459,23530419,CN
chr19,Bn83427,72100596,72887385,786789,TN
chr19,Bn83428,63223446,66839100,3615654,CN
chr19,Bn83429,28133288,61963379,33830091,CN
chr19,Bn83430,46211528,72121699,25910171,CN
chr19,Bn83431,75236806,92911320,17674514,RLK
chr19,Bn83432,87758618,99154478,11395860,CN
chr19,Bn83433,54620501,97824565,43204064,CNL
chr19,Bn83434,65799340,71995770,6196430,TNL
chr19,Bn83435,7349890,67879852,60529962,TNL
chr19,Bn83436,84102200,84955069,852869,CNL
chr19,Bn83437,34669488,49693207,15023719,TNL
chr19,Bn83438,70734409,75074181,4339772,TN
chr19,Bn83439,49719881,82020377,32300496,TNL
chr19,Bn83440,47071700,91198559,44126859,TN
chr19,Bn83441,35142387,46151440,11009053,TN
chr19,Bn83442,20523784,96083103,75559319,NBS
chr19,Bn83443,65733430,85374061,19640631,TN
chr19,Bn83444,30361516,91555391,61193875,NBS
chr19,Bn83445,55823940,56344729,520789,NBS
chr19,Bn83446,28801616,45706345,16904729,RLP
chr19,Bn83447,68549341,70597608,2048267,NBS
chr19,Bn83448,41663750,62393577,20729827,TNL
chr19,Bn83449,70722974,77687549,6964575,NBS
chr19,Bn83450,50312186,88042141,37729955,TNL
chr19,Bn83451,82850353,91473716,8623363,CNL
chr19,Bn83452,40029151,73644359,33615208,TN
chr19,Bn83453,16645589,93536520,76890931,NBS
chr19,Bn83454,35157196,79255491,44098295,NBS
chr19,Bn83455,83072731,83933050,860319,TNL
chr19,Bn83456,83417395,88950244,5532849,TNL
chr19,Bn83457,46467060,88752302,42285242,CNL
chr19,Bn83458,77391132,93983363,16592231,RLP
chr19,Bn83459,79168243,89268835,10100592,CNL
chr19,Bn83460,25413396,71973989,46560593,TNL
chr19,Bn83461,68186622,77693868,9507246,TNL
chr19,Bn83462,31608172,90878040,59269868,CN
chr19,Bn83463,73907823,75953244,2045421,NBS
chr19,Bn83464,98265662,99897218,1631556,TN
chr19,Bn83465,70152048,98656312,28504264,CN
chr19,Bn83466,49579052,54415677,4836625,CNL
chr19,Bn83467,3106327,80817091,77710764,CN
chr19,Bn83468,80564781,91144684,10579903,CN
chr19,Bn83469,25427609,88103139,62675530,RLP
chr19,Bn83470,48806837,50827483,2020646,RLK
chr19,Bn83471,81245246,94286333,13041087,RLK
chr19,Bn83472,74021844,84992434,10970590,RLK
chr19,Bn83473,25363632,83599253,58235621,CNL
chr19,Bn83474,55372963,83103312,27730349,RLP
chr19,Bn83475,64338095,90349853,26011758,RLP
chr19,Bn83476,45495810,85064775,39568965,CN
chr19,Bn83477,47112819,55541370,8428551,CNL
chr19,Bn83478,55091754,89417659,34325905,NBS
chr19,Bn83479,68278129,97671870,29393741,TN
chr19,Bn83480,89454409,95218375,5763966,RLK
chr19,Bn83481,16575181,54822229,38247048,TNL
chr19,Bn83482,60815336,86876153,26060817,NBS
chr19,Bn83483,49709590,59224248,9514658,CN
chr19,Bn83484,61165901,78723223,17557322,TN
chr19,Bn83485,62621397,63206115,584718,CNL
chr19,Bn83486,48986236,80317224,31330988,RLP
chr19,Bn83487,3352280,74408465,71056185,RLP
chr19,Bn83488,96386519,98372591,1986072,CNL
chr19,Bn83489,93390959,99485798,6094839,TNL
chr19,Bn83490,45103967,49946204,4842237,TNL
chr19,Bn83491,31497724,35623093,4125369,TNL
chr19,Bn83492,71582205,99641644,28059439,CN
chr19,Bn83493,94407303,96469481,2062178,CN
chr19,Bn83494,85462495,98867918,13405423,CN
chr19,Bn83495,81176085,93825767,12649682,CN
chr19,Bn83496,79528178,86884879,7356701,RLP
chr19,Bn83497,28748411,83337888,54589477,CN
chr19,Bn83498,33843512,73497834,39654322,RLP
chr19,Bn83499,99073732,99320429,246697,RLP
chr19,Bn83500,8653036,35556605,26903569,RLP
chr19,Bn83501,59263447,82821714,23558267,RLK
chr19,Bn83502,59189259,99996828,40807569,TNL
chr19,Bn83503,88813736,96454792,7641056,TN
chr19,Bn83504,50924632,74282416,23357784,RLP
chr19,Bn83505,34640795,52164173,17523378,TNL
chr19,Bn83506,93060456,95841838,2781382,CNL
chr19,Bn83507,19555038,96700206,77145168,TN
chr19,Bn83508,2240111,74824459,72584348,TN
chr19,Bn83509,36211698,60474954,24263256,TNL
chr19,Bn83510,28043910,56720443,28676533,NBS
chr19,Bn83511,67244346,76166206,8921860,RLK
chr19,Bn83512,15100339,33735005,18634666,TNL
chr19,Bn83513,1381852,5567685,4185833,CNL
chr19,Bn83514,42369911,68051120,25681209,TN
chr19,Bn83515,1243191,96100077,94856886,NBS
chr19,Bn83516,65796938,76601609,10804671,NBS
chr19,Bn83517,10446870,69480742,59033872,RLK
chr19,Bn83518,70742837,90243745,19500908,RLK
chr19,Bn83519,2798382,45017242,42218860,RLP
chr19,Bn83520,55704929,82080453,26375524,RLK
chr19,Bn83521,9342415,85248529,75906114,NBS
chr19,Bn83522,84921997,96669522,11747525,TNL
chr19,Bn83523,52808232,81752915,28944683,TN
chr19,Bn83524,12112637,25952700,13840063,CN
chr19,Bn83525,89485406,99148633,9663227,CNL
chr19,Bn83526,58272267,59491651,1219384,TNL
chr19,Bn83527,13443291,85858690,72415399,TN
chr19,Bn83528,84604843,90320062,5715219,RLP
chr19,Bn83529,54183013,94041539,39858526,NBS
chr19,Bn83530,43754006,60193545,16439539,TN
chr19,Bn83531,98498073,98685459,187386,CNL
chr19,Bn83532,72879264,75207449,2328185,CN
chr19,Bn83533,93513063,95543184,2030121,RLP
chr19,Bn83534,2067071,43354025,41286954,NBS
chr19,Bn83535,84458696,95178113,10719417,RLP
chr19,Bn83536,72029420,88752473,16723053,CN
chr19,Bn83537,30404433,85903044,55498611,TN
chr19,Bn83538,62974651,94565968,31591317,NBS
chr19,Bn83539,35942597,57897466,21954869,TN
chr19,Bn83540,25151648,91510295,66358647,RLK
chr19,Bn83541,22192601,28147902,5955301,TN
chr19,Bn83542,2214153,97808897,95594744,CNL
chr19,Bn83543,27670867,43041899,15371032,RLK
chr19,Bn83544,55345964,96680474,41334510,RLP
chr19,Bn83545,67874913,93603243,25728330,TNL
chr19,Bn83546,50566692,89671339,39104647,TN
chr19,Bn83547,6998946,15764631,8765685,NBS
chr19,Bn83548,56599018,99799144,43200126,TNL
chr19,Bn83549,12315875,25791976,13476101,RLP
chr19,Bn83550,42943697,67018083,24074386,TNL
chr19,Bn83551,4519028,73958755,69439727,NBS
chr19,Bn83552,70651708,76622404,5970696,TNL
chr19,Bn83553,33066635,49647907,16581272,RLP
chr19,Bn83554,28636623,50289526,21652903,RLK
chr19,Bn83555,8439687,31625570,23185883,CN
chr19,Bn83556,79171484,93907888,14736404,TNL
chr19,Bn83557,73557069,97662676,24105607,RLP
chr19,Bn83558,90787194,95034116,4246922,CN
chr19,Bn83559,89216949,96734259,7517310,CNL
chr19,Bn83560,45050433,71969851,26919418,TNL
chr19,Bn83561,30798897,61406887,30607990,TNL
chr19,Bn83562,71639223,86478002,14838779,NBS
chr19,Bn83563,54677823,71197372,16519549,TN
chr19,Bn83564,31022462,65717664,34695202,RLK
chr19,Bn83565,16722326,38024984,21302658,NBS
chr19,Bn83566,71175453,80032800,8857347,CNL
chr19,Bn83567,2014750,46297614,44282864,RLP
chr19,Bn83568,66315745,95710978,29395233,RLK
chr19,Bn83569,82083485,93951349,11867864,RLK
chr19,Bn83570,66262853,89240982,22978129,TNL
chr19,Bn83571,63609032,95640824,32031792,RLP
chr19,Bn83572,19848098,90925136,71077038,TN
chr19,Bn83573,49350115,75602610,26252495,TN
chr19,Bn83574,72857762,79295402,6437640,RLP
chr19,Bn83575,17568501,80615612,63047111,RLP
chr19,Bn83576,70757111,96908047,26150936,TNL
chr19,Bn83577,13002566,54622796,41620230,RLK
chr19,Bn83578,71727473,78039685,6312212,CN
chr19,Bn83579,42488058,69409423,26921365,TNL
chr19,Bn83580,13574757,61444416,47869659,RLK
chr19,Bn83581,65097842,70294670,5196828,NBS
chr19,Bn83582,95194509,96357418,1162909,CN
chr19,Bn83583,83604024,91469898,7865874,CNL
chr19,Bn83584,28888475,60590720,31702245,TNL
chr19,Bn83585,98778093,99881868,1103775,TNL
chr19,Bn83586,50585786,75095203,24509417,RLP
chr19,Bn83587,16971997,19832117,2860120,TNL
chr19,Bn83588,27134338,31984632,4850294,TNL
chr19,Bn83589,11810770,13631816,1821046,NBS
chr19,Bn83590,71491600,76873784,5382184,TNL
chr19,Bn83591,59092181,84933086,25840905,NBS
chr19,Bn83592,88553399,88882702,329303,CNL
chr19,Bn83593,53299213,97371215,44072002,CNL
chr19,Bn83594,3871536,96948320,93076784,CNL
chr19,Bn83595,47392770,56708566,9315796,RLK
chr19,Bn83596,77168891,82997331,5828440,RLK
chr19,Bn83597,80426725,99842468,19415743,TNL
chr19,Bn83598,18734246,69256508,50522262,NBS
chr19,Bn83599,39568090,70607615,31039525,TN
chr19,Bn83600,36564514,42703915,6139401,TNL
chr19,Bn83601,21014008,49786702,28772694,RLK
chr19,Bn83602,46177778,96886023,50708245,CNL
chr19,Bn83603,34708069,74263023,39554954,RLK
chr19,Bn83604,67758924,98219080,30460156,NBS
chr19,Bn83605,93183737,93206113,22376,RLK
chr19,Bn83606,42649016,80228372,37579356,TNL
chr19,Bn83607,38735770,66487637,27751867,TNL
chr19,Bn83608,22790042,60648338,37858296,TN
chr19,Bn83609,69203144,88541142,19337998,NBS
chr19,Bn83610,77481750,90958575,13476825,TNL
chr19,Bn83611,39027308,79469006,40441698,TN
chr19,Bn83612,36306617,59267734,22961117,RLK
chr19,Bn83613,49604858,70581489,20976631,TNL
chr19,Bn83614,47654719,75316448,27661729,NBS
chr19,Bn83615,59541925,97458897,37916972,CNL
chr19,Bn83616,18380638,29770958,11390320,CN
chr19,Bn83617,25163629,62650014,37486385,CN
chr19,Bn83618,81958190,84187947,2229757,RLK
chr19,Bn83619,93323061,95783519,2460458,CNL
chr19,Bn83620,48997162,59267044,10269882,CNL
chr19,Bn83621,57423298,86360199,28936901,TNL
chr19,Bn83622,2348234,2899492,551258,CN
chr19,Bn83623,91538283,94094224,2555941,NBS
chr19,Bn83624,60689031,95980721,35291690,RLP
chr19,Bn83625,29489787,97843452,68353665,RLK
chr19,Bn83626,21742169,69194699,47452530,NBS
chr19,Bn83627,11974765,42837963,30863198,RLK
chr19,Bn83628,50958178,83172386,32214208,TN
chr19,Bn83629,9346684,77607525,68260841,RLK
chr19,Bn83630,45994256,77372893,31378637,NBS
chr19,Bn83631,70285387,78949857,8664470,CN
chr19,Bn83632,78502880,93406823,14903943,CNL
chr19,Bn83633,8021897,16855232,8833335,TN
chr19,Bn83634,81023303,97588834,16565531,TN
chr19,Bn83635,94063027,98220206,4157179,NBS
chr19,Bn83636,84766153,99428946,14662793,RLP
chr19,Bn83637,46525364,90115085,43589721,CN
chr19,Bn83638,33640359,93901017,60260658,TNL
chr19,Bn83639,75495334,86788072,11292738,CNL
chr19,Bn83640,19234287,90018421,70784134,RLP
chr19,Bn83641,34905670,44329851,9424181,RLP
chr19,Bn83642,35153020,47280266,12127246,RLK
chr19,Bn83643,83313806,95787078,12473272,NBS
chr19,Bn83644,9329206,50111967,40782761,CN
chr19,Bn83645,7265356,92736921,85471565,CNL
chr19,Bn83646,16210912,56665331,40454419,TN
chr19,Bn83647,32650978,64169996,31519018,TNL
chr19,Bn83648,56591124,97011963,40420839,RLK
chr19,Bn83649,50149104,63478383,13329279,CN
chr19,Bn83650,80617224,95237221,14619997,CNL
chr19,Bn83651,82842927,93875183,11032256,CN
chr19,Bn83652,96819288,97757221,937933,NBS
chr19,Bn83653,4855848,56050549,51194701,CN
chr19,Bn83654,53558719,70211505,16652786,CN
chr19,Bn83655,14770718,67594882,52824164,TN
chr19,Bn83656,63627154,95218135,31590981,RLK
chr19,Bn83657,68877829,91966741,23088912,RLK
chr19,Bn83658,68747076,75322644,6575568,CN
chr19,Bn83659,31317379,66265427,34948048,TN
chr19,Bn83660,40627067,80396844,39769777,CN
chr19,Bn83661,13179692,70484736,57305044,RLK
chr19,Bn83662,23446804,99163470,75716666,RLP
chr19,Bn83663,22615189,50834744,28219555,RLP
chr19,Bn83664,17516954,39428230,21911276,CN
chr19,Bn83665,47110421,80075562,32965141,RLK
chr19,Bn83666,20543856,70402667,49858811,NBS
chr19,Bn83667,94495490,99214680,4719190,NBS
chr19,Bn83668,57937064,87354739,29417675,TNL
chr19,Bn83669,5407203,49384996,43977793,CN
chr19,Bn83670,26642738,56018042,29375304,CN
chr19,Bn83671,22387264,81375337,58988073,CNL
chr19,Bn83672,20851010,60619731,39768721,NBS
chr19,Bn83673,72520731,77426277,4905546,CN
chr19,Bn83674,99569656,99732991,163335,TN
chr19,Bn83675,38703082,96973008,58269926,TN
chr19,Bn83676,47480667,85178203,37697536,CNL
chr19,Bn83677,45870675,50847579,4976904,RLK
chr19,Bn83678,9524974,71522055,61997081,NBS
chr19,Bn83679,67314483,86192186,18877703,TN
chr19,Bn83680,96493273,97449610,956337,TN
chr19,Bn83681,55336249,83123858,27787609,TNL
chr19,Bn83682,80461143,82405359,1944216,TN
chr19,Bn83683,78195886,80973238,2777352,TN
chr19,Bn83684,30545933,34311953,3766020,NBS
chr19,Bn83685,95799538,95910620,111082,NBS
chr19,Bn83686,3920583,41049916,37129333,NBS
chr19,Bn83687,12750839,59329480,46578641,CNL
chr19,Bn83688,90398327,99471531,9073204,RLK
chr19,Bn83689,94105744,96582589,2476845,RLP
chr19,Bn83690,19886348,36572929,16686581,CN
chr19,Bn83691,68477757,88447177,19969420,CNL
chr19,Bn83692,13805629,59124446,45318817,CN
chr19,Bn83693,76898962,83034523,6135561,CNL
chr19,Bn83694,2747855,44007112,41259257,CNL
chr19,Bn83695,24407736,26703262,2295526,CNL
chr19,Bn83696,23609856,92504869,68895013,NBS
chr19,Bn83697,32545035,52759809,20214774,CN
chr19,Bn83698,6023145,96367842,90344697,TN
chr19,Bn83699,13937980,38056298,24118318,NBS
chr19,Bn83700,47785021,67372533,19587512,NBS
chr19,Bn83701,31542547,66035714,34493167,RLK
chr19,Bn83702,58250864,79203047,20952183,NBS
chr19,Bn83703,44254152,97215313,52961161,NBS
chr19,Bn83704,76192119,78691325,2499206,RLK
chr19,Bn83705,32621257,34213910,1592653,CNL
chr19,Bn83706,49971592,71532408,21560816,CN
chr19,Bn83707,75048729,75626052,577323,NBS
chr19,Bn83708,35536194,81842402,46306208,RLP
chr19,Bn83709,2538920,28352899,25813979,CNL
chr19,Bn83710,71780207,89789405,18009198,TNL
chr19,Bn83711,79107277,86667392,7560115,CN
chr19,Bn83712,2520927,41621306,39100379,CNL
chr19,Bn83713,27398636,81379601,53980965,TNL
chr19,Bn83714,71427925,91611351,20183426,CN
chr19,Bn83715,30433035,86148951,55715916,TNL
chr19,Bn83716,17090051,20094597,3004546,NBS
chr19,Bn83717,36004812,44575836,8571024,RLK
chr19,Bn83718,25155911,27613582,2457671,CNL
chr19,Bn83719,91357165,98190003,6832838,RLP
chr19,Bn83720,37018300,60036325,23018025,CN
chr19,Bn83721,66107662,98534273,32426611,CN
chr19,Bn83722,16338361,28995741,12657380,TNL
chr19,Bn83723,42549433,43873718,1324285,RLP
chr19,Bn83724,91383614,92309939,926325,NBS
chr19,Bn83725,95797504,97213833,1416329,TN
chr19,Bn83726,89765705,91192806,1427101,RLK
chr19,Bn83727,21302967,31415429,10112462,RLK
chr19,Bn83728,66665005,91265612,24600607,TNL
chr19,Bn83729,19810167,88517639,68707472,CNL
chr19,Bn83730,11124207,42131254,31007047,RLP
chr19,Bn83731,55765647,72718596,16952949,RLK
chr19,Bn83732,55540105,66973548,11433443,NBS
chr19,Bn83733,9640314,79799907,70159593,NBS
chr19,Bn83734,80086500,80215442,128942,RLP
chr19,Bn83735,42835244,95853705,53018461,RLP
chr19,Bn83736,57038751,69641867,12603116,CNL
chr19,Bn83737,3030769,99117286,96086517,CNL
chr19,Bn83738,73587260,99006709,25419449,CN
chr19,Bn83739,1036933,9552159,8515226,RLP
chr19,Bn83740,38934584,88957843,50023259,TNL
chr19,Bn83741,93282680,93958348,675668,CN
chr19,Bn83742,65625949,82860485,17234536,TNL
chr19,Bn83743,67720131,68389984,669853,NBS
chr19,Bn83744,18188234,87222007,69033773,NBS
chr19,Bn83745,40636658,90517613,49880955,RLP
chr19,Bn83746,13594324,60805843,47211519,TN
chr19,Bn83747,21468534,39647290,18178756,TNL
chr19,Bn83748,24240992,35707908,11466916,RLP
chr19,Bn83749,53450200,63144301,9694101,RLK
chr19,Bn83750,73542215,86379404,12837189,TN
chr19,Bn83751,78331226,85791937,7460711,NBS
chr19,Bn83752,27018288,90502266,63483978,TN
chr19,Bn83753,21445904,98514907,77069003,RLP
chr19,Bn83754,72497647,87624815,15127168,TNL
chr19,Bn83755,66567030,93759854,27192824,CNL
chr19,Bn83756,39474585,42546826,3072241,CN
chr19,Bn83757,19285165,86573932,67288767,CN
chr19,Bn83758,55406504,64729032,9322528,RLP
chr19,Bn83759,86597242,90453609,3856367,NBS
chr19,Bn83760,87304119,87502815,198696,TN
chr19,Bn83761,45749432,72591496,26842064,TN
chr19,Bn83762,85785087,98411225,12626138,CN
chr19,Bn83763,44443184,72005118,27561934,CNL
chr19,Bn83764,89374834,94432848,5058014,NBS
chr19,Bn83765,98076249,99313529,1237280,CN
chr19,Bn83766,88011870,88262757,250887,CNL
chr19,Bn83767,29010020,38630370,9620350,RLP
chr19,Bn83768,65765974,87936586,22170612,NBS
chr19,Bn83769,86392944,99166608,12773664,RLK
chr19,Bn83770,88495283,98362495,9867212,NBS
chr19,Bn83771,94031958,95529642,1497684,RLP
chr19,Bn83772,51893571,81365449,29471878,NBS
chr19,Bn83773,90625581,96623501,5997920,CN
chr19,Bn83774,42238846,93940086,51701240,TNL
chr19,Bn83775,25492301,88748854,63256553,CNL
chr19,Bn83776,16804660,95639722,78835062,RLP
chr19,Bn83777,60167136,83821866,23654730,RLK
chr19,Bn83778,66587986,75668634,9080648,TNL
chr19,Bn83779,40825973,86859104,46033131,RLK
chr19,Bn83780,94912824,98840971,3928147,CN
chr19,Bn83781,15303673,18729706,3426033,NBS
chr19,Bn83782,97931346,99058026,1126680,RLK
chr19,Bn83783,34256177,41365019,7108842,TNL
chr19,Bn83784,22160781,55153146,32992365,CN
chr19,Bn83785,41470667,65629731,24159064,TN
chr19,Bn83786,44747321,48816394,4069073,CNL
chr19,Bn83787,95928767,96726142,797375,NBS
chr19,Bn83788,50600478,60463173,9862695,RLK
chr19,Bn83789,30121339,81694642,51573303,RLK
chr19,Bn83790,68030214,82864983,14834769,TN
chr19,Bn83791,57762830,71367839,13605009,NBS
chr19,Bn83792,84845698,91374549,6528851,CN
chr19,Bn83793,82100234,88810283,6710049,TN
chr19,Bn83794,1048943,41617185,40568242,CNL
chr19,Bn83795,87883828,91227467,3343639,TNL
chr19,Bn83796,80988125,93629005,12640880,CN
chr19,Bn83797,52742875,81401709,28658834,CNL
chr19,Bn83798,66444650,88742651,22298001,TNL
chr19,Bn83799,48283554,72538165,24254611,NBS
chr19,Bn83800,73309555,94166768,20857213,TNL
chr19,Bn83801,3319247,4488553,1169306,TNL
chr19,Bn83802,64668905,66858451,2189546,CNL
chr19,Bn83803,94915350,98604013,3688663,RLP
chr19,Bn83804,93175713,99522791,6347078,TNL
chr19,Bn83805,15643082,21020066,5376984,CNL
chr19,Bn83806,64416578,65223925,807347,TN
chr19,Bn83807,51288357,59265924,7977567,CNL
chr19,Bn83808,42632387,97965812,55333425,RLP
chr19,Bn83809,95153038,97668288,2515250,CNL
chr19,Bn83810,8540717,90712135,82171418,RLK
chr19,Bn83811,22577574,83152402,60574828,CN
chr19,Bn83812,69597364,97678093,28080729,CNL
chr19,Bn83813,97525638,99121328,1595690,NBS
chr19,Bn83814,57887126,69990167,12103041,RLK
chr19,Bn83815,53608661,83290758,29682097,TN
chr19,Bn83816,34291020,76480936,42189916,RLK
chr19,Bn83817,14393863,64290040,49896177,TNL
chr19,Bn83818,22385527,37618580,15233053,TN
chr19,Bn83819,65109357,82524098,17414741,TN
chr19,Bn83820,62522952,96058871,33535919,TN
chr19,Bn83821,61052981,63165744,2112763,RLP
chr19,Bn83822,20049611,81241475,61191864,CN
chr19,Bn83823,55449191,63055203,7606012,RLP
chr19,Bn83824,15465194,41898829,26433635,CNL
chr19,Bn83825,63509252,63992272,483020,NBS
chr19,Bn83826,53085075,73820238,20735163,TNL
chr19,Bn83827,78001519,83886189,5884670,RLK
chr19,Bn83828,23076640,58719628,35642988,CN
chr19,Bn83829,35853752,70061145,34207393,NBS
chr19,Bn83830,7563902,49537024,41973122,TN
chr19,Bn83831,27921188,35598290,7677102,RLK
chr19,Bn83832,46133896,84980025,38846129,NBS
chr19,Bn83833,15014605,37814987,22800382,NBS
chr19,Bn83834,6285015,13207502,6922487,NBS
chr19,Bn83835,34770412,87848067,53077655,RLK
chr19,Bn83836,75571483,78994605,3423122,RLP
chr19,Bn83837,81260828,93791252,12530424,TNL
chr19,Bn83838,86974936,90504584,3529648,TN
chr19,Bn83839,77132995,84930379,7797384,NBS
chr19,Bn83840,9313600,86748880,77435280,NBS
chr19,Bn83841,93119538,99350408,6230870,CN
chr19,Bn83842,47775683,88085454,40309771,RLK
chr19,Bn83843,78870985,90487816,11616831,CN
chr19,Bn83844,82710140,91470869,8760729,NBS
chr19,Bn83845,51161085,79033823,27872738,NBS
chr19,Bn83846,47178739,66995370,19816631,TNL
chr19,Bn83847,64876019,97333769,32457750,CNL
chr19,Bn83848,76559900,79596186,3036286,RLK
chr19,Bn83849,71444518,78145030,6700512,CNL
chr19,Bn83850,87600190,93691349,6091159,CN
chr19,Bn83851,72026401,85495260,13468859,TN
chr19,Bn83852,72024034,92686923,20662889,TNL
chr19,Bn83853,82863024,93275142,10412118,NBS
chr19,Bn83854,65440608,83977652,18537044,RLP
chr19,Bn83855,23097767,68268933,45171166,TN
chr19,Bn83856,89251449,91432164,2180715,NBS
chr19,Bn83857,74538607,98044890,23506283,CN
chr19,Bn83858,59416102,97974820,38558718,TN
chr19,Bn83859,83147024,86389752,3242728,TN
chr19,Bn83860,62570777,91423967,28853190,TNL
chr19,Bn83861,86724431,88020166,1295735,CNL
chr19,Bn83862,4534172,76432822,71898650,NBS
chr19,Bn83863,76115998,91344548,15228550,CN
chr19,Bn83864,99354995,99618889,263894,NBS
chr19,Bn83865,15589098,34757991,19168893,CN
chr19,Bn83866,85904707,93650949,7746242,CNL
chr19,Bn83867,26313604,68013158,41699554,NBS
chr19,Bn83868,81915191,88391929,6476738,RLP
chr19,Bn83869,19640695,74320903,54680208,RLK
chr19,Bn83870,35381661,51385629,16003968,RLP
chr19,Bn83871,37506663,40382164,2875501,TN
chr19,Bn83872,31259527,69170017,37910490,RLK
chr19,Bn83873,50800157,66832075,16031918,NBS
chr19,Bn83874,75086126,89643352,14557226,TN
chr19,Bn83875,21849055,30595421,8746366,CN
chr19,Bn83876,29929521,70871175,40941654,NBS
chr19,Bn83877,11647282,26308713,14661431,CNL
chr19,Bn83878,81949412,91564742,9615330,NBS
chr19,Bn83879,45049464,84486197,39436733,NBS
chr19,Bn83880,79309501,80335241,1025740,TN
chr19,Bn83881,16126618,26268000,10141382,TNL
chr19,Bn83882,60906968,63769413,2862445,CNL
chr19,Bn83883,82171431,91916167,9744736,RLP
chr19,Bn83884,93744664,93797024,52360,TNL
chr19,Bn83885,41911551,97350823,55439272,RLK
chr19,Bn83886,68683506,93816157,25132651,RLP
chr19,Bn83887,99890612,99908689,18077,CNL
chr19,Bn83888,90434315,97064259,6629944,TN
chr19,Bn83889,85651656,86021393,369737,NBS
chr19,Bn83890,4176122,62991289,58815167,CN
chr19,Bn83891,79628365,82944990,3316625,NBS
chr19,Bn83892,45792107,54514314,8722207,CNL
chr19,Bn83893,43712056,88808342,45096286,RLK
chr19,Bn83894,7258862,48093697,40834835,NBS
chr19,Bn83895,5041639,91431374,86389735,RLK
chr19,Bn83896,4010414,63893604,59883190,RLP
chr19,Bn83897,14040132,53630521,39590389,TNL
chr19,Bn83898,96042593,97540550,1497957,CNL
chr19,Bn83899,92327212,93535616,1208404,RLP
chr19,Bn83900,21667721,49510688,27842967,RLK
chr19,Bn83901,75149986,92438145,17288159,CN
chr19,Bn83902,22719690,77002241,54282551,CN
chr19,Bn83903,31719569,59413279,27693710,NBS
chr19,Bn83904,48971420,82740982,33769562,RLP
chr19,Bn83905,9926604,98045698,88119094,CNL
chr19,Bn83906,85862367,89718048,3855681,CNL
chr19,Bn83907,25265433,33249666,7984233,CNL
chr19,Bn83908,83715261,87585848,3870587,CN
chr19,Bn83909,70975607,89024602,18048995,RLP
chr19,Bn83910,84516426,92887283,8370857,TN
chr19,Bn83911,79839306,82037789,2198483,CNL
chr19,Bn83912,47981829,88942291,40960462,RLK
chr19,Bn83913,30823982,49636981,18812999,TN
chr19,Bn83914,41836046,83453868,41617822,CNL
chr19,Bn83915,99679095,99858024,178929,TN
chr19,Bn83916,79683299,95929742,16246443,RLK
chr19,Bn83917,82346799,87739274,5392475,RLP
chr19,Bn83918,88606442,97199629,8593187,NBS
chr19,Bn83919,18538498,82649877,64111379,RLK
chr19,Bn83920,41059822,49160974,8101152,NBS
chr19,Bn83921,41377751,42268875,891124,NBS
chr19,Bn83922,78635333,93592915,14957582,RLP
chr19,Bn83923,96148867,98280960,2132093,TN
chr19,Bn83924,34082281,54433102,20350821,CN
chr19,Bn83925,76396505,91164669,14768164,CNL
chr19,Bn83926,12057430,23382795,11325365,CNL
chr19,Bn83927,78046616,98750944,20704328,CN
chr19,Bn83928,15402092,89506897,74104805,RLP
chr19,Bn83929,25441032,49763695,24322663,TN
chr19,Bn83930,51549010,92646278,41097268,CN
chr19,Bn83931,63972542,93914656,29942114,RLP
chr19,Bn83932,48756826,92021647,43264821,RLP
chr19,Bn83933,87287233,92174953,4887720,CN
chr19,Bn83934,10362484,40995854,30633370,RLP
chr19,Bn83935,84847967,93627482,8779515,TN
chr19,Bn83936,80288411,90908634,10620223,TNL
chr19,Bn83937,30637650,58161828,27524178,TN
chr19,Bn83938,27776484,32698941,4922457,NBS
chr19,Bn83939,35661546,62783715,27122169,TN
chr19,Bn83940,7196515,52343986,45147471,TNL
chr19,Bn83941,22032281,68172734,46140453,TN
chr19,Bn83942,40405571,67561553,27155982,TNL
chr19,Bn83943,9849952,12456651,2606699,TN
chr19,Bn83944,50632035,90721462,40089427,TNL
chr19,Bn83945,61316757,71781118,10464361,TN
chr19,Bn83946,80865369,83590384,2725015,NBS
chr19,Bn83947,10594663,29488898,18894235,CNL
chr19,Bn83948,94101025,97042189,2941164,RLK
chr19,Bn83949,10653537,51664161,41010624,CN
chr19,Bn83950,60273291,93347131,33073840,TN
chr19,Bn83951,80200527,97505217,17304690,RLK
chr19,Bn83952,57418532,66641368,9222836,CNL
chr19,Bn83953,28313750,76691946,48378196,NBS
chr19,Bn83954,31922501,49221465,17298964,TN
chr19,Bn83955,54812462,68967605,14155143,TN
chr19,Bn83956,25073648,57125842,32052194,RLK
chr19,Bn83957,31985662,92700204,60714542,CN
chr19,Bn83958,55127330,90586222,35458892,CN
chr19,Bn83959,30797327,50813164,20015837,TN
chr19,Bn83960,61302763,95920073,34617310,RLP
chr19,Bn83961,91658539,94683084,3024545,CN
chr19,Bn83962,49456780,60969704,11512924,CNL
chr19,Bn83963,9817103,76175147,66358044,CN
chr19,Bn83964,42823056,45329238,2506182,TNL
chr19,Bn83965,37196764,42891373,5694609,TNL
chr19,Bn83966,12974341,88514047,75539706,CN
chr19,Bn83967,76013192,99693110,23679918,RLK
chr19,Bn83968,17756346,41991613,24235267,NBS
chr19,Bn83969,96318052,99584767,3266715,RLK
chr19,Bn83970,28665028,56847776,28182748,CNL
chr19,Bn83971,21633076,93498530,71865454,TN
chr19,Bn83972,6661558,68112576,61451018,CNL
chr19,Bn83973,32808405,57645478,24837073,CNL
chr19,Bn83974,60042891,82083294,22040403,RLK
chr19,Bn83975,31630916,78050916,46420000,CNL
chr19,Bn83976,8203756,97189032,88985276,NBS
chr19,Bn83977,37991630,93263727,55272097,CNL
chr19,Bn83978,50492310,91020868,40528558,RLP
chr19,Bn83979,97892381,99582257,1689876,CN
chr19,Bn83980,83430354,88580322,5149968,RLP
chr19,Bn83981,69209384,88595620,19386236,TNL
chr19,Bn83982,74696217,84599275,9903058,NBS
chr19,Bn83983,62606758,80064463,17457705,CN
chr19,Bn83984,31408957,95809580,64400623,RLP
chr19,Bn83985,29385441,30193859,808418,CNL
chr19,Bn83986,53932326,92087550,38155224,RLP
chr19,Bn83987,56930655,88743460,31812805,CN
chr19,Bn83988,94427516,97479220,3051704,CNL
chr19,Bn83989,8444323,36654075,28209752,CN
chr19,Bn83990,4375103,16110173,11735070,CN
chr19,Bn83991,57132129,92953799,35821670,NBS
chr19,Bn83992,50712279,59365276,8652997,RLP
chr19,Bn83993,84593187,94439175,9845988,RLP
chr19,Bn83994,12415071,55979384,43564313,RLP
chr19,Bn83995,44795491,94030708,49235217,RLP
chr19,Bn83996,87717276,97841639,10124363,NBS
chr19,Bn83997,91792305,98592165,6799860,NBS
chr19,Bn83998,15590410,38592934,23002524,RLP
chr19,Bn83999,54097300,79186069,25088769,TN
chr19,Bn84000,57401818,73808543,16406725,RLK
chr19,Bn84001,81904241,82018084,113843,TNL
chr19,Bn84002,60999602,73978816,12979214,RLP
chr19,Bn84003,49267042,77078191,27811149,TN
chr19,Bn84004,19103395,70575601,51472206,RLK
chr19,Bn84005,21196176,91623350,70427174,NBS
chr19,Bn84006,64026116,82955282,18929166,RLP
chr19,Bn84007,21809417,39455673,17646256,RLP
chr19,Bn84008,63120104,95266779,32146675,RLP
chr19,Bn84009,48306926,71308637,23001711,CN
chr19,Bn84010,78494372,92180617,13686245,CN
chr19,Bn84011,80583270,87519888,6936618,CNL
chr19,Bn84012,84748988,85028701,279713,NBS
chr19,Bn84013,59201283,83591226,24389943,TN
chr19,Bn84014,31561423,64184967,32623544,NBS
chr19,Bn84015,1336124,70908784,69572660,CNL
chr19,Bn84016,52707845,74939456,22231611,TN
chr19,Bn84017,3638573,5770302,2131729,RLP
chr19,Bn84018,91909775,95084936,3175161,CNL
chr19,Bn84019,84503394,91183420,6680026,TNL
chr19,Bn84020,1474686,61183933,59709247,RLK
chr19,Bn84021,54932347,63837556,8905209,NBS
chr19,Bn84022,22366559,47174310,24807751,TN
chr19,Bn84023,98108996,99446900,1337904,RLK
chr19,Bn84024,46351851,97472704,51120853,RLP
chr19,Bn84025,48092067,83442766,35350699,TNL
chr19,Bn84026,67976642,98407279,30430637,RLP
chr19,Bn84027,58121874,93926617,35804743,NBS
chr19,Bn84028,19766819,67660145,47893326,RLK
chr19,Bn84029,12183198,56634565,44451367,TN
chr19,Bn84030,86428883,97134516,10705633,RLP
chr19,Bn84031,38984301,45933162,6948861,CNL
chr19,Bn84032,86200531,87282588,1082057,TNL
chr19,Bn84033,73858921,93760812,19901891,CNL
chr19,Bn84034,14926008,42687165,27761157,RLP
chr19,Bn84035,69458851,92938547,23479696,TNL
chr19,Bn84036,65097831,73788774,8690943,NBS
chr19,Bn84037,94066030,97897300,3831270,RLP
chr19,Bn84038,1650655,68705423,67054768,TNL
chr19,Bn84039,83266122,92467597,9201475,CN
chr19,Bn84040,34358298,97415739,63057441,TNL
chr19,Bn84041,41072596,59354029,18281433,RLP
chr19,Bn84042,95036353,96136190,1099837,CNL
chr19,Bn84043,89968364,96568567,6600203,CN
chr19,Bn84044,20793857,80259022,59465165,CN
chr19,Bn84045,3741863,38734219,34992356,CN
chr19,Bn84046,27529607,95639445,68109838,RLK
chr19,Bn84047,35606141,72619721,37013580,RLK
chr19,Bn84048,72089679,99846374,27756695,RLP
chr19,Bn84049,96335961,98902449,2566488,TN
chr19,Bn84050,68389962,87265823,18875861,TNL
chr19,Bn84051,15461106,41450345,25989239,RLK
chr19,Bn84052,65084338,65099554,15216,NBS
chr19,Bn84053,88521503,89348965,827462,NBS
chr19,Bn84054,47913936,73318872,25404936,TNL
chr19,Bn84055,68274981,74758400,6483419,CNL
chr19,Bn84056,8749400,72204830,63455430,CNL
chr19,Bn84057,25972334,99107692,73135358,NBS
chr19,Bn84058,17391691,59786639,42394948,NBS
chr19,Bn84059,72337041,98401176,26064135,CN
chr19,Bn84060,98634553,99132698,498145,CNL
chr19,Bn84061,64482775,89589255,25106480,RLK
chr19,Bn84062,39824809,95302848,55478039,TN
chr19,Bn84063,26858299,35115151,8256852,TN
chr19,Bn84064,83120710,96150144,13029434,TN
chr19,Bn84065,96232182,96470262,238080,NBS
chr19,Bn84066,40030452,83453238,43422786,CNL
chr19,Bn84067,18390921,36955228,18564307,RLK
chr19,Bn84068,41754505,60315384,18560879,TNL
chr19,Bn84069,80559360,81595592,1036232,RLK
chr19,Bn84070,6355666,26633981,20278315,CN
chr19,Bn84071,20312839,96160547,75847708,CN
chr19,Bn84072,40037987,54282049,14244062,TN
chr19,Bn84073,7166562,86270454,79103892,CN
chr19,Bn84074,32971189,57438116,24466927,CNL
chr19,Bn84075,73722797,86539798,12817001,NBS
chr19,Bn84076,33809506,64945208,31135702,TNL
chr19,Bn84077,65284400,84118928,18834528,CNL
chr19,Bn84078,97083432,99547729,2464297,TNL
chr19,Bn84079,4838519,26666135,21827616,TNL
chr19,Bn84080,98562483,99195913,633430,RLK
chr19,Bn84081,56623670,80929133,24305463,TN
chr19,Bn84082,89928199,90225885,297686,CN
chr19,Bn84083,60907529,94698744,33791215,RLP
chr19,Bn84084,35105703,57678508,22572805,CN
chr19,Bn84085,85453204,88835784,3382580,NBS
chr19,Bn84086,35941249,38926216,2984967,TN
chr19,Bn84087,50422240,83657433,33235193,RLK
chr19,Bn84088,93730125,94838733,1108608,RLK
chr19,Bn84089,14799064,61012870,46213806,NBS
chr19,Bn84090,28913903,61883236,32969333,CNL
chr19,Bn84091,54770846,72711885,17941039,CN
chr19,Bn84092,7519464,86192477,78673013,NBS
chr19,Bn84093,88112780,89947139,1834359,NBS
chr19,Bn84094,71136247,83416297,12280050,RLK
chr19,Bn84095,10015686,56242501,46226815,CNL
chr19,Bn84096,18036246,21751639,3715393,TNL
chr19,Bn84097,9508636,67525517,58016881,NBS
chr19,Bn84098,98505413,99204205,698792,TN
chr19,Bn84099,87990990,98542207,10551217,RLP
chr19,Bn84100,26065731,74563994,48498263,RLP
chr19,Bn84101,64199927,78089536,13889609,RLP
chr19,Bn84102,6572955,89394913,82821958,RLK
chr19,Bn84103,95961638,99122565,3160927,RLP
chr19,Bn84104,36590650,72633583,36042933,CN
chr19,Bn84105,66201929,84960364,18758435,TN
chr19,Bn84106,16127075,38435782,22308707,TN
chr19,Bn84107,7630178,76129536,68499358,TN
chr19,Bn84108,66330265,77368200,11037935,TN
chr19,Bn84109,7136612,40282182,33145570,RLP
chr19,Bn84110,89074387,93883549,4809162,CNL
chr19,Bn84111,43134772,66760984,23626212,TN
chr19,Bn84112,95052014,98708685,3656671,TNL
chr19,Bn84113,9650512,86453290,76802778,TNL
chr19,Bn84114,87308420,90134634,2826214,CN
chr19,Bn84115,59049848,85200492,26150644,RLP
chr19,Bn84116,97389875,99753003,2363128,TN
chr19,Bn84117,62897720,74799468,11901748,TNL
chr19,Bn84118,3014910,10697045,7682135,CNL
chr19,Bn84119,78654132,86548307,7894175,TN
chr19,Bn84120,59725459,92980196,33254737,TN
chr19,Bn84121,40936493,81824334,40887841,RLP
chr19,Bn84122,57367051,65663427,8296376,NBS
chr19,Bn84123,84347323,95017389,10670066,RLK
chr19,Bn84124,18929868,64107264,45177396,NBS
chr19,Bn84125,4177019,72673632,68496613,TNL
chr19,Bn84126,87034916,93045276,6010360,RLP
chr19,Bn84127,1568637,95082540,93513903,TNL
chr19,Bn84128,33664245,34703595,1039350,CN
chr19,Bn84129,27707936,90786953,63079017,RLK
chr19,Bn84130,33889440,77621848,43732408,RLK
chr19,Bn84131,71657572,93601623,21944051,NBS
chr19,Bn84132,51494574,90225505,38730931,CN
chr19,Bn84133,61566399,81045831,19479432,RLK
chr19,Bn84134,37863730,78995835,41132105,TNL
chr19,Bn84135,3733545,21160825,17427280,CN
chr19,Bn84136,8149368,46531968,38382600,RLK
chr19,Bn84137,23972146,55063946,31091800,RLK
chr19,Bn84138,42649871,57187370,14537499,NBS
chr19,Bn84139,89396284,98591537,9195253,TN
chr19,Bn84140,20612219,51919888,31307669,CN
chr19,Bn84141,84258075,93859737,9601662,CN
chr19,Bn84142,43343318,78288344,34945026,TN
chr19,Bn84143,70048389,91255073,21206684,CNL
chr19,Bn84144,17501161,54469818,36968657,CNL
chr19,Bn84145,18964467,72422141,53457674,TNL
chr19,Bn84146,41246375,85248670,44002295,TN
chr19,Bn84147,61049256,75602190,14552934,RLK
chr19,Bn84148,20034193,30860937,10826744,NBS
chr19,Bn84149,83477857,98552935,15075078,RLP
chr19,Bn84150,14355708,99083235,84727527,CNL
chr19,Bn84151,13485959,72770528,59284569,RLP
chr19,Bn84152,35053926,66985177,31931251,TNL
chr19,Bn84153,6703003,36396310,29693307,RLP
chr19,Bn84154,6482721,83887670,77404949,TNL
chr19,Bn84155,25094682,79123092,54028410,TN
chr19,Bn84156,44593262,67202720,22609458,RLP
chr19,Bn84157,71706529,71717417,10888,CN
chr19,Bn84158,70977449,79674717,8697268,TN
chr19,Bn84159,96407681,96946149,538468,RLP
chr19,Bn84160,71893497,80331764,8438267,NBS
chr19,Bn84161,84052908,96295424,12242516,RLK
chr19,Bn84162,29382060,75775390,46393330,RLP
chr19,Bn84163,18935482,92251325,73315843,NBS
chr19,Bn84164,65783437,74074229,8290792,TNL
chr19,Bn84165,43699087,44441210,742123,NBS
chr19,Bn84166,76987335,88072263,11084928,TNL
chr19,Bn84167,81149161,81340448,191287,TNL
chr19,Bn84168,53813338,54055480,242142,CNL
chr19,Bn84169,4606915,19301154,14694239,CNL
chr19,Bn84170,23089009,39772284,16683275,NBS
chr19,Bn84171,6402237,29208757,22806520,NBS
chr19,Bn84172,78656966,81200294,2543328,CN
chr19,Bn84173,41708699,75647480,33938781,CN
chr19,Bn84174,65135659,66593302,1457643,CN
chr19,Bn84175,37363499,37667948,304449,CNL
chr19,Bn84176,91113032,91661274,548242,NBS
chr19,Bn84177,51053242,93133723,42080481,RLK
chr19,Bn84178,28941906,65669794,36727888,NBS
chr19,Bn84179,60821761,97330623,36508862,NBS
chr19,Bn84180,70633749,81689462,11055713,RLK
chr19,Bn84181,17427834,54934907,37507073,RLK
chr19,Bn84182,70840560,97598317,26757757,RLK
chr19,Bn84183,45274988,89931246,44656258,NBS
chr19,Bn84184,16479568,81674556,65194988,RLP
chr19,Bn84185,54715368,66280659,11565291,RLK
chr19,Bn84186,96893922,99373481,2479559,RLK
chr19,Bn84187,55964406,71678814,15714408,TN
chr19,Bn84188,27306829,52050876,24744047,CNL
chr19,Bn84189,25569930,53755078,28185148,TN
chr19,Bn84190,22692642,59187767,36495125,TN
chr19,Bn84191,75819818,93656297,17836479,CN
chr19,Bn84192,87599190,88587535,988345,CN
chr19,Bn84193,83097976,96348610,13250634,NBS
chr19,Bn84194,5475952,8190054,2714102,CNL
chr19,Bn84195,26488264,27232557,744293,NBS
chr19,Bn84196,46935068,58494947,11559879,RLK
chr19,Bn84197,8251485,20315239,12063754,CN
chr19,Bn84198,37163790,50337184,13173394,TNL
chr19,Bn84199,45324000,71887892,26563892,CNL
chr19,Bn84200,71427903,75408078,3980175,TN
chr19,Bn84201,98424370,99450310,1025940,TN
chr19,Bn84202,14001882,41013498,27011616,NBS
chr19,Bn84203,64420996,66044097,1623101,TNL
chr19,Bn84204,3586728,64213200,60626472,TN
chr19,Bn84205,85481084,99591087,14110003,NBS
chr19,Bn84206,72625464,81515864,8890400,RLK
chr19,Bn84207,38420757,45225238,6804481,RLK
chr19,Bn84208,25628995,75904776,50275781,CN
chr19,Bn84209,77196369,82357546,5161177,RLP
chr19,Bn84210,32991974,49985130,16993156,TN
chr19,Bn84211,99478544,99859488,380944,CN
chr19,Bn84212,35972936,67133138,31160202,TN
chr19,Bn84213,81179906,86256029,5076123,TNL
chr19,Bn84214,41448342,97135897,55687555,CN
chr19,Bn84215,98577546,99065155,487609,RLK
chr19,Bn84216,12207968,20031260,7823292,CNL
chr19,Bn84217,31123424,79125941,48002517,NBS
chr19,Bn84218,36711860,78385247,41673387,CN
chr19,Bn84219,76930302,78378352,1448050,CNL
chr19,Bn84220,52532273,74098154,21565881,CN
chr19,Bn84221,40909018,96378581,55469563,CNL
chr19,Bn84222,32753398,51902484,19149086,CNL
chr19,Bn84223,84119005,90615416,6496411,RLP
chr19,Bn84224,1720975,65203301,63482326,TN
chr19,Bn84225,51442635,66800223,15357588,CN
chr19,Bn84226,35292752,60308339,25015587,RLK
chr19,Bn84227,52478013,83016064,30538051,CN
chr19,Bn84228,40047162,44700049,4652887,TN
chr19,Bn84229,51057229,60800796,9743567,CNL
chr19,Bn84230,37906533,77505489,39598956,TN
chr19,Bn84231,3683721,59957314,56273593,TNL
chr19,Bn84232,32522880,77325854,44802974,CNL
chr19,Bn84233,86449960,98393592,11943632,TNL
chr19,Bn84234,94411151,99663673,5252522,TNL
chr19,Bn84235,16037227,32019738,15982511,CNL
chr19,Bn84236,23223400,40332130,17108730,RLP
chr19,Bn84237,60203282,78417909,18214627,RLP
chr19,Bn84238,52747755,57525852,4778097,CN
chr19,Bn84239,23259888,79824905,56565017,TN
chr19,Bn84240,64815614,67724243,2908629,RLK
chr19,Bn84241,36243647,92433100,56189453,RLP
chr19,Bn84242,33802455,57970416,24167961,TNL
chr19,Bn84243,15805270,81757574,65952304,CNL
chr19,Bn84244,4069156,13787383,9718227,CN
chr19,Bn84245,35609918,91064109,55454191,CN
chr19,Bn84246,76516772,78965332,2448560,CNL
chr19,Bn84247,30906622,66025111,35118489,CN
chr19,Bn84248,77615531,95442651,17827120,CNL
chr19,Bn84249,7691570,11040832,3349262,RLK
chr19,Bn84250,82383211,82448406,65195,TNL
chr19,Bn84251,47171948,81958631,34786683,NBS
chr19,Bn84252,82124613,97138831,15014218,RLP
chr19,Bn84253,73229174,86024640,12795466,NBS
chr19,Bn84254,51759028,74146975,22387947,NBS
chr19,Bn84255,50054461,84383267,34328806,CNL
chr19,Bn84256,81232044,82690489,1458445,CNL
chr19,Bn84257,22565098,31949189,9384091,CN
chr19,Bn84258,29469290,51585271,22115981,CNL
chr19,Bn84259,90237656,95763973,5526317,RLP
chr19,Bn84260,94547181,95850991,1303810,TN
chr19,Bn84261,73518869,84401231,10882362,CNL
chr19,Bn84262,83036506,84309980,1273474,RLK
chr19,Bn84263,28768215,62894505,34126290,TNL
chr19,Bn84264,17898807,47600546,29701739,TNL
chr19,Bn84265,99039697,99342963,303266,RLP
chr19,Bn84266,41783431,88180494,46397063,RLP
chr19,Bn84267,47255520,59213948,11958428,CNL
chr19,Bn84268,32659065,52171617,19512552,TN
chr19,Bn84269,28592736,81480505,52887769,TN
chr19,Bn84270,31826057,76129477,44303420,NBS
chr19,Bn84271,49851717,80179081,30327364,CN
chr19,Bn84272,23945896,70194205,46248309,TN
chr19,Bn84273,73307405,84867181,11559776,RLK
chr19,Bn84274,18553740,24185073,5631333,TNL
chr19,Bn84275,3298477,30046435,26747958,RLK
chr19,Bn84276,52953188,62671261,9718073,TN
chr19,Bn84277,17471138,53315187,35844049,NBS
chr19,Bn84278,39922792,94580930,54658138,NBS
chr19,Bn84279,96744968,97576661,831693,TNL
chr19,Bn84280,80071356,81729167,1657811,RLP
chr19,Bn84281,99191725,99865337,673612,CNL
chr19,Bn84282,61013711,81117199,20103488,TN
chr19,Bn84283,25559407,31922271,6362864,RLP
chr19,Bn84284,79660122,89520166,9860044,RLP
chr19,Bn84285,57888771,72559851,14671080,NBS
chr19,Bn84286,30558054,82664779,52106725,RLP
chr19,Bn84287,78157419,93362544,15205125,RLP
chr19,Bn84288,99965011,99966357,1346,RLP
chr19,Bn84289,10981195,34068452,23087257,TN
chr19,Bn84290,62650154,72947558,10297404,CNL
chr19,Bn84291,38811315,77992857,39181542,RLK
chr19,Bn84292,9810945,79604199,69793254,TNL
chr19,Bn84293,29175342,39669994,10494652,NBS
chr19,Bn84294,51673645,54695457,3021812,CNL
chr19,Bn84295,72459822,74694633,2234811,CN
chr19,Bn84296,87167471,95037547,7870076,CN
chr19,Bn84297,63173481,70912551,7739070,RLP
chr19,Bn84298,33231152,90746795,57515643,TNL
chr19,Bn84299,94120259,97452223,3331964,RLP
chr19,Bn84300,6651342,82077651,75426309,TN
chr19,Bn84301,35034936,60604611,25569675,TNL
chr19,Bn84302,60050708,90551147,30500439,RLK
chr19,Bn84303,53724548,70316081,16591533,TNL
chr19,Bn84304,56814521,81340856,24526335,CN
chr19,Bn84305,93283999,98727970,5443971,RLK
chr19,Bn84306,90477346,99150504,8673158,CNL
chr19,Bn84307,79673783,92706176,13032393,CNL
chr19,Bn84308,8566818,30091748,21524930,NBS
chr19,Bn84309,37041184,53606225,16565041,TN
chr19,Bn84310,80325089,97613582,17288493,CNL
chr19,Bn84311,33204383,83774283,50569900,TNL
chr19,Bn84312,27084676,56980760,29896084,RLK
chr19,Bn84313,31445393,91540015,60094622,NBS
chr19,Bn84314,52001195,82378125,30376930,TN
chr19,Bn84315,67890120,77090145,9200025,NBS
chr19,Bn84316,77167018,97572968,20405950,TNL
chr19,Bn84317,60704947,96385417,35680470,CNL
chr19,Bn84318,82350728,98507474,16156746,CN
chr19,Bn84319,40121314,85928995,45807681,TNL
chr19,Bn84320,14002615,53520974,39518359,TNL
chr19,Bn84321,36134438,78255166,42120728,CN
chr19,Bn84322,49882486,97396064,47513578,CN
chr19,Bn84323,95251948,95428225,176277,RLK
chr19,Bn84324,29792409,57857142,28064733,NBS
chr19,Bn84325,45227966,77058325,31830359,TN
chr19,Bn84326,76500532,78513100,2012568,CNL
chr19,Bn84327,62045062,75463289,13418227,RLK
chr19,Bn84328,23288212,86496448,63208236,RLK
chr19,Bn84329,75048761,92857477,17808716,TNL
chr19,Bn84330,92617711,98761334,6143623,RLK
chr19,Bn84331,70561253,84072635,13511382,TNL
chr19,Bn84332,41428132,70933368,29505236,NBS
chr19,Bn84333,80802533,82775119,1972586,CNL
chr19,Bn84334,53802748,82544022,28741274,TNL
chr19,Bn84335,79892684,87322336,7429652,CNL
chr19,Bn84336,57118383,82954029,25835646,NBS
chr19,Bn84337,42482394,89903204,47420810,NBS
chr19,Bn84338,84336523,88183440,3846917,TNL
chr19,Bn84339,20414213,89959838,69545625,RLP
chr19,Bn84340,88404423,98185368,9780945,NBS
chr19,Bn84341,95787083,99628457,3841374,TNL
chr19,Bn84342,65919520,93873622,27954102,CN
chr19,Bn84343,29284403,55370388,26085985,TNL
chr19,Bn84344,47145435,65472965,18327530,TNL
chr19,Bn84345,54852607,84868137,30015530,CN
chr19,Bn84346,24996652,33080542,8083890,CN
chr19,Bn84347,93326791,99189651,5862860,NBS
chr19,Bn84348,74389909,88501121,14111212,TNL
chr19,Bn84349,82596349,84005488,1409139,CN
chr19,Bn84350,66941085,93730755,26789670,TNL
chr19,Bn84351,1587642,58889782,57302140,TN
chr19,Bn84352,33989188,65140637,31151449,CNL
chr19,Bn84353,69133819,90781449,21647630,CN
chr19,Bn84354,11942178,79984061,68041883,RLK
chr19,Bn84355,42375654,70638780,28263126,NBS
chr19,Bn84356,83927378,97386247,13458869,RLP
chr19,Bn84357,77590623,80226723,2636100,TNL
chr19,Bn84358,75651765,99891130,24239365,NBS
chr19,Bn84359,30764384,63271349,32506965,RLP
chr19,Bn84360,14894025,18236648,3342623,RLK
chr19,Bn84361,66249665,78745005,12495340,RLP
chr19,Bn84362,39029734,52542677,13512943,TNL
chr19,Bn84363,92908380,94549114,1640734,CN
chr19,Bn84364,78550723,92985300,14434577,RLP
chr19,Bn84365,75125165,90031249,14906084,RLP
chr19,Bn84366,69872666,70602661,729995,RLK
chr19,Bn84367,84928714,93290888,8362174,CN
chr19,Bn84368,53157061,53889385,732324,CNL
chr19,Bn84369,78527352,83946421,5419069,RLP
chr19,Bn84370,18972216,22433736,3461520,CN
chr19,Bn84371,12995346,53834748,40839402,TNL
chr19,Bn84372,70382604,81157533,10774929,TNL
chr19,Bn84373,41836161,57550667,15714506,RLP
chr19,Bn84374,63193464,83014701,19821237,RLK
chr19,Bn84375,87130732,97664443,10533711,CN
chr19,Bn84376,36973345,97397516,60424171,RLP
chr19,Bn84377,27287150,76425221,49138071,TN
chr19,Bn84378,7097201,46768369,39671168,CNL
chr19,Bn84379,92087259,97552833,5465574,TNL
chr19,Bn84380,90322749,97878525,7555776,CN
chr19,Bn84381,46908012,52098130,5190118,CN
chr19,Bn84382,76352232,93387119,17034887,RLK
chr19,Bn84383,97529407,98436988,907581,TN
chr19,Bn84384,52232572,99623544,47390972,RLK
chr19,Bn84385,52745639,90972823,38227184,RLK
chr19,Bn84386,23260684,71422686,48162002,TN
chr19,Bn84387,15924908,44905126,28980218,RLP
chr19,Bn84388,57478661,92101028,34622367,CNL
chr19,Bn84389,96844054,98378254,1534200,RLP
chr19,Bn84390,49044137,51108070,2063933,NBS
chr19,Bn84391,79458545,82410684,2952139,CN
chr19,Bn84392,28493354,85610427,57117073,CN
chr19,Bn84393,59624045,78147995,18523950,RLK
chr19,Bn84394,4257103,13509832,9252729,NBS
chr19,Bn84395,31774974,73909774,42134800,RLP
chr19,Bn84396,64366236,83314796,18948560,TN
chr19,Bn84397,54792715,99598313,44805598,RLK
chr19,Bn84398,61661474,73342099,11680625,CN
chr19,Bn84399,90445266,98252297,7807031,NBS
chr19,Bn84400,52699997,53571023,871026,TNL
chr19,Bn84401,9441652,59472337,50030685,TNL
chr19,Bn84402,51286106,91234496,39948390,RLP
chr19,Bn84403,57304644,76127615,18822971,RLP
chr19,Bn84404,56820990,90873287,34052297,CNL
chr19,Bn84405,88709653,89864080,1154427,NBS
chr19,Bn84406,85191462,89383769,4192307,CN
chr19,Bn84407,40727489,62238756,21511267,NBS
chr19,Bn84408,58590167,95509842,36919675,RLK
chr19,Bn84409,72327428,77267495,4940067,CNL
chr19,Bn84410,41762599,84797671,43035072,TNL
chr19,Bn84411,1894923,32020000,30125077,NBS
chr19,Bn84412,77864736,97409681,19544945,TNL
chr19,Bn84413,83485509,88709900,5224391,CN
chr19,Bn84414,23340879,39670613,16329734,CN
chr19,Bn84415,94890372,98165345,3274973,CNL
chr19,Bn84416,16996690,86928644,69931954,CNL
chr19,Bn84417,58617857,86813976,28196119,RLP
chr19,Bn84418,4972656,9056371,4083715,NBS
chr19,Bn84419,83940438,90760210,6819772,TN
chr19,Bn84420,54594829,59425202,4830373,TN
chr19,Bn84421,52172872,68977060,16804188,TN
chr19,Bn84422,79319733,97446687,18126954,RLK
chr19,Bn84423,69472011,80668691,11196680,TNL
chr19,Bn84424,39144561,64182647,25038086,RLP
chr19,Bn84425,36138711,60854914,24716203,CN
chr19,Bn84426,69988253,85870098,15881845,TNL
chr19,Bn84427,62141399,81075830,18934431,CN
chr19,Bn84428,32057560,85119052,53061492,CNL
chr19,Bn84429,22059314,94154530,72095216,TN
chr19,Bn84430,83821171,99665685,15844514,TN
chr19,Bn84431,89748575,94993389,5244814,RLP
chr19,Bn84432,90724184,95049669,4325485,TN
chr19,Bn84433,13564494,91570374,78005880,RLP
chr19,Bn84434,11819405,96196403,84376998,TN
chr19,Bn84435,66422934,67375626,952692,CNL
chr19,Bn84436,88050458,93034974,4984516,TNL
chr19,Bn84437,37815998,96540535,58724537,RLP
chr19,Bn84438,70484518,90315692,19831174,CN
chr19,Bn84439,98550108,98929646,379538,CN
chr19,Bn84440,12745813,27468684,14722871,RLP
chr19,Bn84441,88230853,88724202,493349,CNL
chr19,Bn84442,13393815,32695500,19301685,RLP
chr19,Bn84443,24473032,66512908,42039876,RLK
chr19,Bn84444,52414159,57446737,5032578,CNL
chr19,Bn84445,91031644,99513256,8481612,TNL
chr19,Bn84446,11329318,19378400,8049082,RLP
chr19,Bn84447,75901097,86457818,10556721,CN
chr19,Bn84448,14869470,57730590,42861120,CN
chr19,Bn84449,56737002,84812666,28075664,NBS
chr19,Bn84450,86024271,89561817,3537546,RLP
chr19,Bn84451,49989815,99237675,49247860,TN
chr19,Bn84452,75288718,79065603,3776885,RLK
chr19,Bn84453,60526502,64483812,3957310,CNL
chr19,Bn84454,81037655,83227802,2190147,CNL
chr19,Bn84455,12263299,30765690,18502391,TNL
chr19,Bn84456,54469546,72163681,17694135,TN
chr19,Bn84457,88758277,95979981,7221704,RLK
chr19,Bn84458,11362743,36610578,25247835,CNL
chr19,Bn84459,92236705,93588824,1352119,TNL
chr19,Bn84460,47818708,89775698,41956990,RLP
chr19,Bn84461,13697805,47186074,33488269,CN
chr19,Bn84462,61168259,86461952,25293693,NBS
chr19,Bn84463,30188383,75981727,45793344,TNL
chr19,Bn84464,5069091,82678004,77608913,TNL
chr19,Bn84465,1595593,79732886,78137293,RLP
chr19,Bn84466,26685793,49873569,23187776,RLP
chr19,Bn84467,70493748,79224092,8730344,RLK
chr19,Bn84468,49709492,65111200,15401708,RLK
chr19,Bn84469,88463696,95496891,7033195,TNL
chr19,Bn84470,37417781,95747775,58329994,RLP
chr19,Bn84471,34345822,93048721,58702899,RLP
chr19,Bn84472,10455734,73731885,63276151,TN
chr19,Bn84473,73594772,78922591,5327819,RLK
chr19,Bn84474,33821324,58599286,24777962,CNL
chr19,Bn84475,57950726,79960147,22009421,TN
chr19,Bn84476,93194375,96794508,3600133,CN
chr19,Bn84477,70811644,89580210,18768566,NBS
chr19,Bn84478,8867180,79427592,70560412,RLP
chr19,Bn84479,26468333,87075535,60607202,CNL
chr19,Bn84480,81126448,92747807,11621359,CN
chr19,Bn84481,54548396,66028705,11480309,RLP
chr19,Bn84482,55299636,83835960,28536324,CNL
chr19,Bn84483,24048049,38556142,14508093,CN
chr19,Bn84484,29480187,91167293,61687106,CNL
chr19,Bn84485,3999988,65580332,61580344,RLK
chr19,Bn84486,68115692,82173016,14057324,TN
chr19,Bn84487,95687813,97664121,1976308,NBS
chr19,Bn84488,99961047,99986283,25236,CNL
chr19,Bn84489,3881776,49089308,45207532,TNL
chr19,Bn84490,7209389,98964798,91755409,NBS
chr19,Bn84491,72140761,80865762,8725001,TNL
chr19,Bn84492,67921696,70802627,2880931,CNL
chr19,Bn84493,78169788,99283223,21113435,CN
chr19,Bn84494,87673938,88054188,380250,CNL
chr19,Bn84495,62435750,63595197,1159447,NBS
chr19,Bn84496,64374489,99141632,34767143,NBS
chr19,Bn84497,27704810,31064969,3360159,TNL
chr19,Bn84498,18326450,50306074,31979624,TNL
chr19,Bn84499,54219608,90288064,36068456,CNL
chr19,Bn84500,68935329,90011434,21076105,TNL
chr19,Bn84501,51332599,97857620,46525021,TN
chr19,Bn84502,31609781,85191694,53581913,TNL
chr19,Bn84503,18378704,29473921,11095217,RLK
chr19,Bn84504,8149310,84484169,76334859,RLP
chr19,Bn84505,1091218,87367829,86276611,RLP
chr19,Bn84506,75114369,78509920,3395551,CN
chr19,Bn84507,2210302,95621397,93411095,TN
chr19,Bn84508,70104989,73971626,3866637,CNL
chr19,Bn84509,30092536,34595499,4502963,RLK
chr19,Bn84510,79660214,89238624,9578410,CN
chr19,Bn84511,63837307,99356675,35519368,RLK
chr19,Bn84512,79034621,97956176,18921555,TNL
chr19,Bn84513,69805244,87085569,17280325,CN
chr19,Bn84514,65601926,78471487,12869561,RLP
chr19,Bn84515,75210722,97350472,22139750,RLK
chr19,Bn84516,57009446,74943208,17933762,CN
chr19,Bn84517,4211942,31042914,26830972,CNL
chr19,Bn84518,45457383,77707523,32250140,RLK
chr19,Bn84519,63546146,92198168,28652022,CN
chr19,Bn84520,34131387,51007380,16875993,CNL
chr19,Bn84521,67942499,95286028,27343529,CNL
chr19,Bn84522,29941325,62795358,32854033,CN
chr19,Bn84523,38335255,67238309,28903054,TN
chr19,Bn84524,17159193,18826815,1667622,RLP
chr19,Bn84525,5912726,18662579,12749853,RLK
chr19,Bn84526,51647630,59662328,8014698,NBS
chr19,Bn84527,64542660,80764664,16222004,RLP
chr19,Bn84528,97922464,99300846,1378382,CNL
chr19,Bn84529,77309491,82847548,5538057,TNL
chr19,Bn84530,94467504,98863915,4396411,RLP
chr19,Bn84531,14008704,68301904,54293200,CNL
chr19,Bn84532,99231122,99715783,484661,RLK
chr19,Bn84533,86384025,97028132,10644107,RLP
chr19,Bn84534,60213666,86200574,25986908,CNL
chr19,Bn84535,83720425,99605212,15884787,CN
chr19,Bn84536,41745269,54579863,12834594,TN
chr19,Bn84537,67920415,86164649,18244234,NBS
chr19,Bn84538,28413762,66019531,37605769,TNL
chr19,Bn84539,65485220,83749800,18264580,RLP
chr19,Bn84540,22409022,44675614,22266592,TNL
chr19,Bn84541,34571110,82348497,47777387,TN
chr19,Bn84542,66303721,78186153,11882432,RLK
chr19,Bn84543,42074158,59818422,17744264,CNL
chr19,Bn84544,64200507,95356004,31155497,NBS
chr19,Bn84545,84059069,97660865,13601796,RLP
chr19,Bn84546,47769866,87320539,39550673,CNL
chr19,Bn84547,66205793,69681409,3475616,CN
chr19,Bn84548,2304843,92810040,90505197,CN
chr19,Bn84549,69668101,91938415,22270314,TN
chr19,Bn84550,28326826,43718952,15392126,NBS
chr19,Bn84551,81885120,97148337,15263217,TNL
chr19,Bn84552,20675753,94086523,73410770,TNL
chr19,Bn84553,53308406,75551642,22243236,RLP
chr19,Bn84554,18988878,41730795,22741917,TNL
chr19,Bn84555,94081350,97911566,3830216,CNL
chr19,Bn84556,88002252,93983123,5980871,RLP
chr19,Bn84557,2176903,11658192,9481289,TN
chr19,Bn84558,38753731,98861803,60108072,CNL
chr19,Bn84559,2093908,20039484,17945576,CNL
chr19,Bn84560,4809520,37332533,32523013,TNL
chr19,Bn84561,10421957,87022278,76600321,TN
chr19,Bn84562,15020794,49099575,34078781,TNL
chr19,Bn84563,6104024,7764809,1660785,RLK
chr19,Bn84564,55974711,64443300,8468589,RLP
chr19,Bn84565,42558134,83900507,41342373,RLP
chr19,Bn84566,27795788,74163799,46368011,TNL
chr19,Bn84567,98308796,99691244,1382448,TNL
chr19,Bn84568,47037390,83331529,36294139,CN
chr19,Bn84569,20937602,31038937,10101335,TN
chr19,Bn84570,55648400,78135064,22486664,TN
chr19,Bn84571,71312684,98534042,27221358,NBS
chr19,Bn84572,80395714,94267953,13872239,TN
chr19,Bn84573,39263270,76186065,36922795,TN
chr19,Bn84574,59169174,62661019,3491845,CN
chr19,Bn84575,12039272,68912833,56873561,NBS
chr19,Bn84576,22782075,87435793,64653718,TN
chr19,Bn84577,65163358,96771188,31607830,TN
chr19,Bn84578,8838075,97384853,88546778,TN
chr19,Bn84579,32803340,88244026,55440686,TN
chr19,Bn84580,6751321,9495221,2743900,TNL
chr19,Bn84581,4581743,56704539,52122796,TNL
chr19,Bn84582,72663368,86525181,13861813,CN
chr19,Bn84583,20961455,71885838,50924383,TNL
chr19,Bn84584,96226088,99068936,2842848,RLP
chr19,Bn84585,70609438,71142821,533383,RLK
chr19,Bn84586,84809729,98344390,13534661,RLK
chr19,Bn84587,52522089,77770719,25248630,NBS
chr19,Bn84588,18122477,66587228,48464751,NBS
chr19,Bn84589,32782043,70416597,37634554,TN
chr19,Bn84590,37581299,67919248,30337949,RLP
chr19,Bn84591,16638503,18247496,1608993,TN
chr19,Bn84592,55206296,84707783,29501487,CNL
chr19,Bn84593,95922828,96353063,430235,RLP
chr19,Bn84594,62338169,90370607,28032438,RLP
chr19,Bn84595,69148529,97917142,28768613,TNL
chr19,Bn84596,80734504,99802338,19067834,TN
chr19,Bn84597,48817986,87510601,38692615,TNL
chr19,Bn84598,44997478,68629821,23632343,TNL
chr19,Bn84599,33515512,39208880,5693368,RLK
chr19,Bn84600,63404388,63502972,98584,RLK
chr19,Bn84601,52003256,73675287,21672031,CN
chr19,Bn84602,37316805,71019221,33702416,TN
chr19,Bn84603,75927963,98593400,22665437,TN
chr19,Bn84604,42455749,71289571,28833822,TNL
chr19,Bn84605,92948674,95342927,2394253,CN
chr19,Bn84606,25522908,41968409,16445501,CNL
chr19,Bn84607,23352624,82758306,59405682,RLK
chr19,Bn84608,78362137,84956420,6594283,RLP
chr19,Bn84609,66605594,91285354,24679760,RLK
chr19,Bn84610,74648077,97953990,23305913,NBS
chr19,Bn84611,88077102,92844165,4767063,RLP
chr19,Bn84612,88090676,99341998,11251322,NBS
chr19,Bn84613,94113565,96655144,2541579,RLP
chr19,Bn84614,52049881,88782166,36732285,TNL
chr19,Bn84615,63549656,63604462,54806,TNL
chr19,Bn84616,41486134,43273963,1787829,TN
chr19,Bn84617,21774529,40796590,19022061,RLP
chr19,Bn84618,20946224,52156028,31209804,CNL
chr19,Bn84619,33111019,33391160,280141,RLK
chr19,Bn84620,41233125,86955193,45722068,TNL
chr19,Bn84621,78982607,98606078,19623471,NBS
chr19,Bn84622,94603855,94907662,303807,RLP
chr19,Bn84623,31959706,92492546,60532840,TNL
chr19,Bn84624,82744376,95554288,12809912,RLK
chr19,Bn84625,39067197,63370563,24303366,RLK
chr19,Bn84626,22557343,53392445,30835102,CN
chr19,Bn84627,8870922,93111169,84240247,CN
chr19,Bn84628,12345056,24664075,12319019,CN
chr19,Bn84629,2663720,44317844,41654124,RLK
chr19,Bn84630,8727032,16118029,7390997,TNL
chr19,Bn84631,7637928,19785030,12147102,CN
chr19,Bn84632,80832093,99132951,18300858,TNL
chr19,Bn84633,22744318,44753180,22008862,CNL
chr19,Bn84634,22551921,53416114,30864193,CN
chr19,Bn84635,24251188,26172351,1921163,TN
chr19,Bn84636,97343195,99049889,1706694,CN
chr19,Bn84637,21375964,84667921,63291957,TNL
chr19,Bn84638,11889119,85450509,73561390,CNL
chr19,Bn84639,26918147,59643573,32725426,RLP
chr19,Bn84640,29067062,34556768,5489706,RLP
chr19,Bn84641,60455225,92883060,32427835,CN
chr19,Bn84642,84480500,97018027,12537527,TN
chr19,Bn84643,67217756,69379388,2161632,RLP
chr19,Bn84644,42264239,98969240,56705001,RLK
chr19,Bn84645,41127922,51050819,9922897,RLP
chr19,Bn84646,55756116,67913712,12157596,NBS
chr19,Bn84647,87273130,92520382,5247252,RLP
chr19,Bn84648,52645013,79910484,27265471,RLP
chr19,Bn84649,83442689,98001472,14558783,TNL
chr19,Bn84650,23928699,72267101,48338402,CN
chr19,Bn84651,88852475,93454103,4601628,TNL
chr19,Bn84652,28030175,70195948,42165773,TNL
chr19,Bn84653,24414435,65625928,41211493,NBS
chr19,Bn84654,29049441,73833925,44784484,TNL
chr19,Bn84655,75208414,99724406,24515992,NBS
chr19,Bn84656,96281099,98497723,2216624,CNL
chr19,Bn84657,9787940,44207210,34419270,TN
chr19,Bn84658,65175320,91883103,26707783,RLK
chr19,Bn84659,66667522,86365886,19698364,CN
chr19,Bn84660,38601549,97667742,59066193,CNL
chr19,Bn84661,76456747,87471546,11014799,TN
chr19,Bn84662,68160635,97455652,29295017,CNL
chr19,Bn84663,24890776,43788230,18897454,RLK
chr19,Bn84664,3057936,7462379,4404443,TN
chr19,Bn84665,76856225,93335338,16479113,NBS
chr19,Bn84666,40317857,48262269,7944412,NBS
chr19,Bn84667,50455955,70467050,20011095,TNL
chr19,Bn84668,5832766,43434243,37601477,RLP
chr19,Bn84669,68831583,79277940,10446357,CN
chr19,Bn84670,25868956,45896032,20027076,CNL
chr19,Bn84671,7382646,51986012,44603366,NBS
chr19,Bn84672,2984019,79469762,76485743,NBS
chr19,Bn84673,96095299,97683759,1588460,NBS
chr19,Bn84674,98109251,98426167,316916,NBS
chr19,Bn84675,72259135,97941203,25682068,CN
chr19,Bn84676,60783551,78636521,17852970,TN
chr19,Bn84677,91238860,93005875,1767015,TNL
chr19,Bn84678,67267046,91205140,23938094,RLP
chr19,Bn84679,78946855,88251030,9304175,RLK
chr19,Bn84680,9205228,13570141,4364913,CNL
chr19,Bn84681,44989115,54114007,9124892,RLP
chr19,Bn84682,64460788,74830820,10370032,CN
chr19,Bn84683,58618654,70199364,11580710,NBS
chr19,Bn84684,3572634,65303284,61730650,RLK
chr19,Bn84685,92576648,93050735,474087,CNL
chr19,Bn84686,74881465,86576917,11695452,RLK
chr19,Bn84687,2480408,31494041,29013633,TNL
chr19,Bn84688,77082203,96426385,19344182,TNL
chr19,Bn84689,60031928,67544962,7513034,CNL
chr19,Bn84690,73946553,92673753,18727200,TN
chr19,Bn84691,97271687,98780779,1509092,CN
chr19,Bn84692,16182535,21214105,5031570,TNL
chr19,Bn84693,27265627,42153714,14888087,TNL
chr19,Bn84694,93363941,96510432,3146491,CNL
chr19,Bn84695,73116189,96956878,23840689,RLK
chr19,Bn84696,12538325,21809672,9271347,CNL
chr19,Bn84697,88137647,94431176,6293529,CNL
chr19,Bn84698,40158770,91174493,51015723,RLK
chr19,Bn84699,75562759,77991322,2428563,NBS
chr19,Bn84700,54654923,63711932,9057009,CN
chr19,Bn84701,22313356,88741029,66427673,RLK
chr19,Bn84702,81122514,86098358,4975844,RLP
chr19,Bn84703,65436854,89059067,23622213,TNL
chr19,Bn84704,48110403,48128584,18181,CNL
chr19,Bn84705,56880812,78011658,21130846,CN
chr19,Bn84706,37037704,64497783,27460079,NBS
chr19,Bn84707,11752080,12856318,1104238,CN
chr19,Bn84708,26669384,34815108,8145724,RLP
chr19,Bn84709,85031649,87168241,2136592,NBS
chr19,Bn84710,13036930,84103118,71066188,TN
chr19,Bn84711,10785416,89275424,78490008,CN
chr19,Bn84712,10149496,15617709,5468213,CN
chr19,Bn84713,20972710,33270832,12298122,TNL
chr19,Bn84714,11269855,40554696,29284841,CN
chr19,Bn84715,70258506,81511022,11252516,RLK
chr19,Bn84716,12784896,91062500,78277604,TN
chr19,Bn84717,85036823,99069804,14032981,RLK
chr19,Bn84718,10133059,22642156,12509097,CN
chr19,Bn84719,66985701,98877667,31891966,CNL
chr19,Bn84720,83490777,90127385,6636608,RLP
chr19,Bn84721,48460306,84946286,36485980,RLP
chr19,Bn84722,30188547,90430337,60241790,TNL
chr19,Bn84723,79504796,86301719,6796923,TN
chr19,Bn84724,8123249,63665670,55542421,NBS
chr19,Bn84725,22024020,22731945,707925,TN
chr19,Bn84726,88332933,95932271,7599338,RLP
chr19,Bn84727,81994958,83792939,1797981,CN
chr19,Bn84728,34128363,46860788,12732425,NBS
chr19,Bn84729,90308032,96369094,6061062,RLP
chr19,Bn84730,72640473,72805589,165116,NBS
chr19,Bn84731,29828219,30611647,783428,RLK
chr19,Bn84732,36592760,46613090,10020330,CN
chr19,Bn84733,29729604,74671664,44942060,CNL
chr19,Bn84734,62698777,75470485,12771708,CN
chr19,Bn84735,47229386,64649848,17420462,NBS
chr19,Bn84736,54965452,91912632,36947180,CNL
chr19,Bn84737,27891564,67060831,39169267,CNL
chr19,Bn84738,55581632,96105501,40523869,TN
chr19,Bn84739,19763550,87323368,67559818,NBS
chr19,Bn84740,65793797,93262780,27468983,CNL
chr19,Bn84741,52049246,55005829,2956583,CNL
chr19,Bn84742,71092040,96948531,25856491,CN
chr19,Bn84743,75509572,90163967,14654395,NBS
chr19,Bn84744,36734741,84460856,47726115,NBS
chr19,Bn84745,3538704,93642146,90103442,TN
chr19,Bn84746,16972105,39517626,22545521,TNL
chr19,Bn84747,28658007,56699495,28041488,TN
chr19,Bn84748,24975144,89239460,64264316,RLK
chr19,Bn84749,11720974,55858605,44137631,NBS
chr19,Bn84750,44849405,46022489,1173084,NBS
chr19,Bn84751,85244736,97349352,12104616,NBS
chr19,Bn84752,58941261,99748306,40807045,RLP
chr19,Bn84753,60699090,64119281,3420191,TN
chr19,Bn84754,59924087,91824410,31900323,NBS
chr19,Bn84755,24013356,88124943,64111587,RLK
chr19,Bn84756,94943945,95697718,753773,CN
chr19,Bn84757,36704089,68856253,32152164,CNL
chr19,Bn84758,62949790,91529077,28579287,TN
chr19,Bn84759,99404269,99708791,304522,RLK
chr19,Bn84760,71887553,75556232,3668679,TN
chr19,Bn84761,88748052,92687492,3939440,RLK
chr19,Bn84762,80697002,81053466,356464,NBS
chr19,Bn84763,6514110,47999184,41485074,TNL
chr19,Bn84764,16427440,31289022,14861582,TN
chr19,Bn84765,97830196,98901956,1071760,TNL
chr19,Bn84766,68227746,72538262,4310516,NBS
chr19,Bn84767,13022747,77078301,64055554,NBS
chr19,Bn84768,87784179,95981783,8197604,NBS
chr19,Bn84769,40402452,95150632,54748180,RLK
chr19,Bn84770,81758869,83363223,1604354,RLP
chr19,Bn84771,1852057,99422005,97569948,RLK
chr19,Bn84772,80509334,82743560,2234226,RLP
chr19,Bn84773,21045040,42404109,21359069,CNL
chr19,Bn84774,74802653,85463460,10660807,CNL
chr19,Bn84775,94108023,96383275,2275252,TNL
chr19,Bn84776,4015641,54895141,50879500,TN
chr19,Bn84777,17896922,84348589,66451667,CN
chr19,Bn84778,94883081,99452721,4569640,CN
chr19,Bn84779,13756968,83586919,69829951,TNL
chr19,Bn84780,87585849,89772533,2186684,RLP
chr19,Bn84781,31174445,96916748,65742303,CNL
chr19,Bn84782,80940970,87277466,6336496,TNL
chr19,Bn84783,33884601,83220616,49336015,RLP
chr19,Bn84784,53691031,81028266,27337235,CNL
chr19,Bn84785,3879565,88311527,84431962,RLK
chr19,Bn84786,56351904,96268541,39916637,TNL
chr19,Bn84787,39814650,55898950,16084300,RLK
chr19,Bn84788,25156069,72258059,47101990,NBS
chr19,Bn84789,36156711,86379635,50222924,CN
chr19,Bn84790,59506229,70048878,10542649,NBS
chr19,Bn84791,43280501,66322168,23041667,CN
chr19,Bn84792,86795109,91592868,4797759,TNL
chr19,Bn84793,26248648,42893467,16644819,TN
chr19,Bn84794,86386849,92097672,5710823,TNL
chr19,Bn84795,16541242,38401680,21860438,CN
chr19,Bn84796,52333477,73030721,20697244,RLK
chr19,Bn84797,83249564,89160616,5911052,CNL
chr19,Bn84798,82473210,87267632,4794422,TNL
chr19,Bn84799,74834391,83940954,9106563,NBS
chr19,Bn84800,35798903,47505563,11706660,TN
chr19,Bn84801,87336803,95576200,8239397,TN
chr19,Bn84802,75955068,80814592,4859524,TNL
chr19,Bn84803,3900508,28001242,24100734,CN
chr19,Bn84804,92459921,99834344,7374423,NBS
chr19,Bn84805,43737500,68586670,24849170,TNL
chr19,Bn84806,55602967,59005440,3402473,TN
chr19,Bn84807,38929422,53449205,14519783,RLK
chr19,Bn84808,10529153,68769560,58240407,TNL
chr19,Bn84809,21488084,98769250,77281166,CN
chr19,Bn84810,97305754,97787714,481960,TNL
chr19,Bn84811,77637597,89310203,11672606,CN
chr19,Bn84812,92660647,92943822,283175,NBS
chr19,Bn84813,73700667,79159066,5458399,RLP
chr19,Bn84814,28456514,36983548,8527034,RLK
chr19,Bn84815,59551273,68996093,9444820,CNL
chr19,Bn84816,50998654,75087439,24088785,CNL
chr19,Bn84817,33543374,48526937,14983563,NBS
chr19,Bn84818,37675245,57987187,20311942,TN
chr19,Bn84819,6732349,57911959,51179610,TN
chr19,Bn84820,47914725,75355589,27440864,TN
chr19,Bn84821,94250460,97455841,3205381,CNL
chr19,Bn84822,32348492,74446745,42098253,RLK
chr19,Bn84823,40466500,70452012,29985512,CN
chr19,Bn84824,37368362,65171036,27802674,CN
chr19,Bn84825,85681164,98970993,13289829,NBS
chr19,Bn84826,60776724,89348366,28571642,CNL
chr19,Bn84827,87507899,95411082,7903183,CN
chr19,Bn84828,44974903,96495073,51520170,RLK
chr19,Bn84829,50292455,67136424,16843969,TNL
chr19,Bn84830,37543892,50954094,13410202,RLP
chr19,Bn84831,68217576,96021892,27804316,NBS
chr19,Bn84832,86659313,97584562,10925249,RLK
chr19,Bn84833,16161888,24375616,8213728,TN
chr19,Bn84834,73251191,98143700,24892509,RLK
chr19,Bn84835,14862625,27547223,12684598,TN
chr19,Bn84836,78543088,84495916,5952828,NBS
chr19,Bn84837,55826633,93749529,37922896,NBS
chr19,Bn84838,58826601,64763465,5936864,TN
chr19,Bn84839,72657003,82215067,9558064,CN
chr19,Bn84840,30451163,61955222,31504059,RLP
chr19,Bn84841,12652254,72446870,59794616,CNL
chr19,Bn84842,69395191,92009135,22613944,RLK
chr19,Bn84843,11813814,91352465,79538651,CN
chr19,Bn84844,49430858,98685642,49254784,RLK
chr19,Bn84845,88826090,91547269,2721179,NBS
chr19,Bn84846,28588647,35686056,7097409,RLP
chr19,Bn84847,5154860,46391759,41236899,CN
chr19,Bn84848,70057966,98619169,28561203,CN
chr19,Bn84849,24914225,55605263,30691038,NBS
chr19,Bn84850,65424984,98563632,33138648,CNL
chr19,Bn84851,80067229,84017075,3949846,RLP
chr19,Bn84852,46669105,80353830,33684725,TNL
chr19,Bn84853,3257854,98655085,95397231,NBS
chr19,Bn84854,70370292,70841799,471507,RLP
chr19,Bn84855,52983189,87498272,34515083,RLK
chr19,Bn84856,99806175,99941908,135733,RLP
chr19,Bn84857,61053588,78982279,17928691,CNL
chr19,Bn84858,46221515,79746585,33525070,RLK
chr19,Bn84859,70909012,94443613,23534601,CNL
chr19,Bn84860,75843806,99551456,23707650,CN
chr19,Bn84861,92868881,94112979,1244098,RLK
chr19,Bn84862,64489264,64640162,150898,NBS
chr19,Bn84863,72288438,83727042,11438604,TN
chr19,Bn84864,77172891,89860905,12688014,NBS
chr19,Bn84865,87566600,97244533,9677933,TNL
chr19,Bn84866,77371283,83885207,6513924,RLP
chr19,Bn84867,21480513,21787758,307245,TNL
chr19,Bn84868,96031046,96957657,926611,TNL
chr19,Bn84869,51361215,71017130,19655915,CN
chr19,Bn84870,45783336,69424158,23640822,CNL
chr19,Bn84871,71535349,87540471,16005122,NBS
chr19,Bn84872,63268463,81689489,18421026,CNL
chr19,Bn84873,95836090,99193689,3357599,RLP
chr19,Bn84874,70492756,70880588,387832,CNL
chr19,Bn84875,33049088,58028789,24979701,RLK
chr19,Bn84876,64127413,70331902,6204489,NBS
chr19,Bn84877,74429550,84694641,10265091,CNL
chr19,Bn84878,66525280,86179420,19654140,CN
chr19,Bn84879,23510479,26243750,2733271,CN
chr19,Bn84880,83059122,93246991,10187869,NBS
chr19,Bn84881,34234342,87220073,52985731,RLP
chr19,Bn84882,46185426,78755685,32570259,TN
chr19,Bn84883,80354767,84983906,4629139,RLK
chr19,Bn84884,14134669,53830277,39695608,RLK
chr19,Bn84885,56286498,93697800,37411302,CNL
chr19,Bn84886,41490889,52118023,10627134,CNL
chr19,Bn84887,55103203,85382617,30279414,RLK
chr19,Bn84888,50897378,93951600,43054222,CNL
chr19,Bn84889,52356470,53771801,1415331,RLK
chr19,Bn84890,92700537,95480718,2780181,NBS
chr19,Bn84891,77679769,78575616,895847,TNL
chr19,Bn84892,25907917,88847544,62939627,CN
chr19,Bn84893,74908916,77134977,2226061,TNL
chr19,Bn84894,34018852,53033972,19015120,RLK
chr19,Bn84895,44529349,74756012,30226663,RLP
chr19,Bn84896,47423364,79311358,31887994,TNL
chr19,Bn84897,92559262,97335495,4776233,TNL
chr19,Bn84898,48599204,98114438,49515234,CN
chr19,Bn84899,75165190,86622109,11456919,RLP
chr19,Bn84900,25316581,39117860,13801279,TNL
chr19,Bn84901,45115647,89167725,44052078,RLK
chr19,Bn84902,84183176,92219178,8036002,CN
chr19,Bn84903,88488505,93308478,4819973,RLP
chr19,Bn84904,77281316,91342468,14061152,CN
chr19,Bn84905,72243616,74437931,2194315,NBS
chr19,Bn84906,33853241,71033262,37180021,RLP
chr19,Bn84907,78250025,93006336,14756311,CN
chr19,Bn84908,32247799,83744477,51496678,RLK
chr19,Bn84909,56792655,66174555,9381900,RLP
chr19,Bn84910,10744874,40673860,29928986,NBS
chr19,Bn84911,41044557,80163884,39119327,TN
chr19,Bn84912,20094759,51971014,31876255,RLP
chr19,Bn84913,39233817,96570435,57336618,TNL
chr19,Bn84914,46469120,48828379,2359259,TNL
chr19,Bn84915,41899940,53676940,11777000,CN
chr19,Bn84916,50301352,55939790,5638438,CNL
chr19,Bn84917,18318780,95837578,77518798,RLP
chr19,Bn84918,90810900,92378107,1567207,NBS
chr19,Bn84919,38442316,62685034,24242718,RLP
chr19,Bn84920,93681112,99539593,5858481,RLP
chr19,Bn84921,14651759,76993973,62342214,RLK
chr19,Bn84922,73594366,98286112,24691746,CN
chr19,Bn84923,39013214,70680241,31667027,CNL
chr19,Bn84924,93923643,98330281,4406638,CNL
chr19,Bn84925,44684746,80309382,35624636,RLK
chr19,Bn84926,31924913,33149570,1224657,TNL
chr19,Bn84927,56511926,73325967,16814041,RLK
chr19,Bn84928,75825641,94288826,18463185,RLK
chr19,Bn84929,15786174,21447196,5661022,NBS
chr19,Bn84930,22379531,28123313,5743782,RLK
chr19,Bn84931,14487451,74652992,60165541,CNL
chr19,Bn84932,88902760,97374214,8471454,CN
chr19,Bn84933,29250468,71786533,42536065,CNL
chr19,Bn84934,6064397,34264961,28200564,RLP
chr19,Bn84935,45507181,86719330,41212149,RLK
chr19,Bn84936,81300575,93836515,12535940,TN
chr19,Bn84937,81422298,85278075,3855777,TNL
chr19,Bn84938,57687276,80996529,23309253,NBS
chr19,Bn84939,70622961,97285051,26662090,CN
chr19,Bn84940,78439711,90360037,11920326,CNL
chr19,Bn84941,96088368,98710552,2622184,CN
chr19,Bn84942,65532308,67395558,1863250,TNL
chr19,Bn84943,39835179,74395770,34560591,TNL
chr19,Bn84944,24815847,93871308,69055461,TNL
chr19,Bn84945,29903468,67088235,37184767,TN
chr19,Bn84946,19873421,53486570,33613149,CNL
chr19,Bn84947,76781580,98283654,21502074,CN
chr19,Bn84948,18086879,88853539,70766660,RLK
chr19,Bn84949,86439624,88929753,2490129,CN
chr19,Bn84950,78397794,90392367,11994573,NBS
chr19,Bn84951,14320798,99969168,85648370,CNL
chr19,Bn84952,17483211,28374721,10891510,CNL
chr19,Bn84953,22653919,39429911,16775992,CNL
chr19,Bn84954,56357183,67378550,11021367,CNL
chr19,Bn84955,31039239,69991546,38952307,RLK
chr19,Bn84956,22309983,47899007,25589024,TN
chr19,Bn84957,56442634,63618604,7175970,RLK
chr19,Bn84958,15694911,36972850,21277939,CNL
chr19,Bn84959,8407582,23715767,15308185,RLK
chr19,Bn84960,95108666,98762361,3653695,NBS
chr19,Bn84961,75348783,98778526,23429743,CNL
chr19,Bn84962,55732581,89643543,33910962,CNL
chr19,Bn84963,78620471,97796609,19176138,CNL
chr19,Bn84964,30764047,56311699,25547652,CN
chr19,Bn84965,12602580,52210579,39607999,RLP
chr19,Bn84966,3249810,73492300,70242490,TN
chr19,Bn84967,89700201,96065685,6365484,RLK
chr19,Bn84968,60086892,87526916,27440024,NBS
chr19,Bn84969,46308873,67191101,20882228,TNL
chr19,Bn84970,48654423,83389478,34735055,RLK
chr19,Bn84971,37766001,98101130,60335129,CNL
chr19,Bn84972,69646492,70276371,629879,TN
chr19,Bn84973,92162800,99644666,7481866,CNL
chr19,Bn84974,94469226,98411633,3942407,RLP
chr19,Bn84975,25214950,49362074,24147124,TNL
chr19,Bn84976,19156716,21210432,2053716,TNL
chr19,Bn84977,92308850,99164363,6855513,TNL
chr19,Bn84978,74671213,88821162,14149949,CN
chr19,Bn84979,84968048,95542707,10574659,CN
chr19,Bn84980,90968565,96728473,5759908,RLP
chr19,Bn84981,83848775,94633012,10784237,CN
chr19,Bn84982,75415276,99756038,24340762,TNL
chr19,Bn84983,49222715,52191523,2968808,RLP
chr19,Bn84984,47695749,89670702,41974953,CNL
chr19,Bn84985,33410838,77732290,44321452,CN
chr19,Bn84986,6663489,92473215,85809726,CN
chr19,Bn84987,98874132,99133242,259110,NBS
chr19,Bn84988,93794467,97295207,3500740,CNL
chr19,Bn84989,67774803,78856022,11081219,RLP
chr19,Bn84990,22515465,73900579,51385114,CN
chr19,Bn84991,30077410,34056851,3979441,RLK
chr19,Bn84992,1462194,59741087,58278893,RLP
chr19,Bn84993,87513757,97156393,9642636,CN
chr19,Bn84994,66766835,69065552,2298717,RLP
chr19,Bn84995,88750330,95979863,7229533,NBS
chr19,Bn84996,39921496,95969144,56047648,RLK
chr19,Bn84997,55913285,56304478,391193,NBS
chr19,Bn84998,80398037,94154081,13756044,NBS
chr19,Bn84999,34025668,78059606,44033938,TNL
chr19,Bn85000,40182191,74425962,34243771,TN
chr19,Bn85001,49313683,89698968,40385285,CN
chr19,Bn85002,77400554,88945827,11545273,TNL
chr19,Bn85003,13448695,59387417,45938722,TN
chr19,Bn85004,94767380,97210338,2442958,RLK
chr19,Bn85005,94229740,96135505,1905765,TNL
chr19,Bn85006,11692401,82116479,70424078,RLP
chr19,Bn85007,51604255,54247730,2643475,TNL
chr19,Bn85008,13220259,84856073,71635814,RLP
chr19,Bn85009,82410274,98371476,15961202,CNL
chr19,Bn85010,33118753,50979484,17860731,RLK
chr19,Bn85011,74804911,91812143,17007232,TN
chr19,Bn85012,59414316,98789647,39375331,RLP
chr19,Bn85013,99415930,99624483,208553,RLK
chr19,Bn85014,27505749,37130816,9625067,CN
chr19,Bn85015,43878496,92107124,48228628,CN
chr19,Bn85016,20415537,75796962,55381425,CNL
chr19,Bn85017,43053519,61367065,18313546,NBS
chr19,Bn85018,52328756,77147033,24818277,TNL
chr19,Bn85019,58322981,60292472,1969491,NBS
chr19,Bn85020,60150534,70960355,10809821,CNL
chr19,Bn85021,85060408,92104608,7044200,TN
chr19,Bn85022,51883672,64220955,12337283,CNL
chr19,Bn85023,51816212,71844782,20028570,CNL
chr19,Bn85024,94882761,98560724,3677963,CNL
chr19,Bn85025,85136479,97347246,12210767,CNL
chr19,Bn85026,91720554,96319827,4599273,CNL
chr19,Bn85027,61370519,71877774,10507255,RLK
chr19,Bn85028,24301003,84316729,60015726,NBS
chr19,Bn85029,72692494,79594307,6901813,CN
chr19,Bn85030,47737862,84622342,36884480,CN
chr19,Bn85031,60041405,82876887,22835482,CN
chr19,Bn85032,66360535,77498225,11137690,CN
chr19,Bn85033,56354384,90984023,34629639,TNL
chr19,Bn85034,43747230,67970176,24222946,TNL
chr19,Bn85035,87225935,89193648,1967713,TN
chr19,Bn85036,52169194,80032300,27863106,CN
chr19,Bn85037,43508491,88073940,44565449,RLK
chr19,Bn85038,68519327,69855551,1336224,CNL
chr19,Bn85039,56548652,70069636,13520984,CN
chr19,Bn85040,14235535,98022585,83787050,RLP
chr19,Bn85041,70181869,80261318,10079449,TN
chr19,Bn85042,35090035,77380622,42290587,NBS
chr19,Bn85043,72338739,82697458,10358719,CNL
chr19,Bn85044,46704965,50609219,3904254,TNL
chr19,Bn85045,44337190,82438377,38101187,CNL
chr19,Bn85046,75394509,87204663,11810154,RLP
chr19,Bn85047,77687744,85977587,8289843,TN
chr19,Bn85048,77561771,80895211,3333440,TNL
chr19,Bn85049,35366945,84117775,48750830,NBS
chr19,Bn85050,13295475,17820453,4524978,TNL
chr19,Bn85051,9809415,94842984,85033569,RLP
chr19,Bn85052,54728275,99500877,44772602,RLK
chr19,Bn85053,58869775,75352876,16483101,CN
chr19,Bn85054,2221055,87388968,85167913,RLK
chr19,Bn85055,54964396,77006963,22042567,NBS
chr19,Bn85056,53744669,91851340,38106671,NBS
chr19,Bn85057,8933787,62319920,53386133,CN
chr19,Bn85058,18495153,53084992,34589839,TNL
chr19,Bn85059,97448258,99274179,1825921,CN
chr19,Bn85060,90650802,92137776,1486974,NBS
chr19,Bn85061,18407825,96279097,77871272,CNL
chr19,Bn85062,36514804,93019354,56504550,CN
chr19,Bn85063,43926441,87127089,43200648,TNL
chr19,Bn85064,48047233,77141667,29094434,TNL
chr19,Bn85065,67801463,80038441,12236978,CNL
chr19,Bn85066,9780000,39282460,29502460,CN
chr19,Bn85067,27744278,68922742,41178464,CNL
chr19,Bn85068,78374467,99282167,20907700,CNL
chr19,Bn85069,16591686,76413674,59821988,RLP
chr19,Bn85070,33302073,48775452,15473379,TNL
chr19,Bn85071,72051477,98472220,26420743,CN
chr19,Bn85072,38050089,85507700,47457611,CN
chr19,Bn85073,82441459,94045362,11603903,TNL
chr19,Bn85074,58782769,99986917,41204148,CN
chr19,Bn85075,55597894,64353520,8755626,RLK
chr19,Bn85076,34016758,65836010,31819252,RLP
chr19,Bn85077,23156736,76527867,53371131,TNL
chr19,Bn85078,5021898,42920383,37898485,CNL
chr19,Bn85079,41976573,75887742,33911169,TN
chr19,Bn85080,15440400,76778201,61337801,CNL
chr19,Bn85081,54036133,76370585,22334452,CNL
chr19,Bn85082,1250915,25220473,23969558,RLP
chr19,Bn85083,23077206,85023047,61945841,RLK
chr19,Bn85084,11277086,99027616,87750530,TN
chr19,Bn85085,47534008,96154831,48620823,TNL
chr19,Bn85086,68308075,79994977,11686902,CNL
chr19,Bn85087,78598615,80502755,1904140,CN
chr19,Bn85088,99610909,99975068,364159,CN
chr19,Bn85089,78454708,85202356,6747648,RLK
chr19,Bn85090,75832023,80999528,5167505,RLK
chr19,Bn85091,80970871,82912755,1941884,TNL
chr19,Bn85092,66396775,83930348,17533573,CNL
chr19,Bn85093,9402221,73859438,64457217,CNL
chr19,Bn85094,28851447,96127440,67275993,CNL
chr19,Bn85095,88659249,96804415,8145166,RLK
chr19,Bn85096,15218116,62575692,47357576,TNL
chr19,Bn85097,93661587,94911719,1250132,NBS
chr19,Bn85098,68677058,81642043,12964985,RLP
chr19,Bn85099,89410392,96366162,6955770,CNL
chr19,Bn85100,80391013,87477280,7086267,RLP
chr19,Bn85101,75582192,77472775,1890583,TN
chr19,Bn85102,4313706,21029455,16715749,RLP
chr19,Bn85103,30280852,79639166,49358314,TN
chr19,Bn85104,32694713,41203741,8509028,CN
chr19,Bn85105,8540168,83250836,74710668,NBS
chr19,Bn85106,66741886,97013555,30271669,TN
chr19,Bn85107,15426048,96334831,80908783,NBS
chr19,Bn85108,5129353,16552315,11422962,CN
chr19,Bn85109,62259701,96923474,34663773,TNL
chr19,Bn85110,17536998,67068777,49531779,TNL
chr19,Bn85111,25319528,85735059,60415531,TNL
chr19,Bn85112,10626640,47752935,37126295,TNL
chr19,Bn85113,56439167,57194123,754956,CNL
chr19,Bn85114,42011109,64823461,22812352,RLK
chr19,Bn85115,32634626,75769866,43135240,NBS
chr19,Bn85116,92992273,98896981,5904708,CNL
chr19,Bn85117,67830540,85955949,18125409,TNL
chr19,Bn85118,60574849,98005289,37430440,TNL
chr19,Bn85119,3008819,75814842,72806023,RLK
chr19,Bn85120,74745536,98453146,23707610,TN
chr19,Bn85121,80174161,83186708,3012547,TNL
chr19,Bn85122,19246161,54637644,35391483,CNL
chr19,Bn85123,25260133,40643213,15383080,NBS
chr19,Bn85124,50099351,95499369,45400018,TN
chr19,Bn85125,48389181,60707026,12317845,CN
chr19,Bn85126,51500756,59784644,8283888,TNL
chr19,Bn85127,89101053,89575374,474321,CNL
chr19,Bn85128,44368114,95318416,50950302,CN
chr19,Bn85129,31198988,34056620,2857632,TNL
chr19,Bn85130,62172278,97747695,35575417,RLP
chr19,Bn85131,82023221,99830165,17806944,RLP
chr19,Bn85132,21103905,81770129,60666224,RLK
chr19,Bn85133,66674714,95551347,28876633,RLP
chr19,Bn85134,3728113,92181905,88453792,TNL
chr19,Bn85135,59391773,70675612,11283839,TN
chr19,Bn85136,99091395,99753237,661842,RLK
chr19,Bn85137,60299242,65675387,5376145,CNL
chr19,Bn85138,3417807,18195745,14777938,RLK
chr19,Bn85139,91803396,95737176,3933780,NBS
chr19,Bn85140,5967080,86008055,80040975,RLP
chr19,Bn85141,50864639,78714509,27849870,CNL
chr19,Bn85142,90225084,96753597,6528513,TN
chr19,Bn85143,68215433,77615060,9399627,RLP
chr19,Bn85144,29431718,82236305,52804587,RLK
chr19,Bn85145,58616720,94591023,35974303,RLK
chr19,Bn85146,78401738,79945269,1543531,RLK
chr19,Bn85147,2883293,91394812,88511519,NBS
chr19,Bn85148,39301393,83789815,44488422,CN
chr19,Bn85149,88742749,96538286,7795537,RLP
chr19,Bn85150,17505883,18460797,954914,TN
chr19,Bn85151,18210083,82901144,64691061,RLK
chr19,Bn85152,11930090,99223380,87293290,RLK
chr19,Bn85153,95977959,98997580,3019621,RLP
chr19,Bn85154,83768133,87673879,3905746,TN
chr19,Bn85155,32063254,90223639,58160385,TNL
chr19,Bn85156,33577137,83976834,50399697,CNL
chr19,Bn85157,70072184,71096906,1024722,RLP
chr19,Bn85158,92349035,93316375,967340,RLK
chr19,Bn85159,59019050,86680829,27661779,TNL
chr19,Bn85160,26419074,27196829,777755,CN
chr19,Bn85161,31484847,61007097,29522250,RLP
chr19,Bn85162,27184170,87734252,60550082,TN
chr19,Bn85163,24625187,52138840,27513653,TN
chr19,Bn85164,82635411,83203079,567668,CNL
chr19,Bn85165,58670818,89779187,31108369,RLK
chr19,Bn85166,52285767,61342713,9056946,TNL
chr19,Bn85167,2062857,92474153,90411296,NBS
chr19,Bn85168,49326284,96412846,47086562,TN
chr19,Bn85169,51287357,72711201,21423844,CN
chr19,Bn85170,12939968,29047107,16107139,RLP
chr19,Bn85171,18851129,40306083,21454954,NBS
chr19,Bn85172,19473541,69348506,49874965,RLK
chr19,Bn85173,40242291,92640784,52398493,CNL
chr19,Bn85174,32940238,62880992,29940754,CNL
chr19,Bn85175,6253069,94451975,88198906,TNL
chr19,Bn85176,28027516,47646128,19618612,TNL
chr19,Bn85177,60178407,79306802,19128395,NBS
chr19,Bn85178,29022601,60241495,31218894,RLP
chr19,Bn85179,41448047,77735492,36287445,NBS
chr19,Bn85180,10200494,76600132,66399638,RLK
chr19,Bn85181,79527645,98698971,19171326,TNL
chr19,Bn85182,44153058,46878384,2725326,CNL
chr19,Bn85183,6390039,86969668,80579629,CN
chr19,Bn85184,36563911,86426860,49862949,NBS
chr19,Bn85185,26213971,62661825,36447854,RLP
chr19,Bn85186,98342902,99483617,1140715,RLK
chr19,Bn85187,1141784,19327889,18186105,RLP
chr19,Bn85188,47334685,80133067,32798382,CN
chr19,Bn85189,62988130,74581450,11593320,TN
chr19,Bn85190,22859067,78575753,55716686,RLP
chr19,Bn85191,10074759,10400063,325304,RLP
chr19,Bn85192,40739884,83741958,43002074,TNL
chr19,Bn85193,18122945,19349767,1226822,TNL
chr19,Bn85194,40431042,60800805,20369763,RLK
chr19,Bn85195,11886700,83922378,72035678,RLP
chr19,Bn85196,23273975,43448333,20174358,CNL
chr19,Bn85197,35953688,95697787,59744099,CN
chr19,Bn85198,39459931,80801537,41341606,TN
chr19,Bn85199,63789398,97806209,34016811,TNL
chr19,Bn85200,93381832,95126280,1744448,CN
chr19,Bn85201,40424046,88669268,48245222,NBS
chr19,Bn85202,98183180,98559445,376265,CNL
chr19,Bn85203,79511440,90792340,11280900,CN
chr19,Bn85204,90870783,96929995,6059212,CNL
chr19,Bn85205,73871559,84440252,10568693,RLP
chr19,Bn85206,12256766,74317763,62060997,TN
chr19,Bn85207,58520194,77309226,18789032,TN
chr19,Bn85208,47498282,87919342,40421060,TN
chr19,Bn85209,54482398,96199237,41716839,TNL
chr19,Bn85210,32513399,83810435,51297036,CNL
chr19,Bn85211,97108047,98527712,1419665,TN
chr19,Bn85212,80715868,94128548,13412680,RLK
chr19,Bn85213,92395555,94044021,1648466,RLK
chr19,Bn85214,51843261,86068493,34225232,TNL
chr19,Bn85215,39640074,92182427,52542353,RLK
chr19,Bn85216,35188486,68295828,33107342,CN
chr19,Bn85217,84795472,90928224,6132752,RLP
chr19,Bn85218,9177934,88905043,79727109,NBS
chr19,Bn85219,61933521,89105267,27171746,RLP
chr19,Bn85220,16736354,95179995,78443641,RLP
chr19,Bn85221,40443542,76670719,36227177,TNL
chr19,Bn85222,19941659,77523406,57581747,NBS
chr19,Bn85223,42942650,96056556,53113906,CN
chr19,Bn85224,42200233,67642777,25442544,CNL
chr19,Bn85225,3915853,23703274,19787421,TN
chr19,Bn85226,27939455,70887081,42947626,TN
chr19,Bn85227,89205907,99320135,10114228,RLK
chr19,Bn85228,73608014,78442971,4834957,NBS
chr19,Bn85229,67524273,78215272,10690999,TNL
chr19,Bn85230,95285011,98466023,3181012,TN
chr19,Bn85231,50937341,95472981,44535640,RLP
chr19,Bn85232,41563739,72754320,31190581,TN
chr19,Bn85233,3940049,77740839,73800790,TN
chr19,Bn85234,98816094,99362855,546761,CNL
chr19,Bn85235,41615552,78315912,36700360,TN
chr19,Bn85236,5066683,59952292,54885609,NBS
chr19,Bn85237,62752125,75814792,13062667,NBS
chr19,Bn85238,8574804,95112894,86538090,TNL
chr19,Bn85239,25361961,49857507,24495546,TNL
chr19,Bn85240,16811872,75476184,58664312,CN
chr19,Bn85241,8235349,30476007,22240658,TNL
chr19,Bn85242,71797791,83492032,11694241,TNL
chr19,Bn85243,34087949,38917211,4829262,TN
chr19,Bn85244,72795414,76578257,3782843,TN
chr19,Bn85245,63210730,67700365,4489635,TN
chr19,Bn85246,5378064,81795096,76417032,RLP
chr19,Bn85247,56485277,92974896,36489619,TN
chr19,Bn85248,84905584,93719814,8814230,CNL
chr19,Bn85249,12494645,14088173,1593528,RLK
chr19,Bn85250,43819357,86380035,42560678,TNL
chr19,Bn85251,61324423,88288340,26963917,CN
chr19,Bn85252,30277868,55906217,25628349,TN
chr19,Bn85253,64106020,98603456,34497436,TN
chr19,Bn85254,54066470,89158493,35092023,RLP
chr19,Bn85255,82521063,89281938,6760875,TN
chr19,Bn85256,42159657,84690377,42530720,RLP
chr19,Bn85257,86996627,95887193,8890566,NBS
chr19,Bn85258,22163377,86990227,64826850,NBS
chr19,Bn85259,43972878,94156345,50183467,TN
chr19,Bn85260,85087541,88962727,3875186,RLK
chr19,Bn85261,97173757,99997597,2823840,CN
chr19,Bn85262,85698147,99479591,13781444,RLP
chr19,Bn85263,80231965,90708315,10476350,RLP
chr19,Bn85264,42094263,55959617,13865354,CN
chr19,Bn85265,68656868,85889035,17232167,TNL
chr19,Bn85266,52966008,56768234,3802226,TN
chr19,Bn85267,31330508,84898896,53568388,CN
chr19,Bn85268,3109050,14027517,10918467,NBS
chr19,Bn85269,55141329,68809585,13668256,NBS
chr19,Bn85270,98636621,99675617,1038996,TNL
chr19,Bn85271,80343562,99574731,19231169,TN
chr19,Bn85272,28855730,95937823,67082093,TN
chr19,Bn85273,85303073,97498675,12195602,RLP
chr19,Bn85274,17290596,35239308,17948712,TN
chr19,Bn85275,71354815,85120475,13765660,TNL
chr19,Bn85276,63475793,87275628,23799835,CNL
chr19,Bn85277,16095553,48037543,31941990,TN
chr19,Bn85278,49868345,59681078,9812733,TN
chr19,Bn85279,57003462,66670066,9666604,NBS
chr19,Bn85280,84133182,99061692,14928510,CNL
chr19,Bn85281,84956533,98977302,14020769,TN
chr19,Bn85282,5962561,22578835,16616274,RLP
chr19,Bn85283,2259247,96873863,94614616,RLK
chr19,Bn85284,78130893,82366367,4235474,RLK
chr19,Bn85285,47236848,66752896,19516048,TN
chr19,Bn85286,63528201,80169252,16641051,TN
chr19,Bn85287,90141835,97872811,7730976,CNL
chr19,Bn85288,82039720,84599888,2560168,NBS
chr19,Bn85289,1261747,57824842,56563095,CN
chr19,Bn85290,9202540,42061520,32858980,CNL
chr19,Bn85291,47913958,72280133,24366175,CNL
chr19,Bn85292,93467624,98029140,4561516,TN
chr19,Bn85293,5507249,44894813,39387564,TNL
chr19,Bn85294,27688820,48301848,20613028,CN
chr19,Bn85295,58185348,59561476,1376128,CN
chr19,Bn85296,69602017,70558640,956623,TN
chr19,Bn85297,94610534,98859961,4249427,TNL
chr19,Bn85298,41503497,93464851,51961354,NBS
chr19,Bn85299,43780247,56386942,12606695,CNL
chr19,Bn85300,67061965,88666007,21604042,RLP
chr19,Bn85301,60504150,88044794,27540644,CNL
chr19,Bn85302,86493417,87577587,1084170,NBS
chr19,Bn85303,34156375,85320521,51164146,RLK
chr19,Bn85304,21362251,37191467,15829216,RLP
chr19,Bn85305,90146471,92492890,2346419,CNL
chr19,Bn85306,42779735,91074333,48294598,TNL
chr19,Bn85307,86148497,89010408,2861911,TN
chr19,Bn85308,48997824,73346168,24348344,NBS
chr19,Bn85309,30481591,93876833,63395242,TNL
chr19,Bn85310,59979436,70794517,10815081,NBS
chr19,Bn85311,95775704,97839767,2064063,CNL
chr19,Bn85312,12239073,34393404,22154331,NBS
chr19,Bn85313,38209241,83174461,44965220,NBS
chr19,Bn85314,10111056,31771978,21660922,CNL
chr19,Bn85315,46248689,73532491,27283802,RLK
chr19,Bn85316,14327723,76464590,62136867,NBS
chr19,Bn85317,28699784,50521882,21822098,TN
chr19,Bn85318,86596775,93624447,7027672,RLP
chr19,Bn85319,47189599,86263493,39073894,CN
chr19,Bn85320,54737643,77837804,23100161,TNL
chr19,Bn85321,42810184,50767058,7956874,CNL
chr19,Bn85322,89894711,97817589,7922878,CN
chr19,Bn85323,94970426,99948251,4977825,RLP
chr19,Bn85324,39917301,85398614,45481313,TNL
chr19,Bn85325,46517672,61087291,14569619,RLK
chr19,Bn85326,90362685,96922179,6559494,RLK
chr19,Bn85327,37798786,51583695,13784909,CNL
chr19,Bn85328,75280360,98597188,23316828,NBS
chr19,Bn85329,76299769,77028791,729022,TNL
chr19,Bn85330,81055731,98142772,17087041,NBS
chr19,Bn85331,1977004,44650628,42673624,NBS
chr19,Bn85332,53357014,96852037,43495023,RLP
chr19,Bn85333,43337198,50296338,6959140,NBS
chr19,Bn85334,85446518,92533895,7087377,RLP
chr19,Bn85335,18045800,22666030,4620230,NBS
chr19,Bn85336,44874968,52755104,7880136,RLK
chr19,Bn85337,78068950,88879132,10810182,RLP
chr19,Bn85338,19127772,91478032,72350260,NBS
chr19,Bn85339,39646562,75328258,35681696,NBS
chr19,Bn85340,82269248,97158679,14889431,TNL
chr19,Bn85341,53193143,59470874,6277731,RLK
chr19,Bn85342,86262005,94386679,8124674,CN
chr19,Bn85343,50234193,70653982,20419789,TN
chr19,Bn85344,78515190,91561734,13046544,CN
chr19,Bn85345,20265863,45009718,24743855,RLK
chr19,Bn85346,21229803,29721848,8492045,RLK
chr19,Bn85347,43716796,86533658,42816862,TN
chr19,Bn85348,94388360,99085355,4696995,TNL
chr19,Bn85349,14822411,44529107,29706696,NBS
chr19,Bn85350,43385381,67838053,24452672,CN
chr19,Bn85351,42103880,85588914,43485034,RLK
chr19,Bn85352,45126866,60509897,15383031,NBS
chr19,Bn85353,44200874,83715678,39514804,TN
chr19,Bn85354,85708967,98902796,13193829,TN
chr19,Bn85355,4912888,5219761,306873,TNL
chr19,Bn85356,34647937,86512140,51864203,RLP
chr19,Bn85357,7472424,78291179,70818755,NBS
chr19,Bn85358,96293091,98673451,2380360,RLP
chr19,Bn85359,70072533,74881110,4808577,TN
chr19,Bn85360,30947726,90014976,59067250,CN
chr19,Bn85361,1633197,50172484,48539287,RLK
chr19,Bn85362,89751915,90626959,875044,CN
chr19,Bn85363,60704530,76684738,15980208,CNL
chr19,Bn85364,34228776,80323955,46095179,CNL
chr19,Bn85365,77822822,96154916,18332094,RLP
chr19,Bn85366,73678498,99486106,25807608,TN
chr19,Bn85367,56645511,73612670,16967159,CN
chr19,Bn85368,74660278,99999676,25339398,NBS
chr19,Bn85369,71934742,89301563,17366821,NBS
chr19,Bn85370,63278104,79267767,15989663,NBS
chr19,Bn85371,96559765,96715897,156132,RLK
chr19,Bn85372,22492143,78750439,56258296,CNL
chr19,Bn85373,33571555,87962600,54391045,TN
chr19,Bn85374,13738509,89459724,75721215,CNL
chr19,Bn85375,96345234,97940450,1595216,TNL
chr19,Bn85376,31281383,94508207,63226824,TNL
chr19,Bn85377,4946341,75365752,70419411,CNL
chr19,Bn85378,45578313,53127416,7549103,RLK
chr19,Bn85379,37050269,96775507,59725238,TNL
chr19,Bn85380,94264983,99523127,5258144,TN
chr19,Bn85381,98871304,99713546,842242,TNL
chr19,Bn85382,24594832,66958006,42363174,TN
chr19,Bn85383,45131169,55070889,9939720,TNL
chr19,Bn85384,86474425,99458328,12983903,CN
chr19,Bn85385,14962401,66934426,51972025,TN
chr19,Bn85386,88991740,95277757,6286017,RLP
chr19,Bn85387,62768212,64836344,2068132,TNL
chr19,Bn85388,56403413,57835642,1432229,CN
chr19,Bn85389,18960586,65929188,46968602,TN
chr19,Bn85390,36120188,41929514,5809326,RLP
chr19,Bn85391,86552231,87621424,1069193,NBS
chr19,Bn85392,69998157,90862573,20864416,RLP
chr19,Bn85393,36372404,78787161,42414757,NBS
chr19,Bn85394,69827785,71489829,1662044,TN
chr19,Bn85395,29001992,53176616,24174624,RLP
chr19,Bn85396,27407069,89764202,62357133,TNL
chr19,Bn85397,45854133,62547414,16693281,TN
chr19,Bn85398,30533184,58421853,27888669,RLK
chr19,Bn85399,4648486,59289561,54641075,RLP
chr19,Bn85400,75262140,77128525,1866385,RLP
chr19,Bn85401,14272142,53193457,38921315,RLP
chr19,Bn85402,9543090,37904442,28361352,TN
chr19,Bn85403,69500925,98626256,29125331,TN
chr19,Bn85404,73439286,80476721,7037435,RLK
chr19,Bn85405,59439179,69170883,9731704,RLP
chr19,Bn85406,44852907,55062269,10209362,NBS
chr19,Bn85407,43293100,64127319,20834219,TN
chr19,Bn85408,23336375,99699692,76363317,NBS
chr19,Bn85409,1786739,71556867,69770128,RLK
chr19,Bn85410,76232539,93051405,16818866,RLK
chr19,Bn85411,46124761,85855459,39730698,TN
chr19,Bn85412,97164153,97916381,752228,RLK
chr19,Bn85413,84710198,93276187,8565989,RLP
chr19,Bn85414,57049936,72007048,14957112,RLP
chr19,Bn85415,6752673,79079897,72327224,TN
chr19,Bn85416,53473933,84200531,30726598,TNL
chr19,Bn85417,37672073,88140289,50468216,TN
chr19,Bn85418,37419405,46112523,8693118,CN
chr19,Bn85419,95003628,97422371,2418743,NBS
chr19,Bn85420,95499148,99297804,3798656,RLP
chr19,Bn85421,91544484,95709851,4165367,CN
chr19,Bn85422,76201846,82175543,5973697,RLP
chr19,Bn85423,15524324,56295188,40770864,RLP
chr19,Bn85424,30351778,64901749,34549971,RLK
chr19,Bn85425,20857216,89876174,69018958,TN
chr19,Bn85426,72358664,95330132,22971468,NBS
chr19,Bn85427,2762324,44531219,41768895,CN
chr19,Bn85428,6999586,98759110,91759524,NBS
chr19,Bn85429,47252341,88331850,41079509,TN
chr19,Bn85430,39966934,63181561,23214627,TN
chr19,Bn85431,21092644,63070587,41977943,RLP
chr19,Bn85432,4853542,87306016,82452474,RLP
chr19,Bn85433,1701383,35656094,33954711,RLP
chr19,Bn85434,23188649,91372243,68183594,TNL
chr19,Bn85435,88362477,96157934,7795457,TNL
chr19,Bn85436,88329696,98289856,9960160,TN
chr19,Bn85437,99525847,99900551,374704,TNL
chr19,Bn85438,11961909,84857068,72895159,TNL
chr19,Bn85439,77408163,93026236,15618073,TN
chr19,Bn85440,83896750,94375211,10478461,NBS
chr19,Bn85441,7312902,63083110,55770208,RLP
chr19,Bn85442,45092558,77353140,32260582,RLP
chr19,Bn85443,49980068,81541104,31561036,TN
chr19,Bn85444,53126113,69825804,16699691,NBS
chr19,Bn85445,6141372,94631924,88490552,RLP
chr19,Bn85446,8390501,82126686,73736185,TNL
chr19,Bn85447,22881454,90301164,67419710,NBS
chr19,Bn85448,1685940,68181375,66495435,CN
chr19,Bn85449,35500035,80661698,45161663,TN
chr19,Bn85450,64547408,66204151,1656743,RLK
chr19,Bn85451,87655301,95975525,8320224,CN
chr19,Bn85452,16851787,67814408,50962621,TNL
chr19,Bn85453,53511029,80877835,27366806,CNL
chr19,Bn85454,99585925,99594160,8235,CN
chr19,Bn85455,22047981,57673903,35625922,NBS
chr19,Bn85456,81604944,97912621,16307677,CNL
chr19,Bn85457,78997459,81404936,2407477,TN
chr19,Bn85458,5770055,89414355,83644300,TN
chr19,Bn85459,83919936,92454784,8534848,TNL
chr19,Bn85460,56593679,87822967,31229288,RLP
chr19,Bn85461,43078292,65462932,22384640,TN
chr19,Bn85462,55060105,64651975,9591870,CNL
chr19,Bn85463,68678099,72294780,3616681,RLP
chr19,Bn85464,37563745,64062379,26498634,CN
chr19,Bn85465,9448548,13133387,3684839,CN
chr19,Bn85466,71882425,97206158,25323733,NBS
chr19,Bn85467,49622393,59566759,9944366,TN
chr19,Bn85468,11310407,59985573,48675166,NBS
chr19,Bn85469,42811428,70686989,27875561,TN
chr19,Bn85470,30383711,36540764,6157053,TN
chr19,Bn85471,11095179,87783352,76688173,CNL
chr19,Bn85472,39954529,89782081,49827552,TNL
chr19,Bn85473,96015405,97112062,1096657,CN
chr19,Bn85474,44919713,67730761,22811048,RLP
chr19,Bn85475,58329296,75040848,16711552,RLP
chr19,Bn85476,22375881,55331982,32956101,RLK
chr19,Bn85477,4353769,83697154,79343385,NBS
chr19,Bn85478,11364288,99125128,87760840,TN
chr19,Bn85479,48277139,84278522,36001383,NBS
chr19,Bn85480,5371510,62321684,56950174,CNL
chr19,Bn85481,82530809,87797668,5266859,NBS
chr19,Bn85482,15108485,83517707,68409222,TN
chr19,Bn85483,8499837,42852054,34352217,RLK
chr19,Bn85484,66166214,91812778,25646564,CN
chr19,Bn85485,84942213,92946404,8004191,CN
chr19,Bn85486,35058374,99848847,64790473,TNL
chr19,Bn85487,46528031,68201854,21673823,TNL
chr19,Bn85488,6301347,92886938,86585591,CNL
chr19,Bn85489,39516848,51547228,12030380,RLK
chr19,Bn85490,40114562,57651029,17536467,NBS
chr19,Bn85491,59064156,74732132,15667976,RLP
chr19,Bn85492,89445101,92993559,3548458,TNL
chr19,Bn85493,78898171,96870362,17972191,RLP
chr19,Bn85494,91126978,91972154,845176,CNL
chr19,Bn85495,62128463,64567916,2439453,RLK
chr19,Bn85496,88884989,96920332,8035343,CNL
chr19,Bn85497,92685690,97915556,5229866,TNL
chr19,Bn85498,55087340,58293863,3206523,RLP
chr19,Bn85499,97527506,99773500,2245994,TN
chr19,Bn85500,41874118,73559294,31685176,RLK
chr19,Bn85501,18885477,73025056,54139579,RLP
chr19,Bn85502,46799056,96801199,50002143,RLP
chr19,Bn85503,24647712,48055194,23407482,TNL
chr19,Bn85504,28311238,95727167,67415929,CNL
chr19,Bn85505,36773715,51499410,14725695,CN
chr19,Bn85506,84376784,88120611,3743827,TN
chr19,Bn85507,93169057,97667770,4498713,NBS
chr19,Bn85508,40651763,58751915,18100152,CN
chr19,Bn85509,86811426,92513853,5702427,RLP
chr19,Bn85510,66531109,83917219,17386110,CN
chr19,Bn85511,78443975,95996199,17552224,RLP
chr19,Bn85512,16403790,87605942,71202152,CN
chr19,Bn85513,51895835,92473090,40577255,CNL
chr19,Bn85514,57206274,89847820,32641546,NBS
chr19,Bn85515,77735867,94897500,17161633,TN
chr19,Bn85516,20843676,45868773,25025097,TN
chr19,Bn85517,71949623,92454058,20504435,TN
chr19,Bn85518,41843430,97646869,55803439,TNL
chr19,Bn85519,14471741,64742399,50270658,CN
chr19,Bn85520,76817947,97316726,20498779,NBS
chr19,Bn85521,65444459,66773678,1329219,CN
chr19,Bn85522,30602735,63711000,33108265,RLP
chr19,Bn85523,46383735,70988209,24604474,RLK
chr19,Bn85524,77852639,86732050,8879411,RLP
chr19,Bn85525,96663523,98131914,1468391,NBS
chr19,Bn85526,30012197,45250485,15238288,RLK
chr19,Bn85527,6269122,64427553,58158431,CNL
chr19,Bn85528,70074705,98067183,27992478,CN
chr19,Bn85529,30710187,49418263,18708076,RLP
chr19,Bn85530,63539308,66666367,3127059,NBS
chr19,Bn85531,47674488,56103356,8428868,RLP
chr19,Bn85532,66812074,81429811,14617737,CNL
chr19,Bn85533,68913050,80613181,11700131,TN
chr19,Bn85534,75971846,86346721,10374875,NBS
chr19,Bn85535,15810422,56297423,40487001,TNL
chr19,Bn85536,30488842,44581789,14092947,RLP
chr19,Bn85537,4344466,98932335,94587869,RLP
chr19,Bn85538,62215219,86807671,24592452,TNL
chr19,Bn85539,40859392,63721993,22862601,TNL
chr19,Bn85540,18663299,27360046,8696747,TNL
chr19,Bn85541,25106917,39847137,14740220,RLP
chr19,Bn85542,73698172,99784308,26086136,CN
chr19,Bn85543,98655519,99030217,374698,RLP
chr19,Bn85544,76206870,94929579,18722709,RLP
chr19,Bn85545,10701946,13182192,2480246,TN
chr19,Bn85546,41302592,43223802,1921210,RLP
chr19,Bn85547,29425054,74695149,45270095,CN
chr19,Bn85548,80863638,97073029,16209391,TN
chr19,Bn85549,63538763,89178689,25639926,TN
chr19,Bn85550,80863337,90855885,9992548,NBS
chr19,Bn85551,26832346,79992366,53160020,CN
chr19,Bn85552,12453239,76333120,63879881,RLP
chr19,Bn85553,30357399,49541711,19184312,RLK
chr19,Bn85554,27875304,69126527,41251223,RLP
chr19,Bn85555,46213855,68785575,22571720,RLK
chr19,Bn85556,2261904,88923614,86661710,CN
chr19,Bn85557,64144396,66779448,2635052,NBS
chr19,Bn85558,17145685,50561206,33415521,RLK
chr19,Bn85559,6394224,51896561,45502337,CNL
chr19,Bn85560,15775976,77843248,62067272,TN
chr19,Bn85561,47765650,82024439,34258789,CNL
chr19,Bn85562,42550299,70831416,28281117,RLP
chr19,Bn85563,62662201,94309577,31647376,TN
chr19,Bn85564,61960713,99078643,37117930,RLP
chr19,Bn85565,41661541,97437493,55775952,NBS
chr19,Bn85566,82869210,91213415,8344205,CN
chr19,Bn85567,97597766,98379184,781418,TN
chr19,Bn85568,78743121,94459435,15716314,CN
chr19,Bn85569,52027467,79214067,27186600,TNL
chr19,Bn85570,81386219,88045168,6658949,TN
chr19,Bn85571,40946246,42345238,1398992,RLP
chr19,Bn85572,93532543,98309746,4777203,RLP
chr19,Bn85573,92362652,97508627,5145975,NBS
chr19,Bn85574,14172976,93295938,79122962,RLP
chr19,Bn85575,60986945,89039260,28052315,CNL
chr19,Bn85576,85678169,96233092,10554923,RLK
chr19,Bn85577,35284890,36242756,957866,CN
chr19,Bn85578,75237625,85409591,10171966,TNL
chr19,Bn85579,37676398,57947305,20270907,NBS
chr19,Bn85580,54014999,60283168,6268169,TNL
chr19,Bn85581,11467986,69095501,57627515,TNL
chr19,Bn85582,93675074,95400455,1725381,RLK
chr19,Bn85583,45273323,95815614,50542291,RLP
chr19,Bn85584,52949141,79100010,26150869,TNL
chr19,Bn85585,75446273,83427753,7981480,NBS
chr19,Bn85586,49993150,77191585,27198435,CN
chr19,Bn85587,1845418,27491565,25646147,TNL
chr19,Bn85588,5526897,80196222,74669325,TNL
chr19,Bn85589,94167034,97267080,3100046,CNL
chr19,Bn85590,70352573,74553235,4200662,TNL
chr19,Bn85591,68015165,78391380,10376215,TN
chr19,Bn85592,51445985,77602216,26156231,CN
chr19,Bn85593,5154579,23712386,18557807,CN
chr19,Bn85594,7767434,82402232,74634798,TN
chr19,Bn85595,6273063,74616235,68343172,CNL
chr19,Bn85596,76447445,88770377,12322932,TNL
chr19,Bn85597,84897674,94247256,9349582,NBS
chr19,Bn85598,21507221,84857714,63350493,TNL
chr19,Bn85599,22513011,54630878,32117867,TN
chr19,Bn85600,74514559,87955862,13441303,TN
chr19,Bn85601,37221649,74785540,37563891,RLP
chr19,Bn85602,27864602,77374257,49509655,NBS
chr19,Bn85603,59794161,73867979,14073818,RLP
chr19,Bn85604,77535906,91772180,14236274,TN
chr19,Bn85605,4057905,69009028,64951123,RLK
chr19,Bn85606,27402756,71107290,43704534,RLP
chr19,Bn85607,23023139,56814524,33791385,NBS
chr19,Bn85608,62982708,69902139,6919431,RLP
chr19,Bn85609,57462090,77370295,19908205,CNL
chr19,Bn85610,88227716,99283449,11055733,CN
chr19,Bn85611,87831913,94789416,6957503,TNL
chr19,Bn85612,43992026,88051153,44059127,TN
chr19,Bn85613,99085048,99990699,905651,RLP
chr19,Bn85614,65271307,83121378,17850071,RLP
chr19,Bn85615,66338528,97991262,31652734,TNL
chr19,Bn85616,69667338,99227741,29560403,RLK
chr19,Bn85617,75083939,80951815,5867876,CN
chr19,Bn85618,80967834,97493162,16525328,CN
chr19,Bn85619,20022056,73709528,53687472,TNL
chr19,Bn85620,71006704,88456851,17450147,RLK
chr19,Bn85621,4523973,50087503,45563530,RLK
chr19,Bn85622,71972740,96399465,24426725,NBS
chr19,Bn85623,80591179,93392888,12801709,CNL
chr19,Bn85624,77414645,92077427,14662782,TNL
chr19,Bn85625,10651808,18665093,8013285,TNL
chr19,Bn85626,82386072,96453211,14067139,TN
chr19,Bn85627,48733938,81497524,32763586,CN
chr19,Bn85628,64386967,91640594,27253627,CNL
chr19,Bn85629,98006492,99400850,1394358,TN
chr19,Bn85630,29168887,99865005,70696118,RLP
chr19,Bn85631,60110327,79009190,18898863,RLK
chr19,Bn85632,80382007,88421239,8039232,RLK
chr19,Bn85633,2404377,22577393,20173016,NBS
chr19,Bn85634,46948409,47268685,320276,CNL
chr19,Bn85635,91527864,94390354,2862490,RLP
chr19,Bn85636,71154691,85907247,14752556,CN
chr19,Bn85637,44795309,87200163,42404854,RLK
chr19,Bn85638,87705799,91409247,3703448,TN
chr19,Bn85639,72335766,99507975,27172209,RLP
chr19,Bn85640,42803085,68581809,25778724,TN
chr19,Bn85641,19870534,36878840,17008306,RLP
chr19,Bn85642,60513721,88742186,28228465,TNL
chr19,Bn85643,67904659,88641072,20736413,RLP
chr19,Bn85644,48718410,57931988,9213578,CNL
chr19,Bn85645,56300952,92447737,36146785,TN
chr19,Bn85646,14244206,88846264,74602058,TN
chr19,Bn85647,75475207,79823270,4348063,NBS
chr19,Bn85648,83339380,86980834,3641454,NBS
chr19,Bn85649,75262328,96530760,21268432,CNL
chr19,Bn85650,14897879,83304913,68407034,CN
chr19,Bn85651,95747840,96618659,870819,RLP
chr19,Bn85652,32466078,81309765,48843687,CN
chr19,Bn85653,57643162,82246985,24603823,NBS
chr19,Bn85654,5123862,58384079,53260217,CN
chr19,Bn85655,50174863,72136222,21961359,CN
chr19,Bn85656,17327879,19496186,2168307,RLK
chr19,Bn85657,29288345,52210339,22921994,RLK
chr19,Bn85658,95447794,99455740,4007946,CNL
chr19,Bn85659,48979341,52541413,3562072,CNL
chr19,Bn85660,81018969,84888544,3869575,RLK
chr19,Bn85661,51933062,73875496,21942434,RLK
chr19,Bn85662,37412252,66951354,29539102,TN
chr19,Bn85663,55968281,98314276,42345995,RLP
chr19,Bn85664,14878266,84443638,69565372,RLK
chr19,Bn85665,75780870,80008034,4227164,CN
chr19,Bn85666,77514116,88555221,11041105,NBS
chr19,Bn85667,95034101,98350578,3316477,RLK
chr19,Bn85668,99813384,99933262,119878,CNL
chr19,Bn85669,76354741,91868018,15513277,TNL
chr19,Bn85670,74858134,98810348,23952214,CN
chr19,Bn85671,15812175,38041310,22229135,RLK
chr19,Bn85672,87188960,96165071,8976111,CN
chr19,Bn85673,79866358,92127566,12261208,RLP
chr19,Bn85674,44365898,92493246,48127348,NBS
chr19,Bn85675,53237484,57747314,4509830,RLK
chr19,Bn85676,82877138,98301320,15424182,CN
chr19,Bn85677,94252808,97788868,3536060,TN
chr19,Bn85678,59922896,88010380,28087484,RLP
chr19,Bn85679,58407309,72219797,13812488,RLP
chr19,Bn85680,2416724,54656746,52240022,CN
chr19,Bn85681,34530454,89835797,55305343,TN
chr19,Bn85682,60793574,81847338,21053764,CNL
chr19,Bn85683,45116090,83592047,38475957,NBS
chr19,Bn85684,87950287,98150265,10199978,TNL
chr19,Bn85685,47783637,59450769,11667132,TNL
chr19,Bn85686,27226210,50194930,22968720,RLK
chr19,Bn85687,6986519,59598235,52611716,RLP
chr19,Bn85688,48929718,64813368,15883650,CNL
chr19,Bn85689,35873233,56059714,20186481,NBS
chr19,Bn85690,64247837,94135136,29887299,RLK
chr19,Bn85691,78696835,82931242,4234407,RLK
chr19,Bn85692,48011149,63773103,15761954,CN
chr19,Bn85693,43753031,95649320,51896289,CNL
chr19,Bn85694,28903693,58860243,29956550,NBS
chr19,Bn85695,8068942,20508511,12439569,RLK
chr19,Bn85696,30628927,91408677,60779750,RLK
chr19,Bn85697,50136119,64549187,14413068,RLK
chr19,Bn85698,76500279,94572949,18072670,RLK
chr19,Bn85699,84158329,92840323,8681994,TNL
chr19,Bn85700,89768771,91190197,1421426,CN
chr19,Bn85701,26652896,86620144,59967248,NBS
chr19,Bn85702,42194036,45128672,2934636,CN
chr19,Bn85703,81866767,99994996,18128229,NBS
chr19,Bn85704,60365794,82734206,22368412,TNL
chr19,Bn85705,35240220,62721079,27480859,TNL
chr19,Bn85706,83208246,87673047,4464801,TN
chr19,Bn85707,60835243,88850871,28015628,NBS
chr19,Bn85708,66220145,94386188,28166043,RLK
chr19,Bn85709,15409303,15468226,58923,NBS
chr19,Bn85710,64827150,95213490,30386340,NBS
chr19,Bn85711,53804534,67209469,13404935,CN
chr19,Bn85712,90467293,94995051,4527758,TNL
chr19,Bn85713,58372895,75814261,17441366,TN
chr19,Bn85714,15985005,75523827,59538822,NBS
chr19,Bn85715,91460453,94406479,2946026,TN
chr19,Bn85716,26949312,60984387,34035075,RLP
chr19,Bn85717,58119216,70899029,12779813,CNL
chr19,Bn85718,35614978,60728245,25113267,NBS
chr19,Bn85719,48517921,55278597,6760676,RLP
chr19,Bn85720,35148137,83977378,48829241,CNL
chr19,Bn85721,42242726,98687807,56445081,RLK
chr19,Bn85722,29369686,60149569,30779883,CNL
chr19,Bn85723,29318784,43811505,14492721,CNL
chr19,Bn85724,74269921,82542951,8273030,RLP
chr19,Bn85725,49176216,59774411,10598195,RLK
chr19,Bn85726,86005140,96029578,10024438,RLP
chr19,Bn85727,26150795,67348896,41198101,CNL
chr19,Bn85728,67239274,76260879,9021605,TN
chr19,Bn85729,27796247,97628877,69832630,CN
chr19,Bn85730,22372798,37980824,15608026,TNL
chr19,Bn85731,40356627,78661981,38305354,CN
chr19,Bn85732,2580423,16694354,14113931,CN
chr19,Bn85733,85331177,92119572,6788395,CNL
chr19,Bn85734,91298702,91891750,593048,CNL
chr19,Bn85735,89301017,99591158,10290141,TNL
chr19,Bn85736,7804728,67851791,60047063,TNL
chr19,Bn85737,20015300,96457671,76442371,TNL
chr19,Bn85738,83055287,92941607,9886320,TN
chr19,Bn85739,13006430,70114755,57108325,NBS
chr19,Bn85740,32274827,49511545,17236718,RLK
chr19,Bn85741,34105579,73383748,39278169,NBS
chr19,Bn85742,71822556,73340005,1517449,TN
chr19,Bn85743,97762344,99089761,1327417,NBS
chr19,Bn85744,68295653,82238994,13943341,RLP
chr19,Bn85745,85675971,88070500,2394529,RLP
chr19,Bn85746,95911688,97721852,1810164,CN
chr19,Bn85747,6314112,91086228,84772116,TNL
chr19,Bn85748,72706035,95414576,22708541,RLP
chr19,Bn85749,16491768,20504780,4013012,TN
chr19,Bn85750,65878496,68349928,2471432,CN
chr19,Bn85751,58446157,61499690,3053533,CN
chr19,Bn85752,52088538,62954152,10865614,RLP
chr19,Bn85753,23788402,73712631,49924229,TN
chr19,Bn85754,13712841,28843065,15130224,CN
chr19,Bn85755,45144717,64595783,19451066,TN
chr19,Bn85756,74351646,76863121,2511475,CNL
chr19,Bn85757,64326336,75049878,10723542,NBS
chr19,Bn85758,2186066,89345112,87159046,CNL
chr19,Bn85759,94847988,95439175,591187,TN
chr19,Bn85760,69446629,78966418,9519789,TNL
chr19,Bn85761,86674961,89628166,2953205,CN
chr19,Bn85762,82559861,87560971,5001110,CNL
chr19,Bn85763,52431986,81831092,29399106,NBS
chr19,Bn85764,59612170,69702909,10090739,NBS
chr19,Bn85765,90257607,94200396,3942789,RLK
chr19,Bn85766,26028779,49953459,23924680,RLK
chr19,Bn85767,77225800,95996070,18770270,RLP
chr19,Bn85768,33178157,33643239,465082,TNL
chr19,Bn85769,73708224,76867765,3159541,TN
chr19,Bn85770,12668667,53736571,41067904,TN
chr19,Bn85771,54264780,98452383,44187603,CN
chr19,Bn85772,99251977,99757225,505248,CN
chr19,Bn85773,17735532,27087705,9352173,TN
chr19,Bn85774,5933004,41558560,35625556,CNL
chr19,Bn85775,24194602,24577552,382950,RLP
chr19,Bn85776,23098521,60919863,37821342,TNL
chr19,Bn85777,61576836,69321278,7744442,CNL
chr19,Bn85778,2848349,77652851,74804502,TNL
chr19,Bn85779,63888197,92937701,29049504,TN
chr19,Bn85780,72824640,88138971,15314331,NBS
chr19,Bn85781,88272847,94422289,6149442,TN
chr19,Bn85782,73143747,83273556,10129809,NBS
chr19,Bn85783,23079445,56479415,33399970,NBS
chr19,Bn85784,17165477,70825374,53659897,CNL
chr19,Bn85785,40047607,75141664,35094057,CNL
chr19,Bn85786,58222596,87994721,29772125,TNL
chr19,Bn85787,70835040,73953197,3118157,CN
chr19,Bn85788,14068098,77939294,63871196,RLP
chr19,Bn85789,38118575,54614517,16495942,RLP
chr19,Bn85790,37883730,52001714,14117984,CN
chr19,Bn85791,86714393,97486526,10772133,NBS
chr19,Bn85792,62654025,97540140,34886115,NBS
chr19,Bn85793,31466314,99467489,68001175,NBS
chr19,Bn85794,56480583,99479600,42999017,TNL
chr19,Bn85795,43011841,56132614,13120773,RLP
chr19,Bn85796,1385459,42655616,41270157,TNL
chr19,Bn85797,17844859,60353773,42508914,TNL
chr19,Bn85798,10963511,16363643,5400132,TNL
chr19,Bn85799,76339050,87396441,11057391,RLP
chr19,Bn85800,30268803,37318229,7049426,TNL
chr19,Bn85801,70074254,95940338,25866084,CNL
chr19,Bn85802,36959535,40687695,3728160,CNL
chr19,Bn85803,4715403,63920562,59205159,NBS
chr19,Bn85804,87780419,92432534,4652115,TNL
chr19,Bn85805,29810382,59686015,29875633,TN
chr19,Bn85806,6083391,81418309,75334918,RLK
chr19,Bn85807,52420175,79486130,27065955,NBS
chr19,Bn85808,51984135,82286369,30302234,TN
chr19,Bn85809,37199588,52576411,15376823,CNL
chr19,Bn85810,44808472,89106850,44298378,TN
chr19,Bn85811,18661541,28024056,9362515,TNL
chr19,Bn85812,10071593,66622408,56550815,RLK
chr19,Bn85813,25390444,57917606,32527162,NBS
chr19,Bn85814,50860141,93977238,43117097,TNL
chr19,Bn85815,76409405,91840498,15431093,NBS
chr19,Bn85816,70525915,85501183,14975268,TN
chr19,Bn85817,62123133,76432576,14309443,CNL
chr19,Bn85818,64148195,72825477,8677282,TN
chr19,Bn85819,88751388,89437038,685650,RLK
chr19,Bn85820,54884791,70590067,15705276,TN
chr19,Bn85821,92739553,93812981,1073428,TN
chr19,Bn85822,82959661,91906636,8946975,RLP
chr19,Bn85823,48927204,84234891,35307687,CNL
chr19,Bn85824,93284328,93835314,550986,CN
chr19,Bn85825,26448641,33064000,6615359,RLP
chr19,Bn85826,18033198,28332007,10298809,CNL
chr19,Bn85827,41926759,62624035,20697276,TN
chr19,Bn85828,88109444,97303141,9193697,NBS
chr19,Bn85829,28651385,92165493,63514108,TNL
chr19,Bn85830,23600925,63284893,39683968,NBS
chr19,Bn85831,99501695,99834785,333090,NBS
chr19,Bn85832,35788146,96608919,60820773,NBS
chr19,Bn85833,15750154,76200252,60450098,RLP
chr19,Bn85834,59409814,61236279,1826465,RLK
chr19,Bn85835,12207241,99001578,86794337,TN
chr19,Bn85836,89932820,97545396,7612576,RLP
chr19,Bn85837,43469041,83939756,40470715,TNL
chr19,Bn85838,82590842,92394635,9803793,RLP
chr19,Bn85839,63301239,88612929,25311690,RLP
chr19,Bn85840,10041393,51129464,41088071,TN
chr19,Bn85841,27032546,41815892,14783346,RLP
chr19,Bn85842,6342364,64158403,57816039,RLP
chr19,Bn85843,58316901,97347966,39031065,NBS
chr19,Bn85844,43059996,80395462,37335466,NBS
chr19,Bn85845,14741101,60194746,45453645,TN
chr19,Bn85846,61786075,74718342,12932267,TN
chr19,Bn85847,41090665,67526196,26435531,TNL
chr19,Bn85848,29538704,94121159,64582455,RLP
chr19,Bn85849,18167425,43216493,25049068,TNL
chr19,Bn85850,81675205,85893359,4218154,NBS
chr19,Bn85851,94377368,94938157,560789,CN
chr19,Bn85852,90996995,94058632,3061637,RLP
chr19,Bn85853,7854527,71342915,63488388,CNL
chr19,Bn85854,34870538,77668348,42797810,CN
chr19,Bn85855,16250327,96192156,79941829,NBS
chr19,Bn85856,44909117,90215109,45305992,TN
chr19,Bn85857,35278829,82136469,46857640,CNL
chr19,Bn85858,29090266,57258159,28167893,CN
chr19,Bn85859,47008206,88352650,41344444,RLP
chr19,Bn85860,89247061,93930013,4682952,TNL
chr19,Bn85861,24248125,85192249,60944124,TNL
chr19,Bn85862,9590435,17860300,8269865,CN
chr19,Bn85863,21489359,88074407,66585048,CN
chr19,Bn85864,51586034,98609250,47023216,RLK
chr19,Bn85865,73590664,98090028,24499364,RLK
chr19,Bn85866,8178987,73003478,64824491,TN
chr19,Bn85867,34193020,86952997,52759977,CNL
chr19,Bn85868,59854816,85447030,25592214,CNL
chr19,Bn85869,43771792,67494251,23722459,CNL
chr19,Bn85870,34995621,86888179,51892558,TNL
chr19,Bn85871,18272062,87776691,69504629,RLK
chr19,Bn85872,45887166,49889828,4002662,TN
chr19,Bn85873,11005181,52641353,41636172,CN
chr19,Bn85874,15847284,91230029,75382745,NBS
chr19,Bn85875,40311120,44397111,4085991,TN
chr19,Bn85876,37183413,83965144,46781731,NBS
chr19,Bn85877,27505525,69442658,41937133,NBS
chr19,Bn85878,88495670,89109275,613605,RLK
chr19,Bn85879,21567403,33879353,12311950,RLP
chr19,Bn85880,41816620,49859306,8042686,CNL
chr19,Bn85881,52928007,91166694,38238687,CN
chr19,Bn85882,64543105,87678232,23135127,CNL
chr19,Bn85883,89589067,97437713,7848646,TN
chr19,Bn85884,32097045,66285196,34188151,NBS
chr19,Bn85885,14916288,59594865,44678577,TNL
chr19,Bn85886,43900791,78763697,34862906,TNL
chr19,Bn85887,96962002,97696044,734042,NBS
chr19,Bn85888,5224643,84461886,79237243,RLK
chr19,Bn85889,10992585,72686088,61693503,NBS
chr19,Bn85890,91474140,97502302,6028162,RLP
chr19,Bn85891,66034654,88694677,22660023,CN
chr19,Bn85892,71713460,76352909,4639449,CN
chr19,Bn85893,11754968,24676692,12921724,TNL
chr19,Bn85894,9366140,96045597,86679457,RLK
chr19,Bn85895,10903556,69457251,58553695,NBS
chr19,Bn85896,89398812,90807968,1409156,NBS
chr19,Bn85897,61630614,98852686,37222072,CN
chr19,Bn85898,94513727,94772594,258867,CN
chr19,Bn85899,71250243,96830132,25579889,NBS
chr19,Bn85900,49564092,55260037,5695945,TNL
chr19,Bn85901,2447154,66054445,63607291,RLP
chr19,Bn85902,87915409,97391911,9476502,TNL
chr19,Bn85903,87502604,95826748,8324144,RLK
chr19,Bn85904,39871463,83121980,43250517,TN
chr19,Bn85905,97319188,99273481,1954293,NBS
chr19,Bn85906,49850779,72124235,22273456,TNL
chr19,Bn85907,91251685,99456286,8204601,RLK
chr19,Bn85908,38752139,54749334,15997195,RLP
chr19,Bn85909,88099251,93058129,4958878,TN
chr19,Bn85910,35975597,52398871,16423274,RLK
chr19,Bn85911,25661513,98695677,73034164,TNL
chr19,Bn85912,48756083,63230518,14474435,CNL
chr19,Bn85913,45224221,90851686,45627465,NBS
chr19,Bn85914,96301911,97005211,703300,RLP
chr19,Bn85915,70405949,96895835,26489886,CNL
chr19,Bn85916,39844677,85460138,45615461,RLK
chr19,Bn85917,42024237,95983073,53958836,TN
chr19,Bn85918,68624425,83231692,14607267,TN
chr19,Bn85919,92538010,99207546,6669536,CN
chr19,Bn85920,39584369,96056460,56472091,RLK
chr19,Bn85921,22664104,81172957,58508853,NBS
chr19,Bn85922,58065898,89464483,31398585,CN
chr19,Bn85923,54086966,89237901,35150935,RLP
chr19,Bn85924,7394071,14158322,6764251,NBS
chr19,Bn85925,4012486,30929778,26917292,RLP
chr19,Bn85926,17609675,70632509,53022834,CN
chr19,Bn85927,69344527,98161775,28817248,CNL
chr19,Bn85928,48744712,97131278,48386566,TNL
chr19,Bn85929,82188403,88647092,6458689,CNL
chr19,Bn85930,59758262,67755065,7996803,CN
chr19,Bn85931,39803586,92281905,52478319,CN
chr19,Bn85932,4608310,55061707,50453397,RLP
chr19,Bn85933,6685113,88188850,81503737,RLK
chr19,Bn85934,1314873,27395473,26080600,TNL
chr19,Bn85935,65665499,86699693,21034194,CN
chr19,Bn85936,44063576,52308538,8244962,NBS
chr19,Bn85937,57031307,96617158,39585851,TNL
chr19,Bn85938,80515832,95475847,14960015,CNL
chr19,Bn85939,26019288,36245474,10226186,CN
chr19,Bn85940,81592387,82614147,1021760,CNL
chr19,Bn85941,49231136,60946284,11715148,TNL
chr19,Bn85942,16731258,75674045,58942787,CNL
chr19,Bn85943,84478287,84582865,104578,TNL
chr19,Bn85944,83780836,88074529,4293693,CN
chr19,Bn85945,55689588,96966335,41276747,TNL
chr19,Bn85946,95604385,99898452,4294067,CNL
chr19,Bn85947,40952298,74587787,33635489,RLP
chr19,Bn85948,28235304,46829260,18593956,TN
chr19,Bn85949,52689755,57365401,4675646,TN
chr19,Bn85950,48692298,84160860,35468562,NBS
chr19,Bn85951,20978895,33044187,12065292,CN
chr19,Bn85952,66559389,71418729,4859340,TN
chr19,Bn85953,8431023,17381721,8950698,RLK
chr19,Bn85954,24941930,69461422,44519492,TN
chr19,Bn85955,2287973,15763559,13475586,NBS
chr19,Bn85956,81861357,87764749,5903392,CNL
chr19,Bn85957,12150006,80855516,68705510,CN
chr19,Bn85958,10501333,56950514,46449181,TN
chr19,Bn85959,3911446,41140848,37229402,TN
chr19,Bn85960,36032905,63876404,27843499,RLP
chr19,Bn85961,73957917,81283620,7325703,RLK
chr19,Bn85962,41825140,97659941,55834801,RLK
chr19,Bn85963,22741129,79574144,56833015,RLP
chr19,Bn85964,45379841,63608127,18228286,CNL
chr19,Bn85965,58971022,83462177,24491155,NBS
chr19,Bn85966,76519508,80140542,3621034,CN
chr19,Bn85967,77342414,97441723,20099309,CN
chr19,Bn85968,81403503,83903561,2500058,RLK
chr19,Bn85969,95378479,99084156,3705677,TN
chr19,Bn85970,16017502,23107037,7089535,CNL
chr19,Bn85971,63440138,81033736,17593598,TNL
chr19,Bn85972,64032399,84439840,20407441,RLP
chr19,Bn85973,52519578,75996198,23476620,TNL
chr19,Bn85974,80804701,90107345,9302644,TNL
chr19,Bn85975,14275335,60306330,46030995,TNL
chr19,Bn85976,70686568,93516301,22829733,CNL
chr19,Bn85977,75458743,93862106,18403363,RLK
chr19,Bn85978,5773105,72709250,66936145,CN
chr19,Bn85979,79710108,92887907,13177799,TN
chr19,Bn85980,75991424,84860677,8869253,TNL
chr19,Bn85981,2086090,75822538,73736448,TN
chr19,Bn85982,30870525,84984485,54113960,CN
chr19,Bn85983,46879938,92820491,45940553,TNL
chr19,Bn85984,14411993,55960605,41548612,CNL
chr19,Bn85985,97419192,97961308,542116,CN
chr19,Bn85986,24555429,90904082,66348653,NBS
chr19,Bn85987,27615261,78662086,51046825,CN
chr19,Bn85988,14000211,91953966,77953755,NBS
chr19,Bn85989,86265032,87069355,804323,NBS
chr19,Bn85990,29986873,65386022,35399149,RLK
chr19,Bn85991,39846763,65002534,25155771,TN
chr19,Bn85992,67553240,99043796,31490556,RLK
chr19,Bn85993,90267223,91405931,1138708,TNL
chr19,Bn85994,56223149,75753381,19530232,CN
chr19,Bn85995,93972884,97375637,3402753,NBS
chr19,Bn85996,26768880,38098545,11329665,NBS
chr19,Bn85997,6060428,85449222,79388794,RLK
chr19,Bn85998,35891344,71852702,35961358,NBS
chr19,Bn85999,6139159,88278752,82139593,NBS
chr19,Bn86000,19540635,73534747,53994112,CNL
chr19,Bn86001,64257661,64574607,316946,TN
chr19,Bn86002,41283265,69570085,28286820,CNL
chr19,Bn86003,13182748,93079290,79896542,TN
chr19,Bn86004,43716575,46436605,2720030,TNL
chr19,Bn86005,42513293,70500224,27986931,CNL
chr19,Bn86006,25130797,68804653,43673856,RLK
chr19,Bn86007,82161351,97922002,15760651,CN
chr19,Bn86008,22970188,77937137,54966949,RLK
chr19,Bn86009,73414507,80561521,7147014,RLK
chr19,Bn86010,84091014,90737495,6646481,TNL
chr19,Bn86011,69990019,98279069,28289050,CN
chr19,Bn86012,24890852,91566547,66675695,RLP
chr19,Bn86013,59155798,63460342,4304544,RLK
chr19,Bn86014,18081534,78558658,60477124,RLP
chr19,Bn86015,68669749,99380932,30711183,TNL
chr19,Bn86016,45984120,86728849,40744729,NBS
chr19,Bn86017,73525996,99978024,26452028,RLP
chr19,Bn86018,3582710,73897802,70315092,CNL
chr19,Bn86019,10543325,78136401,67593076,RLP
chr19,Bn86020,95278107,99114821,3836714,CNL
chr19,Bn86021,62331599,83621466,21289867,RLK
chr19,Bn86022,75495820,95402353,19906533,TN
chr19,Bn86023,21429554,99252455,77822901,CNL
chr19,Bn86024,22228491,26075703,3847212,RLK
chr19,Bn86025,26788224,97117692,70329468,TN
chr19,Bn86026,80446023,84421575,3975552,RLP
chr19,Bn86027,32313062,47233573,14920511,NBS
chr19,Bn86028,84159123,86476802,2317679,RLP
chr19,Bn86029,96704542,96762962,58420,RLP
chr19,Bn86030,33931824,36984781,3052957,CN
chr19,Bn86031,21784810,58402760,36617950,TN
chr19,Bn86032,46385549,61323800,14938251,TNL
chr19,Bn86033,73825929,91175355,17349426,TN
chr19,Bn86034,61869001,94937434,33068433,RLK
chr19,Bn86035,42034934,95661176,53626242,CNL
chr19,Bn86036,88129132,95359229,7230097,CNL
chr19,Bn86037,5256284,21855469,16599185,CNL
chr19,Bn86038,58446361,66375166,7928805,TN
chr19,Bn86039,35388334,61409831,26021497,RLP
chr19,Bn86040,64588666,91299844,26711178,TN
chr19,Bn86041,11392880,87311303,75918423,CNL
chr19,Bn86042,87615123,98778811,11163688,RLP
chr19,Bn86043,49604129,73793050,24188921,NBS
chr19,Bn86044,28290494,30066208,1775714,RLP
chr19,Bn86045,41862357,71501413,29639056,CN
chr19,Bn86046,29377397,79815394,50437997,RLP
chr19,Bn86047,42397139,54326216,11929077,TNL
chr19,Bn86048,58450758,87995313,29544555,CN
chr19,Bn86049,26296989,90711976,64414987,TN
chr19,Bn86050,11004058,38255064,27251006,CNL
chr19,Bn86051,85046968,88027795,2980827,RLP
chr19,Bn86052,99887161,99901675,14514,NBS
chr19,Bn86053,72352683,97995341,25642658,RLK
chr19,Bn86054,2191326,84727532,82536206,CNL
chr19,Bn86055,11047227,91352525,80305298,TN
chr19,Bn86056,4334312,8717642,4383330,CN
chr19,Bn86057,63495515,91566858,28071343,TNL
chr19,Bn86058,66942453,79169147,12226694,NBS
chr19,Bn86059,59108899,96372622,37263723,CNL
chr19,Bn86060,44063122,52998690,8935568,CNL
chr19,Bn86061,44404427,60296718,15892291,TN
chr19,Bn86062,48941598,81132444,32190846,CN
chr19,Bn86063,51388562,62679595,11291033,CN
chr19,Bn86064,49590321,55459173,5868852,RLP
chr19,Bn86065,47580531,59976960,12396429,RLP
chr19,Bn86066,5862387,23547521,17685134,RLK
chr19,Bn86067,32677055,56999291,24322236,RLP
chr19,Bn86068,19078455,66299500,47221045,CNL
chr19,Bn86069,27577819,97496895,69919076,TN
chr19,Bn86070,74653100,87767447,13114347,CNL
chr19,Bn86071,75430039,99884807,24454768,CNL
chr19,Bn86072,39789387,96180236,56390849,NBS
chr19,Bn86073,71558557,82542718,10984161,NBS
chr19,Bn86074,83419996,93704622,10284626,NBS
chr19,Bn86075,64634444,82979548,18345104,TN
chr19,Bn86076,84679104,92747268,8068164,RLK
chr19,Bn86077,1265397,94258954,92993557,TNL
chr19,Bn86078,57947530,93358261,35410731,TNL
chr19,Bn86079,27565354,41353450,13788096,TN
chr19,Bn86080,81061854,90666952,9605098,RLP
chr19,Bn86081,78769532,86177419,7407887,NBS
chr19,Bn86082,23523397,27738190,4214793,TN
chr19,Bn86083,42969273,48671137,5701864,RLP
chr19,Bn86084,51660857,64776817,13115960,NBS
chr19,Bn86085,61745914,74855583,13109669,NBS
chr19,Bn86086,56451751,64187866,7736115,RLP
chr19,Bn86087,19865548,70092416,50226868,NBS
chr19,Bn86088,61511749,94180257,32668508,RLP
chr19,Bn86089,26800940,53968970,27168030,RLP
chr19,Bn86090,7173378,76173441,69000063,CN
chr19,Bn86091,68740955,97545429,28804474,TN
chr19,Bn86092,33403901,48568903,15165002,CNL
chr19,Bn86093,53935410,90464027,36528617,NBS
chr19,Bn86094,96097014,96534035,437021,CNL
chr19,Bn86095,86757172,94994000,8236828,RLP
chr19,Bn86096,5727528,68755440,63027912,CN
chr19,Bn86097,49212439,77078423,27865984,TNL
chr19,Bn86098,97618134,98905547,1287413,TNL
chr19,Bn86099,80740584,95035162,14294578,NBS
chr19,Bn86100,35261451,88917401,53655950,TN
chr19,Bn86101,57557967,68892112,11334145,CNL
chr19,Bn86102,13282075,85628389,72346314,TNL
chr19,Bn86103,55561969,60798938,5236969,NBS
chr19,Bn86104,44251257,67457213,23205956,CNL
chr19,Bn86105,10236198,38964143,28727945,RLK
chr19,Bn86106,7905509,35694876,27789367,CN
chr19,Bn86107,10503881,15995501,5491620,RLK
chr19,Bn86108,81337292,91571375,10234083,NBS
chr19,Bn86109,52313471,67101500,14788029,RLK
chr19,Bn86110,31954271,36480402,4526131,RLP
chr19,Bn86111,74209809,87031760,12821951,CNL
chr19,Bn86112,80536911,86028056,5491145,TN
chr19,Bn86113,48532591,78023887,29491296,CNL
chr19,Bn86114,44016784,75936893,31920109,CN
chr19,Bn86115,55748816,77569748,21820932,RLP
chr19,Bn86116,39609437,53106649,13497212,CN
chr19,Bn86117,15727053,23556429,7829376,RLK
chr19,Bn86118,65549115,68313911,2764796,CNL
chr19,Bn86119,99183687,99616167,432480,TNL
chr19,Bn86120,66706802,88324214,21617412,CN
chr19,Bn86121,28076001,64553304,36477303,CNL
chr19,Bn86122,10894438,86952407,76057969,CNL
chr19,Bn86123,98839028,99390494,551466,CN
chr19,Bn86124,30780328,83796479,53016151,RLP
chr19,Bn86125,78326880,80405350,2078470,RLK
chr19,Bn86126,64219466,70186799,5967333,RLK
chr19,Bn86127,60507315,92151190,31643875,TNL
chr19,Bn86128,42887093,74320981,31433888,TNL
chr19,Bn86129,49515414,63031890,13516476,TNL
chr19,Bn86130,56562376,70142505,13580129,TN
chr19,Bn86131,12453994,88755957,76301963,RLP
chr19,Bn86132,52146594,68748899,16602305,RLK
chr19,Bn86133,56991972,73336886,16344914,TN
chr19,Bn86134,67735318,98174744,30439426,CN
chr19,Bn86135,15472598,44955677,29483079,CN
chr19,Bn86136,36693184,39459719,2766535,CN
chr19,Bn86137,29043740,48233479,19189739,RLK
chr19,Bn86138,94903638,99638860,4735222,NBS
chr19,Bn86139,83577995,87934702,4356707,CNL
chr19,Bn86140,87155772,91236903,4081131,TNL
chr19,Bn86141,17960186,40863209,22903023,TNL
chr19,Bn86142,12344459,24180393,11835934,RLP
chr19,Bn86143,39250541,67488004,28237463,NBS
chr19,Bn86144,54768754,81339966,26571212,RLP
chr19,Bn86145,60144255,69865689,9721434,TNL
chr19,Bn86146,30013757,60181238,30167481,RLP
chr19,Bn86147,18090103,65014809,46924706,CNL
chr19,Bn86148,28686039,66649960,37963921,CN
chr19,Bn86149,99917478,99994159,76681,RLK
chr19,Bn86150,50915181,89429253,38514072,TNL
chr19,Bn86151,91982181,95724986,3742805,RLP
chr19,Bn86152,84190834,95938143,11747309,CN
chr19,Bn86153,66736493,80773068,14036575,CN
chr19,Bn86154,18965242,57953115,38987873,CNL
chr19,Bn86155,55654009,78360654,22706645,NBS
chr19,Bn86156,97184958,98816182,1631224,TN
chr19,Bn86157,17037078,63894567,46857489,RLP
chr19,Bn86158,37033297,42954155,5920858,NBS
chr19,Bn86159,46999924,92369459,45369535,RLK
chr19,Bn86160,3229587,12154749,8925162,RLK
chr19,Bn86161,69766397,76774189,7007792,CNL
chr19,Bn86162,40738850,64513471,23774621,RLK
chr19,Bn86163,70202188,76973913,6771725,CNL
chr19,Bn86164,95987082,98149249,2162167,TN
chr19,Bn86165,4101794,64943173,60841379,TNL
chr19,Bn86166,78943578,91850276,12906698,RLK
chr19,Bn86167,64766053,86304668,21538615,CNL
chr19,Bn86168,18591666,96206541,77614875,CN
chr19,Bn86169,58332219,99491240,41159021,RLP
chr19,Bn86170,11331189,15643317,4312128,RLK
chr19,Bn86171,70985917,82060030,11074113,CNL
chr19,Bn86172,55683324,70527957,14844633,NBS
chr19,Bn86173,95856984,96202299,345315,RLK
chr19,Bn86174,49743558,79282677,29539119,RLK
chr19,Bn86175,36680504,58624854,21944350,NBS
chr19,Bn86176,85948811,92311586,6362775,NBS
chr19,Bn86177,85269149,99715766,14446617,RLP
chr19,Bn86178,22078447,95986753,73908306,NBS
chr19,Bn86179,57263601,87885372,30621771,TNL
chr19,Bn86180,26858681,37132186,10273505,TNL
chr19,Bn86181,51732531,64576077,12843546,CN
chr19,Bn86182,45218314,86498439,41280125,CNL
chr19,Bn86183,73908968,97638477,23729509,TNL
chr19,Bn86184,37610856,82548269,44937413,CN
chr19,Bn86185,55245757,64990334,9744577,CNL
chr19,Bn86186,71926799,83063087,11136288,RLK
chr19,Bn86187,20740396,69137966,48397570,NBS
chr19,Bn86188,7879083,28853938,20974855,RLP
chr19,Bn86189,14438741,33573800,19135059,TN
chr19,Bn86190,92300094,98803033,6502939,TNL
chr19,Bn86191,70498370,91912610,21414240,CN
chr19,Bn86192,14414033,21042572,6628539,CN
chr19,Bn86193,37514094,81951930,44437836,RLP
chr19,Bn86194,25092194,69633512,44541318,TNL
chr19,Bn86195,16019162,38512612,22493450,RLK
chr19,Bn86196,34051307,64978385,30927078,RLK
chr19,Bn86197,17439459,24527661,7088202,RLK
chr19,Bn86198,91771799,98036761,6264962,CN
chr19,Bn86199,33498596,60314551,26815955,CN
chr19,Bn86200,2943539,29450132,26506593,CNL
chr19,Bn86201,98743173,99163224,420051,NBS
chr19,Bn86202,48595097,84221585,35626488,NBS
chr19,Bn86203,10329101,47041472,36712371,RLP
chr19,Bn86204,33526324,50423765,16897441,CNL
chr19,Bn86205,16479854,32300105,15820251,NBS
chr19,Bn86206,57299179,87459426,30160247,NBS
chr19,Bn86207,44535241,75206246,30671005,CNL
chr19,Bn86208,76137932,86759788,10621856,RLP
chr19,Bn86209,57018103,89898645,32880542,RLP
chr19,Bn86210,10938829,60991712,50052883,RLP
chr19,Bn86211,4930750,21174503,16243753,CN
chr19,Bn86212,83412147,92885566,9473419,TN
chr19,Bn86213,92928916,96569532,3640616,TNL
chr19,Bn86214,26382269,33224018,6841749,RLP
chr19,Bn86215,34191912,76852179,42660267,CN
chr19,Bn86216,14801290,90758578,75957288,TN
chr19,Bn86217,14436138,87458248,73022110,RLK
chr19,Bn86218,81086991,96904282,15817291,RLK
chr19,Bn86219,85142437,85954033,811596,RLP
chr19,Bn86220,14226706,86506828,72280122,RLP
chr19,Bn86221,5833081,33003415,27170334,NBS
chr19,Bn86222,71054705,94169777,23115072,RLK
chr19,Bn86223,85113185,88587857,3474672,TN
chr19,Bn86224,42328878,76316706,33987828,RLP
chr19,Bn86225,98261708,98383846,122138,CNL
chr19,Bn86226,28700639,59189490,30488851,CNL
chr19,Bn86227,3318371,93190784,89872413,NBS
chr19,Bn86228,69457740,78105462,8647722,RLP
chr19,Bn86229,66162835,95200020,29037185,RLK
chr19,Bn86230,95216551,96586583,1370032,NBS
chr19,Bn86231,37103433,58596214,21492781,TN
chr19,Bn86232,91604428,98384444,6780016,TN
chr19,Bn86233,40747137,44856454,4109317,CNL
chr19,Bn86234,24387599,29608979,5221380,CN
chr19,Bn86235,21603421,25383424,3780003,TN
chr19,Bn86236,86547647,93949732,7402085,CNL
chr19,Bn86237,17116949,45794772,28677823,CN
chr19,Bn86238,45209302,83203099,37993797,TNL
chr19,Bn86239,81843288,99323445,17480157,NBS
chr19,Bn86240,28768808,84041623,55272815,TN
chr19,Bn86241,83600248,96906536,13306288,RLP
chr19,Bn86242,9626875,37582436,27955561,RLK
chr19,Bn86243,1028345,65370076,64341731,TN
chr19,Bn86244,33961456,74116931,40155475,TNL
chr19,Bn86245,6204814,29798662,23593848,CN
chr19,Bn86246,26374347,66189346,39814999,RLP
chr19,Bn86247,84310266,88372565,4062299,NBS
chr19,Bn86248,6980132,84488767,77508635,CN
chr19,Bn86249,66925780,98603843,31678063,RLP
chr19,Bn86250,80242223,96677784,16435561,TNL
chr19,Bn86251,55465608,68178472,12712864,TNL
chr19,Bn86252,40389927,78852617,38462690,RLP
chr19,Bn86253,79576300,92848041,13271741,NBS
chr19,Bn86254,64908377,93730510,28822133,RLK
chr19,Bn86255,19048772,37810902,18762130,TN
chr19,Bn86256,87369205,99230792,11861587,RLK
chr19,Bn86257,62203204,83627957,21424753,RLP
chr19,Bn86258,43671697,79564524,35892827,CNL
chr19,Bn86259,71908087,73136384,1228297,RLK
chr19,Bn86260,24069707,47773879,23704172,NBS
chr19,Bn86261,50528529,70212170,19683641,RLP
chr19,Bn86262,64830746,71944044,7113298,TN
chr19,Bn86263,98641855,98770484,128629,CN
chr19,Bn86264,34434130,43259679,8825549,RLP
chr19,Bn86265,50665924,79825824,29159900,NBS
chr19,Bn86266,63800192,70207426,6407234,RLK
chr19,Bn86267,68283819,69377867,1094048,CN
chr19,Bn86268,77163841,95347132,18183291,TNL
chr19,Bn86269,81284657,86733299,5448642,CNL
chr19,Bn86270,37610509,59230260,21619751,CNL
chr19,Bn86271,24535782,61827225,37291443,TNL
chr19,Bn86272,9233212,94479463,85246251,TNL
chr19,Bn86273,34273817,73927785,39653968,RLP
chr19,Bn86274,87398476,99039064,11640588,RLK
chr19,Bn86275,57176589,73378682,16202093,NBS
chr19,Bn86276,54210103,62941210,8731107,TN
chr19,Bn86277,22578347,38241653,15663306,RLK
chr19,Bn86278,37604997,98947398,61342401,NBS
chr19,Bn86279,72840102,76786028,3945926,RLP
chr19,Bn86280,79696145,95263560,15567415,RLP
chr19,Bn86281,48908125,96287947,47379822,TN
chr19,Bn86282,59113740,92423202,33309462,RLP
chr19,Bn86283,54266686,56185843,1919157,CN
chr19,Bn86284,25011576,34219322,9207746,RLK
chr19,Bn86285,14152287,20006723,5854436,TNL
chr19,Bn86286,1671892,44749093,43077201,CN
chr19,Bn86287,44705152,68701634,23996482,TNL
chr19,Bn86288,68718018,91499503,22781485,RLP
chr19,Bn86289,52224972,79007845,26782873,CN
chr19,Bn86290,43360116,95521582,52161466,RLP
chr19,Bn86291,13624802,52896757,39271955,RLK
chr19,Bn86292,10585857,21349634,10763777,RLP
chr19,Bn86293,50295361,94309554,44014193,NBS
chr19,Bn86294,4988406,92579415,87591009,RLK
chr19,Bn86295,61412755,89528119,28115364,CNL
chr19,Bn86296,45174572,64671389,19496817,TN
chr19,Bn86297,87872933,96775162,8902229,RLK
chr19,Bn86298,10855713,47384422,36528709,NBS
chr19,Bn86299,9056897,88948470,79891573,TNL
chr19,Bn86300,19817068,45919280,26102212,CN
chr19,Bn86301,92574645,94210154,1635509,CN
chr19,Bn86302,59173794,96563386,37389592,CN
chr19,Bn86303,52129722,81022213,28892491,RLK
chr19,Bn86304,30718845,59387559,28668714,RLP
chr19,Bn86305,75142134,96708514,21566380,TN
chr19,Bn86306,97782917,99416344,1633427,TNL
chr19,Bn86307,36726881,74739038,38012157,RLP
chr19,Bn86308,87358217,95503636,8145419,RLP
chr19,Bn86309,95676605,97340141,1663536,CNL
chr19,Bn86310,41121002,94640877,53519875,TNL
chr19,Bn86311,14081374,65801780,51720406,RLP
chr19,Bn86312,40822381,77825917,37003536,CNL
chr19,Bn86313,40941185,95035548,54094363,RLP
chr19,Bn86314,9327464,57056262,47728798,CN
chr19,Bn86315,80916381,87909030,6992649,CN
chr19,Bn86316,64531021,95715209,31184188,TNL
chr19,Bn86317,20293773,55502850,35209077,CN
chr19,Bn86318,14232645,29325708,15093063,RLP
chr19,Bn86319,33182916,93649587,60466671,TN
chr19,Bn86320,44245517,92830034,48584517,RLK
chr19,Bn86321,84299801,85613938,1314137,TN
chr19,Bn86322,29561068,56814803,27253735,TN
chr19,Bn86323,64779089,95340595,30561506,NBS
chr19,Bn86324,22938226,83715884,60777658,CNL
chr19,Bn86325,16529107,59360396,42831289,CNL
chr19,Bn86326,99802321,99817028,14707,RLK
chr19,Bn86327,60877265,74619804,13742539,CNL
chr19,Bn86328,97193275,97391508,198233,TN
chr19,Bn86329,38440077,46930395,8490318,NBS
chr19,Bn86330,56041497,90686787,34645290,TN
chr19,Bn86331,16696438,18874314,2177876,CN
chr19,Bn86332,24449206,64760776,40311570,CN
chr19,Bn86333,59679707,90337492,30657785,TN
chr19,Bn86334,92382458,99958933,7576475,TNL
chr19,Bn86335,35396797,76890672,41493875,TN
chr19,Bn86336,65345341,90961485,25616144,TNL
chr19,Bn86337,17228317,22838437,5610120,CN
chr19,Bn86338,98476864,99603919,1127055,CN
chr19,Bn86339,91457348,97284364,5827016,RLP
chr19,Bn86340,97866675,98489610,622935,TN
chr19,Bn86341,72666342,76526600,3860258,TN
chr19,Bn86342,26521874,48144126,21622252,CNL
chr19,Bn86343,22625178,69314869,46689691,CNL
chr19,Bn86344,30611413,60452701,29841288,CN
chr19,Bn86345,10703507,79794795,69091288,TN
chr19,Bn86346,92537323,95170361,2633038,TNL
chr19,Bn86347,88974384,91699286,2724902,RLP
chr19,Bn86348,7659965,96049547,88389582,CN
chr19,Bn86349,90501716,91880495,1378779,CN
chr19,Bn86350,34473355,93259991,58786636,CN
chr19,Bn86351,25587618,76935648,51348030,RLK
chr19,Bn86352,74515995,78983342,4467347,NBS
chr19,Bn86353,8453455,15025273,6571818,TNL
chr19,Bn86354,29403194,37904748,8501554,CNL
chr19,Bn86355,61752844,95818500,34065656,TN
chr19,Bn86356,29065912,37241102,8175190,TNL
chr19,Bn86357,24138431,51212634,27074203,CNL
chr19,Bn86358,43857906,95884340,52026434,CNL
chr19,Bn86359,80231081,81386845,1155764,CNL
chr19,Bn86360,70730031,97728796,26998765,NBS
chr19,Bn86361,94727053,97519515,2792462,NBS
chr19,Bn86362,87319689,97090238,9770549,CNL
chr19,Bn86363,34436320,70282267,35845947,RLK
chr19,Bn86364,74644714,77392560,2747846,RLK
chr19,Bn86365,21091518,31892367,10800849,RLP
chr19,Bn86366,77852837,93248003,15395166,CN
chr19,Bn86367,28739670,78249687,49510017,NBS
chr19,Bn86368,73789961,81050172,7260211,RLP
chr19,Bn86369,44482828,85725637,41242809,RLK
chr19,Bn86370,16557125,96570968,80013843,CNL
chr19,Bn86371,88428026,89517941,1089915,TNL
chr19,Bn86372,46351758,86893846,40542088,RLK
chr19,Bn86373,7996187,64351362,56355175,RLK
chr19,Bn86374,97572986,98430382,857396,RLK
chr19,Bn86375,67363928,82181673,14817745,CN
chr19,Bn86376,39107579,67390340,28282761,CN
chr19,Bn86377,91700844,99561940,7861096,CNL
chr19,Bn86378,41248645,89202020,47953375,CNL
chr19,Bn86379,4772954,13287800,8514846,NBS
chr19,Bn86380,75851003,82467969,6616966,CNL
chr19,Bn86381,13460794,30580762,17119968,NBS
chr19,Bn86382,12270319,42280991,30010672,NBS
chr19,Bn86383,41207238,76691043,35483805,RLK
chr19,Bn86384,30519361,74972023,44452662,TN
chr19,Bn86385,17397081,68707879,51310798,CNL
chr19,Bn86386,94587430,97977983,3390553,RLP
chr19,Bn86387,69670215,99436226,29766011,RLP
chr19,Bn86388,40744372,96488847,55744475,NBS
chr19,Bn86389,25351707,45179384,19827677,TNL
chr19,Bn86390,41036944,56628352,15591408,TNL
chr19,Bn86391,85811451,90466000,4654549,CNL
chr19,Bn86392,58796749,86863316,28066567,CNL
chr19,Bn86393,8133033,10907306,2774273,TNL
chr19,Bn86394,37664025,76231180,38567155,RLK
chr19,Bn86395,19111494,65961638,46850144,CNL
chr19,Bn86396,65630540,82938473,17307933,RLP
chr19,Bn86397,81836465,95909621,14073156,RLK
chr19,Bn86398,9551860,72609544,63057684,TN
chr19,Bn86399,30601550,78637629,48036079,RLK
chr19,Bn86400,85280205,88568838,3288633,TN
chr19,Bn86401,85764445,89452239,3687794,RLK
chr19,Bn86402,73681318,88874875,15193557,TNL
chr19,Bn86403,78064411,89132913,11068502,RLK
chr19,Bn86404,36499410,90265642,53766232,CNL
chr19,Bn86405,47594198,88489927,40895729,RLP
chr19,Bn86406,26891266,58256043,31364777,NBS
chr19,Bn86407,5243709,71608265,66364556,CNL
chr19,Bn86408,26036598,43399340,17362742,RLK
chr19,Bn86409,9502349,38700104,29197755,TNL
chr19,Bn86410,98380429,99266687,886258,TNL
chr19,Bn86411,31347617,50147555,18799938,TN
chr19,Bn86412,95007333,99227608,4220275,RLP
chr19,Bn86413,32398109,75806201,43408092,CNL
chr19,Bn86414,93612599,93846396,233797,RLK
chr19,Bn86415,57565823,85980571,28414748,NBS
chr19,Bn86416,69901300,72042080,2140780,RLP
chr19,Bn86417,85954821,87308640,1353819,TN
chr19,Bn86418,32424124,38907298,6483174,RLP
chr19,Bn86419,11248442,83919364,72670922,CNL
chr19,Bn86420,97445436,98897910,1452474,NBS
chr19,Bn86421,64840699,81577092,16736393,TNL
chr19,Bn86422,45173196,62477863,17304667,RLK
chr19,Bn86423,76628271,99207169,22578898,TNL
chr19,Bn86424,67892890,92672700,24779810,RLK
chr19,Bn86425,34343169,39801889,5458720,TN
chr19,Bn86426,81886603,86835314,4948711,CNL
chr19,Bn86427,83196277,99167139,15970862,CNL
chr19,Bn86428,10778849,29917909,19139060,CNL
chr19,Bn86429,3397678,6206272,2808594,RLK
chr19,Bn86430,15161423,38705493,23544070,TN
chr19,Bn86431,90754341,99095175,8340834,CN
chr19,Bn86432,96452846,99407872,2955026,RLK
chr19,Bn86433,52191698,60734938,8543240,TN
chr19,Bn86434,28506927,48057796,19550869,NBS
chr19,Bn86435,47038820,91681521,44642701,RLK
chr19,Bn86436,90110047,94468021,4357974,RLK
chr19,Bn86437,82467480,83533165,1065685,TN
chr19,Bn86438,53584130,70222197,16638067,TN
chr19,Bn86439,38336179,61530209,23194030,RLK
chr19,Bn86440,78049612,85816182,7766570,TN
chr19,Bn86441,85173448,92439762,7266314,TNL
chr19,Bn86442,3415765,32721038,29305273,NBS
chr19,Bn86443,57112738,96864563,39751825,CN
chr19,Bn86444,31461461,62914707,31453246,RLK
chr19,Bn86445,74927520,87672026,12744506,CNL
chr19,Bn86446,82068319,92120485,10052166,CNL
chr19,Bn86447,35380161,69249134,33868973,CN
chr19,Bn86448,95974074,99888553,3914479,RLP
chr19,Bn86449,25099452,77698397,52598945,RLK
chr19,Bn86450,50845301,68690938,17845637,CNL
chr19,Bn86451,16446519,94391737,77945218,TNL
chr19,Bn86452,57784806,72149851,14365045,CNL
chr19,Bn86453,93584891,99690388,6105497,RLP
chr19,Bn86454,88854412,96342499,7488087,TNL
chr19,Bn86455,73074739,81178096,8103357,NBS
chr19,Bn86456,58652767,63084834,4432067,RLP
chr19,Bn86457,81952636,89553378,7600742,NBS
chr19,Bn86458,61169406,73940727,12771321,RLK
chr19,Bn86459,73925922,84083229,10157307,RLP
chr19,Bn86460,48834357,61848213,13013856,TNL
chr19,Bn86461,54416546,69431525,15014979,RLK
chr19,Bn86462,69560672,99662397,30101725,RLP
chr19,Bn86463,13508081,42150177,28642096,CN
chr19,Bn86464,53560580,81476268,27915688,CNL
chr19,Bn86465,92900616,95335848,2435232,RLP
chr19,Bn86466,83961286,94745162,10783876,TN
chr19,Bn86467,81425818,97065581,15639763,CNL
chr19,Bn86468,23204693,59597477,36392784,RLK
chr19,Bn86469,79291735,97756037,18464302,CNL
chr19,Bn86470,50566102,74501560,23935458,RLP
chr19,Bn86471,64487197,99664283,35177086,NBS
chr19,Bn86472,10665404,45224391,34558987,CNL
chr19,Bn86473,73820837,85636074,11815237,RLP
chr19,Bn86474,92183462,95266608,3083146,CN
chr19,Bn86475,71597302,85357770,13760468,TNL
chr19,Bn86476,59521418,97082087,37560669,TN
chr19,Bn86477,2410309,73203059,70792750,RLP
chr19,Bn86478,77231725,85355569,8123844,NBS
chr19,Bn86479,26431544,30995838,4564294,TN
chr19,Bn86480,23713883,97326720,73612837,TNL
chr19,Bn86481,24555930,79451522,54895592,RLP
chr19,Bn86482,26363675,62386031,36022356,TNL
chr19,Bn86483,67702375,92403969,24701594,RLK
chr19,Bn86484,23089323,66628099,43538776,RLK
chr19,Bn86485,90699193,93455719,2756526,TN
chr19,Bn86486,17768751,79393194,61624443,TNL
chr19,Bn86487,58117839,90190743,32072904,RLP
chr19,Bn86488,30863087,32490987,1627900,CN
chr19,Bn86489,62180846,68158941,5978095,RLK
chr19,Bn86490,88005688,93320228,5314540,TNL
chr19,Bn86491,82288143,97444403,15156260,CN
chr19,Bn86492,68947684,85213317,16265633,RLP
chr19,Bn86493,2771941,99455384,96683443,CNL
chr19,Bn86494,53344459,69017240,15672781,TN
chr19,Bn86495,81564302,99584996,18020694,RLP
chr19,Bn86496,25481832,89901694,64419862,TN
chr19,Bn86497,88567771,98172986,9605215,TNL
chr19,Bn86498,54434849,78744571,24309722,RLP
chr19,Bn86499,48932891,97143966,48211075,TN
chr19,Bn86500,45972872,69215842,23242970,NBS
chr19,Bn86501,94040347,94556434,516087,RLK
chr19,Bn86502,76484165,96436097,19951932,RLK
chr19,Bn86503,32922459,93743306,60820847,TN
chr19,Bn86504,48339588,79035426,30695838,CNL
chr19,Bn86505,50285103,55901551,5616448,TNL
chr19,Bn86506,69781426,93964776,24183350,CN
chr19,Bn86507,32399158,76813840,44414682,TNL
chr19,Bn86508,23489882,86759153,63269271,RLK
chr19,Bn86509,9746901,11220541,1473640,RLP
chr19,Bn86510,29836521,59328908,29492387,TN
chr19,Bn86511,77932973,86779468,8846495,RLK
chr19,Bn86512,4253127,25173057,20919930,CNL
chr19,Bn86513,67446340,99933609,32487269,NBS
chr19,Bn86514,39412909,75628753,36215844,TN
chr19,Bn86515,25831103,68056244,42225141,NBS
chr19,Bn86516,89482027,98808465,9326438,RLP
chr19,Bn86517,6912071,42135968,35223897,CNL
chr19,Bn86518,10310516,51734774,41424258,CN
chr19,Bn86519,79955934,81147800,1191866,RLK
chr19,Bn86520,78369977,99204186,20834209,TN
chr19,Bn86521,57344201,80491928,23147727,TNL
chr19,Bn86522,30174424,99234399,69059975,TNL
chr19,Bn86523,97430128,97491511,61383,CN
chr19,Bn86524,34639394,53110881,18471487,CN
chr19,Bn86525,72696273,81961628,9265355,RLP
chr19,Bn86526,78697312,90390261,11692949,RLP
chr19,Bn86527,55001516,81525850,26524334,CN
chr19,Bn86528,74236767,96643309,22406542,CN
chr19,Bn86529,71274799,77044461,5769662,RLP
chr19,Bn86530,64773100,68291042,3517942,RLK
chr19,Bn86531,80784345,93362817,12578472,CNL
chr19,Bn86532,96484652,99295944,2811292,RLP
chr19,Bn86533,1649876,22847466,21197590,CN
chr19,Bn86534,86110383,86849378,738995,RLP
chr19,Bn86535,42983294,93146173,50162879,RLP
chr19,Bn86536,4672892,42979721,38306829,CN
chr19,Bn86537,16666346,82045994,65379648,RLP
chr19,Bn86538,62900965,72044870,9143905,RLP
chr19,Bn86539,49612706,52512503,2899797,CNL
chr19,Bn86540,11798528,31779177,19980649,TN
chr19,Bn86541,42536195,79596987,37060792,RLK
chr19,Bn86542,75097614,80665472,5567858,RLK
chr19,Bn86543,28470230,28482219,11989,TNL
chr19,Bn86544,88557147,98220425,9663278,NBS
chr19,Bn86545,69872990,91275944,21402954,CN
chr19,Bn86546,47049902,88116007,41066105,TN
chr19,Bn86547,19069611,87231615,68162004,CNL
chr19,Bn86548,45411384,82233061,36821677,CNL
chr19,Bn86549,66627036,79232269,12605233,RLK
chr19,Bn86550,70535112,81205629,10670517,CNL
chr19,Bn86551,62106628,86082633,23976005,TN
chr19,Bn86552,64267580,93452144,29184564,CNL
chr19,Bn86553,73050623,77792231,4741608,NBS
chr19,Bn86554,76240585,90944078,14703493,RLK
chr19,Bn86555,8304779,57387708,49082929,CN
chr19,Bn86556,28817774,82992470,54174696,NBS
chr19,Bn86557,9697083,17883852,8186769,RLP
chr19,Bn86558,2257688,17880554,15622866,NBS
chr19,Bn86559,64818781,69448526,4629745,NBS
chr19,Bn86560,98760090,98766924,6834,TN
chr19,Bn86561,8098509,97183307,89084798,NBS
chr19,Bn86562,88505130,94064120,5558990,CN
chr19,Bn86563,92396671,96812547,4415876,CN
chr19,Bn86564,59994488,78880365,18885877,RLK
chr19,Bn86565,48746023,98059360,49313337,TNL
chr19,Bn86566,31604454,66995486,35391032,NBS
chr19,Bn86567,86160930,91600239,5439309,TNL
chr19,Bn86568,19789335,36527340,16738005,CNL
chr19,Bn86569,21528202,60570571,39042369,NBS
chr19,Bn86570,43455820,50042612,6586792,TN
chr19,Bn86571,92605963,93883600,1277637,TNL
chr19,Bn86572,51970436,68200769,16230333,TNL
chr19,Bn86573,47990363,67602932,19612569,CN
chr19,Bn86574,39761190,43496486,3735296,TN
chr19,Bn86575,71701607,87321133,15619526,TN
chr19,Bn86576,62315786,68321483,6005697,CNL
chr19,Bn86577,14739449,46104615,31365166,RLK
chr19,Bn86578,45739160,90816184,45077024,CNL
chr19,Bn86579,96647231,99949197,3301966,NBS
chr19,Bn86580,62707270,87856912,25149642,CN
chr19,Bn86581,67990093,90293929,22303836,CN
chr19,Bn86582,89570552,89784841,214289,RLP
chr19,Bn86583,80521799,90775850,10254051,CNL
chr19,Bn86584,46658509,87156278,40497769,RLK
chr19,Bn86585,12892225,68451564,55559339,TN
chr19,Bn86586,48888367,79666044,30777677,NBS
chr19,Bn86587,74067521,90651309,16583788,TN
chr19,Bn86588,53481816,78150464,24668648,RLK
chr19,Bn86589,55235867,64914478,9678611,NBS
chr19,Bn86590,9210859,63450751,54239892,TNL
chr19,Bn86591,70165805,94684637,24518832,TN
chr19,Bn86592,49255040,96579732,47324692,RLK
chr19,Bn86593,42055384,58656457,16601073,RLK
chr19,Bn86594,39078743,66656897,27578154,RLP
chr19,Bn86595,90067690,91342138,1274448,TN
chr19,Bn86596,86203855,90688225,4484370,CN
chr19,Bn86597,67341036,98248122,30907086,NBS
chr19,Bn86598,54197191,60666571,6469380,RLK
chr19,Bn86599,22438499,68689401,46250902,NBS
chr19,Bn86600,81089731,81654993,565262,TNL
chr19,Bn86601,16162694,39253138,23090444,NBS
chr19,Bn86602,82107144,87021421,4914277,CNL
chr19,Bn86603,28303372,74366211,46062839,NBS
chr19,Bn86604,70574642,73599197,3024555,TN
chr19,Bn86605,30646385,45530204,14883819,NBS
chr19,Bn86606,41801151,52691160,10890009,CN
chr19,Bn86607,43219641,58518286,15298645,CNL
chr19,Bn86608,17404439,63137290,45732851,RLP
chr19,Bn86609,16218094,98626775,82408681,TNL
chr19,Bn86610,46741235,52403385,5662150,TNL
chr19,Bn86611,75338505,92321912,16983407,TN
chr19,Bn86612,3877362,49686824,45809462,CN
chr19,Bn86613,37838961,72924737,35085776,RLK
chr19,Bn86614,33527579,38874029,5346450,CN
chr19,Bn86615,93854100,94341085,486985,NBS
chr19,Bn86616,35800294,55925334,20125040,CN
chr19,Bn86617,60986384,63180746,2194362,RLP
chr19,Bn86618,57522979,85337615,27814636,CNL
chr19,Bn86619,78146494,83560408,5413914,CNL
chr19,Bn86620,66840771,74039487,7198716,TNL
chr19,Bn86621,70217783,87759263,17541480,TNL
chr19,Bn86622,33985468,89634171,55648703,TNL
chr19,Bn86623,56147235,60883320,4736085,TN
chr19,Bn86624,55706299,56692927,986628,RLP
chr19,Bn86625,45429884,57680225,12250341,NBS
chr19,Bn86626,15326878,82693514,67366636,RLP
chr19,Bn86627,98728616,98832261,103645,CNL
chr19,Bn86628,48111816,52071053,3959237,CNL
chr19,Bn86629,15112576,61482944,46370368,NBS
chr19,Bn86630,35216950,74034292,38817342,CN
chr19,Bn86631,46486222,64025844,17539622,RLP
chr19,Bn86632,92221352,94066869,1845517,TN
chr19,Bn86633,42147871,84978508,42830637,CNL
chr19,Bn86634,42924959,61290385,18365426,CNL
chr19,Bn86635,43281214,78456281,35175067,TNL
chr19,Bn86636,15986097,66869577,50883480,CN
chr19,Bn86637,44447844,52791943,8344099,TNL
chr19,Bn86638,4598387,12799617,8201230,NBS
chr19,Bn86639,23076942,37672609,14595667,TN
chr19,Bn86640,62023041,71215687,9192646,TN
chr19,Bn86641,71381738,89732438,18350700,NBS
chr19,Bn86642,75251552,99169883,23918331,RLP
chr19,Bn86643,35075250,35961719,886469,TN
chr19,Bn86644,21410543,37740579,16330036,RLK
chr19,Bn86645,85482706,95958073,10475367,NBS
chr19,Bn86646,11323070,74666706,63343636,CNL
chr19,Bn86647,23705626,94090104,70384478,TN
chr19,Bn86648,16999354,61095844,44096490,RLP
chr19,Bn86649,61533361,85771302,24237941,CN
chr19,Bn86650,15653748,45365526,29711778,RLK
chr19,Bn86651,98395271,98689051,293780,NBS
chr19,Bn86652,67533685,71741085,4207400,RLP
chr19,Bn86653,87950231,98048857,10098626,TNL
chr19,Bn86654,99938997,99955577,16580,CN
chr19,Bn86655,81374620,93712779,12338159,CNL
chr19,Bn86656,3784826,83960233,80175407,TN
chr19,Bn86657,26725655,27591466,865811,TN
chr19,Bn86658,79370971,94055491,14684520,CN
chr19,Bn86659,66637781,90227224,23589443,RLP
chr19,Bn86660,28168813,40578362,12409549,NBS
chr19,Bn86661,20935286,85080686,64145400,TNL
chr19,Bn86662,13229368,29000874,15771506,TNL
chr19,Bn86663,28557135,83693335,55136200,CN
chr19,Bn86664,25921272,88698949,62777677,CN
chr19,Bn86665,13154807,85052642,71897835,RLP
chr19,Bn86666,28421467,79727853,51306386,RLK
chr19,Bn86667,67488308,81716647,14228339,NBS
chr19,Bn86668,68473595,83777930,15304335,NBS
chr19,Bn86669,93045392,97722782,4677390,TN
chr19,Bn86670,76706073,95167783,18461710,TN
chr19,Bn86671,67106198,83481650,16375452,NBS
chr19,Bn86672,16208043,35169046,18961003,TN
chr19,Bn86673,80125995,95586018,15460023,TNL
chr19,Bn86674,10444224,36969938,26525714,NBS
chr19,Bn86675,46628640,88293274,41664634,TNL
chr19,Bn86676,11008650,21012462,10003812,CN
chr19,Bn86677,71576923,78609129,7032206,TN
chr19,Bn86678,47107501,80334012,33226511,TN
chr19,Bn86679,23234932,53058324,29823392,CNL
chr19,Bn86680,9146776,41439280,32292504,NBS
chr19,Bn86681,38344269,55257119,16912850,CN
chr19,Bn86682,33734648,89182344,55447696,TNL
chr19,Bn86683,89898966,90359451,460485,CN
chr19,Bn86684,98260004,99213533,953529,NBS
chr19,Bn86685,24946180,28860330,3914150,CN
chr19,Bn86686,63786688,90812405,27025717,RLK
chr19,Bn86687,39353845,43161713,3807868,RLK
chr19,Bn86688,70869822,89940561,19070739,RLK
chr19,Bn86689,8200792,26530268,18329476,RLK
chr19,Bn86690,20370307,53439741,33069434,TN
chr19,Bn86691,77848319,80718906,2870587,CNL
chr19,Bn86692,71328976,97176171,25847195,RLK
chr19,Bn86693,12545417,15691277,3145860,TN
chr19,Bn86694,91646973,97294825,5647852,RLP
chr19,Bn86695,49652337,54187254,4534917,CN
chr19,Bn86696,91851554,92380201,528647,RLP
chr19,Bn86697,76786155,92388455,15602300,CNL
chr19,Bn86698,83748674,96902085,13153411,NBS
chr19,Bn86699,88550776,91155451,2604675,TNL
chr19,Bn86700,79137703,95051161,15913458,NBS
chr19,Bn86701,31739407,96930969,65191562,TNL
chr19,Bn86702,68221789,85589475,17367686,NBS
chr19,Bn86703,93915513,95080615,1165102,TN
chr19,Bn86704,38253240,46912885,8659645,CNL
chr19,Bn86705,26058703,69399811,43341108,RLP
chr19,Bn86706,52109630,82826677,30717047,CN
chr19,Bn86707,88025958,95296966,7271008,RLP
chr19,Bn86708,72108611,85884784,13776173,CNL
chr19,Bn86709,34472233,48792160,14319927,CNL
chr19,Bn86710,61842491,88499246,26656755,CNL
chr19,Bn86711,71225170,82692114,11466944,TNL
chr19,Bn86712,49378185,59636958,10258773,TNL
chr19,Bn86713,82893999,95602738,12708739,CN
chr19,Bn86714,62060666,71240865,9180199,RLP
chr19,Bn86715,5770905,27995341,22224436,NBS
chr19,Bn86716,7737958,94800553,87062595,RLP
chr19,Bn86717,3927198,17989456,14062258,TNL
chr19,Bn86718,3193182,47206170,44012988,NBS
chr19,Bn86719,7071855,15258927,8187072,CN
chr19,Bn86720,53976161,59897444,5921283,CN
chr19,Bn86721,19935134,96410564,76475430,RLP
chr19,Bn86722,31875647,66758806,34883159,NBS
chr19,Bn86723,80781390,88878800,8097410,NBS
chr19,Bn86724,5615124,73562903,67947779,TN
chr19,Bn86725,2326881,89699393,87372512,CN
chr19,Bn86726,89832778,91528505,1695727,NBS
chr19,Bn86727,34987997,69553567,34565570,CN
chr19,Bn86728,20603174,98425468,77822294,TNL
chr19,Bn86729,56040138,66176616,10136478,TN
chr19,Bn86730,8577660,78223595,69645935,NBS
chr19,Bn86731,43927098,92266551,48339453,NBS
chr19,Bn86732,3010497,84483054,81472557,CNL
chr19,Bn86733,63552265,63743140,190875,TN
chr19,Bn86734,84450599,91520238,7069639,NBS
chr19,Bn86735,56798163,88551421,31753258,RLP
chr19,Bn86736,48393169,78415924,30022755,RLP
chr19,Bn86737,25491485,40417298,14925813,CNL
chr19,Bn86738,13001301,77431806,64430505,CN
chr19,Bn86739,69232982,75463301,6230319,NBS
chr19,Bn86740,39547768,86054055,46506287,NBS
chr19,Bn86741,37222717,78482265,41259548,CNL
chr19,Bn86742,82750116,86717548,3967432,CNL
chr19,Bn86743,13039312,35708084,22668772,NBS
chr19,Bn86744,54946731,82359402,27412671,CN
chr19,Bn86745,98804513,98894207,89694,CN
chr19,Bn86746,3866059,10343154,6477095,RLK
chr19,Bn86747,54997814,55451283,453469,CN
chr19,Bn86748,11182603,46478460,35295857,CN
chr19,Bn86749,53034188,87049375,34015187,CN
chr19,Bn86750,8946023,81744653,72798630,TNL
chr19,Bn86751,5411257,67516764,62105507,TN
chr19,Bn86752,9307441,94083096,84775655,TN
chr19,Bn86753,75769896,83974510,8204614,CNL
chr19,Bn86754,68721582,87199415,18477833,RLK
chr19,Bn86755,26497080,51731813,25234733,NBS
chr19,Bn86756,15531921,43456526,27924605,CNL
chr19,Bn86757,67209861,71508084,4298223,NBS
chr19,Bn86758,99415941,99739700,323759,CN
chr19,Bn86759,46410668,94412558,48001890,CNL
chr19,Bn86760,63371523,90432748,27061225,CNL
chr19,Bn86761,93371107,98516753,5145646,RLP
chr19,Bn86762,30821120,65300866,34479746,TNL
chr19,Bn86763,61866496,91361967,29495471,NBS
chr19,Bn86764,14519023,24036599,9517576,CN
chr19,Bn86765,64337230,72721277,8384047,RLK
chr19,Bn86766,85516364,98740886,13224522,RLP
chr19,Bn86767,15705817,72425854,56720037,TNL
chr19,Bn86768,93902103,97291635,3389532,RLK
chr19,Bn86769,99186494,99347279,160785,CNL
chr19,Bn86770,36142168,36794363,652195,RLP
chr19,Bn86771,61500120,65214633,3714513,CN
chr19,Bn86772,22306507,83427425,61120918,RLP
chr19,Bn86773,53188204,95958510,42770306,NBS
chr19,Bn86774,96255376,99886855,3631479,RLK
chr19,Bn86775,48162301,96456538,48294237,TNL
chr19,Bn86776,91729172,92981056,1251884,TN
chr19,Bn86777,95765773,98911277,3145504,TN
chr19,Bn86778,33784816,45586616,11801800,RLK
chr19,Bn86779,85679149,95046089,9366940,TNL
chr19,Bn86780,11774856,17672869,5898013,RLK
chr19,Bn86781,59546208,80014990,20468782,TNL
chr19,Bn86782,56864141,85542708,28678567,RLK
chr19,Bn86783,92761896,94601383,1839487,TN
chr19,Bn86784,51514873,82642824,31127951,TN
chr19,Bn86785,94047724,99867374,5819650,TN
chr19,Bn86786,24306230,96586513,72280283,TNL
chr19,Bn86787,99321818,99666280,344462,CNL
chr19,Bn86788,10922852,58865962,47943110,NBS
chr19,Bn86789,79947261,88792070,8844809,RLK
chr19,Bn86790,93376882,96988324,3611442,CNL
chr19,Bn86791,37128830,71186948,34058118,CNL
chr19,Bn86792,40755869,48662269,7906400,CNL
chr19,Bn86793,21914081,90869483,68955402,RLK
chr19,Bn86794,5436602,13873486,8436884,CNL
chr19,Bn86795,96568440,98324613,1756173,TN
chr19,Bn86796,92777108,99069877,6292769,RLK
chr19,Bn86797,39763076,68305207,28542131,TNL
chr19,Bn86798,9220330,9942387,722057,RLP
chr19,Bn86799,65246712,99637386,34390674,RLK
chr19,Bn86800,70167803,74258893,4091090,CN
chr19,Bn86801,20262513,99876093,79613580,RLP
chr19,Bn86802,78873975,85838541,6964566,CNL
chr19,Bn86803,99641834,99995554,353720,NBS
chr19,Bn86804,23528093,88712453,65184360,NBS
chr19,Bn86805,25161436,70152658,44991222,CNL
chr19,Bn86806,39497458,57810676,18313218,CNL
chr19,Bn86807,7876586,82642472,74765886,NBS
chr19,Bn86808,19871981,65338441,45466460,RLK
chr19,Bn86809,62935584,94669235,31733651,RLK
chr19,Bn86810,43508430,50731363,7222933,CNL
chr19,Bn86811,3019304,76391253,73371949,RLP
chr19,Bn86812,93422985,99288382,5865397,TN
chr19,Bn86813,27756686,83898823,56142137,NBS
chr19,Bn86814,50072314,95446728,45374414,NBS
chr19,Bn86815,55358934,89346583,33987649,TN
chr19,Bn86816,32618702,58560353,25941651,NBS
chr19,Bn86817,69662748,93590268,23927520,CNL
chr19,Bn86818,12462026,89926688,77464662,RLP
chr19,Bn86819,3988662,79956743,75968081,NBS
chr19,Bn86820,27552582,59900278,32347696,CN
chr19,Bn86821,34846901,39635551,4788650,RLP
chr19,Bn86822,47451022,62598847,15147825,TNL
chr19,Bn86823,97347143,98750776,1403633,TNL
chr19,Bn86824,93529913,96581837,3051924,NBS
chr19,Bn86825,29418350,97744036,68325686,RLP
chr19,Bn86826,97791112,99443969,1652857,RLP
chr19,Bn86827,23627439,63112632,39485193,CNL
chr19,Bn86828,93753198,97854696,4101498,NBS
chr19,Bn86829,72139814,72281179,141365,TNL
chr19,Bn86830,27225396,59774438,32549042,TN
chr19,Bn86831,87063223,94920522,7857299,CNL
chr19,Bn86832,12023133,94057341,82034208,RLP
chr19,Bn86833,33532813,91865042,58332229,CNL
chr19,Bn86834,59577863,97275797,37697934,CNL
chr19,Bn86835,94657402,99499993,4842591,TNL
chr19,Bn86836,1190131,1622077,431946,CNL
chr19,Bn86837,86118432,95171775,9053343,CNL
chr19,Bn86838,94000788,95773464,1772676,TN
chr19,Bn86839,50997553,79038900,28041347,NBS
chr19,Bn86840,17746879,56806420,39059541,TNL
chr19,Bn86841,91692065,95527949,3835884,NBS
chr19,Bn86842,57716209,66694486,8978277,NBS
chr19,Bn86843,26550448,62659892,36109444,RLP
chr19,Bn86844,74317628,81309623,6991995,RLP
chr19,Bn86845,14833745,21156975,6323230,RLP
chr19,Bn86846,42546445,71064410,28517965,RLP
chr19,Bn86847,65573194,85308158,19734964,RLK
chr19,Bn86848,17627378,91143594,73516216,TNL
chr19,Bn86849,82969557,94142972,11173415,CNL
chr19,Bn86850,75482000,81716370,6234370,CN
chr19,Bn86851,68907317,75769710,6862393,TN
chr19,Bn86852,2093965,76780738,74686773,NBS
chr19,Bn86853,35808991,42792997,6984006,CN
chr19,Bn86854,27526041,70354135,42828094,TN
chr19,Bn86855,97409585,99281350,1871765,RLP
chr19,Bn86856,71835312,93463006,21627694,TN
chr19,Bn86857,65682740,79121847,13439107,NBS
chr19,Bn86858,99091968,99510704,418736,CN
chr19,Bn86859,32422254,53445572,21023318,RLP
chr19,Bn86860,28539748,39267603,10727855,TNL
chr19,Bn86861,28898952,77313438,48414486,TNL
chr19,Bn86862,86014656,96174511,10159855,RLK
chr19,Bn86863,76836706,91591610,14754904,TN
chr19,Bn86864,26866085,75135591,48269506,CN
chr19,Bn86865,26216601,70150062,43933461,TNL
chr19,Bn86866,5759560,87136290,81376730,NBS
chr19,Bn86867,74759556,76048615,1289059,TNL
chr19,Bn86868,77646551,80718480,3071929,RLK
chr19,Bn86869,85846993,90110905,4263912,CNL
chr19,Bn86870,87235211,95702915,8467704,CN
chr19,Bn86871,94523287,96474280,1950993,TN
chr19,Bn86872,80564518,91724853,11160335,RLK
chr19,Bn86873,34255748,58783951,24528203,RLK
chr19,Bn86874,63387031,92870681,29483650,CN
chr19,Bn86875,79636247,96582618,16946371,TN
chr19,Bn86876,9378210,85960053,76581843,TNL
chr19,Bn86877,40279338,89533493,49254155,TNL
chr19,Bn86878,53988104,61758604,7770500,RLK
chr19,Bn86879,94078417,96144946,2066529,RLK
chr19,Bn86880,76919419,84400641,7481222,CN
chr19,Bn86881,30699661,73727766,43028105,RLP
chr19,Bn86882,23663886,73480856,49816970,TNL
chr19,Bn86883,82928641,89493461,6564820,RLP
chr19,Bn86884,77596666,95115624,17518958,TN
chr19,Bn86885,91892417,93810957,1918540,RLK
chr19,Bn86886,82087727,92342138,10254411,RLK
chr19,Bn86887,63554569,84951824,21397255,RLP
chr19,Bn86888,5349608,47904468,42554860,RLP
chr19,Bn86889,90748830,93632466,2883636,NBS
chr19,Bn86890,27925943,67574883,39648940,RLK
chr19,Bn86891,23055798,62010960,38955162,NBS
chr19,Bn86892,24725863,85780376,61054513,TN
chr19,Bn86893,26608307,79096105,52487798,TN
chr19,Bn86894,27639229,38576917,10937688,NBS
chr19,Bn86895,21381011,54987885,33606874,CNL
chr19,Bn86896,7340992,50938858,43597866,NBS
chr19,Bn86897,3033854,48740163,45706309,RLK
chr19,Bn86898,46527623,63824893,17297270,CNL
chr19,Bn86899,74774613,86052432,11277819,NBS
chr19,Bn86900,41604873,70177456,28572583,RLK
chr19,Bn86901,34553176,62232278,27679102,RLP
chr19,Bn86902,66277958,84059598,17781640,RLP
chr19,Bn86903,23627104,97086477,73459373,NBS
chr19,Bn86904,96361574,97543998,1182424,RLP
chr19,Bn86905,12342216,44186017,31843801,CNL
chr19,Bn86906,32358001,71169118,38811117,RLK
chr19,Bn86907,64179081,87439006,23259925,TNL
chr19,Bn86908,20722872,97437931,76715059,TNL
chr19,Bn86909,53665556,60976253,7310697,CN
chr19,Bn86910,7499937,89100625,81600688,NBS
chr19,Bn86911,23239667,34015150,10775483,RLP
chr19,Bn86912,88388824,93501223,5112399,TN
chr19,Bn86913,86084247,99375576,13291329,RLK
chr19,Bn86914,3024416,5115546,2091130,CNL
chr19,Bn86915,26246602,77767581,51520979,TN
chr19,Bn86916,97637763,98871610,1233847,TNL
chr19,Bn86917,91957433,99915134,7957701,TNL
chr19,Bn86918,44285313,93197892,48912579,CN
chr19,Bn86919,74904809,92291306,17386497,RLK
chr19,Bn86920,53131952,97643124,44511172,TNL
chr19,Bn86921,40266649,52558718,12292069,TNL
chr19,Bn86922,46742687,62167412,15424725,TN
chr19,Bn86923,76773087,85608856,8835769,TNL
chr19,Bn86924,56332318,97214015,40881697,NBS
chr19,Bn86925,32295021,69519749,37224728,CNL
chr19,Bn86926,71687220,87611607,15924387,RLK
chr19,Bn86927,24536123,99301666,74765543,NBS
chr19,Bn86928,84306950,99841609,15534659,NBS
chr19,Bn86929,47605561,58784729,11179168,RLP
chr19,Bn86930,72133007,85146372,13013365,RLK
chr19,Bn86931,34088046,61414747,27326701,CN
chr19,Bn86932,16070870,20208621,4137751,CN
chr19,Bn86933,87551411,92308426,4757015,RLK
chr19,Bn86934,55752256,77184498,21432242,CNL
chr19,Bn86935,92439901,92628268,188367,TN
chr19,Bn86936,38917349,50235822,11318473,NBS
chr19,Bn86937,65842753,75817290,9974537,TNL
chr19,Bn86938,1850187,69864173,68013986,TN
chr19,Bn86939,33537233,71604607,38067374,TNL
chr19,Bn86940,95405334,97008810,1603476,NBS
chr19,Bn86941,22960694,84997273,62036579,NBS
chr19,Bn86942,85841990,90892201,5050211,CNL
chr19,Bn86943,20887155,90078340,69191185,TNL
chr19,Bn86944,33221439,42634740,9413301,TNL
chr19,Bn86945,2407464,91173402,88765938,CNL
chr19,Bn86946,28588190,82977931,54389741,TN
chr19,Bn86947,64510670,75938054,11427384,NBS
chr19,Bn86948,87804205,92377134,4572929,NBS
chr19,Bn86949,12824660,59982369,47157709,NBS
chr19,Bn86950,5636943,10367829,4730886,CNL
chr19,Bn86951,83906105,86969970,3063865,RLP
chr19,Bn86952,62791874,95625575,32833701,RLK
chr19,Bn86953,91312465,91327696,15231,TN
chr19,Bn86954,92949898,94989700,2039802,TNL
chr19,Bn86955,90604238,90730251,126013,TNL
chr19,Bn86956,91705025,98071381,6366356,CN
chr19,Bn86957,8713019,46077364,37364345,RLP
chr19,Bn86958,80868621,92499260,11630639,RLP
chr19,Bn86959,91031386,95087426,4056040,TNL
chr19,Bn86960,88018778,91732803,3714025,TNL
chr19,Bn86961,58608130,71915218,13307088,RLK
chr19,Bn86962,14082032,79122166,65040134,RLP
chr19,Bn86963,46343964,52172123,5828159,NBS
chr19,Bn86964,24852687,26884011,2031324,CNL
chr19,Bn86965,83074946,89510193,6435247,RLP
chr19,Bn86966,66777255,96208644,29431389,CNL
chr19,Bn86967,58382012,91235480,32853468,TNL
chr19,Bn86968,94888492,96295209,1406717,CN
chr19,Bn86969,93944505,98525660,4581155,TNL
chr19,Bn86970,50326386,64492152,14165766,RLK
chr19,Bn86971,43617242,78338954,34721712,RLP
chr19,Bn86972,99937159,99978542,41383,RLP
chr19,Bn86973,82717681,90455665,7737984,CN
chr19,Bn86974,88470492,99170376,10699884,TNL
chr19,Bn86975,77761173,90547058,12785885,CN
chr19,Bn86976,63019607,93139917,30120310,TN
chr19,Bn86977,16548995,94010937,77461942,NBS
chr19,Bn86978,77092984,80399522,3306538,CN
chr19,Bn86979,59631473,85657296,26025823,RLK
chr19,Bn86980,1190935,20135011,18944076,TN
chr19,Bn86981,29830960,93808265,63977305,RLP
chr19,Bn86982,10031808,60101457,50069649,CNL
chr19,Bn86983,66602425,94875787,28273362,NBS
chr19,Bn86984,44925166,45684892,759726,RLK
chr19,Bn86985,55240647,86408034,31167387,RLK
chr19,Bn86986,55979752,79893089,23913337,CN
chr19,Bn86987,26309870,81561062,55251192,CN
chr19,Bn86988,40687724,42167370,1479646,RLK
chr19,Bn86989,73177977,99262877,26084900,RLP
chr19,Bn86990,53263099,54322871,1059772,TN
chr19,Bn86991,66018428,86354063,20335635,RLK
chr19,Bn86992,49153639,77829126,28675487,NBS
chr19,Bn86993,32860047,46652934,13792887,RLP
chr19,Bn86994,4648824,66595543,61946719,RLK
chr19,Bn86995,52034535,55013548,2979013,CN
chr19,Bn86996,42840782,95503971,52663189,NBS
chr19,Bn86997,88403634,96021414,7617780,CN
chr19,Bn86998,9139760,49215186,40075426,RLP
chr19,Bn86999,94368916,94909131,540215,TN
chr19,Bn87000,55584950,90520178,34935228,RLK
chr19,Bn87001,83564402,85519404,1955002,CN
chr19,Bn87002,86338562,90328588,3990026,TNL
chr19,Bn87003,4392016,21054056,16662040,RLK
chr19,Bn87004,1217422,58933378,57715956,TN
chr19,Bn87005,47655160,92817510,45162350,TN
chr19,Bn87006,66341980,68839391,2497411,CNL
chr19,Bn87007,30649270,39860727,9211457,TN
chr19,Bn87008,68472655,85549986,17077331,TNL
chr19,Bn87009,84575051,86861401,2286350,RLP
chr19,Bn87010,94704741,98725264,4020523,CNL
chr19,Bn87011,9650111,16533322,6883211,RLK
chr19,Bn87012,56675648,82140257,25464609,TN
chr19,Bn87013,40555208,47533346,6978138,TN
chr19,Bn87014,10047979,85392940,75344961,RLP
chr19,Bn87015,34901468,59273343,24371875,NBS
chr19,Bn87016,13906743,47307695,33400952,TN
chr19,Bn87017,99742192,99879127,136935,TN
chr19,Bn87018,46861886,91676290,44814404,NBS
chr19,Bn87019,73368138,94484586,21116448,TN
chr19,Bn87020,65752050,97284189,31532139,TNL
chr19,Bn87021,72904530,95799602,22895072,RLP
chr19,Bn87022,77753667,91422975,13669308,RLP
chr19,Bn87023,34392547,82146873,47754326,CN
chr19,Bn87024,45461720,87344823,41883103,TNL
chr19,Bn87025,59449134,73161491,13712357,TNL
chr19,Bn87026,49832543,85141147,35308604,NBS
chr19,Bn87027,2863580,66025385,63161805,NBS
chr19,Bn87028,71342394,97666807,26324413,TN
chr19,Bn87029,13828880,82019660,68190780,NBS
chr19,Bn87030,48459832,84200891,35741059,NBS
chr19,Bn87031,1007626,41198086,40190460,CNL
chr19,Bn87032,96555819,97784198,1228379,RLP
chr19,Bn87033,95491729,99494622,4002893,NBS
chr19,Bn87034,25616445,34508904,8892459,CNL
chr19,Bn87035,4709328,55832380,51123052,CN
chr19,Bn87036,74613627,88266130,13652503,CNL
chr19,Bn87037,40042730,47759971,7717241,RLP
chr19,Bn87038,11481805,44046790,32564985,TN
chr19,Bn87039,1812689,77919084,76106395,CNL
chr19,Bn87040,66594178,89187559,22593381,NBS
chr19,Bn87041,56283044,81283829,25000785,RLP
chr19,Bn87042,95849524,99178738,3329214,CN
chr19,Bn87043,35912517,83499794,47587277,CN
chr19,Bn87044,89011660,93454990,4443330,CN
chr19,Bn87045,64207107,69902347,5695240,CNL
chr19,Bn87046,28286933,62914691,34627758,RLP
chr19,Bn87047,45410694,63520064,18109370,CNL
chr19,Bn87048,99804026,99906014,101988,CNL
chr19,Bn87049,13592847,98889130,85296283,TN
chr19,Bn87050,67829395,82394885,14565490,RLK
chr19,Bn87051,11340131,75646645,64306514,TN
chr19,Bn87052,56402051,94350750,37948699,CN
chr19,Bn87053,41605581,54480319,12874738,RLK
chr19,Bn87054,49627233,92615601,42988368,NBS
chr19,Bn87055,55157020,59292932,4135912,CN
chr19,Bn87056,17988293,44375416,26387123,RLK
chr19,Bn87057,66065798,92200708,26134910,CNL
chr19,Bn87058,41463149,90832035,49368886,RLK
chr19,Bn87059,71845677,72937448,1091771,CNL
chr19,Bn87060,24125817,89728685,65602868,CNL
chr19,Bn87061,50550510,97177896,46627386,CN
chr19,Bn87062,94864131,97641759,2777628,CN
chr19,Bn87063,55806044,99057210,43251166,RLP
chr19,Bn87064,36553194,78413491,41860297,RLP
chr19,Bn87065,36309386,48259484,11950098,TNL
chr19,Bn87066,50633563,65935161,15301598,TN
chr19,Bn87067,39196402,59842770,20646368,RLK
chr19,Bn87068,41441442,48194679,6753237,RLP
chr19,Bn87069,56712206,94015277,37303071,TN
chr19,Bn87070,85406681,88635189,3228508,TN
chr19,Bn87071,67168119,69883141,2715022,NBS
chr19,Bn87072,74813394,80461674,5648280,TNL
chr19,Bn87073,53528321,72222597,18694276,TN
chr19,Bn87074,3385230,17891713,14506483,TN
chr19,Bn87075,39016344,57338422,18322078,CN
chr19,Bn87076,67893865,82536903,14643038,CNL
chr19,Bn87077,53873126,84198247,30325121,CNL
chr19,Bn87078,73373574,78530209,5156635,TNL
chr19,Bn87079,97450007,97701447,251440,CN
chr19,Bn87080,80185384,96577768,16392384,TNL
chr19,Bn87081,62274732,87324767,25050035,RLP
chr19,Bn87082,51108106,73462625,22354519,TNL
chr19,Bn87083,68732426,81980966,13248540,NBS
chr19,Bn87084,90437274,95068824,4631550,TN
chr19,Bn87085,9649657,76970866,67321209,NBS
chr19,Bn87086,95143246,95732203,588957,TN
chr19,Bn87087,37914517,54086370,16171853,RLK
chr19,Bn87088,48407293,61719931,13312638,NBS
chr19,Bn87089,13891286,77495626,63604340,RLP
chr19,Bn87090,29493024,63818475,34325451,RLK
chr19,Bn87091,73937607,78087651,4150044,TN
chr19,Bn87092,37094535,64092662,26998127,CN
chr19,Bn87093,58664145,79747130,21082985,RLP
chr19,Bn87094,88715553,94206903,5491350,CN
chr19,Bn87095,25851250,95433904,69582654,TNL
chr19,Bn87096,62411973,79068820,16656847,CNL
chr19,Bn87097,58193779,90305432,32111653,CNL
chr19,Bn87098,66347756,97729149,31381393,RLP
chr19,Bn87099,4248796,11309252,7060456,CN
chr19,Bn87100,85513461,99292860,13779399,RLK
chr19,Bn87101,28273595,99047523,70773928,CN
chr19,Bn87102,54524881,77344518,22819637,CN
chr19,Bn87103,8538889,83475441,74936552,NBS
chr19,Bn87104,91693023,94495424,2802401,TNL
chr19,Bn87105,5561567,49087558,43525991,RLK
chr19,Bn87106,33851573,82967259,49115686,NBS
chr19,Bn87107,19654823,67257080,47602257,TN
chr19,Bn87108,19915408,47550911,27635503,TN
chr19,Bn87109,68122507,94610668,26488161,RLK
chr19,Bn87110,30050979,38377687,8326708,TN
chr19,Bn87111,97066280,99749218,2682938,TN
chr19,Bn87112,70219690,77196110,6976420,CN
chr19,Bn87113,84337111,88642759,4305648,CNL
chr19,Bn87114,68437826,77521367,9083541,NBS
chr19,Bn87115,58188137,87059476,28871339,RLP
chr19,Bn87116,69403751,80894800,11491049,CN
chr19,Bn87117,50806868,86812055,36005187,CN
chr19,Bn87118,82692623,87189644,4497021,RLP
chr19,Bn87119,1280480,84633064,83352584,RLP
chr19,Bn87120,39554529,84636857,45082328,CNL
chr19,Bn87121,7382366,53185115,45802749,TN
chr19,Bn87122,30057833,70487621,40429788,RLP
chr19,Bn87123,62791086,67520884,4729798,RLK
chr19,Bn87124,52659616,65904059,13244443,CNL
chr19,Bn87125,22994756,40366991,17372235,RLK
chr19,Bn87126,27575274,62068418,34493144,TNL
chr19,Bn87127,28772080,51747222,22975142,CN
chr19,Bn87128,21817850,90786445,68968595,NBS
chr19,Bn87129,4999176,25704621,20705445,CN
chr19,Bn87130,56044535,56144358,99823,TNL
chr19,Bn87131,3766916,53172809,49405893,NBS
chr19,Bn87132,4663165,40740233,36077068,CN
chr19,Bn87133,28498997,86399282,57900285,CNL
chr19,Bn87134,50285954,54914548,4628594,RLP
chr19,Bn87135,9389408,50102346,40712938,TNL
chr19,Bn87136,94793253,96293095,1499842,TN
chr19,Bn87137,50225237,99190070,48964833,NBS
chr19,Bn87138,68796195,86266183,17469988,RLK
chr19,Bn87139,58788477,84300293,25511816,CNL
chr19,Bn87140,33330899,50718627,17387728,RLK
chr19,Bn87141,88713497,96024765,7311268,CNL
chr19,Bn87142,1024529,97235911,96211382,TNL
chr19,Bn87143,2517542,82338013,79820471,CN
chr19,Bn87144,80493144,98080066,17586922,CNL
chr19,Bn87145,25843982,87366950,61522968,RLP
chr19,Bn87146,8138442,69616098,61477656,RLK
chr19,Bn87147,61802660,76672217,14869557,TNL
chr19,Bn87148,49583937,91578597,41994660,TNL
chr19,Bn87149,1122578,18840460,17717882,TNL
chr19,Bn87150,76757342,79117531,2360189,CN
chr19,Bn87151,19994323,83004364,63010041,RLP
chr19,Bn87152,14570774,26673973,12103199,NBS
chr19,Bn87153,64653605,81063191,16409586,CN
chr19,Bn87154,85398184,88142291,2744107,RLK
chr19,Bn87155,60049997,65399277,5349280,RLP
chr19,Bn87156,26927856,40851942,13924086,CN
chr19,Bn87157,67934527,91745583,23811056,RLP
chr19,Bn87158,35154094,70655499,35501405,TNL
chr19,Bn87159,12859545,71934190,59074645,RLK
chr19,Bn87160,43025139,92120838,49095699,TNL
chr19,Bn87161,57812287,83985284,26172997,NBS
chr19,Bn87162,34529950,76835256,42305306,TN
chr19,Bn87163,43598490,78980465,35381975,CNL
chr19,Bn87164,99138616,99919702,781086,TN
chr19,Bn87165,7742182,44068712,36326530,RLP
chr19,Bn87166,81665693,83415981,1750288,CNL
chr19,Bn87167,52467154,62251368,9784214,CN
chr19,Bn87168,98424916,98738126,313210,CNL
chr19,Bn87169,48960823,79994924,31034101,RLP
chr19,Bn87170,79852869,84009538,4156669,CNL
chr19,Bn87171,38539212,94798296,56259084,CN
chr19,Bn87172,57567002,64276480,6709478,TN
chr19,Bn87173,68761828,76525921,7764093,RLK
chr19,Bn87174,53092234,95195705,42103471,CNL
chr19,Bn87175,22804288,97610565,74806277,TNL
chr19,Bn87176,89867590,93510646,3643056,CN
chr19,Bn87177,65505956,85611766,20105810,TN
chr19,Bn87178,59126116,69030575,9904459,NBS
chr19,Bn87179,57402443,77272213,19869770,NBS
chr19,Bn87180,51813886,69676373,17862487,RLK
chr19,Bn87181,18571043,38535102,19964059,NBS
chr19,Bn87182,99676907,99860405,183498,RLP
chr19,Bn87183,67838007,91696926,23858919,CN
chr19,Bn87184,86333213,97301292,10968079,CN
chr19,Bn87185,69117391,85945583,16828192,RLP
chr19,Bn87186,63121631,86869647,23748016,TN
chr19,Bn87187,6889514,62604027,55714513,TNL
chr19,Bn87188,43289600,68609790,25320190,TN
chr19,Bn87189,40802936,84968149,44165213,CNL
chr19,Bn87190,38954646,99696391,60741745,CNL
chr19,Bn87191,60024220,94456205,34431985,RLK
chr19,Bn87192,56147378,84575036,28427658,RLP
chr19,Bn87193,85321530,87935788,2614258,CN
chr19,Bn87194,18885663,72610273,53724610,RLK
chr19,Bn87195,92449200,97451277,5002077,CNL
chr19,Bn87196,23359942,36158874,12798932,TNL
chr19,Bn87197,48428630,54803854,6375224,TN
chr19,Bn87198,96875589,97430952,555363,RLP
chr19,Bn87199,83907840,91366954,7459114,CNL
chr19,Bn87200,20499877,29633631,9133754,CNL
chr19,Bn87201,80169389,97562059,17392670,CN
chr19,Bn87202,18259401,36637675,18378274,RLK
chr19,Bn87203,20236993,91427683,71190690,RLK
chr19,Bn87204,53372849,98983111,45610262,RLK
chr19,Bn87205,14279473,15738684,1459211,TN
chr19,Bn87206,45172794,88822837,43650043,NBS
chr19,Bn87207,64215137,97553315,33338178,RLP
chr19,Bn87208,61514332,73274024,11759692,CNL
chr19,Bn87209,26945224,43917206,16971982,CN
chr19,Bn87210,94824371,99409621,4585250,TNL
chr19,Bn87211,17893282,92193619,74300337,NBS
chr19,Bn87212,73584027,86722064,13138037,TNL
chr19,Bn87213,80442123,84769740,4327617,TN
chr19,Bn87214,64457659,75747541,11289882,TN
chr19,Bn87215,34618993,60371975,25752982,NBS
chr19,Bn87216,7121484,13985960,6864476,TNL
chr19,Bn87217,37673116,95998009,58324893,NBS
chr19,Bn87218,64898057,73644148,8746091,CNL
chr19,Bn87219,25950282,63977863,38027581,CNL
chr19,Bn87220,90917247,91388063,470816,CNL
chr19,Bn87221,88278876,96729300,8450424,TNL
chr19,Bn87222,50250190,79803708,29553518,TN
chr19,Bn87223,57918408,58313860,395452,NBS
chr19,Bn87224,84659501,99789191,15129690,TNL
chr19,Bn87225,33535275,88467839,54932564,RLK
chr19,Bn87226,93903996,99018092,5114096,CN
chr19,Bn87227,57439218,77760403,20321185,CNL
chr19,Bn87228,63070559,76420375,13349816,RLK
chr19,Bn87229,64149038,95633439,31484401,NBS
chr19,Bn87230,26817071,71027809,44210738,CN
chr19,Bn87231,94014791,97287009,3272218,TN
chr19,Bn87232,50695368,80990217,30294849,RLP
chr19,Bn87233,95616013,97995277,2379264,NBS
chr19,Bn87234,84608904,84743905,135001,TN
chr19,Bn87235,64987087,98485591,33498504,TN
chr19,Bn87236,3757960,55569100,51811140,RLP
chr19,Bn87237,33100060,89071810,55971750,NBS
chr19,Bn87238,74716634,78948165,4231531,CNL
chr19,Bn87239,51236221,82430529,31194308,CNL
chr19,Bn87240,97076031,97988292,912261,TN
chr19,Bn87241,13264818,20208099,6943281,RLP
chr19,Bn87242,86609902,98774588,12164686,CNL
chr19,Bn87243,7980479,32050003,24069524,RLK
chr19,Bn87244,56494964,97971301,41476337,RLK
chr19,Bn87245,16255452,60042910,43787458,CNL
chr19,Bn87246,73134588,84067533,10932945,RLK
chr19,Bn87247,70484152,98780125,28295973,TNL
chr19,Bn87248,13529937,18688287,5158350,TNL
chr19,Bn87249,8307454,43846006,35538552,NBS
chr19,Bn87250,74216190,99146304,24930114,RLP
chr19,Bn87251,87006863,92398469,5391606,RLK
chr19,Bn87252,99822405,99871697,49292,TNL
chr19,Bn87253,61346741,66011043,4664302,NBS
chr19,Bn87254,55669352,76159652,20490300,CN
chr19,Bn87255,60231456,63723232,3491776,RLP
chr19,Bn87256,32163059,69321247,37158188,TNL
chr19,Bn87257,7864289,71472011,63607722,TN
chr19,Bn87258,10636408,68269643,57633235,TNL
chr19,Bn87259,74927639,84583905,9656266,TNL
chr19,Bn87260,77010943,87657467,10646524,RLK
chr19,Bn87261,48062965,69079984,21017019,CNL
chr19,Bn87262,33081082,42094509,9013427,RLK
chr19,Bn87263,45490683,86207617,40716934,RLP
chr19,Bn87264,45496291,87158262,41661971,CNL
chr19,Bn87265,43623867,75331180,31707313,TNL
chr19,Bn87266,52572511,86302009,33729498,RLP
chr19,Bn87267,76640861,82912396,6271535,CNL
chr19,Bn87268,50838758,87675673,36836915,TN
chr19,Bn87269,12140810,83106878,70966068,TN
chr19,Bn87270,52192017,89727293,37535276,CN
chr19,Bn87271,67399167,95923357,28524190,TN
chr19,Bn87272,19863788,34088275,14224487,CN
chr19,Bn87273,82940909,83910542,969633,CNL
chr19,Bn87274,50642651,67583666,16941015,TNL
chr19,Bn87275,5110105,73684191,68574086,CN
chr19,Bn87276,11121636,91578385,80456749,NBS
chr19,Bn87277,75457195,98274637,22817442,CN
chr19,Bn87278,45605945,78926968,33321023,TNL
chr19,Bn87279,88238957,98564415,10325458,NBS
chr19,Bn87280,21081184,51503842,30422658,TN
chr19,Bn87281,79683307,81461006,1777699,TN
chr19,Bn87282,43692255,74845005,31152750,TN
chr19,Bn87283,23981505,61797676,37816171,NBS
chr19,Bn87284,93300885,95485548,2184663,RLK
chr19,Bn87285,93363202,95089660,1726458,NBS
chr19,Bn87286,43867817,67775983,23908166,CN
chr19,Bn87287,94601362,99322861,4721499,TNL
chr19,Bn87288,46854344,88151057,41296713,RLP
chr19,Bn87289,3283513,16903832,13620319,RLK
chr19,Bn87290,84920095,97609343,12689248,CN
chr19,Bn87291,86634202,96861594,10227392,RLP
chr19,Bn87292,81154065,89219372,8065307,TNL
chr19,Bn87293,11630123,24160854,12530731,RLP
chr19,Bn87294,47355613,65152558,17796945,TNL
chr19,Bn87295,67143707,89604312,22460605,TN
chr19,Bn87296,34626173,73040922,38414749,RLK
chr19,Bn87297,23359151,54402000,31042849,CN
chr19,Bn87298,75660937,91449239,15788302,RLP
chr19,Bn87299,3967884,71559732,67591848,TNL
chr19,Bn87300,27976958,95827869,67850911,CN
chr19,Bn87301,13460861,79643593,66182732,TNL
chr19,Bn87302,81349153,90611559,9262406,TNL
chr19,Bn87303,21132300,83788186,62655886,RLP
chr19,Bn87304,80329877,96952257,16622380,RLP
chr19,Bn87305,12617398,62366641,49749243,CN
chr19,Bn87306,50383917,92846965,42463048,CNL
chr19,Bn87307,29546111,72954541,43408430,NBS
chr19,Bn87308,16220497,80561483,64340986,TN
chr19,Bn87309,96548021,97348418,800397,RLK
chr19,Bn87310,32857053,82400781,49543728,CNL
chr19,Bn87311,81893038,82596721,703683,CNL
chr19,Bn87312,35879665,95715884,59836219,TN
chr19,Bn87313,96316492,98564221,2247729,TN
chr19,Bn87314,41693687,46435190,4741503,NBS
chr19,Bn87315,40310818,96215229,55904411,CNL
chr19,Bn87316,58349297,78249137,19899840,CN
chr19,Bn87317,77378554,92138775,14760221,CN
chr19,Bn87318,80909321,96122614,15213293,NBS
chr19,Bn87319,56534796,86976286,30441490,TNL
chr19,Bn87320,92593706,92999130,405424,RLP
chr19,Bn87321,97896313,99700470,1804157,TN
chr19,Bn87322,59564306,87701278,28136972,NBS
chr19,Bn87323,67344488,75536635,8192147,RLK
chr19,Bn87324,4703647,10406147,5702500,RLK
chr19,Bn87325,16368721,71816951,55448230,RLP
chr19,Bn87326,96645924,99480677,2834753,CN
chr19,Bn87327,87599144,96637469,9038325,TNL
chr19,Bn87328,44515791,93280545,48764754,TNL
chr19,Bn87329,48959770,80597676,31637906,TNL
chr19,Bn87330,37071894,74606795,37534901,RLK
chr19,Bn87331,30023161,97200609,67177448,CNL
chr19,Bn87332,12812939,41684058,28871119,RLP
chr19,Bn87333,29677156,72905932,43228776,TNL
chr19,Bn87334,21107216,51593233,30486017,RLP
chr19,Bn87335,98097195,98185480,88285,NBS
chr19,Bn87336,53696689,88841180,35144491,TNL
chr19,Bn87337,17886481,61709620,43823139,CNL
chr19,Bn87338,45315193,68372248,23057055,TN
chr19,Bn87339,1388787,38929284,37540497,TN
chr19,Bn87340,35477758,92945067,57467309,NBS
chr19,Bn87341,71728322,88119632,16391310,NBS
chr19,Bn87342,86562458,92628705,6066247,RLP
chr19,Bn87343,43010624,80161189,37150565,TN
chr19,Bn87344,17204833,29605652,12400819,CNL
chr19,Bn87345,36153794,84820344,48666550,CN
chr19,Bn87346,37758159,82292269,44534110,CNL
chr19,Bn87347,37333334,79830138,42496804,TN
chr19,Bn87348,21952856,71753123,49800267,CN
chr19,Bn87349,66034874,98902008,32867134,CN
chr19,Bn87350,21343030,79363792,58020762,TN
chr19,Bn87351,97151614,97723341,571727,NBS
chr19,Bn87352,72493017,83852806,11359789,TN
chr19,Bn87353,96191055,97448219,1257164,TNL
chr19,Bn87354,27785261,69006909,41221648,CN
chr19,Bn87355,62149177,67213071,5063894,TNL
chr19,Bn87356,65476805,66405560,928755,TNL
chr19,Bn87357,83940487,84294169,353682,NBS
chr19,Bn87358,79732735,95788546,16055811,TN
chr19,Bn87359,69533655,94634101,25100446,CN
chr19,Bn87360,49354459,61841599,12487140,RLP
chr19,Bn87361,37676482,78728066,41051584,NBS
chr19,Bn87362,26844469,55757979,28913510,RLK
chr19,Bn87363,29550473,86242140,56691667,TNL
chr19,Bn87364,3693718,67878545,64184827,NBS
chr19,Bn87365,50401112,59936497,9535385,RLP
chr19,Bn87366,51914987,72214197,20299210,TN
chr19,Bn87367,21841363,81204281,59362918,RLK
chr19,Bn87368,77935960,78880524,944564,CNL
chr19,Bn87369,97025785,99396788,2371003,RLK
chr19,Bn87370,48889720,74767232,25877512,RLK
chr19,Bn87371,90753602,98987360,8233758,CN
chr19,Bn87372,30125398,64605148,34479750,TN
chr19,Bn87373,18823967,59278396,40454429,RLP
chr19,Bn87374,23366362,31823164,8456802,TNL
chr19,Bn87375,68868791,91270055,22401264,NBS
chr19,Bn87376,36258978,81389840,45130862,RLP
chr19,Bn87377,56785489,86370971,29585482,RLP
chr19,Bn87378,52111496,67635382,15523886,CN
chr19,Bn87379,18630793,43053067,24422274,RLP
chr19,Bn87380,61830286,63559722,1729436,TN
chr19,Bn87381,85468188,99813577,14345389,RLP
chr19,Bn87382,49457226,91327967,41870741,RLK
chr19,Bn87383,16251560,97670312,81418752,CNL
chr19,Bn87384,69720171,87263364,17543193,CN
chr19,Bn87385,52628838,87221974,34593136,RLP
chr19,Bn87386,76894224,98749278,21855054,TN
chr19,Bn87387,79342136,96105590,16763454,TNL
chr19,Bn87388,85536169,98339588,12803419,NBS
chr19,Bn87389,64656915,98854805,34197890,RLP
chr19,Bn87390,46006240,87548315,41542075,CN
chr19,Bn87391,2687701,51496072,48808371,CN
chr19,Bn87392,91586278,91975470,389192,TNL
chr19,Bn87393,82981671,95420791,12439120,RLK
chr19,Bn87394,23792797,35383912,11591115,CNL
chr19,Bn87395,72656420,98328292,25671872,RLP
chr19,Bn87396,72746619,90702425,17955806,CN
chr19,Bn87397,30533698,33823991,3290293,TN
chr19,Bn87398,37408418,58687084,21278666,NBS
chr19,Bn87399,98198967,98232662,33695,TN
chr19,Bn87400,90509029,90552287,43258,TNL
chr19,Bn87401,27519149,96969962,69450813,CN
chr19,Bn87402,55110093,81669741,26559648,TN
chr19,Bn87403,46608901,74142928,27534027,TNL
chr19,Bn87404,71704049,96500573,24796524,NBS
chr19,Bn87405,35023316,52041397,17018081,TNL
chr19,Bn87406,6703759,77926614,71222855,RLK
chr19,Bn87407,37046241,71170268,34124027,RLK
chr19,Bn87408,24929452,86943695,62014243,TN
chr19,Bn87409,72349809,87621874,15272065,CNL
chr19,Bn87410,92564772,92970446,405674,CN
chr19,Bn87411,70242766,73253425,3010659,RLP
chr19,Bn87412,68969572,75353202,6383630,CN
chr19,Bn87413,48079163,91823217,43744054,TN
chr19,Bn87414,71563396,88768818,17205422,RLK
chr19,Bn87415,28805932,95450827,66644895,NBS
chr19,Bn87416,64380041,95139508,30759467,CN
chr19,Bn87417,19819838,94470337,74650499,RLK
chr19,Bn87418,4609263,13720825,9111562,TNL
chr19,Bn87419,90693983,94453700,3759717,CN
chr19,Bn87420,23031028,45723667,22692639,NBS
chr19,Bn87421,70357500,97291010,26933510,TN
chr19,Bn87422,48242020,97739598,49497578,TNL
chr19,Bn87423,96067946,98021888,1953942,CNL
chr19,Bn87424,78126415,92507482,14381067,NBS
chr19,Bn87425,16816456,34689751,17873295,NBS
chr19,Bn87426,42050484,99579121,57528637,RLP
chr19,Bn87427,79157778,91843356,12685578,RLK
chr19,Bn87428,41377742,91404669,50026927,RLP
chr19,Bn87429,23656382,99063197,75406815,RLK
chr19,Bn87430,71467820,81922927,10455107,NBS
chr19,Bn87431,99445387,99894193,448806,CNL
chr19,Bn87432,86444810,92661649,6216839,TNL
chr19,Bn87433,48350226,54925018,6574792,RLP
chr19,Bn87434,81696807,94648180,12951373,TN
chr19,Bn87435,29168277,90869218,61700941,RLK
chr19,Bn87436,79521478,85518167,5996689,TN
chr19,Bn87437,69247860,92967911,23720051,NBS
chr19,Bn87438,4845051,66753278,61908227,NBS
chr19,Bn87439,18028936,34044473,16015537,TN
chr19,Bn87440,60225600,75371918,15146318,TNL
chr19,Bn87441,86021495,93627437,7605942,CNL
chr19,Bn87442,37860417,64920064,27059647,CNL
chr19,Bn87443,82734789,88796679,6061890,TN
chr19,Bn87444,80187120,95586546,15399426,CNL
chr19,Bn87445,72795090,90630103,17835013,CNL
chr19,Bn87446,39968878,56165082,16196204,RLK
chr19,Bn87447,43553017,51867491,8314474,CN
chr19,Bn87448,80128364,80130713,2349,RLP
chr19,Bn87449,22615001,30593051,7978050,TN
chr19,Bn87450,20230460,40246461,20016001,TNL
chr19,Bn87451,72601987,90528467,17926480,CNL
chr19,Bn87452,74194406,91532436,17338030,TN
chr19,Bn87453,46753462,67981363,21227901,TN
chr19,Bn87454,19558792,56277431,36718639,TNL
chr19,Bn87455,26514838,58586673,32071835,CN
chr19,Bn87456,38207408,65092307,26884899,RLK
chr19,Bn87457,29868173,35268546,5400373,NBS
chr19,Bn87458,36758950,43584635,6825685,TNL
chr19,Bn87459,57130280,80923265,23792985,RLK
chr19,Bn87460,42481824,49108043,6626219,CNL
chr19,Bn87461,71450563,85461025,14010462,NBS
chr19,Bn87462,71314445,78658660,7344215,CN
chr19,Bn87463,28043122,72298805,44255683,TNL
chr19,Bn87464,24907947,32380610,7472663,RLK
chr19,Bn87465,18382740,55975607,37592867,RLP
chr19,Bn87466,71646534,85741795,14095261,CNL
chr19,Bn87467,83113435,85031561,1918126,CNL
chr19,Bn87468,23514584,58811067,35296483,NBS
chr19,Bn87469,23830304,35636476,11806172,TNL
chr19,Bn87470,27629432,30789015,3159583,TN
chr19,Bn87471,47612478,85333201,37720723,TNL
chr19,Bn87472,75161375,92360345,17198970,TNL
chr19,Bn87473,39506492,51748791,12242299,CNL
chr19,Bn87474,75107158,83749374,8642216,CNL
chr19,Bn87475,36302136,61230773,24928637,NBS
chr19,Bn87476,70339599,96975476,26635877,CNL
chr19,Bn87477,67719825,88875522,21155697,TNL
chr19,Bn87478,79027683,86980550,7952867,RLP
chr19,Bn87479,13650867,75425882,61775015,TN
chr19,Bn87480,10542360,19867882,9325522,RLK
chr19,Bn87481,14539634,86232600,71692966,RLP
chr19,Bn87482,89043503,97015149,7971646,CNL
chr19,Bn87483,58373798,86744833,28371035,NBS
chr19,Bn87484,60422112,89723053,29300941,TN
chr19,Bn87485,91693701,94721579,3027878,NBS
chr19,Bn87486,50294563,65029737,14735174,RLK
chr19,Bn87487,96652915,98413482,1760567,CN
chr19,Bn87488,50516344,76946340,26429996,TN
chr19,Bn87489,5893629,33588551,27694922,CNL
chr19,Bn87490,39564200,62537907,22973707,CN
chr19,Bn87491,47311531,49085033,1773502,TN
chr19,Bn87492,74599343,85276949,10677606,CN
chr19,Bn87493,18392918,43840799,25447881,TNL
chr19,Bn87494,26433910,45057916,18624006,RLK
chr19,Bn87495,43010038,47637129,4627091,RLK
chr19,Bn87496,3573326,13728174,10154848,TN
chr19,Bn87497,26225533,66307468,40081935,CNL
chr19,Bn87498,10199441,74861230,64661789,NBS
chr19,Bn87499,11658325,27441767,15783442,RLK
chr19,Bn87500,8937925,89354697,80416772,TN
chr19,Bn87501,28907237,30241305,1334068,CNL
chr19,Bn87502,44832803,94246026,49413223,NBS
chr19,Bn87503,20708022,84270235,63562213,CNL
chr19,Bn87504,42625863,51001278,8375415,RLK
chr19,Bn87505,2744206,50055482,47311276,CN
chr19,Bn87506,26747462,92943890,66196428,TN
chr19,Bn87507,8970972,95649619,86678647,TN
chr19,Bn87508,90182587,99170447,8987860,NBS
chr19,Bn87509,78869798,83316747,4446949,CNL
chr19,Bn87510,22482348,67590298,45107950,RLP
chr19,Bn87511,65627444,74351631,8724187,RLK
chr19,Bn87512,39152358,92304483,53152125,CN
chr19,Bn87513,23623451,81202205,57578754,CNL
chr19,Bn87514,43428848,55732460,12303612,RLK
chr19,Bn87515,39836951,88083602,48246651,RLP
chr19,Bn87516,77015852,81570869,4555017,CNL
chr19,Bn87517,92278136,99433515,7155379,CNL
chr19,Bn87518,94554698,95986839,1432141,TNL
chr19,Bn87519,91625807,93286808,1661001,TNL
chr19,Bn87520,78817653,89811100,10993447,TNL
chr19,Bn87521,38494866,81856906,43362040,CNL
chr19,Bn87522,77473252,91931145,14457893,RLP
chr19,Bn87523,16784190,25184165,8399975,CNL
chr19,Bn87524,66578587,82298802,15720215,CNL
chr19,Bn87525,20509115,35640141,15131026,TNL
chr19,Bn87526,28991166,34591362,5600196,CNL
chr19,Bn87527,27367942,32396249,5028307,NBS
chr19,Bn87528,91980461,92080511,100050,NBS
chr19,Bn87529,16930420,25705540,8775120,RLP
chr19,Bn87530,96969460,98067930,1098470,RLK
chr19,Bn87531,46510536,61182734,14672198,NBS
chr19,Bn87532,73500101,93562238,20062137,TN
chr19,Bn87533,98006594,98256755,250161,RLP
chr19,Bn87534,88881314,96081179,7199865,TNL
chr19,Bn87535,24876603,54520751,29644148,NBS
chr19,Bn87536,12924826,40637170,27712344,RLP
chr19,Bn87537,47072549,86927081,39854532,NBS
chr19,Bn87538,33480543,49826501,16345958,NBS
chr19,Bn87539,93519222,94571811,1052589,CNL
chr19,Bn87540,48192887,89159161,40966274,CN
chr19,Bn87541,87378248,93171550,5793302,RLP
chr19,Bn87542,28361051,80311229,51950178,TN
chr19,Bn87543,4292088,23262997,18970909,CN
chr19,Bn87544,13228164,89944338,76716174,NBS
chr19,Bn87545,46153753,56268955,10115202,CNL
chr19,Bn87546,54603748,87393271,32789523,RLK
chr19,Bn87547,53224130,57853046,4628916,TNL
chr19,Bn87548,34421130,98417057,63995927,TN
chr19,Bn87549,96363326,97937957,1574631,TN
chr19,Bn87550,80701414,93015672,12314258,TNL
chr19,Bn87551,67161452,95499758,28338306,TNL
chr19,Bn87552,97850634,98934293,1083659,TN
chr19,Bn87553,52599312,85405696,32806384,NBS
chr19,Bn87554,5985212,32877855,26892643,RLK
chr19,Bn87555,37188113,90869898,53681785,RLP
chr19,Bn87556,50578254,89610899,39032645,RLP
chr19,Bn87557,72721977,74722849,2000872,RLP
chr19,Bn87558,89040021,92976810,3936789,NBS
chr19,Bn87559,31057289,64755475,33698186,RLK
chr19,Bn87560,66518209,79043759,12525550,CNL
chr19,Bn87561,87987689,97663007,9675318,TNL
chr19,Bn87562,15730317,77075034,61344717,TNL
chr19,Bn87563,1072687,56684294,55611607,CNL
chr19,Bn87564,8004420,79108461,71104041,RLP
chr19,Bn87565,5213940,43321899,38107959,NBS
chr19,Bn87566,91738530,99030007,7291477,RLK
chr19,Bn87567,53341492,82812686,29471194,TN
chr19,Bn87568,96392551,98761733,2369182,RLK
chr19,Bn87569,10873494,98971760,88098266,CNL
chr19,Bn87570,18109309,77687159,59577850,CNL
chr19,Bn87571,98563272,99515626,952354,CNL
chr19,Bn87572,95341032,98994365,3653333,CNL
chr19,Bn87573,63654460,99331020,35676560,CN
chr19,Bn87574,71400665,88554695,17154030,CN
chr19,Bn87575,88463939,97276288,8812349,NBS
chr19,Bn87576,75139932,81811910,6671978,RLK
chr19,Bn87577,12110395,88596132,76485737,RLP
chr19,Bn87578,56810090,65200174,8390084,TN
chr19,Bn87579,35329659,66924682,31595023,NBS
chr19,Bn87580,29609764,92909863,63300099,RLP
chr19,Bn87581,8655955,75947361,67291406,RLP
chr19,Bn87582,97638573,99010736,1372163,CN
chr19,Bn87583,16734378,74976515,58242137,TNL
chr19,Bn87584,97420696,99482002,2061306,CN
chr19,Bn87585,51339609,55888890,4549281,RLP
chr19,Bn87586,36079455,54276763,18197308,CNL
chr19,Bn87587,94315504,96118688,1803184,RLP
chr19,Bn87588,89527270,89812229,284959,TNL
chr19,Bn87589,57158287,92640542,35482255,RLP
chr19,Bn87590,79534432,98741845,19207413,CN
chr19,Bn87591,56991434,83781627,26790193,TN
chr19,Bn87592,26468884,71016050,44547166,TN
chr19,Bn87593,53720504,57613351,3892847,CN
chr19,Bn87594,14833952,61435449,46601497,CN
chr19,Bn87595,55361806,57473765,2111959,RLK
chr19,Bn87596,57624172,88556340,30932168,TN
chr19,Bn87597,14745455,42614182,27868727,RLP
chr19,Bn87598,18960972,25417628,6456656,NBS
chr19,Bn87599,28279929,47811002,19531073,TN
chr19,Bn87600,91309053,97414926,6105873,TNL
chr19,Bn87601,9568468,22684710,13116242,TN
chr19,Bn87602,47344790,62530954,15186164,RLK
chr19,Bn87603,10316328,83446992,73130664,TNL
chr19,Bn87604,21431326,26446514,5015188,RLK
chr19,Bn87605,57685948,92157335,34471387,TN
chr19,Bn87606,16955995,36053209,19097214,NBS
chr19,Bn87607,7453471,52262880,44809409,RLK
chr19,Bn87608,37100107,40729157,3629050,RLK
chr19,Bn87609,84459991,86254717,1794726,TN
chr19,Bn87610,86550547,99159518,12608971,TNL
chr19,Bn87611,7307313,97104636,89797323,CNL
chr19,Bn87612,93798954,99187069,5388115,CN
chr19,Bn87613,3806085,11442766,7636681,TN
chr19,Bn87614,74838971,91297856,16458885,TN
chr19,Bn87615,33825434,35958083,2132649,CN
chr19,Bn87616,22037227,75691034,53653807,RLP
chr19,Bn87617,81064401,87893551,6829150,TNL
chr19,Bn87618,53509737,94680007,41170270,RLP
chr19,Bn87619,41026906,89444070,48417164,TN
chr19,Bn87620,60904835,96609581,35704746,RLP
chr19,Bn87621,32135917,47871291,15735374,CN
chr19,Bn87622,59181495,63927972,4746477,CNL
chr19,Bn87623,17676307,24172872,6496565,CNL
chr19,Bn87624,60226747,74334623,14107876,RLP
chr19,Bn87625,60721668,86647990,25926322,TNL
chr19,Bn87626,28652238,55611463,26959225,TN
chr19,Bn87627,11794791,34851911,23057120,NBS
chr19,Bn87628,26228798,59144490,32915692,RLP
chr19,Bn87629,77201580,94350053,17148473,TNL
chr19,Bn87630,96869413,99929785,3060372,CNL
chr19,Bn87631,99379317,99600562,221245,RLK
chr19,Bn87632,10572727,67964543,57391816,RLP
chr19,Bn87633,50913565,69142998,18229433,RLP
chr19,Bn87634,92385495,98732549,6347054,NBS
chr19,Bn87635,65424331,80672771,15248440,TNL
chr19,Bn87636,23730794,50740147,27009353,TNL
chr19,Bn87637,84893467,93282802,8389335,CN
chr19,Bn87638,38244586,39262702,1018116,CNL
chr19,Bn87639,23914896,36887770,12972874,RLK
chr19,Bn87640,52316861,59935953,7619092,RLP
chr19,Bn87641,93101499,93702644,601145,TN
chr19,Bn87642,87462630,96072911,8610281,TN
chr19,Bn87643,31875645,69265346,37389701,RLP
chr19,Bn87644,31338732,79528253,48189521,RLK
chr19,Bn87645,34131268,84637661,50506393,NBS
chr19,Bn87646,30915275,47853636,16938361,CNL
chr19,Bn87647,62086641,78686878,16600237,NBS
chr19,Bn87648,92079988,95961276,3881288,NBS
chr19,Bn87649,63464951,86255112,22790161,CNL
chr19,Bn87650,91596453,93279272,1682819,NBS
chr19,Bn87651,31976074,49504419,17528345,NBS
chr19,Bn87652,72726666,85161767,12435101,RLK
chr19,Bn87653,59259539,83713888,24454349,CNL
chr19,Bn87654,38872011,96340225,57468214,CN
chr19,Bn87655,52878324,79282552,26404228,CN
chr19,Bn87656,87427778,95802343,8374565,TNL
chr19,Bn87657,53565599,66255846,12690247,CNL
chr19,Bn87658,99234620,99668253,433633,CNL
chr19,Bn87659,90536325,97421766,6885441,NBS
chr19,Bn87660,63837607,76678443,12840836,RLK
chr19,Bn87661,59877037,60902003,1024966,RLP
chr19,Bn87662,74773716,98050957,23277241,TN
chr19,Bn87663,33882520,55686377,21803857,TN
chr19,Bn87664,5337052,14438839,9101787,RLP
chr19,Bn87665,84253522,88519332,4265810,TN
chr19,Bn87666,66681521,89897022,23215501,NBS
chr19,Bn87667,52326496,90392285,38065789,RLP
chr19,Bn87668,7775011,78613013,70838002,CN
chr19,Bn87669,75573157,98249040,22675883,CN
chr19,Bn87670,50442900,57529955,7087055,TNL
chr19,Bn87671,34140449,80396931,46256482,CN
chr19,Bn87672,46534285,47082606,548321,CN
chr19,Bn87673,20501350,24211363,3710013,RLP
chr19,Bn87674,27511927,64882836,37370909,TN
chr19,Bn87675,16219911,47414159,31194248,NBS
chr19,Bn87676,13433685,89475702,76042017,RLP
chr19,Bn87677,67779340,84979794,17200454,NBS
chr19,Bn87678,92569864,96629432,4059568,NBS
chr19,Bn87679,87468813,93817210,6348397,RLP
chr19,Bn87680,34369123,65146320,30777197,NBS
chr19,Bn87681,39411537,50537414,11125877,CN
chr19,Bn87682,79257735,81554560,2296825,NBS
chr19,Bn87683,44768558,66243380,21474822,RLK
chr19,Bn87684,66902860,71303070,4400210,TNL
chr19,Bn87685,81365640,81906769,541129,CN
chr19,Bn87686,18215075,61924470,43709395,TN
chr19,Bn87687,82452405,87171162,4718757,NBS
chr19,Bn87688,31766215,67271003,35504788,RLP
chr19,Bn87689,72649708,90097252,17447544,TNL
chr19,Bn87690,44019233,46893948,2874715,RLK
chr19,Bn87691,13741104,30066371,16325267,TN
chr19,Bn87692,65709353,98109203,32399850,RLK
chr19,Bn87693,53018846,69371377,16352531,RLK
chr19,Bn87694,75795305,80438750,4643445,TNL
chr19,Bn87695,21768567,69788460,48019893,TNL
chr19,Bn87696,15660668,25490282,9829614,RLK
chr19,Bn87697,5048186,99902076,94853890,TNL
chr19,Bn87698,95952932,98026249,2073317,CN
chr19,Bn87699,2134209,82391226,80257017,CNL
chr19,Bn87700,72837481,77807347,4969866,TNL
chr19,Bn87701,8175234,93728730,85553496,CNL
chr19,Bn87702,97733545,98872858,1139313,TNL
chr19,Bn87703,36601761,95594235,58992474,CN
chr19,Bn87704,80845725,95917408,15071683,RLK
chr19,Bn87705,16782339,68381298,51598959,NBS
chr19,Bn87706,42910209,92861126,49950917,CN
chr19,Bn87707,81881277,95812689,13931412,NBS
chr19,Bn87708,74225552,77093733,2868181,TN
chr19,Bn87709,59392592,98175033,38782441,RLK
chr19,Bn87710,32951882,98435489,65483607,CN
chr19,Bn87711,18123238,73611648,55488410,CNL
chr19,Bn87712,58179397,66115968,7936571,CNL
chr19,Bn87713,55184495,90386590,35202095,TNL
chr19,Bn87714,67097856,77614809,10516953,RLK
chr19,Bn87715,42391314,92044499,49653185,CN
chr19,Bn87716,46212973,64071165,17858192,RLP
chr19,Bn87717,65479192,96899204,31420012,CN
chr19,Bn87718,29948994,31422423,1473429,RLK
chr19,Bn87719,96817313,98755408,1938095,TNL
chr19,Bn87720,77797669,97778786,19981117,TN
chr19,Bn87721,30758347,84068463,53310116,RLK
chr19,Bn87722,68467043,70116193,1649150,RLK
chr19,Bn87723,28205278,82289744,54084466,TN
chr19,Bn87724,62574679,66410130,3835451,TNL
chr19,Bn87725,70664890,82656077,11991187,NBS
chr19,Bn87726,21762810,99211831,77449021,NBS
chr19,Bn87727,21256775,72833364,51576589,RLP
chr19,Bn87728,44460274,85017968,40557694,RLP
chr19,Bn87729,4746318,14934569,10188251,CNL
chr19,Bn87730,82167721,83132425,964704,CNL
chr19,Bn87731,34305669,69022643,34716974,CN
chr19,Bn87732,76494595,94266048,17771453,TNL
chr19,Bn87733,19884746,82918539,63033793,RLP
chr19,Bn87734,23210323,93973958,70763635,NBS
chr19,Bn87735,36771305,48699520,11928215,CNL
chr19,Bn87736,13779993,92065850,78285857,NBS
chr19,Bn87737,7017000,51981266,44964266,RLP
chr19,Bn87738,37240907,56496096,19255189,CN
chr19,Bn87739,60724630,71787656,11063026,TN
chr19,Bn87740,99867487,99895895,28408,CN
chr19,Bn87741,43544520,51966857,8422337,RLP
chr19,Bn87742,60469765,94815775,34346010,CNL
chr19,Bn87743,8042682,83787666,75744984,RLK
chr19,Bn87744,43913580,55449174,11535594,TN
chr19,Bn87745,85606144,89897345,4291201,TNL
chr19,Bn87746,77988485,98726748,20738263,CNL
chr19,Bn87747,17233817,66996281,49762464,CN
chr19,Bn87748,52399210,58282949,5883739,NBS
chr19,Bn87749,84071025,85912604,1841579,TNL
chr19,Bn87750,58761370,91726734,32965364,TN
chr19,Bn87751,55346376,91216092,35869716,NBS
chr19,Bn87752,60930420,79968070,19037650,RLP
chr19,Bn87753,87704020,94076189,6372169,NBS
chr19,Bn87754,41425183,57849908,16424725,CN
chr19,Bn87755,33435872,69894466,36458594,RLP
chr19,Bn87756,87931252,97320607,9389355,RLP
chr19,Bn87757,14036062,86046441,72010379,CN
chr19,Bn87758,19489362,23812675,4323313,RLK
chr19,Bn87759,38790581,67481602,28691021,TN
chr19,Bn87760,26235723,32657880,6422157,TNL
chr19,Bn87761,98449765,98618532,168767,NBS
chr19,Bn87762,85019020,86243500,1224480,NBS
chr19,Bn87763,86049307,95400423,9351116,RLP
chr19,Bn87764,46649697,82056941,35407244,CNL
chr19,Bn87765,76108059,97501275,21393216,RLK
chr19,Bn87766,48083310,58887940,10804630,CN
chr19,Bn87767,59270549,72297918,13027369,NBS
chr19,Bn87768,20612931,77065635,56452704,CNL
chr19,Bn87769,37265632,61019458,23753826,TNL
chr19,Bn87770,99395800,99538626,142826,CN
chr19,Bn87771,54810172,74301349,19491177,CNL
chr19,Bn87772,18113086,95805696,77692610,RLK
chr19,Bn87773,88372296,96102606,7730310,CNL
chr19,Bn87774,37546416,59782972,22236556,TNL
chr19,Bn87775,25682119,41449424,15767305,TN
chr19,Bn87776,16859791,88852705,71992914,CNL
chr19,Bn87777,29079398,95950889,66871491,RLK
chr19,Bn87778,28809522,61997930,33188408,TN
chr19,Bn87779,18390670,88829253,70438583,TN
chr19,Bn87780,73319693,83230557,9910864,RLP
chr19,Bn87781,32413455,36563321,4149866,CN
chr19,Bn87782,43976963,78674265,34697302,NBS
chr19,Bn87783,79954372,89470135,9515763,CNL
chr19,Bn87784,19964317,37690407,17726090,RLK
chr19,Bn87785,12506271,59519776,47013505,TN
chr19,Bn87786,81223828,86504767,5280939,CN
chr19,Bn87787,75189597,97935229,22745632,TN
chr19,Bn87788,33247571,47256370,14008799,TN
chr19,Bn87789,84173173,91886440,7713267,CNL
chr19,Bn87790,74484075,84233679,9749604,NBS
chr19,Bn87791,62406623,91709942,29303319,TNL
chr19,Bn87792,21337889,60201948,38864059,TNL
chr19,Bn87793,66185164,74432573,8247409,CNL
chr19,Bn87794,5097051,61870664,56773613,TNL
chr19,Bn87795,19096868,23321001,4224133,TN
chr19,Bn87796,40563576,73391572,32827996,RLK
chr19,Bn87797,92619089,94573293,1954204,TNL
chr19,Bn87798,86890114,92393440,5503326,RLP
chr19,Bn87799,82326858,84434246,2107388,TN
chr19,Bn87800,71131966,89032284,17900318,RLP
chr19,Bn87801,78417812,99065187,20647375,CNL
chr19,Bn87802,30142053,80826664,50684611,CNL
chr19,Bn87803,92026524,98573569,6547045,RLP
chr19,Bn87804,7809436,65413544,57604108,NBS
chr19,Bn87805,40278794,99318681,59039887,TNL
chr19,Bn87806,24042248,63108940,39066692,NBS
chr19,Bn87807,28109837,63395774,35285937,RLP
chr19,Bn87808,63002917,70555746,7552829,CN
chr19,Bn87809,49141086,91256785,42115699,TNL
chr19,Bn87810,14751551,80485222,65733671,RLK
chr19,Bn87811,94239056,96572364,2333308,CNL
chr19,Bn87812,35189748,70936670,35746922,RLK
chr19,Bn87813,97244499,98531142,1286643,TN
chr19,Bn87814,82532341,89546115,7013774,RLK
chr19,Bn87815,77825788,94055195,16229407,RLK
chr19,Bn87816,29697995,99111403,69413408,TNL
chr19,Bn87817,17946357,18235668,289311,TN
chr19,Bn87818,3354850,26314150,22959300,NBS
chr19,Bn87819,65895857,99011613,33115756,NBS
chr19,Bn87820,72294782,89000249,16705467,TN
chr19,Bn87821,82098845,85221707,3122862,TN
chr19,Bn87822,51893626,66627598,14733972,CNL
chr19,Bn87823,81227445,89416081,8188636,RLP
chr19,Bn87824,38913704,88312371,49398667,NBS
chr19,Bn87825,10511946,14781748,4269802,CN
chr19,Bn87826,74110237,85770659,11660422,TN
chr19,Bn87827,12022017,71236956,59214939,CNL
chr19,Bn87828,83478149,91930587,8452438,CN
chr19,Bn87829,19754597,52964808,33210211,TN
chr19,Bn87830,51053946,79256682,28202736,CN
chr19,Bn87831,78597397,91939030,13341633,CNL
chr19,Bn87832,19575558,49965254,30389696,RLK
chr19,Bn87833,47129627,86176366,39046739,RLP
chr19,Bn87834,76207072,89042303,12835231,RLP
chr19,Bn87835,14743134,68901614,54158480,CNL
chr19,Bn87836,10387496,41895632,31508136,NBS
chr19,Bn87837,91624607,96912234,5287627,TN
chr19,Bn87838,6196493,52716016,46519523,TN
chr19,Bn87839,37173832,87992981,50819149,CNL
chr19,Bn87840,4207806,75678586,71470780,RLK
chr19,Bn87841,76012465,98383915,22371450,TNL
chr19,Bn87842,47140272,95596595,48456323,TNL
chr19,Bn87843,33209914,71944434,38734520,CN
chr19,Bn87844,3723590,26530096,22806506,RLK
chr19,Bn87845,30853173,96192975,65339802,CNL
chr19,Bn87846,33436903,72014381,38577478,CNL
chr19,Bn87847,26896669,76897606,50000937,RLP
chr19,Bn87848,42203009,86179214,43976205,CNL
chr19,Bn87849,1782336,4313234,2530898,TNL
chr19,Bn87850,37553820,82265284,44711464,RLK
chr19,Bn87851,51092965,61820086,10727121,CNL
chr19,Bn87852,22428063,46206760,23778697,RLK
chr19,Bn87853,26554923,99271720,72716797,CNL
chr19,Bn87854,25841343,90205818,64364475,RLK
chr19,Bn87855,65039361,78565077,13525716,CN
chr19,Bn87856,85440294,90116906,4676612,RLP
chr19,Bn87857,68027297,76844851,8817554,NBS
chr19,Bn87858,85972822,99081794,13108972,NBS
chr19,Bn87859,10571940,54446859,43874919,TN
chr19,Bn87860,38676531,75372230,36695699,RLP
chr19,Bn87861,1846982,78466284,76619302,TNL
chr19,Bn87862,92219366,99290489,7071123,TNL
chr19,Bn87863,31463476,33089436,1625960,RLK
chr19,Bn87864,21992640,99265925,77273285,TNL
chr19,Bn87865,74317454,93320066,19002612,CN
chr19,Bn87866,62348791,72724601,10375810,NBS
chr19,Bn87867,51052137,64781075,13728938,RLK
chr19,Bn87868,47799147,65712063,17912916,NBS
chr19,Bn87869,99239015,99802261,563246,CNL
chr19,Bn87870,33105734,87804414,54698680,RLK
chr19,Bn87871,53392684,74154606,20761922,NBS
chr19,Bn87872,23834774,59461852,35627078,TN
chr19,Bn87873,79559608,98300437,18740829,RLK
chr19,Bn87874,55329287,92393934,37064647,CNL
chr19,Bn87875,25849197,95439502,69590305,CNL
chr19,Bn87876,74551512,91488188,16936676,NBS
chr19,Bn87877,15524255,95173937,79649682,CN
chr19,Bn87878,12265960,22031949,9765989,TN
chr19,Bn87879,62989903,71734460,8744557,RLP
chr19,Bn87880,51099596,81123197,30023601,CN
chr19,Bn87881,4770866,54705584,49934718,RLP
chr19,Bn87882,58107002,62223597,4116595,NBS
chr19,Bn87883,37438279,53785217,16346938,RLP
chr19,Bn87884,10288218,44276791,33988573,CNL
chr19,Bn87885,39951305,76916779,36965474,TN
chr19,Bn87886,43219626,78262973,35043347,NBS
chr19,Bn87887,54528181,74265018,19736837,RLK
chr19,Bn87888,8784238,26554374,17770136,CNL
chr19,Bn87889,7251660,58243582,50991922,TN
chr19,Bn87890,87202502,97635610,10433108,NBS
chr19,Bn87891,68578588,70026825,1448237,RLK
chr19,Bn87892,43124413,82718640,39594227,CNL
chr19,Bn87893,59319373,73818675,14499302,RLP
chr19,Bn87894,66865787,80068325,13202538,RLP
chr19,Bn87895,71516356,78884673,7368317,NBS
chr19,Bn87896,9540093,66148485,56608392,CN
chr19,Bn87897,34809213,72107540,37298327,CN
chr19,Bn87898,28068674,44105793,16037119,RLP
chr19,Bn87899,61959460,80846207,18886747,CN
chr19,Bn87900,41209132,99677613,58468481,RLP
chr19,Bn87901,16946687,47783490,30836803,CN
chr19,Bn87902,24639984,94047429,69407445,TNL
chr19,Bn87903,69239449,98582292,29342843,CN
chr19,Bn87904,74998951,84712209,9713258,CN
chr19,Bn87905,25517809,95000191,69482382,RLK
chr19,Bn87906,40124103,52823157,12699054,RLP
chr19,Bn87907,72104292,91522582,19418290,NBS
chr19,Bn87908,18066918,18718271,651353,TNL
chr19,Bn87909,92006613,94303600,2296987,RLK
chr19,Bn87910,61685235,64268242,2583007,CN
chr19,Bn87911,42217121,71045704,28828583,RLK
chr19,Bn87912,36455884,70262915,33807031,TNL
chr19,Bn87913,15569820,24225018,8655198,CNL
chr19,Bn87914,63255646,88785725,25530079,RLP
chr19,Bn87915,92580480,96808333,4227853,TNL
chr19,Bn87916,69835630,91786865,21951235,NBS
chr19,Bn87917,43886424,61290819,17404395,TNL
chr19,Bn87918,32243243,62174420,29931177,RLP
chr19,Bn87919,47832747,91858986,44026239,CNL
chr19,Bn87920,71255886,78431121,7175235,RLK
chr19,Bn87921,67267209,99439271,32172062,RLP
chr19,Bn87922,72898822,77637468,4738646,RLP
chr19,Bn87923,37600738,99090073,61489335,RLK
chr19,Bn87924,48138370,91022968,42884598,RLP
chr19,Bn87925,72615253,76992114,4376861,CN
chr19,Bn87926,39388240,83386160,43997920,CNL
chr19,Bn87927,9194583,44302563,35107980,TNL
chr19,Bn87928,67033471,90106419,23072948,CNL
chr19,Bn87929,33826420,53875773,20049353,RLK
chr19,Bn87930,7689201,14907915,7218714,NBS
chr19,Bn87931,45426572,86976753,41550181,NBS
chr19,Bn87932,91805507,94736913,2931406,RLP
chr19,Bn87933,73655949,86424985,12769036,RLK
chr19,Bn87934,70760175,92339730,21579555,CNL
chr19,Bn87935,29648769,53838720,24189951,RLP
chr19,Bn87936,76374604,92014731,15640127,TN
chr19,Bn87937,81116865,90714139,9597274,RLP
chr19,Bn87938,27832069,70696561,42864492,RLP
chr19,Bn87939,25179144,62557745,37378601,TNL
chr19,Bn87940,80104599,83370682,3266083,CN
chr19,Bn87941,90008513,92091113,2082600,NBS
chr19,Bn87942,52608855,92612758,40003903,RLP
chr19,Bn87943,50419581,66977770,16558189,RLP
chr19,Bn87944,47141359,53152146,6010787,RLK
chr19,Bn87945,95960671,96356737,396066,RLK
chr19,Bn87946,35735784,36548447,812663,CNL
chr19,Bn87947,56980230,88341522,31361292,RLK
chr19,Bn87948,30860391,58137645,27277254,RLK
chr19,Bn87949,2444166,31019710,28575544,RLP
chr19,Bn87950,75556956,85213199,9656243,RLP
chr19,Bn87951,12239689,55293993,43054304,TN
chr19,Bn87952,66162442,86737653,20575211,RLP
chr19,Bn87953,24251309,64991866,40740557,CN
chr19,Bn87954,76944917,95536374,18591457,CNL
chr19,Bn87955,83271701,84778794,1507093,CN
chr19,Bn87956,15929664,32013785,16084121,TNL
chr19,Bn87957,33529178,90487646,56958468,RLK
chr19,Bn87958,15915541,53989688,38074147,CN
chr19,Bn87959,80895881,95866231,14970350,CN
chr19,Bn87960,78353644,89411837,11058193,CN
chr19,Bn87961,49694129,88598865,38904736,RLP
chr19,Bn87962,91341385,93550674,2209289,CN
chr19,Bn87963,98138763,99808516,1669753,TNL
chr19,Bn87964,56309070,59405192,3096122,TNL
chr19,Bn87965,51112776,60775794,9663018,CN
chr19,Bn87966,5593661,54023411,48429750,TN
chr19,Bn87967,6215464,66511820,60296356,TNL
chr19,Bn87968,28207294,89812169,61604875,RLK
chr19,Bn87969,60697323,84179678,23482355,RLP
chr19,Bn87970,16557088,90329118,73772030,CN
chr19,Bn87971,4701513,84101490,79399977,NBS
chr19,Bn87972,90604916,99094606,8489690,NBS
chr19,Bn87973,6940843,96766199,89825356,NBS
chr19,Bn87974,38923516,91627632,52704116,TNL
chr19,Bn87975,1517785,75616668,74098883,TN
chr19,Bn87976,66753868,72312842,5558974,CNL
chr19,Bn87977,26470991,49510273,23039282,RLP
chr19,Bn87978,69894069,89127607,19233538,CN
chr19,Bn87979,43266163,47366013,4099850,RLK
chr19,Bn87980,10045420,83146171,73100751,NBS
chr19,Bn87981,32408308,88951246,56542938,CN
chr19,Bn87982,4041015,17254139,13213124,TN
chr19,Bn87983,74658711,87776881,13118170,CN
chr19,Bn87984,63021236,95223933,32202697,TNL
chr19,Bn87985,6285996,50661219,44375223,NBS
chr19,Bn87986,96509451,98174917,1665466,NBS
chr19,Bn87987,19008718,49565834,30557116,RLK
chr19,Bn87988,14176811,61526037,47349226,TNL
chr19,Bn87989,98687603,98928670,241067,RLP
chr19,Bn87990,59780251,94689136,34908885,RLP
chr19,Bn87991,41112103,86051663,44939560,NBS
chr19,Bn87992,94307955,97107767,2799812,TN
chr19,Bn87993,56294825,67723615,11428790,CNL
chr19,Bn87994,81978447,86353227,4374780,TNL
chr19,Bn87995,27113001,74617314,47504313,CN
chr19,Bn87996,24527670,50536969,26009299,RLP
chr19,Bn87997,38951672,87978024,49026352,NBS
chr19,Bn87998,98019140,98222266,203126,TN
chr19,Bn87999,34194836,96358935,62164099,CN
chr19,Bn88000,79196995,90530980,11333985,TN
chr19,Bn88001,54753853,93966884,39213031,TNL
chr19,Bn88002,68928876,94984875,26055999,TN
chr19,Bn88003,65188094,87362404,22174310,NBS
chr19,Bn88004,11753428,86621266,74867838,CN
chr19,Bn88005,96348210,98311848,1963638,TN
chr19,Bn88006,61427123,66485996,5058873,NBS
chr19,Bn88007,65615114,72744889,7129775,CNL
chr19,Bn88008,89605511,92924592,3319081,NBS
chr19,Bn88009,96060454,96448976,388522,TN
chr19,Bn88010,60652387,92016432,31364045,TNL
chr19,Bn88011,79118052,98014813,18896761,TNL
chr19,Bn88012,42610425,91096931,48486506,CN
chr19,Bn88013,79710689,88814562,9103873,NBS
chr19,Bn88014,80602580,93140652,12538072,NBS
chr19,Bn88015,64868499,72770195,7901696,CNL
chr19,Bn88016,80362340,98373471,18011131,CNL
chr19,Bn88017,99622327,99942331,320004,CN
chr19,Bn88018,12246430,65748998,53502568,CN
chr19,Bn88019,93349044,93692074,343030,CN
chr19,Bn88020,26361735,63054220,36692485,NBS
chr19,Bn88021,77606658,97276234,19669576,TN
chr19,Bn88022,14020173,83364071,69343898,NBS
chr19,Bn88023,21874807,60753425,38878618,RLK
chr19,Bn88024,76064090,78885170,2821080,NBS
chr19,Bn88025,28301297,40253554,11952257,NBS
chr19,Bn88026,85854243,96412109,10557866,CN
chr19,Bn88027,59842289,67928732,8086443,TNL
chr19,Bn88028,6204101,49429206,43225105,TNL
chr19,Bn88029,22039328,76207089,54167761,CN
chr19,Bn88030,45026985,70911211,25884226,CN
chr19,Bn88031,39445680,67675550,28229870,NBS
chr19,Bn88032,65523610,89932528,24408918,RLK
chr19,Bn88033,7542621,43093044,35550423,TN
chr19,Bn88034,36925252,60076001,23150749,TN
chr19,Bn88035,57098552,99056720,41958168,TNL
chr19,Bn88036,75238764,76209140,970376,TNL
chr19,Bn88037,95605775,97794735,2188960,RLP
chr19,Bn88038,54455780,79490889,25035109,CN
chr19,Bn88039,37712108,51393247,13681139,TNL
chr19,Bn88040,42164540,68340058,26175518,RLP
chr19,Bn88041,14805029,65473283,50668254,RLK
chr19,Bn88042,31963900,59532791,27568891,TN
chr19,Bn88043,67349461,76135002,8785541,CN
chr19,Bn88044,69749117,82979801,13230684,CNL
chr19,Bn88045,12967646,38668735,25701089,CN
chr19,Bn88046,69433986,70841468,1407482,TN
chr19,Bn88047,83207494,91491329,8283835,RLK
chr19,Bn88048,63184909,77776398,14591489,TN
chr19,Bn88049,53386288,77354012,23967724,NBS
chr19,Bn88050,27362178,56206260,28844082,CNL
chr19,Bn88051,37191089,79951906,42760817,NBS
chr19,Bn88052,7376536,86108740,78732204,RLK
chr19,Bn88053,45224802,96826628,51601826,CNL
chr19,Bn88054,61041467,95282502,34241035,TN
chr19,Bn88055,70972955,97550621,26577666,RLP
chr19,Bn88056,89300571,91282892,1982321,NBS
chr19,Bn88057,65370383,66646403,1276020,NBS
chr19,Bn88058,62477109,62904061,426952,TNL
chr19,Bn88059,66285895,97269159,30983264,CNL
chr19,Bn88060,98404820,99792449,1387629,CN
chr19,Bn88061,88522343,94924040,6401697,TNL
chr19,Bn88062,1841858,36541805,34699947,RLP
chr19,Bn88063,60844522,79522078,18677556,CNL
chr19,Bn88064,58719190,93672273,34953083,TNL
chr19,Bn88065,67831234,87613492,19782258,RLP
chr19,Bn88066,13472730,51730067,38257337,CNL
chr19,Bn88067,63885298,71862557,7977259,CNL
chr19,Bn88068,2726930,57523857,54796927,CN
chr19,Bn88069,87149642,96353029,9203387,RLK
chr19,Bn88070,3530726,13043335,9512609,TN
chr19,Bn88071,96136623,96627272,490649,RLP
chr19,Bn88072,38873718,52153943,13280225,TN
chr19,Bn88073,64177718,66725925,2548207,CNL
chr19,Bn88074,44612661,46864718,2252057,CNL
chr19,Bn88075,76327684,84983363,8655679,RLP
chr19,Bn88076,2156221,14882812,12726591,RLP
chr19,Bn88077,35588858,51762167,16173309,RLK
chr19,Bn88078,86848491,99026933,12178442,CN
chr19,Bn88079,50528302,86349254,35820952,CNL
chr19,Bn88080,72996387,94412059,21415672,CN
chr19,Bn88081,58953304,68808345,9855041,CN
chr19,Bn88082,44267682,52873945,8606263,RLP
chr19,Bn88083,68316873,98684780,30367907,RLP
chr19,Bn88084,13349007,22381593,9032586,TN
chr19,Bn88085,23550851,69839901,46289050,TN
chr19,Bn88086,97292869,98856496,1563627,RLK
chr19,Bn88087,87724880,93419979,5695099,RLK
chr19,Bn88088,36806300,59118515,22312215,CNL
chr19,Bn88089,34638430,53235245,18596815,RLK
chr19,Bn88090,92776853,92845993,69140,TN
chr19,Bn88091,61585397,78476022,16890625,RLP
chr19,Bn88092,56195053,59910230,3715177,TN
chr19,Bn88093,20799562,72009750,51210188,CN
chr19,Bn88094,54612210,92875828,38263618,CN
chr19,Bn88095,34008802,78012591,44003789,TNL
chr19,Bn88096,34143407,42579828,8436421,NBS
chr19,Bn88097,93774389,99406761,5632372,CNL
chr19,Bn88098,54978866,56911097,1932231,TN
chr19,Bn88099,77126228,89918087,12791859,RLK
chr19,Bn88100,91972053,94332819,2360766,RLP
chr19,Bn88101,18610754,95225147,76614393,RLK
chr19,Bn88102,22852863,29274313,6421450,CN
chr19,Bn88103,95983756,97541840,1558084,CN
chr19,Bn88104,41002202,80340827,39338625,TNL
chr19,Bn88105,10979540,31868734,20889194,NBS
chr19,Bn88106,86669786,95749261,9079475,RLP
chr19,Bn88107,28453623,49789308,21335685,TN
chr19,Bn88108,23494524,98054820,74560296,NBS
chr19,Bn88109,98773656,98963380,189724,RLP
chr19,Bn88110,29586915,73945224,44358309,NBS
chr19,Bn88111,84701378,87538821,2837443,RLP
chr19,Bn88112,75138813,81465376,6326563,CNL
chr19,Bn88113,85974632,91114720,5140088,TN
chr19,Bn88114,21116963,36095747,14978784,RLP
chr19,Bn88115,5067225,51519653,46452428,RLP
chr19,Bn88116,5237323,23983165,18745842,NBS
chr19,Bn88117,45197277,49203024,4005747,CN
chr19,Bn88118,29765427,82610632,52845205,CNL
chr19,Bn88119,64274223,87587001,23312778,RLK
chr19,Bn88120,71580523,80301762,8721239,TNL
chr19,Bn88121,64184381,72914008,8729627,NBS
chr19,Bn88122,60711424,63176447,2465023,RLP
chr19,Bn88123,67898474,78288595,10390121,RLK
chr19,Bn88124,8286178,35954858,27668680,CN
chr19,Bn88125,79492057,84800022,5307965,CN
chr19,Bn88126,63809577,81837532,18027955,RLK
chr19,Bn88127,80877021,91003163,10126142,NBS
chr19,Bn88128,59694790,82664693,22969903,TN
chr19,Bn88129,33742368,82054466,48312098,RLP
chr19,Bn88130,91005588,94576170,3570582,RLP
chr19,Bn88131,81113902,89337508,8223606,CNL
chr19,Bn88132,74669983,76562488,1892505,RLK
chr19,Bn88133,32494005,73245521,40751516,RLK
chr19,Bn88134,87099065,89466814,2367749,NBS
chr19,Bn88135,55335241,58622346,3287105,NBS
chr19,Bn88136,29180530,73706145,44525615,TN
chr19,Bn88137,99224857,99415282,190425,TNL
chr19,Bn88138,64375587,77019329,12643742,RLP
chr19,Bn88139,55445930,93861611,38415681,CNL
chr19,Bn88140,90781435,99778887,8997452,TN
chr19,Bn88141,42855417,78867810,36012393,TN
chr19,Bn88142,50442275,61021421,10579146,RLK
chr19,Bn88143,1024222,95845476,94821254,CNL
chr19,Bn88144,6181126,13108899,6927773,RLP
chr19,Bn88145,56590126,95602633,39012507,NBS
chr19,Bn88146,71742905,77234437,5491532,TNL
chr19,Bn88147,1652977,37774052,36121075,CN
chr19,Bn88148,75056731,83734202,8677471,TNL
chr19,Bn88149,62090329,98917509,36827180,RLP
chr19,Bn88150,75462305,98661548,23199243,NBS
chr19,Bn88151,84511235,89983210,5471975,TNL
chr19,Bn88152,87175201,88748697,1573496,NBS
chr19,Bn88153,81102587,93252646,12150059,NBS
chr19,Bn88154,77433115,92687597,15254482,TNL
chr19,Bn88155,63197070,65246489,2049419,RLK
chr19,Bn88156,69837548,81204847,11367299,NBS
chr19,Bn88157,88600412,95420165,6819753,RLK
chr19,Bn88158,53118203,68320933,15202730,CN
chr19,Bn88159,5346874,24756045,19409171,RLK
chr19,Bn88160,64769183,97666629,32897446,TN
chr19,Bn88161,7693116,57319083,49625967,TN
chr19,Bn88162,2387213,86314080,83926867,TNL
chr19,Bn88163,63007145,76085495,13078350,NBS
chr19,Bn88164,11087461,49147908,38060447,CNL
chr19,Bn88165,18458416,36631747,18173331,CNL
chr19,Bn88166,46652377,91787616,45135239,TN
chr19,Bn88167,97250439,97738309,487870,TN
chr19,Bn88168,6492121,82641594,76149473,NBS
chr19,Bn88169,4724858,77850474,73125616,TN
chr19,Bn88170,34548980,74921540,40372560,TN
chr19,Bn88171,4252739,30341290,26088551,RLP
chr19,Bn88172,19640579,24625889,4985310,TNL
chr19,Bn88173,23850646,45623652,21773006,TN
chr19,Bn88174,55111427,71184193,16072766,CN
chr19,Bn88175,6569064,32206809,25637745,NBS
chr19,Bn88176,20165264,48381447,28216183,TNL
chr19,Bn88177,6626760,8623094,1996334,TN
chr19,Bn88178,73703485,83592820,9889335,NBS
chr19,Bn88179,13206947,55048952,41842005,TN
chr19,Bn88180,87604427,98312344,10707917,NBS
chr19,Bn88181,75238264,75910484,672220,CNL
chr19,Bn88182,79116478,89870450,10753972,RLK
chr19,Bn88183,46991640,85321405,38329765,NBS
chr19,Bn88184,19795192,29899031,10103839,RLP
chr19,Bn88185,69756806,84630157,14873351,CN
chr19,Bn88186,83645550,99427860,15782310,NBS
chr19,Bn88187,67884275,78943793,11059518,TN
chr19,Bn88188,31366844,50280330,18913486,RLK
chr19,Bn88189,90661890,94402453,3740563,RLP
chr19,Bn88190,9024081,48797405,39773324,TN
chr19,Bn88191,53024139,98528168,45504029,RLP
chr19,Bn88192,17338005,58931576,41593571,CN
chr19,Bn88193,3745340,4630002,884662,RLK
chr19,Bn88194,46755450,62146746,15391296,TNL
chr19,Bn88195,20910092,83245110,62335018,TN
chr19,Bn88196,84229314,98638241,14408927,RLK
chr19,Bn88197,87858529,92202202,4343673,RLP
chr19,Bn88198,19406398,22474461,3068063,CNL
chr19,Bn88199,34734730,81115441,46380711,RLK
chr19,Bn88200,45687508,54099128,8411620,TN
chr19,Bn88201,38145907,78496346,40350439,RLP
chr19,Bn88202,21502260,59374581,37872321,CN
chr19,Bn88203,74742642,98554148,23811506,CNL
chr19,Bn88204,25351884,38707744,13355860,NBS
chr19,Bn88205,57263165,80395348,23132183,CN
chr19,Bn88206,2593456,24860526,22267070,NBS
chr19,Bn88207,26018905,32300694,6281789,RLK
chr19,Bn88208,74672216,93742681,19070465,TNL
chr19,Bn88209,23067230,25740295,2673065,NBS
chr19,Bn88210,4808737,30774365,25965628,CN
chr19,Bn88211,80965878,85310921,4345043,NBS
chr19,Bn88212,53469307,62613581,9144274,RLK
chr19,Bn88213,51261874,86133620,34871746,RLK
chr19,Bn88214,26215354,53379734,27164380,RLK
chr19,Bn88215,92203363,93803733,1600370,TN
chr19,Bn88216,95561275,95708580,147305,TNL
chr19,Bn88217,40030502,48413589,8383087,TNL
chr19,Bn88218,47826097,56747438,8921341,CNL
chr19,Bn88219,65069406,82082073,17012667,RLK
chr19,Bn88220,56619450,66273074,9653624,TN
chr19,Bn88221,79932128,85006656,5074528,RLK
chr19,Bn88222,71837133,99081304,27244171,TNL
chr19,Bn88223,81812762,97536457,15723695,TNL
chr19,Bn88224,41736683,65270392,23533709,TN
chr19,Bn88225,74576061,91064775,16488714,RLP
chr19,Bn88226,70751921,97530176,26778255,TN
chr19,Bn88227,94116088,96796067,2679979,CN
chr19,Bn88228,48864438,75328339,26463901,CNL
chr19,Bn88229,37275319,39032024,1756705,RLP
chr19,Bn88230,21047670,45985795,24938125,TN
chr19,Bn88231,47461402,90861326,43399924,RLP
chr19,Bn88232,61068935,97858876,36789941,RLK
chr19,Bn88233,2155908,64332925,62177017,TN
chr19,Bn88234,44216375,71006372,26789997,CN
chr19,Bn88235,14786133,35387844,20601711,TN
chr19,Bn88236,72677474,86735156,14057682,NBS
chr19,Bn88237,56128520,58888949,2760429,TN
chr19,Bn88238,62408940,87714899,25305959,CNL
chr19,Bn88239,88017955,94673822,6655867,RLK
chr19,Bn88240,32374344,74252909,41878565,TNL
chr19,Bn88241,63767473,65593024,1825551,NBS
chr19,Bn88242,6556130,47069885,40513755,NBS
chr19,Bn88243,99526541,99534399,7858,NBS
chr19,Bn88244,22272020,80401146,58129126,RLP
chr19,Bn88245,10582367,42409018,31826651,TN
chr19,Bn88246,88689855,88792522,102667,RLK
chr19,Bn88247,63028263,64383358,1355095,TNL
chr19,Bn88248,80365354,98628461,18263107,TN
chr19,Bn88249,69436172,84683375,15247203,RLP
chr19,Bn88250,81973488,89029931,7056443,TNL
chr19,Bn88251,83767152,96511437,12744285,NBS
chr19,Bn88252,19233426,50017009,30783583,RLK
chr19,Bn88253,29524356,85511551,55987195,TNL
chr19,Bn88254,67621357,90443477,22822120,RLP
chr19,Bn88255,67771966,98193195,30421229,RLK
chr19,Bn88256,63811614,76858673,13047059,CNL
chr19,Bn88257,63977727,73766397,9788670,RLP
chr19,Bn88258,81409557,94952295,13542738,TN
chr19,Bn88259,83775323,89755092,5979769,RLK
chr19,Bn88260,47604243,59609999,12005756,TN
chr19,Bn88261,69325112,97066013,27740901,TNL
chr19,Bn88262,75781036,86867541,11086505,TNL
chr19,Bn88263,22013770,49103496,27089726,TN
chr19,Bn88264,25849953,47016412,21166459,CN
chr19,Bn88265,16479477,50966606,34487129,RLP
chr19,Bn88266,64027682,92146936,28119254,CN
chr19,Bn88267,54693725,96105609,41411884,TNL
chr19,Bn88268,69343938,75653049,6309111,TN
chr19,Bn88269,19875692,76121909,56246217,NBS
chr19,Bn88270,78769140,83867372,5098232,CNL
chr19,Bn88271,56064662,66128023,10063361,RLK
chr19,Bn88272,30239311,35664982,5425671,TNL
chr19,Bn88273,18241284,81108655,62867371,TNL
chr19,Bn88274,30038648,79693137,49654489,NBS
chr19,Bn88275,18786758,29245933,10459175,CN
chr19,Bn88276,41502886,70765350,29262464,RLP
chr19,Bn88277,22106149,70920467,48814318,RLK
chr19,Bn88278,78848442,94450935,15602493,NBS
chr19,Bn88279,38989644,77886223,38896579,CNL
chr19,Bn88280,31073321,37654567,6581246,RLP
chr19,Bn88281,95864846,97085682,1220836,CNL
chr19,Bn88282,7424581,25656670,18232089,TNL
chr19,Bn88283,55714344,60360986,4646642,RLP
chr19,Bn88284,85715283,91954206,6238923,NBS
chr19,Bn88285,84376701,87290629,2913928,RLP
chr19,Bn88286,42521575,76492633,33971058,RLK
chr19,Bn88287,5643900,63437565,57793665,RLK
chr19,Bn88288,70966787,92586005,21619218,NBS
chr19,Bn88289,10904778,13528416,2623638,TNL
chr19,Bn88290,34654066,88837393,54183327,TN
chr19,Bn88291,27364659,68008743,40644084,TN
chr19,Bn88292,82614755,94923025,12308270,NBS
chr19,Bn88293,74022816,74704113,681297,NBS
chr19,Bn88294,4199767,84970199,80770432,TN
chr19,Bn88295,49191489,55897119,6705630,RLP
chr19,Bn88296,51618540,93809917,42191377,CN
chr19,Bn88297,8552119,79897097,71344978,CNL
chr19,Bn88298,50697740,99028888,48331148,CN
chr19,Bn88299,69217226,96104759,26887533,CNL
chr19,Bn88300,40057676,82540858,42483182,CNL
chr19,Bn88301,70555094,87442624,16887530,CNL
chr19,Bn88302,83782673,96862175,13079502,CNL
chr19,Bn88303,52364020,70025711,17661691,TNL
chr19,Bn88304,74977948,75620064,642116,RLP
chr19,Bn88305,78070047,79761744,1691697,RLP
chr19,Bn88306,75088644,83834180,8745536,RLP
chr19,Bn88307,13682889,45839627,32156738,RLP
chr19,Bn88308,66765040,99525380,32760340,CNL
chr19,Bn88309,33529699,86601671,53071972,RLK
chr19,Bn88310,63842471,90294470,26451999,CN
chr19,Bn88311,31352510,49435242,18082732,RLP
chr19,Bn88312,97781029,99068054,1287025,NBS
chr19,Bn88313,83698213,93768358,10070145,CNL
chr19,Bn88314,12506915,83153882,70646967,CN
chr19,Bn88315,14409137,63073246,48664109,TN
chr19,Bn88316,87957073,94012556,6055483,TNL
chr19,Bn88317,60972620,85119827,24147207,TNL
chr19,Bn88318,95981950,98307376,2325426,RLP
chr19,Bn88319,65931979,71464672,5532693,RLK
chr19,Bn88320,6384527,21972551,15588024,TNL
chr19,Bn88321,90616030,96581932,5965902,RLP
chr19,Bn88322,33873698,41842333,7968635,TNL
chr19,Bn88323,6680454,57014964,50334510,TNL
chr19,Bn88324,78045737,84157356,6111619,CNL
chr19,Bn88325,14186857,36739473,22552616,CN
chr19,Bn88326,74302321,78618434,4316113,RLK
chr19,Bn88327,52416072,98098031,45681959,NBS
chr19,Bn88328,41233805,74386225,33152420,RLK
chr19,Bn88329,95251717,99651060,4399343,TNL
chr19,Bn88330,83895516,99824484,15928968,RLK
chr19,Bn88331,54679979,72964322,18284343,TN
chr19,Bn88332,71494307,99094625,27600318,NBS
chr19,Bn88333,46305644,53262344,6956700,RLP
chr19,Bn88334,75453911,86227957,10774046,TN
chr19,Bn88335,78026171,82747338,4721167,CNL
chr19,Bn88336,22934829,81820982,58886153,CN
chr19,Bn88337,27657637,98341345,70683708,TN
chr19,Bn88338,83963448,99529036,15565588,TN
chr19,Bn88339,34077392,95589817,61512425,RLK
chr19,Bn88340,92176291,96535350,4359059,TNL
chr19,Bn88341,2517469,5090848,2573379,RLK
chr19,Bn88342,55798590,65853126,10054536,TNL
chr19,Bn88343,97683492,98467945,784453,RLK
chr19,Bn88344,73522213,78535479,5013266,CNL
chr19,Bn88345,12380224,38012779,25632555,CNL
chr19,Bn88346,37783492,50932155,13148663,NBS
chr19,Bn88347,84155901,86481976,2326075,TN
chr19,Bn88348,16947062,89918261,72971199,RLK
chr19,Bn88349,20872033,94097694,73225661,NBS
chr19,Bn88350,44344762,75692337,31347575,TNL
chr19,Bn88351,91374254,97978748,6604494,TN
chr19,Bn88352,34529293,89756921,55227628,CN
chr19,Bn88353,96590182,97359499,769317,RLP
chr19,Bn88354,40197242,81618227,41420985,TN
chr19,Bn88355,39611256,75545900,35934644,CN
chr19,Bn88356,27225862,99431270,72205408,TNL
chr19,Bn88357,63321736,79262135,15940399,TN
chr19,Bn88358,58588742,84978345,26389603,TNL
chr19,Bn88359,84166382,86192218,2025836,RLK
chr19,Bn88360,47953873,54924875,6971002,CN
chr19,Bn88361,83690097,99482056,15791959,CN
chr19,Bn88362,35594857,50512851,14917994,TN
chr19,Bn88363,85344297,89031466,3687169,CN
chr19,Bn88364,38624897,77298193,38673296,TNL
chr19,Bn88365,84376611,99827183,15450572,NBS
chr19,Bn88366,73964555,96868397,22903842,RLP
chr19,Bn88367,83591182,96884588,13293406,RLK
chr19,Bn88368,32879547,33451713,572166,CNL
chr19,Bn88369,72163516,93490433,21326917,CNL
chr19,Bn88370,97338088,98003248,665160,CNL
chr19,Bn88371,55492240,67794512,12302272,CNL
chr19,Bn88372,94667255,97065463,2398208,CN
chr19,Bn88373,26366294,54880975,28514681,CN
chr19,Bn88374,76509425,80667694,4158269,RLK
chr19,Bn88375,62869630,94188768,31319138,TN
chr19,Bn88376,64238898,67922132,3683234,CN
chr19,Bn88377,4583922,74898732,70314810,TN
chr19,Bn88378,85559381,87320302,1760921,CN
chr19,Bn88379,70675378,89472405,18797027,NBS
chr19,Bn88380,3771639,9252876,5481237,CN
chr19,Bn88381,92088546,99820590,7732044,CN
chr19,Bn88382,89514267,89533638,19371,TNL
chr19,Bn88383,32011512,95091855,63080343,NBS
chr19,Bn88384,3636391,31739717,28103326,TNL
chr19,Bn88385,28598867,35852212,7253345,TNL
chr19,Bn88386,10508334,94895829,84387495,TN
chr19,Bn88387,53591985,90814820,37222835,TN
chr19,Bn88388,22873108,96314001,73440893,NBS
chr19,Bn88389,72592556,74431927,1839371,TNL
chr19,Bn88390,56388975,98365364,41976389,RLP
chr19,Bn88391,95146211,99873297,4727086,RLP
chr19,Bn88392,36043258,57379146,21335888,CNL
chr19,Bn88393,24656381,35076718,10420337,TNL
chr19,Bn88394,22409401,51078145,28668744,RLP
chr19,Bn88395,51252561,66766010,15513449,NBS
chr19,Bn88396,90791168,99157881,8366713,NBS
chr19,Bn88397,35616514,41213892,5597378,CN
chr19,Bn88398,66454803,78580060,12125257,RLK
chr19,Bn88399,31902704,37746578,5843874,TN
chr19,Bn88400,1483813,2653580,1169767,CNL
chr19,Bn88401,79186429,83446391,4259962,RLK
chr19,Bn88402,76011212,78071449,2060237,RLP
chr19,Bn88403,21912339,59335135,37422796,RLP
chr19,Bn88404,51299834,72343810,21043976,RLK
chr19,Bn88405,70404899,92156968,21752069,TN
chr19,Bn88406,44421508,91304134,46882626,TN
chr19,Bn88407,67356416,88524240,21167824,NBS
chr19,Bn88408,37924829,66213273,28288444,TN
chr19,Bn88409,17365006,55804479,38439473,TNL
chr19,Bn88410,31778725,77796582,46017857,TN
chr19,Bn88411,61668041,85519390,23851349,CNL
chr19,Bn88412,40145016,99618888,59473872,TNL
chr19,Bn88413,21720089,38366317,16646228,RLP
chr19,Bn88414,42134413,52144267,10009854,TNL
chr19,Bn88415,33730313,62982217,29251904,RLK
chr19,Bn88416,55935399,60688940,4753541,TN
chr19,Bn88417,18913779,24636250,5722471,RLK
chr19,Bn88418,75706732,76336940,630208,TN
chr19,Bn88419,39387213,43136132,3748919,TN
chr19,Bn88420,74870055,75133114,263059,RLK
chr19,Bn88421,70575889,95482701,24906812,RLP
chr19,Bn88422,29373100,39903578,10530478,RLP
chr19,Bn88423,38413992,70296731,31882739,RLK
chr19,Bn88424,52136586,98046651,45910065,TNL
chr19,Bn88425,70074323,91977872,21903549,RLP
chr19,Bn88426,28713593,36234582,7520989,CNL
chr19,Bn88427,83996805,90805240,6808435,RLP
chr19,Bn88428,75122876,99256020,24133144,RLP
chr19,Bn88429,96258644,96384354,125710,NBS
chr19,Bn88430,93109451,97197939,4088488,NBS
chr19,Bn88431,4911034,74128813,69217779,NBS
chr19,Bn88432,83208117,87422705,4214588,TN
chr19,Bn88433,27751803,42141496,14389693,NBS
chr19,Bn88434,53167041,57353348,4186307,TN
chr19,Bn88435,42222230,68753033,26530803,CN
chr19,Bn88436,48311341,80051802,31740461,TNL
chr19,Bn88437,89423940,91105712,1681772,RLP
chr19,Bn88438,56873728,72690469,15816741,TN
chr19,Bn88439,9109911,26171231,17061320,TNL
chr19,Bn88440,68112916,87113512,19000596,RLP
chr19,Bn88441,6834891,91580629,84745738,CN
chr19,Bn88442,74897257,87561030,12663773,TNL
chr19,Bn88443,91124073,97632140,6508067,CN
chr19,Bn88444,10079946,88905612,78825666,TNL
chr19,Bn88445,55539580,57565063,2025483,RLK
chr19,Bn88446,31625442,99874462,68249020,CNL
chr19,Bn88447,97423617,97879784,456167,CN
chr19,Bn88448,61738450,72819481,11081031,CN
chr19,Bn88449,41786340,64596245,22809905,TN
chr19,Bn88450,41787055,64963101,23176046,CN
chr19,Bn88451,10656244,22677385,12021141,CNL
chr19,Bn88452,55578898,59212957,3634059,RLP
chr19,Bn88453,84212512,93094555,8882043,CN
chr19,Bn88454,85485831,95594685,10108854,TN
chr19,Bn88455,68786958,86729410,17942452,TNL
chr19,Bn88456,67887252,89260579,21373327,TN
chr19,Bn88457,96937255,97316560,379305,CNL
chr19,Bn88458,61411951,86216648,24804697,RLP
chr19,Bn88459,62359025,93557401,31198376,RLK
chr19,Bn88460,47500087,71861480,24361393,TNL
chr19,Bn88461,26286118,68026897,41740779,RLK
chr19,Bn88462,13101308,94674110,81572802,CNL
chr19,Bn88463,16117104,32931863,16814759,RLP
chr19,Bn88464,78309830,94179410,15869580,TNL
chr19,Bn88465,86928777,99446343,12517566,CN
chr19,Bn88466,48813854,76322979,27509125,RLK
chr19,Bn88467,44212612,54728915,10516303,TN
chr19,Bn88468,23619299,84352521,60733222,CNL
chr19,Bn88469,96057661,98024091,1966430,CN
chr19,Bn88470,28154836,58108620,29953784,RLP
chr19,Bn88471,76559440,95321838,18762398,RLP
chr19,Bn88472,94919440,99240365,4320925,TN
chr19,Bn88473,84771879,85032147,260268,TNL
chr19,Bn88474,97657307,98655605,998298,TN
chr19,Bn88475,74099414,81683081,7583667,RLP
chr19,Bn88476,57548625,66268303,8719678,CN
chr19,Bn88477,89374100,99501837,10127737,CNL
chr19,Bn88478,21574268,99564118,77989850,RLK
chr19,Bn88479,82433504,84658939,2225435,TN
chr19,Bn88480,73424093,80548019,7123926,TNL
chr19,Bn88481,69870453,83705287,13834834,CN
chr19,Bn88482,2598951,30833060,28234109,TN
chr19,Bn88483,23702512,82954026,59251514,TNL
chr19,Bn88484,34677875,73519225,38841350,NBS
chr19,Bn88485,34845235,77043538,42198303,CN
chr19,Bn88486,36457905,71432080,34974175,TN
chr19,Bn88487,22668948,94732889,72063941,TN
chr19,Bn88488,31937352,84723085,52785733,TN
chr19,Bn88489,21308062,91828603,70520541,CN
chr19,Bn88490,37263700,68830279,31566579,RLP
chr19,Bn88491,87198148,92668872,5470724,RLP
chr19,Bn88492,23999110,36724814,12725704,TN
chr19,Bn88493,64407479,70756361,6348882,TNL
chr19,Bn88494,75499242,94778769,19279527,TN
chr19,Bn88495,5423763,81364947,75941184,RLK
chr19,Bn88496,77575478,79386083,1810605,TNL
chr19,Bn88497,23313910,23327661,13751,TNL
chr19,Bn88498,29011654,92097073,63085419,TN
chr19,Bn88499,22507733,64215585,41707852,RLK
chr19,Bn88500,27703254,49149061,21445807,TNL
chr19,Bn88501,74889775,79710260,4820485,RLK
chr19,Bn88502,86161940,89807561,3645621,RLK
chr19,Bn88503,95615176,99252565,3637389,TN
chr19,Bn88504,11510800,58939139,47428339,TN
chr19,Bn88505,68681208,86468228,17787020,CN
chr19,Bn88506,72100988,77595702,5494714,TNL
chr19,Bn88507,88496608,90341614,1845006,TNL
chr19,Bn88508,43379663,74175391,30795728,CN
chr19,Bn88509,54224223,67608985,13384762,CN
chr19,Bn88510,36486368,73608714,37122346,CN
chr19,Bn88511,20066072,52157753,32091681,CNL
chr19,Bn88512,93039228,94093492,1054264,NBS
chr19,Bn88513,45163418,71985546,26822128,TNL
chr19,Bn88514,27177711,70475128,43297417,CN
chr19,Bn88515,98048645,99342493,1293848,CN
chr19,Bn88516,26610685,33550329,6939644,NBS
chr19,Bn88517,27809865,39007743,11197878,CN
chr19,Bn88518,7170091,74604813,67434722,RLK
chr19,Bn88519,83529861,84979466,1449605,CNL
chr19,Bn88520,87667245,98381801,10714556,RLK
chr19,Bn88521,67122853,86161819,19038966,CNL
chr19,Bn88522,90659237,92517297,1858060,RLK
chr19,Bn88523,67345037,85194867,17849830,TNL
chr19,Bn88524,25304022,71066466,45762444,NBS
chr19,Bn88525,59964841,94968979,35004138,RLP
chr19,Bn88526,32010909,35658921,3648012,RLK
chr19,Bn88527,99742936,99888386,145450,TN
chr19,Bn88528,66485330,81955739,15470409,TN
chr19,Bn88529,33893388,87067425,53174037,RLP
chr19,Bn88530,25803330,32099808,6296478,TNL
chr19,Bn88531,70439732,71560392,1120660,TNL
chr19,Bn88532,21431546,82926349,61494803,CNL
chr19,Bn88533,15128458,52676755,37548297,NBS
chr19,Bn88534,6449116,26139704,19690588,RLK
chr19,Bn88535,40801871,71402688,30600817,TNL
chr19,Bn88536,73828124,79188048,5359924,TN
chr19,Bn88537,86652705,89774554,3121849,TN
chr19,Bn88538,29992721,43665547,13672826,RLP
chr19,Bn88539,25259404,57046893,31787489,CN
chr19,Bn88540,87086306,99695914,12609608,CNL
chr19,Bn88541,4978493,29626223,24647730,TNL
chr19,Bn88542,63383484,99496040,36112556,TNL
chr19,Bn88543,79312330,92463347,13151017,RLP
chr19,Bn88544,83896517,94806934,10910417,CN
chr19,Bn88545,26704756,76533561,49828805,RLK
chr19,Bn88546,71877062,82238751,10361689,CN
chr19,Bn88547,40408909,74026680,33617771,RLK
chr19,Bn88548,79046296,79168735,122439,TNL
chr19,Bn88549,26946334,83140060,56193726,RLP
chr19,Bn88550,51677475,80574204,28896729,CN
chr19,Bn88551,55971427,72961830,16990403,NBS
chr19,Bn88552,28447207,33852556,5405349,NBS
chr19,Bn88553,3591696,68182564,64590868,RLK
chr19,Bn88554,62250828,94339379,32088551,RLK
chr19,Bn88555,55493707,85771713,30278006,RLP
chr19,Bn88556,98337377,99539471,1202094,TN
chr19,Bn88557,31060032,31098020,37988,NBS
chr19,Bn88558,35855306,37062511,1207205,TN
chr19,Bn88559,8553383,15532256,6978873,TNL
chr19,Bn88560,84911694,89912822,5001128,TN
chr19,Bn88561,9341286,23212971,13871685,RLK
chr19,Bn88562,80851074,84585709,3734635,NBS
chr19,Bn88563,27776266,70843868,43067602,CN
chr19,Bn88564,18369889,88679853,70309964,RLK
chr19,Bn88565,19397672,28919110,9521438,NBS
chr19,Bn88566,87585076,88023052,437976,TN
chr19,Bn88567,29880076,94097885,64217809,RLP
chr19,Bn88568,66879262,92326133,25446871,CN
chr19,Bn88569,53879605,59940590,6060985,CNL
chr19,Bn88570,34707087,72729592,38022505,TNL
chr19,Bn88571,8078879,98558193,90479314,RLK
chr19,Bn88572,55414116,99689805,44275689,TNL
chr19,Bn88573,71362725,77878937,6516212,TNL
chr19,Bn88574,74909653,80182269,5272616,TN
chr19,Bn88575,87371613,98426679,11055066,CN
chr19,Bn88576,14932169,60099396,45167227,RLP
chr19,Bn88577,37763441,49698930,11935489,CNL
chr19,Bn88578,12073223,73790141,61716918,RLP
chr19,Bn88579,57296337,60714642,3418305,TNL
chr19,Bn88580,53911755,87581046,33669291,RLK
chr19,Bn88581,69743374,85834688,16091314,CNL
chr19,Bn88582,17365382,24904221,7538839,RLK
chr19,Bn88583,53273840,82267202,28993362,TN
chr19,Bn88584,40724810,66089738,25364928,TNL
chr19,Bn88585,25499691,87092356,61592665,CN
chr19,Bn88586,98740633,99892389,1151756,TN
chr19,Bn88587,84693248,93217531,8524283,RLP
chr19,Bn88588,32412630,43342855,10930225,CN
chr19,Bn88589,47451273,74766539,27315266,RLK
chr19,Bn88590,57991178,79509058,21517880,NBS
chr19,Bn88591,83978150,85867276,1889126,TNL
chr19,Bn88592,50241038,82145202,31904164,CN
chr19,Bn88593,91667271,99890292,8223021,TN
chr19,Bn88594,3487790,37926675,34438885,CNL
chr19,Bn88595,67376877,99311195,31934318,CNL
chr19,Bn88596,10315381,43599702,33284321,CN
chr19,Bn88597,99978239,99979334,1095,CNL
chr19,Bn88598,48322086,53555034,5232948,CN
chr19,Bn88599,52316521,94359445,42042924,CN
chr19,Bn88600,54295592,81553275,27257683,CN
chr19,Bn88601,40935962,42575567,1639605,TNL
chr19,Bn88602,21205675,48639959,27434284,CN
chr19,Bn88603,15692567,61915483,46222916,NBS
chr19,Bn88604,10544058,21601616,11057558,RLK
chr19,Bn88605,49135753,92486999,43351246,NBS
chr19,Bn88606,64960673,95748320,30787647,CN
chr19,Bn88607,97549209,97999120,449911,CN
chr19,Bn88608,68748853,77261871,8513018,RLP
chr19,Bn88609,6472451,64069528,57597077,TNL
chr19,Bn88610,10013297,72982994,62969697,TNL
chr19,Bn88611,57485320,93843654,36358334,CNL
chr19,Bn88612,60346436,89150922,28804486,RLK
chr19,Bn88613,64610372,99323486,34713114,CN
chr19,Bn88614,68173391,73511170,5337779,NBS
chr19,Bn88615,13476755,53816318,40339563,CN
chr19,Bn88616,17195983,97269758,80073775,RLP
chr19,Bn88617,4582783,22807517,18224734,TN
chr19,Bn88618,79119757,96570920,17451163,NBS
chr19,Bn88619,14516034,86187060,71671026,CN
chr19,Bn88620,63933929,87858304,23924375,TN
chr19,Bn88621,92994867,99186880,6192013,TN
chr19,Bn88622,88550626,90519894,1969268,TN
chr19,Bn88623,83944495,94189897,10245402,RLK
chr19,Bn88624,94602361,98327572,3725211,NBS
chr19,Bn88625,17269285,26819571,9550286,CNL
chr19,Bn88626,21376981,51887707,30510726,RLK
chr19,Bn88627,20756986,68971036,48214050,RLK
chr19,Bn88628,84986591,97564350,12577759,RLP
chr19,Bn88629,32145996,87931074,55785078,RLP
chr19,Bn88630,50237811,95880154,45642343,TNL
chr19,Bn88631,34305683,70474278,36168595,TNL
chr19,Bn88632,94801868,96584994,1783126,CN
chr19,Bn88633,7812425,42188414,34375989,RLP
chr19,Bn88634,36540647,73576748,37036101,RLP
chr19,Bn88635,76285496,96213902,19928406,CNL
chr19,Bn88636,38507873,73209141,34701268,RLP
chr19,Bn88637,27422706,36487482,9064776,CN
chr19,Bn88638,28482019,93906419,65424400,RLK
chr19,Bn88639,57110938,64115145,7004207,CNL
chr19,Bn88640,54779994,74073446,19293452,TN
chr19,Bn88641,44171217,55558228,11387011,TN
chr19,Bn88642,45604828,68853791,23248963,CNL
chr19,Bn88643,53124947,74738209,21613262,NBS
chr19,Bn88644,18170291,59486709,41316418,TN
chr19,Bn88645,88209341,98765929,10556588,TN
chr19,Bn88646,50218262,70655095,20436833,CNL
chr19,Bn88647,49864881,75491998,25627117,RLK
chr19,Bn88648,10327975,50656894,40328919,CNL
chr19,Bn88649,22934936,77815273,54880337,RLP
chr19,Bn88650,15521635,94148125,78626490,TNL
chr19,Bn88651,2016648,4111450,2094802,NBS
chr19,Bn88652,59057033,74885835,15828802,CN
chr19,Bn88653,50198628,75311170,25112542,NBS
chr19,Bn88654,99779916,99867912,87996,RLK
chr19,Bn88655,19481291,84468251,64986960,CNL
chr19,Bn88656,42513106,89822509,47309403,NBS
chr19,Bn88657,47412520,83029107,35616587,CN
chr19,Bn88658,63087714,87172458,24084744,CN
chr19,Bn88659,45790587,78284332,32493745,CNL
chr19,Bn88660,33270718,69468745,36198027,RLK
chr19,Bn88661,52383044,66291270,13908226,CNL
chr19,Bn88662,39644739,91116513,51471774,CN
chr19,Bn88663,58246542,69655932,11409390,CN
chr19,Bn88664,99875071,99914592,39521,RLP
chr19,Bn88665,87961319,92117281,4155962,NBS
chr19,Bn88666,12226831,22900833,10674002,RLP
chr19,Bn88667,89208507,94530329,5321822,CN
chr19,Bn88668,53826849,84050251,30223402,TN
chr19,Bn88669,81958472,99603127,17644655,CN
chr19,Bn88670,52849955,91147029,38297074,RLP
chr19,Bn88671,74403722,89978549,15574827,TN
chr19,Bn88672,42097806,64823300,22725494,TN
chr19,Bn88673,40654676,67628684,26974008,CNL
chr19,Bn88674,67421890,83589574,16167684,CN
chr19,Bn88675,62350308,95914156,33563848,CNL
chr19,Bn88676,21120348,60678455,39558107,CN
chr19,Bn88677,60939990,61054055,114065,TN
chr19,Bn88678,32796522,86051207,53254685,NBS
chr19,Bn88679,83223108,87348782,4125674,RLK
chr19,Bn88680,65237198,81582627,16345429,TNL
chr19,Bn88681,72427413,74671542,2244129,TNL
chr19,Bn88682,19407441,61646692,42239251,RLP
chr19,Bn88683,40565961,96973535,56407574,RLK
chr19,Bn88684,96021839,96986728,964889,TN
chr19,Bn88685,68800366,76725242,7924876,RLP
chr19,Bn88686,28671189,57659297,28988108,RLP
chr19,Bn88687,56366775,80947008,24580233,TN
chr19,Bn88688,30008754,61621046,31612292,TN
chr19,Bn88689,53826765,56573045,2746280,CNL
chr19,Bn88690,84071994,93674432,9602438,RLK
chr19,Bn88691,21876510,95515887,73639377,NBS
chr19,Bn88692,35478399,80736866,45258467,NBS
chr19,Bn88693,19424547,30994926,11570379,CN
chr19,Bn88694,34416640,47189939,12773299,CN
chr19,Bn88695,76483511,85686000,9202489,TNL
chr19,Bn88696,11896774,79368652,67471878,RLP
chr19,Bn88697,65225283,87329856,22104573,RLK
chr19,Bn88698,18230781,20168738,1937957,RLK
chr19,Bn88699,56842784,71032229,14189445,NBS
chr19,Bn88700,74456168,98684675,24228507,TNL
chr19,Bn88701,88079545,89790118,1710573,TNL
chr19,Bn88702,57947378,80496182,22548804,CN
chr19,Bn88703,6432561,81500855,75068294,NBS
chr19,Bn88704,14787750,91392415,76604665,TNL
chr19,Bn88705,75159447,96335648,21176201,CN
chr19,Bn88706,57514201,69827554,12313353,TN
chr19,Bn88707,92023401,95183204,3159803,RLK
chr19,Bn88708,44440929,49465219,5024290,NBS
chr19,Bn88709,79476615,94026241,14549626,TNL
chr19,Bn88710,5401030,87707860,82306830,CNL
chr19,Bn88711,11307498,28012341,16704843,NBS
chr19,Bn88712,87589645,95733945,8144300,RLP
chr19,Bn88713,41321736,90827818,49506082,CNL
chr19,Bn88714,39641972,87256359,47614387,TN
chr19,Bn88715,10027360,67633153,57605793,TNL
chr19,Bn88716,9034001,83124624,74090623,CNL
chr19,Bn88717,92027387,94613337,2585950,RLP
chr19,Bn88718,88864919,96960600,8095681,RLK
chr19,Bn88719,4936796,18861412,13924616,CN
chr19,Bn88720,29608188,74867002,45258814,TNL
chr19,Bn88721,5653071,86614629,80961558,TN
chr19,Bn88722,38314493,94977239,56662746,RLP
chr19,Bn88723,23703371,98447819,74744448,CN
chr19,Bn88724,31535290,67260990,35725700,RLP
chr19,Bn88725,85887293,87685937,1798644,CNL
chr19,Bn88726,79107810,99059027,19951217,TNL
chr19,Bn88727,27658628,33381931,5723303,RLP
chr19,Bn88728,43342010,99083462,55741452,TNL
chr19,Bn88729,97219691,99963058,2743367,CNL
chr19,Bn88730,76259353,79500717,3241364,RLP
chr19,Bn88731,29391130,65791145,36400015,CNL
chr19,Bn88732,91495614,98092307,6596693,RLK
chr19,Bn88733,61311095,65858967,4547872,NBS
chr19,Bn88734,81273873,97031647,15757774,CN
chr19,Bn88735,1371349,42232593,40861244,TNL
chr19,Bn88736,74071544,98826464,24754920,TN
chr19,Bn88737,71022625,88893987,17871362,RLK
chr19,Bn88738,8003125,22090961,14087836,CN
chr19,Bn88739,40960430,63913545,22953115,TNL
chr19,Bn88740,36546870,81930692,45383822,TNL
chr19,Bn88741,47249340,90034653,42785313,CNL
chr19,Bn88742,81735915,85680369,3944454,RLP
chr19,Bn88743,19254722,92105319,72850597,NBS
chr19,Bn88744,40070454,98442903,58372449,CN
chr19,Bn88745,49895468,98880794,48985326,NBS
chr19,Bn88746,20251304,44280947,24029643,RLP
chr19,Bn88747,88255032,89784523,1529491,RLP
chr19,Bn88748,53104965,94140865,41035900,RLP
chr19,Bn88749,33036480,57338670,24302190,TNL
chr19,Bn88750,94526488,95763647,1237159,CN
chr19,Bn88751,99075954,99714872,638918,RLK
chr19,Bn88752,63834689,90986302,27151613,CN
chr19,Bn88753,21519681,53220861,31701180,RLP
chr19,Bn88754,69042151,94531429,25489278,TNL
chr19,Bn88755,50391262,59757740,9366478,TNL
chr19,Bn88756,41467023,91040353,49573330,CNL
chr19,Bn88757,35481221,93243298,57762077,RLK
chr19,Bn88758,76875353,82212474,5337121,CNL
chr19,Bn88759,2357693,42059062,39701369,RLK
chr19,Bn88760,32142666,53353338,21210672,CNL
chr19,Bn88761,46386400,59727573,13341173,RLP
chr19,Bn88762,37279166,75076657,37797491,RLK
chr19,Bn88763,70681991,91119710,20437719,RLK
chr19,Bn88764,85136844,86336660,1199816,RLP
chr19,Bn88765,1165473,15085417,13919944,CN
chr19,Bn88766,68122952,98716272,30593320,CNL
chr19,Bn88767,54090410,83030712,28940302,TN
chr19,Bn88768,13105853,52679510,39573657,RLK
chr19,Bn88769,59179597,87822381,28642784,CNL
chr19,Bn88770,70191526,77654137,7462611,RLP
chr19,Bn88771,87695641,98896354,11200713,RLP
chr19,Bn88772,77615092,79065999,1450907,TN
chr19,Bn88773,76904331,94351268,17446937,RLP
chr19,Bn88774,92535584,97921155,5385571,TNL
chr19,Bn88775,44109564,83494613,39385049,TNL
chr19,Bn88776,49112345,74524582,25412237,TNL
chr19,Bn88777,14549323,33069690,18520367,CN
chr19,Bn88778,72844296,83480587,10636291,CN
chr19,Bn88779,1583781,88674023,87090242,TN
chr19,Bn88780,44660033,91456865,46796832,TN
chr19,Bn88781,98277590,99871908,1594318,CNL
chr19,Bn88782,84040293,86499445,2459152,TN
chr19,Bn88783,77605188,88699093,11093905,RLP
chr19,Bn88784,41180529,50369277,9188748,NBS
chr19,Bn88785,46279007,57739251,11460244,CN
chr19,Bn88786,94766943,96055912,1288969,RLP
chr19,Bn88787,74454632,96138456,21683824,CNL
chr19,Bn88788,8955800,94390636,85434836,CNL
chr19,Bn88789,98579533,99032523,452990,RLK
chr19,Bn88790,96619535,97574722,955187,TN
chr19,Bn88791,96629809,98785730,2155921,NBS
chr19,Bn88792,13862692,20379183,6516491,CN
chr19,Bn88793,30154749,99427902,69273153,TN
chr19,Bn88794,4857375,59525571,54668196,RLK
chr19,Bn88795,54137931,63858803,9720872,CN
chr19,Bn88796,8084001,97102549,89018548,TNL
chr19,Bn88797,76421320,79076056,2654736,TNL
chr19,Bn88798,38621849,69719565,31097716,CN
chr19,Bn88799,90137661,99678835,9541174,RLK
chr19,Bn88800,91900182,94838832,2938650,TNL
chr19,Bn88801,1183434,54137934,52954500,RLK
chr19,Bn88802,9618214,88943349,79325135,TNL
chr19,Bn88803,51935119,82469549,30534430,NBS
chr19,Bn88804,79673032,82435419,2762387,RLK
chr19,Bn88805,78028140,81559897,3531757,NBS
chr19,Bn88806,42273616,57839936,15566320,TNL
chr19,Bn88807,39290503,39473435,182932,RLP
chr19,Bn88808,2164505,91255271,89090766,CNL
chr19,Bn88809,11009130,79567219,68558089,NBS
chr19,Bn88810,8178246,64278057,56099811,NBS
chr19,Bn88811,33932090,46719794,12787704,NBS
chr19,Bn88812,18378182,99099349,80721167,RLP
chr19,Bn88813,96874180,98945835,2071655,CNL
chr19,Bn88814,87356977,88599797,1242820,RLP
chr19,Bn88815,70509815,81289493,10779678,CN
chr19,Bn88816,50542429,95614225,45071796,CN
chr19,Bn88817,47807829,76108782,28300953,CN
chr19,Bn88818,27112507,78412759,51300252,TNL
chr19,Bn88819,4019423,16437372,12417949,CNL
chr19,Bn88820,76153776,80951613,4797837,CNL
chr19,Bn88821,34545119,98820794,64275675,CNL
chr19,Bn88822,56074121,91084847,35010726,TN
chr19,Bn88823,74467006,76351777,1884771,CN
chr19,Bn88824,14882580,49217586,34335006,TN
chr19,Bn88825,20993582,67657757,46664175,CNL
chr19,Bn88826,23075595,42913538,19837943,RLP
chr19,Bn88827,90369128,96297136,5928008,CNL
chr19,Bn88828,70919425,96099013,25179588,TNL
chr19,Bn88829,29857333,41590659,11733326,RLK
chr19,Bn88830,88961259,99031649,10070390,RLP
chr19,Bn88831,69767418,79661252,9893834,RLP
chr19,Bn88832,29709910,85161855,55451945,RLK
chr19,Bn88833,23577062,99737123,76160061,RLP
chr19,Bn88834,93398629,94546000,1147371,TNL
chr19,Bn88835,42408069,93119846,50711777,CNL
chr19,Bn88836,25007730,51278753,26271023,CNL
chr19,Bn88837,96714439,97287857,573418,CNL
chr19,Bn88838,72417223,82088019,9670796,TN
chr19,Bn88839,8479807,73772121,65292314,TN
chr19,Bn88840,73308715,79468694,6159979,RLK
chr19,Bn88841,6996939,62091897,55094958,CN
chr19,Bn88842,12946612,89706928,76760316,CN
chr19,Bn88843,98965983,99898742,932759,NBS
chr19,Bn88844,99793329,99986739,193410,RLP
chr19,Bn88845,42665636,58225906,15560270,RLP
chr19,Bn88846,13220492,95051095,81830603,CN
chr19,Bn88847,79359244,79954213,594969,NBS
chr19,Bn88848,76916958,85699501,8782543,CNL
chr19,Bn88849,33740125,36839695,3099570,RLP
chr19,Bn88850,84483358,88535624,4052266,NBS
chr19,Bn88851,73735670,88528683,14793013,NBS
chr19,Bn88852,73143166,94617700,21474534,TNL
chr19,Bn88853,79026132,90524663,11498531,TNL
chr19,Bn88854,56334893,63967390,7632497,NBS
chr19,Bn88855,91301294,96603358,5302064,CN
chr19,Bn88856,86522029,91349548,4827519,CNL
chr19,Bn88857,29820515,43844550,14024035,TNL
chr19,Bn88858,19751453,77701364,57949911,CNL
chr19,Bn88859,40535546,67474032,26938486,RLK
chr19,Bn88860,88157879,94792291,6634412,TNL
chr19,Bn88861,73310106,93752805,20442699,RLK
chr19,Bn88862,69351822,81876454,12524632,CNL
chr19,Bn88863,84049918,85423671,1373753,RLK
chr19,Bn88864,96793887,99933258,3139371,TNL
chr19,Bn88865,57456078,58045925,589847,NBS
chr19,Bn88866,57092235,93486124,36393889,CN
chr19,Bn88867,5512993,35803952,30290959,CNL
chr19,Bn88868,68630269,86044493,17414224,CNL
chr19,Bn88869,25076695,26542760,1466065,RLP
chr19,Bn88870,84375495,90475367,6099872,RLK
chr19,Bn88871,12502053,36008975,23506922,RLP
chr19,Bn88872,88992680,90759063,1766383,RLP
chr19,Bn88873,51893927,54807182,2913255,TNL
chr19,Bn88874,50453580,69202101,18748521,NBS
chr19,Bn88875,96343372,97157418,814046,RLP
chr19,Bn88876,98216770,98828476,611706,CNL
chr19,Bn88877,65832897,90674421,24841524,CNL
chr19,Bn88878,72226708,98328465,26101757,NBS
chr19,Bn88879,70942016,80201063,9259047,RLP
chr19,Bn88880,1625928,47632540,46006612,RLK
chr19,Bn88881,98243755,99141672,897917,RLK
chr19,Bn88882,41964262,42254414,290152,RLK
chr19,Bn88883,74261719,81485623,7223904,RLK
chr19,Bn88884,87319026,98880435,11561409,RLK
chr19,Bn88885,59018077,99426273,40408196,RLK
chr19,Bn88886,18971876,67242267,48270391,RLK
chr19,Bn88887,73042730,82134943,9092213,TN
chr19,Bn88888,14593074,92928761,78335687,TN
chr19,Bn88889,25743026,80450503,54707477,RLK
chr19,Bn88890,57122272,70296517,13174245,RLK
chr19,Bn88891,54621409,70152972,15531563,CNL
chr19,Bn88892,60694977,84416842,23721865,TNL
chr19,Bn88893,68862156,97021414,28159258,RLK
chr19,Bn88894,45581910,47782237,2200327,TN
chr19,Bn88895,49947310,58469534,8522224,CNL
chr19,Bn88896,88653292,96701272,8047980,CNL
chr19,Bn88897,80196440,89989225,9792785,CN
chr19,Bn88898,7377932,74293067,66915135,CN
chr19,Bn88899,47319151,71452655,24133504,NBS
chr19,Bn88900,39136144,66539135,27402991,CNL
chr19,Bn88901,32387618,39335149,6947531,CN
chr19,Bn88902,28357038,85856223,57499185,CN
chr19,Bn88903,69008914,86727440,17718526,TN
chr19,Bn88904,24075410,79381739,55306329,TNL
chr19,Bn88905,72835053,81109848,8274795,TN
chr19,Bn88906,94961321,97030817,2069496,NBS
chr19,Bn88907,16462353,84211026,67748673,CN
chr19,Bn88908,39945671,42870619,2924948,CN
chr19,Bn88909,76612774,76989693,376919,TN
chr19,Bn88910,61814289,78214765,16400476,RLK
chr19,Bn88911,95544452,95778077,233625,RLK
chr19,Bn88912,3365347,17565894,14200547,TN
chr19,Bn88913,15667003,44496277,28829274,NBS
chr19,Bn88914,47043413,98772464,51729051,NBS
chr19,Bn88915,15886800,61354741,45467941,TN
chr19,Bn88916,80020527,86784791,6764264,NBS
chr19,Bn88917,93488300,99259049,5770749,NBS
chr19,Bn88918,98768265,99843117,1074852,RLK
chr19,Bn88919,62655378,78435845,15780467,RLP
chr19,Bn88920,94435751,96710034,2274283,RLP
chr19,Bn88921,49038849,90957044,41918195,CNL
chr19,Bn88922,97708516,99135424,1426908,NBS
chr19,Bn88923,84943724,89444968,4501244,RLP
chr19,Bn88924,44558289,53180792,8622503,CN
chr19,Bn88925,13715221,52226787,38511566,TN
chr19,Bn88926,34610521,58256982,23646461,RLK
chr19,Bn88927,34235604,92247745,58012141,TN
chr19,Bn88928,17461039,98593143,81132104,CN
chr19,Bn88929,55897906,69071486,13173580,RLK
chr19,Bn88930,33188623,46611905,13423282,NBS
chr19,Bn88931,54282341,67001673,12719332,RLK
chr19,Bn88932,50570641,52838458,2267817,CN
chr19,Bn88933,12568168,32398042,19829874,TNL
chr19,Bn88934,75581900,94667023,19085123,RLP
chr19,Bn88935,69189884,78091963,8902079,TN
chr19,Bn88936,67869565,86896786,19027221,NBS
chr19,Bn88937,53039670,78487009,25447339,NBS
chr19,Bn88938,47936345,50394036,2457691,NBS
chr19,Bn88939,63811796,89143257,25331461,NBS
chr19,Bn88940,7523967,32218442,24694475,CN
chr19,Bn88941,69936228,89441221,19504993,CNL
chr19,Bn88942,89208940,93907130,4698190,NBS
chr19,Bn88943,53420319,90084014,36663695,TN
chr19,Bn88944,25527182,37889890,12362708,RLP
chr19,Bn88945,62544903,95942736,33397833,NBS
chr19,Bn88946,95225085,99228442,4003357,CNL
chr19,Bn88947,43953981,50951161,6997180,NBS
chr19,Bn88948,90794372,91485391,691019,CNL
chr19,Bn88949,28771411,53634767,24863356,CNL
chr19,Bn88950,43155825,75163279,32007454,TN
chr19,Bn88951,60857698,91576227,30718529,TN
chr19,Bn88952,41755977,99382800,57626823,RLP
chr19,Bn88953,14393598,20894370,6500772,CNL
chr19,Bn88954,79640703,81784487,2143784,TNL
chr19,Bn88955,71181378,86831955,15650577,TN
chr19,Bn88956,33805157,64018397,30213240,RLK
chr19,Bn88957,3857562,72864949,69007387,NBS
chr19,Bn88958,43583489,72790910,29207421,CN
chr19,Bn88959,28365931,64463596,36097665,TNL
chr19,Bn88960,21470764,26785155,5314391,CNL
chr19,Bn88961,36031768,54102460,18070692,TN
chr19,Bn88962,92652412,99312626,6660214,RLK
chr19,Bn88963,38807334,40960961,2153627,RLK
chr19,Bn88964,90047834,91912545,1864711,RLK
chr19,Bn88965,87263170,93124525,5861355,TNL
chr19,Bn88966,63132683,80252177,17119494,TN
chr19,Bn88967,35919522,77580468,41660946,TN
chr19,Bn88968,95705540,97579369,1873829,NBS
chr19,Bn88969,23465070,79756195,56291125,CN
chr19,Bn88970,47207408,87788535,40581127,CN
chr19,Bn88971,93345748,93374824,29076,NBS
chr19,Bn88972,75272802,79089350,3816548,RLP
chr19,Bn88973,78117782,99564308,21446526,CN
chr19,Bn88974,5956461,29223666,23267205,RLP
chr19,Bn88975,53363483,96595273,43231790,RLK
chr19,Bn88976,52094748,93713309,41618561,RLP
chr19,Bn88977,83790560,96782086,12991526,CNL
chr19,Bn88978,4824054,15321528,10497474,RLP
chr19,Bn88979,9466336,12731603,3265267,RLP
chr19,Bn88980,82633312,82907777,274465,RLK
chr19,Bn88981,99353164,99355647,2483,RLK
chr19,Bn88982,25567751,32686175,7118424,NBS
chr19,Bn88983,27102526,90320051,63217525,CNL
chr19,Bn88984,18821937,61874025,43052088,RLK
chr19,Bn88985,97908126,98009809,101683,TNL
chr19,Bn88986,41484602,87734465,46249863,CNL
chr19,Bn88987,95327677,98058519,2730842,TN
chr19,Bn88988,11461939,26083940,14622001,CNL
chr19,Bn88989,29564011,44795644,15231633,RLK
chr19,Bn88990,18364594,65716948,47352354,NBS
chr19,Bn88991,34865348,46780926,11915578,TNL
chr19,Bn88992,44050186,55816239,11766053,CNL
chr19,Bn88993,32161968,54293679,22131711,CNL
chr19,Bn88994,80559105,93549906,12990801,CN
chr19,Bn88995,62222224,72282520,10060296,RLP
chr19,Bn88996,8533913,55404651,46870738,RLK
chr19,Bn88997,90249923,90395853,145930,RLK
chr19,Bn88998,80640766,87685303,7044537,TN
chr19,Bn88999,22296933,83513088,61216155,CNL
chr19,Bn89000,38451276,73731596,35280320,CNL
chr19,Bn89001,2148385,87604101,85455716,NBS
chr19,Bn89002,35448423,97107413,61658990,TN
chr19,Bn89003,53541796,56729887,3188091,RLK
chr19,Bn89004,52510599,73832578,21321979,CN
chr19,Bn89005,8980937,65003882,56022945,RLK
chr19,Bn89006,76437411,89083480,12646069,RLK
chr19,Bn89007,6773137,98531071,91757934,TNL
chr19,Bn89008,92520037,96372145,3852108,TN
chr19,Bn89009,3930334,60456484,56526150,RLK
chr19,Bn89010,88618447,98824559,10206112,RLK
chr19,Bn89011,82756859,89983101,7226242,CNL
chr19,Bn89012,96341788,98119622,1777834,TNL
chr19,Bn89013,16971112,18479575,1508463,CN
chr19,Bn89014,93448861,99511665,6062804,RLP
chr19,Bn89015,84734897,91527209,6792312,CNL
chr19,Bn89016,45690778,79295546,33604768,CN
chr19,Bn89017,47771874,61098290,13326416,RLK
chr19,Bn89018,70886956,74974690,4087734,TN
chr19,Bn89019,52185330,72049719,19864389,CN
chr19,Bn89020,63199278,68851908,5652630,CN
chr19,Bn89021,6069886,20789658,14719772,TNL
chr19,Bn89022,22110633,96631014,74520381,TN
chr19,Bn89023,7024077,70846247,63822170,TNL
chr19,Bn89024,20528692,37236770,16708078,CN
chr19,Bn89025,45916954,58145672,12228718,TNL
chr19,Bn89026,31336017,32617429,1281412,TNL
chr19,Bn89027,75374242,94950807,19576565,TN
chr19,Bn89028,63280449,80821160,17540711,TNL
chr19,Bn89029,88821382,94864225,6042843,TNL
chr19,Bn89030,21136900,63618593,42481693,CNL
chr19,Bn89031,98395806,99041677,645871,TN
chr19,Bn89032,35798958,91383046,55584088,RLK
chr19,Bn89033,7931861,48007677,40075816,TNL
chr19,Bn89034,48655811,52649769,3993958,TN
chr19,Bn89035,69364703,80157731,10793028,TN
chr19,Bn89036,65403749,97272709,31868960,TN
chr19,Bn89037,32381402,72279847,39898445,RLK
chr19,Bn89038,87312433,94813121,7500688,CN
chr19,Bn89039,1876334,37835394,35959060,RLK
chr19,Bn89040,35408850,69797926,34389076,TNL
chr19,Bn89041,72097043,87310408,15213365,CNL
chr19,Bn89042,61508673,65482913,3974240,RLP
chr19,Bn89043,97516160,99740403,2224243,NBS
chr19,Bn89044,96887830,99068864,2181034,NBS
chr19,Bn89045,64574898,77671703,13096805,RLK
chr19,Bn89046,80846312,92330535,11484223,CN
chr19,Bn89047,12670367,37298408,24628041,RLP
chr19,Bn89048,83800667,89952274,6151607,CNL
chr19,Bn89049,48750122,59759048,11008926,TN
chr19,Bn89050,13995972,58613804,44617832,RLK
chr19,Bn89051,82768134,97595903,14827769,RLK
chr19,Bn89052,5817112,14404203,8587091,RLK
chr19,Bn89053,84638515,89672846,5034331,TN
chr19,Bn89054,49431613,54264974,4833361,RLP
chr19,Bn89055,33371594,45453436,12081842,NBS
chr19,Bn89056,44775988,80792277,36016289,RLK
chr19,Bn89057,61669083,64106693,2437610,RLP
chr19,Bn89058,83323405,92500587,9177182,CNL
chr19,Bn89059,61626057,70707939,9081882,CN
chr19,Bn89060,14754373,53595193,38840820,RLP
chr19,Bn89061,97422322,98183287,760965,RLK
chr19,Bn89062,9965665,46554568,36588903,TN
chr19,Bn89063,29188822,95899978,66711156,TNL
chr19,Bn89064,68560841,71216262,2655421,RLP
chr19,Bn89065,93205260,93685624,480364,TN
chr19,Bn89066,15006019,22560953,7554934,CNL
chr19,Bn89067,51169493,87382483,36212990,NBS
chr19,Bn89068,81330944,86409213,5078269,TNL
chr19,Bn89069,1691327,20653748,18962421,NBS
chr19,Bn89070,62791632,96240541,33448909,NBS
chr19,Bn89071,24012100,49918711,25906611,CNL
chr19,Bn89072,31503803,43142215,11638412,CN
chr19,Bn89073,91996482,97737724,5741242,NBS
chr19,Bn89074,32029475,66201952,34172477,RLP
chr19,Bn89075,38420544,67898500,29477956,RLP
chr19,Bn89076,50217395,79633279,29415884,CNL
chr19,Bn89077,66316136,97428683,31112547,RLK
chr19,Bn89078,87725365,91442216,3716851,RLP
chr19,Bn89079,33307104,75169483,41862379,NBS
chr19,Bn89080,27078233,28120000,1041767,TN
chr19,Bn89081,67903976,78493150,10589174,NBS
chr19,Bn89082,15861270,32936508,17075238,RLK
chr19,Bn89083,90693143,96116136,5422993,NBS
chr19,Bn89084,18747176,90623797,71876621,RLK
chr19,Bn89085,29275671,55487261,26211590,CNL
chr19,Bn89086,96624712,97526471,901759,CN
chr19,Bn89087,80830450,81437195,606745,CN
chr19,Bn89088,32349248,96340843,63991595,TN
chr19,Bn89089,19421248,26206249,6785001,RLP
chr19,Bn89090,31833921,55222575,23388654,RLP
chr19,Bn89091,35190884,49565871,14374987,RLK
chr19,Bn89092,10135576,69957930,59822354,TNL
chr19,Bn89093,47418741,99833041,52414300,TN
chr19,Bn89094,86962579,93900149,6937570,CN
chr19,Bn89095,82760529,96178342,13417813,RLK
chr19,Bn89096,69237046,91203847,21966801,TNL
chr19,Bn89097,5913175,32727043,26813868,CN
chr19,Bn89098,73878878,88882662,15003784,NBS
chr19,Bn89099,29492157,69466821,39974664,TNL
chr19,Bn89100,16397851,38998735,22600884,CN
chr19,Bn89101,28299681,38377041,10077360,RLK
chr19,Bn89102,58121732,69842529,11720797,TN
chr19,Bn89103,18586479,41252500,22666021,CN
chr19,Bn89104,89160987,92834977,3673990,NBS
chr19,Bn89105,38519696,44700163,6180467,RLK
chr19,Bn89106,58636575,86415299,27778724,RLP
chr19,Bn89107,28112247,87158210,59045963,RLP
chr19,Bn89108,78797356,92700766,13903410,CNL
chr19,Bn89109,55166818,94079616,38912798,CNL
chr19,Bn89110,24024944,26028330,2003386,NBS
chr19,Bn89111,28713668,41455443,12741775,RLK
chr19,Bn89112,64776013,90221909,25445896,RLK
chr19,Bn89113,13921742,57164075,43242333,TN
chr19,Bn89114,6971505,79574513,72603008,CNL
chr19,Bn89115,41414033,71569776,30155743,TNL
chr19,Bn89116,13463904,52557960,39094056,CNL
chr19,Bn89117,2968606,33491784,30523178,RLP
chr19,Bn89118,37835799,83079782,45243983,TN
chr19,Bn89119,85285731,96575493,11289762,NBS
chr19,Bn89120,96536538,97756121,1219583,RLP
chr19,Bn89121,76392306,87196457,10804151,TNL
chr19,Bn89122,75649853,91366208,15716355,CN
chr19,Bn89123,3610405,15684707,12074302,CNL
chr19,Bn89124,53454714,78074230,24619516,CNL
chr19,Bn89125,70609818,73836024,3226206,CN
chr19,Bn89126,37091577,94974897,57883320,CNL
chr19,Bn89127,58774747,81700871,22926124,CNL
chr19,Bn89128,60765684,99885376,39119692,TNL
chr19,Bn89129,79563926,91154910,11590984,TN
chr19,Bn89130,32639461,45646558,13007097,RLP
chr19,Bn89131,20212713,74644245,54431532,RLK
chr19,Bn89132,35970532,69609440,33638908,TNL
chr19,Bn89133,26240149,56028085,29787936,CN
chr19,Bn89134,31166319,70874413,39708094,RLK
chr19,Bn89135,82082016,93927438,11845422,NBS
chr19,Bn89136,19747634,33754444,14006810,TNL
chr19,Bn89137,7866617,34383303,26516686,TN
chr19,Bn89138,52334609,89108272,36773663,TN
chr19,Bn89139,61629017,63839340,2210323,TNL
chr19,Bn89140,87661669,96173439,8511770,RLK
chr19,Bn89141,3024846,80824509,77799663,TNL
chr19,Bn89142,17805521,70512077,52706556,TN
chr19,Bn89143,21744014,81344471,59600457,TNL
chr19,Bn89144,18174321,53185969,35011648,CN
chr19,Bn89145,74726664,87734533,13007869,TNL
chr19,Bn89146,95978178,96723279,745101,CNL
chr19,Bn89147,11503962,51541400,40037438,CN
chr19,Bn89148,24379848,69912174,45532326,CNL
chr19,Bn89149,16510206,53436503,36926297,NBS
chr19,Bn89150,28102441,81482032,53379591,NBS
chr19,Bn89151,2212664,98062572,95849908,RLK
chr19,Bn89152,35870743,37537778,1667035,CNL
chr19,Bn89153,89247826,97811789,8563963,TNL
chr19,Bn89154,49333386,90073136,40739750,TN
chr19,Bn89155,67159312,71994808,4835496,CN
chr19,Bn89156,99776894,99982186,205292,RLP
chr19,Bn89157,7102602,8867694,1765092,TN
chr19,Bn89158,91872909,98659495,6786586,RLP
chr19,Bn89159,92131170,92153814,22644,CNL
chr19,Bn89160,85807870,89917589,4109719,RLK
chr19,Bn89161,60584221,61499806,915585,TNL
chr19,Bn89162,48184778,73815365,25630587,TN
chr19,Bn89163,49969538,95878775,45909237,TNL
chr19,Bn89164,28695338,73228259,44532921,CNL
chr19,Bn89165,68062733,84290842,16228109,RLK
chr19,Bn89166,51406481,58078817,6672336,TN
chr19,Bn89167,2198580,87035868,84837288,CNL
chr19,Bn89168,2455718,55435945,52980227,TNL
chr19,Bn89169,96118766,99998465,3879699,TN
chr19,Bn89170,57215092,76819302,19604210,CN
chr19,Bn89171,36990084,71303568,34313484,TN
chr19,Bn89172,92868332,98241436,5373104,RLK
chr19,Bn89173,5227516,84186872,78959356,TN
chr19,Bn89174,88918222,95320229,6402007,CN
chr19,Bn89175,83611191,89675562,6064371,CNL
chr19,Bn89176,17426129,26160861,8734732,CN
chr19,Bn89177,14717293,16259021,1541728,RLP
chr19,Bn89178,63849168,93774709,29925541,RLK
chr19,Bn89179,5615345,65519810,59904465,NBS
chr19,Bn89180,32876571,70503129,37626558,NBS
chr19,Bn89181,55450281,91445563,35995282,TNL
chr19,Bn89182,82608989,87893159,5284170,TN
chr19,Bn89183,65556218,94963383,29407165,TN
chr19,Bn89184,18350407,81330278,62979871,CNL
chr19,Bn89185,69534377,81685552,12151175,TNL
chr19,Bn89186,45629126,88495015,42865889,CN
chr19,Bn89187,81566413,86015960,4449547,CNL
chr19,Bn89188,94242232,95902480,1660248,TN
chr19,Bn89189,57769156,83722620,25953464,RLP
chr19,Bn89190,86938273,97919932,10981659,CN
chr19,Bn89191,6989746,65642185,58652439,TNL
chr19,Bn89192,29567138,81472217,51905079,TN
chr19,Bn89193,69705109,76157259,6452150,NBS
chr19,Bn89194,9025721,59742750,50717029,RLK
chr19,Bn89195,98915026,99937961,1022935,TNL
chr19,Bn89196,11657771,43687410,32029639,CN
chr19,Bn89197,4973216,79993748,75020532,TNL
chr19,Bn89198,37333882,40402673,3068791,TNL
chr19,Bn89199,57181751,88619441,31437690,RLK
chr19,Bn89200,78336841,90526976,12190135,CN
chr19,Bn89201,2045870,93725104,91679234,CNL
chr19,Bn89202,73259785,96331249,23071464,CN
chr19,Bn89203,2659817,75311417,72651600,CN
chr19,Bn89204,7841687,94049935,86208248,CN
chr19,Bn89205,14885634,85180147,70294513,RLK
